id,Età,Celibi,Coniugati,Divorziati,Vedovi,Uniti civilmente,Maschi già in unione civile (per scioglimento unione),Maschi già in unione civile (per decesso del partner),Totale maschi,Nubili,Coniugate,Divorziate,Vedove,Unite civilmente,Femmine già in unione civile (per scioglimento unione),Femmine già in unione civile (per decesso del partner),Totale femmine,Totale
26,0,6731,0,0,0,0,0,0,6731,6276,0,0,0,0,0,0,6276,13007
26,1,6979,0,0,0,0,0,0,6979,6661,0,0,0,0,0,0,6661,13640
26,2,7290,0,0,0,0,0,0,7290,6921,0,0,0,0,0,0,6921,14211
26,3,7481,0,0,0,0,0,0,7481,7104,0,0,0,0,0,0,7104,14585
26,4,7690,0,0,0,0,0,0,7690,7308,0,0,0,0,0,0,7308,14998
26,5,7870,0,0,0,0,0,0,7870,7623,0,0,0,0,0,0,7623,15493
26,6,8392,0,0,0,0,0,0,8392,7972,0,0,0,0,0,0,7972,16364
26,7,8787,0,0,0,0,0,0,8787,8296,0,0,0,0,0,0,8296,17083
26,8,9195,0,0,0,0,0,0,9195,8391,0,0,0,0,0,0,8391,17586
26,9,9233,0,0,0,0,0,0,9233,8990,0,0,0,0,0,0,8990,18223
26,10,9750,0,0,0,0,0,0,9750,9076,0,0,0,0,0,0,9076,18826
26,11,9954,0,0,0,0,0,0,9954,9436,0,0,0,0,0,0,9436,19390
26,12,10247,0,0,0,0,0,0,10247,9399,0,0,0,0,0,0,9399,19646
26,13,10391,0,0,0,0,0,0,10391,9814,0,0,0,0,0,0,9814,20205
26,14,10742,0,0,0,0,0,0,10742,9946,0,0,0,0,0,0,9946,20688
26,15,10822,0,0,0,0,0,0,10822,10103,0,0,0,0,0,0,10103,20925
26,16,10662,0,0,0,0,0,0,10662,9982,0,1,0,0,0,0,9983,20645
26,17,10725,0,0,0,0,0,0,10725,9732,0,0,0,0,0,0,9732,20457
26,18,10670,0,0,0,0,0,0,10670,9923,2,0,0,0,0,0,9925,20595
26,19,10887,3,0,0,0,0,0,10890,9799,21,0,0,0,0,0,9820,20710
26,20,10898,5,0,0,0,0,0,10903,9887,58,1,0,1,0,0,9947,20850
26,21,10630,9,1,0,1,0,0,10641,9781,100,2,0,1,0,0,9884,20525
26,22,10621,39,1,0,2,0,0,10663,9744,177,9,0,0,0,0,9930,20593
26,23,11402,64,3,1,1,0,0,11471,9878,292,5,1,2,0,0,10178,21649
26,24,11294,115,9,0,1,0,0,11419,9476,441,6,2,2,1,0,9928,21347
26,25,11542,208,6,0,7,0,0,11763,9596,592,11,0,4,0,0,10203,21966
26,26,11277,288,7,0,4,0,0,11576,9581,831,21,1,4,1,0,10439,22015
26,27,11310,422,13,0,9,1,0,11755,9437,1083,37,2,10,0,0,10569,22324
26,28,10993,702,14,0,11,0,0,11720,8991,1399,32,7,6,0,0,10435,22155
26,29,10905,940,18,1,10,2,0,11876,8623,1902,65,12,21,0,0,10623,22499
26,30,10306,1318,42,0,19,2,0,11687,8534,2389,74,3,23,2,0,11025,22712
26,31,10336,1778,53,1,18,2,0,12188,8031,3099,99,6,21,4,0,11260,23448
26,32,9764,2245,71,2,18,0,0,12100,7743,3655,127,12,26,0,0,11563,23663
26,33,9599,2932,82,1,17,0,0,12631,7272,4206,218,13,33,4,0,11746,24377
26,34,8667,3266,111,11,25,1,0,12081,6806,4542,222,13,24,4,0,11611,23692
26,35,8326,3895,161,12,46,3,0,12443,6410,5100,270,28,27,2,0,11837,24280
26,36,7537,4154,173,7,37,2,0,11910,5839,5469,324,34,39,0,0,11705,23615
26,37,7277,4556,225,11,29,2,0,12100,5447,5782,402,42,22,1,0,11696,23796
26,38,6980,4940,258,10,30,1,0,12219,5328,6322,486,63,31,1,0,12231,24450
26,39,6619,5253,288,13,26,1,0,12200,5122,6456,587,52,31,4,0,12252,24452
26,40,6371,5698,353,12,33,0,0,12467,4882,6970,596,67,34,1,0,12550,25017
26,41,6246,6284,409,8,22,2,0,12971,4836,7404,710,65,22,2,0,13039,26010
26,42,5915,6393,495,38,25,0,0,12866,4635,7512,791,116,25,0,0,13079,25945
26,43,5765,6724,528,25,30,2,0,13074,4505,7793,897,131,21,1,0,13348,26422
26,44,5816,7143,554,41,28,1,1,13584,4294,8276,1012,135,18,1,0,13736,27320
26,45,5922,7556,680,56,26,1,1,14242,4543,8855,1144,148,26,1,0,14717,28959
26,46,5952,8172,773,47,31,1,0,14976,4516,9565,1267,172,24,1,0,15545,30521
26,47,5981,8629,905,47,24,1,0,15587,4409,9998,1550,206,19,3,0,16185,31772
26,48,5990,9464,1129,55,44,0,1,16683,4495,10714,1658,256,31,1,0,17155,33838
26,49,6110,10231,1218,63,44,3,0,17669,4357,11393,1886,271,22,3,0,17932,35601
26,50,5758,10375,1337,68,50,2,1,17591,4193,11400,1925,301,27,0,0,17846,35437
26,51,5437,10941,1383,116,32,1,1,17911,3831,11777,2162,328,14,0,0,18112,36023
26,52,5213,10964,1492,99,39,2,1,17810,3615,12300,2164,447,21,2,0,18549,36359
26,53,4872,11251,1509,101,35,0,0,17768,3506,12195,2281,496,24,0,0,18502,36270
26,54,4680,11549,1634,146,39,1,0,18049,3245,12823,2337,546,15,0,0,18966,37015
26,55,4316,11869,1714,139,37,1,0,18076,2965,12503,2480,644,22,1,0,18615,36691
26,56,3970,11876,1733,161,34,0,1,17775,2876,12506,2489,734,24,0,0,18629,36404
26,57,3784,11993,1851,219,33,1,2,17883,2581,12678,2407,780,12,0,0,18458,36341
26,58,3433,11867,1839,201,43,0,2,17385,2444,12458,2450,905,14,0,0,18271,35656
26,59,3234,12222,1871,218,37,0,1,17583,2334,12723,2485,977,14,0,0,18533,36116
26,60,2765,11508,1735,267,36,1,2,16314,2070,12133,2223,1045,12,0,0,17483,33797
26,61,2372,11077,1563,301,28,0,2,15343,1845,11608,2164,1168,10,0,1,16796,32139
26,62,2223,11137,1529,295,29,0,1,15214,1634,11571,2032,1350,6,0,0,16593,31807
26,63,1932,10802,1515,306,19,0,3,14577,1437,11060,1979,1465,8,0,0,15949,30526
26,64,1802,10738,1434,382,31,0,2,14389,1361,10872,1813,1464,3,0,0,15513,29902
26,65,1666,10426,1295,382,21,0,1,13791,1273,10538,1710,1685,11,0,0,15217,29008
26,66,1565,10458,1241,407,19,0,0,13690,1190,10373,1540,1886,10,0,0,14999,28689
26,67,1357,10343,1137,498,22,0,1,13358,1094,10052,1530,2071,9,0,0,14756,28114
26,68,1311,10064,1002,527,15,0,1,12920,1001,9733,1376,2287,3,0,0,14400,27320
26,69,1243,9875,970,572,10,0,0,12670,956,9476,1262,2459,2,0,0,14155,26825
26,70,1091,9433,860,598,13,0,1,11996,829,9094,1207,2598,5,0,1,13734,25730
26,71,929,9383,802,671,11,0,0,11796,820,8862,1093,2788,9,0,0,13572,25368
26,72,918,9043,687,702,10,0,1,11361,735,8655,991,3110,6,0,0,13497,24858
26,73,915,9368,689,745,8,1,2,11728,717,8784,958,3475,1,0,0,13935,25663
26,74,805,9590,636,885,8,0,1,11925,721,8634,860,3851,1,0,0,14067,25992
26,75,840,9895,599,1043,9,0,3,12389,762,8803,906,4412,3,0,0,14886,27275
26,76,723,9790,550,1063,7,0,1,12134,676,8295,797,4622,3,0,0,14393,26527
26,77,693,9222,510,1180,7,0,0,11612,662,7627,800,4985,0,0,0,14074,25686
26,78,494,6944,334,925,10,0,0,8707,473,5584,497,4191,3,0,0,10748,19455
26,79,467,6989,326,1141,7,0,0,8930,544,5573,527,4635,0,0,0,11279,20209
26,80,467,6528,268,1117,5,0,1,8386,523,5045,498,5069,0,0,0,11135,19521
26,81,495,6280,224,1286,7,0,0,8292,536,4563,486,5302,2,0,0,10889,19181
26,82,440,5929,228,1227,4,0,0,7828,530,4120,379,5713,0,0,0,10742,18570
26,83,416,6092,232,1552,3,0,1,8296,541,4036,370,6524,1,0,1,11473,19769
26,84,375,5530,170,1552,4,0,1,7632,546,3441,334,6636,1,0,1,10959,18591
26,85,323,4971,157,1473,3,0,0,6927,484,2916,311,6388,1,0,0,10100,17027
26,86,274,3950,121,1441,1,0,0,5787,472,2209,244,5894,0,0,0,8819,14606
26,87,196,3121,82,1288,1,0,0,4688,413,1571,190,5403,0,0,0,7577,12265
26,88,175,2606,73,1252,1,0,0,4107,368,1267,173,5191,0,0,0,6999,11106
26,89,135,2109,52,1067,2,0,0,3365,305,913,129,4800,0,0,0,6147,9512
26,90,94,1566,40,954,1,0,0,2655,265,650,108,4087,0,0,0,5110,7765
26,91,84,1161,26,828,0,0,0,2099,277,498,75,3601,0,0,0,4451,6550
26,92,67,872,16,723,0,0,0,1678,213,304,68,3201,0,0,0,3786,5464
26,93,46,642,9,582,0,0,0,1279,208,228,55,2724,0,0,0,3215,4494
26,94,34,409,5,405,0,0,0,853,163,127,41,2005,0,0,0,2336,3189
26,95,21,261,7,284,0,0,0,573,119,86,21,1487,0,0,0,1713,2286
26,96,17,149,1,200,0,0,0,367,93,56,19,1071,0,0,0,1239,1606
26,97,10,83,1,145,0,0,0,239,59,20,9,778,0,0,0,866,1105
26,98,5,41,0,83,0,0,0,129,51,16,11,517,0,0,0,595,724
26,99,7,23,0,59,1,0,0,90,29,6,7,378,0,0,0,420,510
26,100,9,23,2,77,0,0,0,111,57,10,7,519,0,0,0,593,704
26,999,515347,476764,46071,32415,1350,38,37,1072022,438392,485170,67490,140851,867,41,4,1132815,2204837
27,0,480,0,0,0,0,0,0,480,468,0,0,0,0,0,0,468,948
27,1,475,0,0,0,0,0,0,475,520,0,0,0,0,0,0,520,995
27,2,539,0,0,0,0,0,0,539,495,0,0,0,0,0,0,495,1034
27,3,520,0,0,0,0,0,0,520,517,0,0,0,0,0,0,517,1037
27,4,573,0,0,0,0,0,0,573,482,0,0,0,0,0,0,482,1055
27,5,560,0,0,0,0,0,0,560,580,0,0,0,0,0,0,580,1140
27,6,583,0,0,0,0,0,0,583,594,0,0,0,0,0,0,594,1177
27,7,638,0,0,0,0,0,0,638,566,0,0,0,0,0,0,566,1204
27,8,657,0,0,0,0,0,0,657,618,0,0,0,0,0,0,618,1275
27,9,685,0,0,0,0,0,0,685,613,0,0,0,0,0,0,613,1298
27,10,643,0,0,0,0,0,0,643,667,0,0,0,0,0,0,667,1310
27,11,721,0,0,0,0,0,0,721,701,0,0,0,0,0,0,701,1422
27,12,701,0,0,0,0,0,0,701,629,0,0,0,0,0,0,629,1330
27,13,738,0,0,0,0,0,0,738,648,0,0,0,0,0,0,648,1386
27,14,770,0,0,0,0,0,0,770,710,0,0,0,0,0,0,710,1480
27,15,724,0,0,0,0,0,0,724,706,0,0,0,0,0,0,706,1430
27,16,774,0,0,0,0,0,0,774,741,0,0,0,0,0,0,741,1515
27,17,756,0,0,0,0,0,0,756,707,0,0,0,0,0,0,707,1463
27,18,740,0,0,0,0,0,0,740,706,1,0,0,0,0,0,707,1447
27,19,758,0,0,0,0,0,0,758,676,2,0,0,0,0,0,678,1436
27,20,809,0,0,0,0,0,0,809,677,10,0,0,0,0,0,687,1496
27,21,771,3,0,0,0,0,0,774,691,16,0,0,0,0,0,707,1481
27,22,770,8,1,0,1,0,0,780,671,14,0,0,0,0,0,685,1465
27,23,840,9,0,0,0,0,0,849,690,24,2,0,0,0,0,716,1565
27,24,826,11,2,0,0,0,0,839,694,40,2,0,0,0,0,736,1575
27,25,838,9,4,0,0,0,0,851,680,53,2,0,0,0,0,735,1586
27,26,839,24,1,0,1,0,0,865,668,73,1,0,0,0,0,742,1607
27,27,803,41,1,1,1,0,0,847,656,97,7,1,0,0,0,761,1608
27,28,818,62,6,0,2,0,0,888,602,128,1,0,1,1,0,733,1621
27,29,774,70,5,0,0,1,0,850,563,143,3,1,0,0,0,710,1560
27,30,730,95,3,0,1,0,0,829,552,220,3,0,0,0,0,775,1604
27,31,750,155,4,1,0,0,0,910,537,230,18,0,0,0,0,785,1695
27,32,698,178,6,0,0,0,0,882,519,273,7,1,0,1,0,801,1683
27,33,685,213,11,2,2,1,0,914,469,325,22,2,0,1,0,819,1733
27,34,583,237,8,2,2,0,0,832,425,334,20,1,1,0,0,781,1613
27,35,562,281,21,1,0,0,0,865,433,377,18,2,3,0,0,833,1698
27,36,564,278,14,0,1,0,0,857,383,383,25,1,1,0,0,793,1650
27,37,535,294,26,4,3,0,0,862,337,479,33,1,0,0,0,850,1712
27,38,531,376,21,1,2,0,0,931,360,467,42,3,1,0,0,873,1804
27,39,512,373,34,3,1,0,0,923,356,475,28,4,0,0,0,863,1786
27,40,469,370,26,1,1,0,0,867,329,533,56,9,0,0,0,927,1794
27,41,497,467,27,1,1,0,0,993,311,549,54,4,0,0,0,918,1911
27,42,478,471,32,1,1,0,0,983,319,525,54,4,0,0,0,902,1885
27,43,403,493,40,4,1,0,0,941,290,594,64,11,0,0,0,959,1900
27,44,427,563,52,5,0,0,0,1047,265,587,71,9,0,0,0,932,1979
27,45,452,545,62,4,0,0,0,1063,308,652,87,14,1,0,0,1062,2125
27,46,458,574,61,5,0,0,0,1098,305,749,97,19,2,0,0,1172,2270
27,47,425,664,68,5,1,0,0,1163,296,727,106,20,0,1,0,1150,2313
27,48,455,683,85,5,2,0,0,1230,260,785,131,22,0,0,0,1198,2428
27,49,462,692,77,7,0,0,0,1238,253,744,120,25,2,0,0,1144,2382
27,50,412,716,113,4,1,0,0,1246,257,887,125,22,2,0,0,1293,2539
27,51,440,763,108,11,0,0,0,1322,291,839,137,42,5,0,0,1314,2636
27,52,416,815,111,5,1,0,0,1348,261,890,158,32,1,0,0,1342,2690
27,53,398,780,111,9,2,0,0,1300,199,864,175,51,0,0,0,1289,2589
27,54,350,881,135,11,2,0,0,1379,228,948,171,41,1,0,0,1389,2768
27,55,358,853,137,11,3,0,0,1362,214,907,172,54,1,0,0,1348,2710
27,56,308,898,143,9,1,0,0,1359,188,917,160,79,0,0,0,1344,2703
27,57,301,927,127,13,1,0,0,1369,170,955,214,83,0,0,0,1422,2791
27,58,296,995,155,17,2,0,0,1465,199,1028,156,85,0,0,0,1468,2933
27,59,277,954,148,24,0,0,0,1403,185,1031,163,85,0,0,0,1464,2867
27,60,245,982,132,17,2,0,0,1378,157,983,150,90,0,0,0,1380,2758
27,61,256,958,129,25,2,0,0,1370,139,934,156,127,1,0,0,1357,2727
27,62,206,935,131,21,2,0,0,1295,141,942,132,161,0,0,0,1376,2671
27,63,203,898,124,37,2,0,0,1264,107,944,128,162,0,0,0,1341,2605
27,64,182,858,107,35,2,0,0,1184,95,867,117,138,0,0,0,1217,2401
27,65,157,893,89,31,0,0,0,1170,100,876,123,183,0,0,0,1282,2452
27,66,137,830,100,34,3,0,0,1104,78,849,131,157,0,0,0,1215,2319
27,67,129,805,85,50,2,0,0,1071,66,790,108,224,0,0,0,1188,2259
27,68,136,837,93,58,0,0,0,1124,66,784,84,201,0,0,0,1135,2259
27,69,114,781,96,45,0,0,0,1036,75,755,97,213,0,0,0,1140,2176
27,70,99,782,72,47,1,0,0,1001,74,710,70,241,0,0,0,1095,2096
27,71,103,816,67,49,0,0,0,1035,52,684,73,263,0,0,0,1072,2107
27,72,87,778,62,70,0,0,0,997,37,687,69,256,0,0,0,1049,2046
27,73,97,785,54,72,0,0,0,1008,57,645,64,343,0,0,0,1109,2117
27,74,88,740,56,75,0,0,0,959,44,675,61,356,0,0,0,1136,2095
27,75,84,793,47,99,0,0,0,1023,45,668,77,377,0,0,0,1167,2190
27,76,73,720,52,86,1,0,0,932,52,579,65,401,0,0,0,1097,2029
27,77,78,666,37,103,1,0,0,885,48,533,52,436,0,0,0,1069,1954
27,78,55,465,22,68,0,0,0,610,30,346,27,350,0,0,0,753,1363
27,79,46,499,22,89,0,0,0,656,41,356,41,390,0,0,0,828,1484
27,80,46,416,27,83,1,0,0,573,37,352,23,435,0,0,0,847,1420
27,81,42,443,20,80,0,0,0,585,39,297,28,419,0,0,0,783,1368
27,82,47,402,16,99,0,0,0,564,43,327,21,430,0,0,0,821,1385
27,83,40,466,18,117,0,0,0,641,52,273,24,543,0,0,0,892,1533
27,84,34,417,12,135,0,0,0,598,49,253,29,607,0,0,0,938,1536
27,85,39,335,12,112,0,0,0,498,37,205,23,566,0,0,0,831,1329
27,86,37,286,5,109,0,0,0,437,41,135,16,536,0,0,0,728,1165
27,87,31,219,6,114,0,0,0,370,31,114,14,458,0,0,0,617,987
27,88,28,195,5,92,0,0,0,320,31,74,8,502,0,0,0,615,935
27,89,13,164,5,95,0,0,0,277,28,58,6,421,0,0,0,513,790
27,90,11,107,1,66,0,0,0,185,29,33,8,363,0,0,0,433,618
27,91,6,82,2,75,0,0,0,165,25,19,4,365,0,0,0,413,578
27,92,5,73,0,49,0,0,0,127,17,29,3,289,0,0,0,338,465
27,93,6,51,0,45,0,0,0,102,27,14,3,257,0,0,0,301,403
27,94,4,22,0,35,0,0,0,61,15,12,3,200,0,0,0,230,291
27,95,4,12,0,23,0,0,0,39,9,2,3,145,0,0,0,159,198
27,96,4,9,0,19,0,0,0,32,9,4,0,119,0,0,0,132,164
27,97,2,5,0,13,0,0,0,20,6,0,3,67,0,0,0,76,96
27,98,2,7,0,11,0,0,0,20,4,2,0,46,0,0,0,52,72
27,99,0,2,0,8,0,0,0,10,4,0,0,35,0,0,0,39,49
27,100,2,4,0,13,0,0,0,19,6,0,1,51,0,0,0,58,77
27,999,38333,36359,3692,2671,56,2,0,81113,30478,36685,4750,12651,23,4,0,84591,165704
28,0,1102,0,0,0,0,0,0,1102,1149,0,0,0,0,0,0,1149,2251
28,1,1221,0,0,0,0,0,0,1221,1150,0,0,0,0,0,0,1150,2371
28,2,1269,0,0,0,0,0,0,1269,1194,0,0,0,0,0,0,1194,2463
28,3,1307,0,0,0,0,0,0,1307,1188,0,0,0,0,0,0,1188,2495
28,4,1373,0,0,0,0,0,0,1373,1285,0,0,0,0,0,0,1285,2658
28,5,1377,0,0,0,0,0,0,1377,1371,0,0,0,0,0,0,1371,2748
28,6,1444,0,0,0,0,0,0,1444,1382,0,0,0,0,0,0,1382,2826
28,7,1527,0,0,0,0,0,0,1527,1444,0,0,0,0,0,0,1444,2971
28,8,1536,0,0,0,0,0,0,1536,1480,0,0,0,0,0,0,1480,3016
28,9,1602,0,0,0,0,0,0,1602,1520,0,0,0,0,0,0,1520,3122
28,10,1615,0,0,0,0,0,0,1615,1600,0,0,0,0,0,0,1600,3215
28,11,1706,0,0,0,0,0,0,1706,1630,0,0,0,0,0,0,1630,3336
28,12,1740,0,0,0,0,0,0,1740,1632,0,0,0,0,0,0,1632,3372
28,13,1721,0,0,0,0,0,0,1721,1616,0,0,0,0,0,0,1616,3337
28,14,1757,0,0,0,0,0,0,1757,1709,0,0,0,0,0,0,1709,3466
28,15,1742,0,0,0,0,0,0,1742,1695,0,0,0,0,0,0,1695,3437
28,16,1831,0,0,0,0,0,0,1831,1818,0,0,0,0,0,0,1818,3649
28,17,1737,0,0,0,0,0,0,1737,1728,1,0,0,0,0,0,1729,3466
28,18,1817,0,0,0,0,0,0,1817,1676,1,0,0,0,0,0,1677,3494
28,19,1855,0,0,0,0,0,0,1855,1658,4,0,0,0,0,0,1662,3517
28,20,1824,0,0,0,1,0,0,1825,1602,12,0,0,0,0,0,1614,3439
28,21,1810,3,0,0,1,0,0,1814,1605,21,0,0,1,0,0,1627,3441
28,22,1829,11,4,0,0,0,0,1844,1517,46,1,0,0,0,0,1564,3408
28,23,1892,16,4,0,0,0,0,1912,1632,68,2,0,0,0,0,1702,3614
28,24,1903,29,1,0,0,0,0,1933,1570,103,5,0,1,0,0,1679,3612
28,25,1887,41,3,0,1,0,0,1932,1544,147,1,0,0,0,0,1692,3624
28,26,1886,50,1,0,0,0,0,1937,1551,153,4,0,1,0,0,1709,3646
28,27,1798,90,5,0,0,0,0,1893,1436,212,8,0,1,0,0,1657,3550
28,28,1783,100,7,1,0,0,0,1891,1414,304,7,1,0,1,0,1727,3618
28,29,1649,182,11,0,1,0,0,1843,1400,430,17,0,5,0,0,1852,3695
28,30,1653,254,8,0,1,0,0,1916,1209,510,17,1,1,2,0,1740,3656
28,31,1637,330,11,0,5,0,0,1983,1278,627,21,3,2,0,0,1931,3914
28,32,1531,392,18,1,2,0,0,1944,1149,658,35,2,4,1,0,1849,3793
28,33,1470,474,18,3,5,0,0,1970,965,774,20,2,3,0,0,1764,3734
28,34,1365,589,20,1,8,0,0,1983,984,873,38,5,4,0,0,1904,3887
28,35,1354,659,26,4,2,0,0,2045,903,931,46,5,4,0,0,1889,3934
28,36,1209,728,32,1,1,0,0,1971,815,1063,51,10,1,0,0,1940,3911
28,37,1128,778,45,1,4,1,0,1957,813,1102,68,8,1,0,0,1992,3949
28,38,1059,875,49,1,4,0,0,1988,735,1129,96,7,3,0,0,1970,3958
28,39,1032,968,45,2,3,1,0,2051,750,1153,83,10,0,0,0,1996,4047
28,40,1046,1077,65,4,3,0,0,2195,734,1325,112,14,3,1,0,2189,4384
28,41,1007,1117,64,6,3,2,0,2199,733,1329,132,19,3,0,0,2216,4415
28,42,1042,1209,85,7,2,0,0,2345,687,1386,153,21,1,0,0,2248,4593
28,43,1000,1270,91,4,2,0,0,2367,662,1350,153,24,5,0,0,2194,4561
28,44,959,1288,129,14,5,0,0,2395,663,1457,171,20,1,0,0,2312,4707
28,45,982,1409,120,9,1,1,0,2522,641,1576,180,35,2,0,0,2434,4956
28,46,980,1495,131,7,3,0,0,2616,671,1677,204,38,1,0,0,2591,5207
28,47,995,1528,156,6,9,0,0,2694,658,1802,243,48,0,0,0,2751,5445
28,48,1036,1628,177,15,4,0,0,2860,653,1883,270,53,1,0,0,2860,5720
28,49,948,1754,214,15,7,0,0,2938,626,1951,298,50,4,0,0,2929,5867
28,50,937,1789,227,16,11,0,1,2981,588,1933,321,64,1,1,0,2908,5889
28,51,819,1864,225,18,3,1,0,2930,584,2032,292,58,2,0,0,2968,5898
28,52,889,1945,225,23,4,1,0,3087,533,1959,311,68,2,0,0,2873,5960
28,53,722,1885,218,24,10,0,0,2859,491,2006,344,91,2,0,0,2934,5793
28,54,733,2077,282,23,4,0,0,3119,473,2088,357,116,0,1,0,3035,6154
28,55,713,1957,253,20,9,1,0,2953,437,2133,326,103,3,0,0,3002,5955
28,56,622,2068,282,33,6,0,0,3011,390,2098,335,146,2,0,0,2971,5982
28,57,632,2138,300,37,2,0,0,3109,438,2170,344,134,2,0,0,3088,6197
28,58,516,2060,301,37,5,1,0,2920,382,2242,367,165,1,0,0,3157,6077
28,59,502,2169,292,61,2,0,0,3026,344,2312,358,180,0,1,0,3195,6221
28,60,451,2130,251,50,3,1,0,2886,311,2114,301,207,1,0,0,2934,5820
28,61,407,2023,254,47,5,0,0,2736,303,1935,283,245,0,0,0,2766,5502
28,62,373,2052,247,48,3,0,0,2723,267,2009,297,229,1,0,0,2803,5526
28,63,316,1949,225,45,1,0,0,2536,243,1968,257,317,0,0,0,2785,5321
28,64,293,1938,187,56,3,0,0,2477,243,1858,223,320,0,0,0,2644,5121
28,65,271,1829,168,73,5,0,0,2346,171,1704,226,321,2,1,0,2425,4771
28,66,245,1727,174,82,2,0,0,2230,193,1773,215,308,2,0,0,2491,4721
28,67,224,1677,153,77,0,0,0,2131,145,1659,197,326,0,0,0,2327,4458
28,68,210,1726,143,102,0,0,1,2182,138,1680,175,385,1,0,0,2379,4561
28,69,201,1656,128,108,1,0,0,2094,155,1578,164,428,1,0,0,2326,4420
28,70,162,1678,113,123,2,1,0,2079,122,1418,145,439,1,0,0,2125,4204
28,71,168,1594,116,111,0,1,0,1990,118,1449,132,469,0,0,0,2168,4158
28,72,145,1571,93,107,0,0,0,1916,115,1374,130,460,1,0,0,2080,3996
28,73,149,1617,70,139,0,0,0,1975,120,1359,119,608,0,0,0,2206,4181
28,74,135,1534,72,144,0,0,0,1885,98,1348,127,656,1,0,0,2230,4115
28,75,134,1515,84,161,0,0,0,1894,93,1287,106,759,1,0,0,2246,4140
28,76,111,1467,73,160,0,0,0,1811,118,1187,113,804,0,0,0,2222,4033
28,77,94,1412,75,186,3,0,0,1770,84,1049,98,787,1,0,0,2019,3789
28,78,65,977,45,144,0,0,0,1231,76,793,70,663,0,0,0,1602,2833
28,79,75,994,45,155,1,0,0,1270,72,748,61,725,0,0,0,1606,2876
28,80,80,892,32,158,0,0,0,1162,79,680,64,787,0,0,0,1610,2772
28,81,63,842,43,184,0,0,0,1132,89,592,54,834,0,0,0,1569,2701
28,82,65,800,31,191,0,0,0,1087,101,605,46,970,0,0,0,1722,2809
28,83,60,803,32,211,0,0,0,1106,85,577,41,1065,1,0,0,1769,2875
28,84,63,766,32,216,0,0,0,1077,109,471,43,1036,0,0,0,1659,2736
28,85,50,726,18,221,0,0,0,1015,90,372,31,1092,0,0,0,1585,2600
28,86,42,569,14,209,0,0,0,834,82,320,19,1016,0,0,0,1437,2271
28,87,20,456,11,199,1,0,0,687,66,200,21,925,0,0,0,1212,1899
28,88,20,398,10,154,0,0,0,582,66,168,13,823,0,0,0,1070,1652
28,89,25,284,11,147,0,0,0,467,41,119,13,780,0,0,0,953,1420
28,90,29,241,4,138,0,0,0,412,57,81,12,690,0,0,0,840,1252
28,91,13,161,2,123,0,0,0,299,57,60,10,605,0,0,0,732,1031
28,92,17,120,3,103,0,0,0,243,46,38,7,537,0,0,0,628,871
28,93,7,90,0,75,0,0,0,172,43,26,2,448,0,0,0,519,691
28,94,7,58,1,61,0,0,0,127,25,13,2,349,0,0,0,389,516
28,95,2,38,1,57,0,0,0,98,20,10,4,260,0,0,0,294,392
28,96,1,16,1,30,0,0,0,48,11,5,1,213,0,0,0,230,278
28,97,1,12,1,19,0,0,0,33,16,0,0,135,0,0,0,151,184
28,98,2,6,0,17,0,0,0,25,11,2,0,86,0,0,0,99,124
28,99,2,3,3,7,0,0,0,15,11,1,0,69,0,0,0,81,96
28,100,0,0,0,18,0,0,0,18,9,1,0,117,0,0,0,127,145
28,999,84856,80643,7111,5050,164,12,2,177838,70484,81662,9613,23794,82,9,0,185644,363482
29,0,2057,0,0,0,0,0,0,2057,1914,0,0,0,0,0,0,1914,3971
29,1,2050,0,0,0,0,0,0,2050,1967,0,0,0,0,0,0,1967,4017
29,2,2137,0,0,0,0,0,0,2137,2151,0,0,0,0,0,0,2151,4288
29,3,2225,0,0,0,0,0,0,2225,2099,0,0,0,0,0,0,2099,4324
29,4,2210,0,0,0,0,0,0,2210,2235,0,0,0,0,0,0,2235,4445
29,5,2375,0,0,0,0,0,0,2375,2227,0,0,0,0,0,0,2227,4602
29,6,2412,0,0,0,0,0,0,2412,2421,0,0,0,0,0,0,2421,4833
29,7,2562,0,0,0,0,0,0,2562,2427,0,0,0,0,0,0,2427,4989
29,8,2640,0,0,0,0,0,0,2640,2381,0,0,0,0,0,0,2381,5021
29,9,2669,0,0,0,0,0,0,2669,2573,0,0,0,0,0,0,2573,5242
29,10,2732,0,0,0,0,0,0,2732,2586,0,0,0,0,0,0,2586,5318
29,11,2812,0,0,0,0,0,0,2812,2609,0,0,0,0,0,0,2609,5421
29,12,2886,0,0,0,0,0,0,2886,2527,0,0,0,0,0,0,2527,5413
29,13,2881,0,0,0,0,0,0,2881,2634,0,0,0,0,0,0,2634,5515
29,14,2854,0,0,0,0,0,0,2854,2806,0,0,0,0,0,0,2806,5660
29,15,2905,0,0,0,0,0,0,2905,2712,0,0,0,0,0,0,2712,5617
29,16,2903,0,0,1,0,0,0,2904,2749,0,0,0,0,0,0,2749,5653
29,17,2848,0,0,0,0,0,0,2848,2700,0,0,0,0,0,0,2700,5548
29,18,2918,0,0,0,0,0,0,2918,2635,1,1,0,0,0,0,2637,5555
29,19,2987,3,0,0,0,0,0,2990,2652,13,0,0,0,0,0,2665,5655
29,20,2931,5,1,0,0,0,0,2937,2654,25,0,0,0,0,0,2679,5616
29,21,2900,7,0,0,0,0,0,2907,2617,57,0,0,0,0,0,2674,5581
29,22,3030,22,0,0,0,0,0,3052,2676,108,3,0,0,0,0,2787,5839
29,23,3235,22,0,0,0,0,0,3257,2754,154,4,0,0,0,0,2912,6169
29,24,3165,60,0,0,2,0,0,3227,2617,218,7,2,3,0,0,2847,6074
29,25,3279,92,4,0,0,0,0,3375,2539,285,6,0,1,0,0,2831,6206
29,26,3148,124,5,0,2,0,0,3279,2484,407,9,0,3,0,0,2903,6182
29,27,3184,217,5,0,0,0,0,3406,2305,555,8,0,0,1,0,2869,6275
29,28,2959,275,10,0,0,0,0,3244,2203,644,23,1,3,0,0,2874,6118
29,29,2764,397,11,1,3,0,0,3176,2087,895,23,0,3,0,0,3008,6184
29,30,2638,547,10,0,2,0,0,3197,1902,991,33,2,1,0,0,2929,6126
29,31,2613,728,17,0,2,1,0,3361,1871,1233,31,0,1,0,0,3136,6497
29,32,2421,946,20,1,2,0,0,3390,1595,1357,43,3,2,0,0,3000,6390
29,33,2295,1057,36,2,2,1,0,3393,1584,1451,62,3,1,0,0,3101,6494
29,34,2166,1171,39,7,8,2,0,3393,1396,1576,76,4,4,0,0,3056,6449
29,35,2053,1282,59,2,10,0,0,3406,1340,1712,83,6,4,0,0,3145,6551
29,36,1782,1364,42,1,5,0,0,3194,1196,1792,110,5,6,0,0,3109,6303
29,37,1779,1457,69,0,5,2,0,3312,1147,1864,136,11,3,0,0,3161,6473
29,38,1773,1561,78,2,3,2,0,3419,1101,1855,135,12,4,1,0,3108,6527
29,39,1629,1641,85,2,7,0,0,3364,1077,1964,129,11,6,0,0,3187,6551
29,40,1560,1788,120,8,5,0,0,3481,1088,1969,171,24,7,0,1,3260,6741
29,41,1487,1919,114,5,5,1,0,3531,1041,2126,206,22,2,0,0,3397,6928
29,42,1450,1898,141,10,4,0,0,3503,959,2172,209,25,4,0,0,3369,6872
29,43,1467,2035,144,8,7,0,0,3661,947,2335,263,35,5,0,0,3585,7246
29,44,1357,2094,138,9,3,0,0,3601,907,2333,255,35,3,0,0,3533,7134
29,45,1448,2190,192,14,5,0,0,3849,896,2438,279,41,1,0,0,3655,7504
29,46,1389,2309,193,9,3,0,0,3903,911,2493,325,53,11,0,0,3793,7696
29,47,1416,2483,237,15,2,0,0,4153,859,2757,347,51,4,0,0,4018,8171
29,48,1384,2635,267,21,4,0,0,4311,902,2850,410,76,9,0,0,4247,8558
29,49,1357,2808,312,13,5,0,0,4495,894,3108,431,70,3,0,0,4506,9001
29,50,1401,2818,342,12,6,0,0,4579,847,3005,465,96,4,0,0,4417,8996
29,51,1240,2949,343,18,4,0,0,4554,845,3090,465,102,3,0,0,4505,9059
29,52,1196,2954,408,24,2,0,0,4584,747,3226,474,138,2,0,0,4587,9171
29,53,1094,2987,363,40,2,0,0,4486,729,3183,460,107,5,0,0,4484,8970
29,54,1093,3147,395,29,7,1,0,4672,686,3284,512,129,1,0,0,4612,9284
29,55,1007,3243,415,55,7,2,0,4729,653,3356,515,159,3,0,0,4686,9415
29,56,1013,3183,429,46,3,0,0,4674,644,3288,515,187,3,0,0,4637,9311
29,57,955,3209,415,56,5,0,0,4640,633,3371,518,194,3,0,0,4719,9359
29,58,871,3412,427,66,9,0,0,4785,578,3353,480,252,2,0,1,4666,9451
29,59,784,3452,436,78,6,0,0,4756,554,3538,509,251,1,0,0,4853,9609
29,60,760,3197,384,70,4,0,0,4415,473,3119,476,290,2,0,1,4361,8776
29,61,648,3119,384,78,5,0,0,4234,442,3142,425,336,2,0,0,4347,8581
29,62,640,3010,379,55,3,0,1,4088,418,3033,395,351,0,0,0,4197,8285
29,63,553,3029,336,111,5,0,0,4034,404,2882,370,400,0,0,0,4056,8090
29,64,575,2938,314,103,2,0,0,3932,328,2786,369,482,0,0,0,3965,7897
29,65,513,2983,271,96,1,0,0,3864,315,2604,306,418,1,0,0,3644,7508
29,66,489,2847,266,120,4,0,0,3726,271,2715,325,506,0,0,0,3817,7543
29,67,446,2682,247,124,4,0,0,3503,262,2588,293,553,1,0,0,3697,7200
29,68,398,2738,239,145,1,0,0,3521,255,2463,244,644,0,0,0,3606,7127
29,69,379,2531,221,161,1,0,0,3293,208,2467,237,663,0,0,0,3575,6868
29,70,377,2543,190,169,4,0,0,3283,233,2303,232,676,0,0,0,3444,6727
29,71,384,2528,215,189,0,0,0,3316,218,2216,221,760,1,0,0,3416,6732
29,72,350,2458,176,155,1,0,0,3140,195,2269,196,752,1,0,0,3413,6553
29,73,362,2514,151,206,1,0,0,3234,187,2206,184,894,1,0,0,3472,6706
29,74,346,2511,144,235,1,0,0,3237,194,2115,173,992,1,0,0,3475,6712
29,75,317,2518,135,275,1,0,0,3246,186,2068,153,1152,1,0,0,3560,6806
29,76,280,2344,149,272,1,0,0,3046,194,1882,123,1174,0,0,0,3373,6419
29,77,279,2094,130,262,0,0,0,2765,161,1673,105,1215,0,0,0,3154,5919
29,78,237,1600,75,220,0,0,0,2132,123,1214,88,1024,0,0,0,2449,4581
29,79,226,1629,74,285,1,0,1,2216,129,1264,88,1140,1,0,0,2622,4838
29,80,217,1630,44,272,0,0,0,2163,147,1102,83,1269,0,0,0,2601,4764
29,81,222,1512,54,277,0,0,0,2065,161,1045,76,1348,0,0,0,2630,4695
29,82,234,1378,50,291,0,0,0,1953,175,944,61,1493,0,0,0,2673,4626
29,83,233,1353,41,334,0,0,0,1961,142,851,44,1633,0,0,0,2670,4631
29,84,198,1286,40,324,0,0,0,1848,162,721,53,1619,1,0,0,2556,4404
29,85,186,1138,32,367,1,0,0,1724,135,614,54,1686,0,0,0,2489,4213
29,86,153,927,27,316,0,0,0,1423,128,458,42,1493,0,0,0,2121,3544
29,87,100,725,14,298,0,0,0,1137,113,311,31,1339,0,0,0,1794,2931
29,88,106,613,17,298,0,0,0,1034,143,228,16,1325,0,0,0,1712,2746
29,89,90,488,5,259,0,0,0,842,111,175,16,1239,0,0,0,1541,2383
29,90,62,313,4,206,0,0,0,585,92,119,14,1073,0,0,0,1298,1883
29,91,43,268,7,176,0,0,0,494,71,70,10,930,0,0,0,1081,1575
29,92,36,198,5,158,0,0,0,397,77,56,11,787,0,0,0,931,1328
29,93,28,139,4,132,0,0,0,303,58,41,7,687,0,0,0,793,1096
29,94,13,107,2,110,0,0,0,232,82,21,6,502,0,0,0,611,843
29,95,10,64,3,61,0,0,0,138,45,8,2,424,0,0,0,479,617
29,96,10,41,1,49,0,0,0,101,35,9,5,284,0,0,0,333,434
29,97,7,19,1,40,0,0,0,67,18,6,5,229,0,0,0,258,325
29,98,1,9,1,20,0,0,0,31,23,0,3,153,0,0,0,179,210
29,99,3,7,0,19,0,0,0,29,19,0,0,105,0,0,0,124,153
29,100,4,5,1,24,0,0,0,34,21,1,1,137,0,0,0,160,194
29,999,139291,130524,11155,7917,188,12,2,289089,111624,130221,14274,36284,134,2,3,292542,581631
30,0,603,0,0,0,0,0,0,603,581,0,0,0,0,0,0,581,1184
30,1,627,0,0,0,0,0,0,627,614,0,0,0,0,0,0,614,1241
30,2,691,0,0,0,0,0,0,691,632,0,0,0,0,0,0,632,1323
30,3,706,0,0,0,0,0,0,706,625,0,0,0,0,0,0,625,1331
30,4,741,0,0,0,0,0,0,741,650,0,0,0,0,0,0,650,1391
30,5,693,0,0,0,0,0,0,693,699,0,0,0,0,0,0,699,1392
30,6,778,0,0,0,0,0,0,778,776,0,0,0,0,0,0,776,1554
30,7,819,0,0,0,0,0,0,819,807,0,0,0,0,0,0,807,1626
30,8,856,0,0,0,0,0,0,856,781,0,0,0,0,0,0,781,1637
30,9,840,0,0,0,0,0,0,840,829,0,0,0,0,0,0,829,1669
30,10,882,0,0,0,0,0,0,882,863,0,0,0,0,0,0,863,1745
30,11,956,0,0,0,0,0,0,956,872,0,0,0,0,0,0,872,1828
30,12,945,0,0,0,0,0,0,945,846,0,0,0,0,0,0,846,1791
30,13,925,0,0,0,0,0,0,925,871,0,0,0,0,0,0,871,1796
30,14,976,0,0,0,0,0,0,976,916,0,0,0,0,0,0,916,1892
30,15,1003,0,0,0,0,0,0,1003,925,0,0,0,0,0,0,925,1928
30,16,1044,0,0,0,0,0,0,1044,873,0,0,0,0,0,0,873,1917
30,17,942,0,0,0,0,0,0,942,963,0,0,0,0,0,0,963,1905
30,18,1032,0,0,0,0,0,0,1032,950,0,0,0,0,0,0,950,1982
30,19,1016,1,0,0,0,0,0,1017,922,4,0,0,0,0,0,926,1943
30,20,1033,3,2,0,0,0,0,1038,905,14,0,0,1,0,0,920,1958
30,21,1019,2,0,0,0,0,0,1021,960,12,0,0,0,0,0,972,1993
30,22,998,9,0,0,0,0,0,1007,911,25,0,0,0,0,0,936,1943
30,23,1059,13,0,0,0,0,0,1072,873,47,0,1,1,0,0,922,1994
30,24,1049,21,2,0,0,0,0,1072,859,70,1,0,0,0,0,930,2002
30,25,1145,31,2,0,0,0,0,1178,853,81,0,1,0,0,0,935,2113
30,26,995,33,4,0,0,0,0,1032,807,124,4,0,1,0,0,936,1968
30,27,1042,63,5,0,0,1,0,1111,755,152,8,1,1,0,0,917,2028
30,28,998,78,3,0,1,0,0,1080,758,190,6,1,1,0,0,956,2036
30,29,927,108,3,0,0,0,0,1038,657,250,8,0,1,0,0,916,1954
30,30,891,185,6,0,1,0,0,1083,650,280,13,1,2,1,0,947,2030
30,31,850,214,3,0,2,0,0,1069,623,363,14,0,3,1,0,1004,2073
30,32,756,246,14,0,3,0,0,1019,559,369,13,6,2,0,0,949,1968
30,33,753,264,9,0,2,0,0,1028,570,444,23,2,4,0,0,1043,2071
30,34,705,345,14,0,1,0,0,1065,478,472,20,8,1,1,0,980,2045
30,35,700,429,15,1,2,0,0,1147,503,518,19,6,0,0,0,1046,2193
30,36,605,420,20,0,4,0,0,1049,404,593,38,4,2,0,0,1041,2090
30,37,590,474,27,1,4,0,0,1096,412,548,34,11,0,0,0,1005,2101
30,38,573,465,20,1,1,0,0,1060,423,645,57,8,1,0,0,1134,2194
30,39,555,509,24,4,1,0,0,1093,391,589,64,7,1,1,0,1053,2146
30,40,485,523,41,1,1,0,0,1051,377,679,54,7,5,1,0,1123,2174
30,41,513,574,31,1,1,0,0,1120,376,710,60,12,2,0,0,1160,2280
30,42,479,626,49,0,0,0,0,1154,361,729,85,11,0,0,0,1186,2340
30,43,526,656,47,2,2,0,0,1233,360,735,92,14,2,0,0,1203,2436
30,44,514,682,61,2,6,1,0,1266,341,795,85,12,0,0,0,1233,2499
30,45,511,757,71,1,4,0,0,1344,359,852,109,19,2,1,0,1342,2686
30,46,504,804,75,7,2,0,0,1392,391,938,106,21,3,0,0,1459,2851
30,47,535,866,97,6,4,0,0,1508,342,934,153,23,3,0,0,1455,2963
30,48,518,931,109,6,1,0,0,1565,359,1060,162,26,3,0,0,1610,3175
30,49,552,971,126,6,6,0,0,1661,358,1061,165,47,5,1,0,1637,3298
30,50,543,957,120,8,4,0,0,1632,291,1015,177,30,2,0,0,1515,3147
30,51,490,1064,125,15,3,0,0,1697,329,1132,185,49,5,0,0,1700,3397
30,52,444,1061,146,12,4,0,0,1667,289,1188,169,51,2,0,0,1699,3366
30,53,430,1078,156,14,0,1,0,1679,259,1116,196,52,1,1,0,1625,3304
30,54,446,1189,155,10,2,0,0,1802,290,1191,226,53,1,0,0,1761,3563
30,55,383,1120,176,17,3,0,0,1699,256,1197,210,60,2,0,0,1725,3424
30,56,394,1179,158,11,9,0,0,1751,248,1204,226,64,1,0,0,1743,3494
30,57,372,1174,168,28,1,0,0,1743,249,1242,224,80,0,0,0,1795,3538
30,58,318,1233,184,27,3,0,0,1765,241,1200,212,82,1,0,0,1736,3501
30,59,333,1204,150,21,6,0,0,1714,236,1220,208,95,1,0,0,1760,3474
30,60,268,1164,171,31,2,0,0,1636,189,1190,209,146,1,0,0,1735,3371
30,61,244,1167,143,26,2,0,0,1582,178,1116,178,111,1,0,0,1584,3166
30,62,232,1138,146,35,0,0,0,1551,143,1158,164,135,1,0,0,1601,3152
30,63,218,1106,163,41,1,0,0,1529,132,1133,163,149,1,0,0,1578,3107
30,64,200,1121,144,38,2,0,0,1505,115,1032,156,148,1,0,0,1452,2957
30,65,200,1090,118,33,1,0,0,1442,99,991,123,181,1,0,0,1395,2837
30,66,169,1021,133,45,0,0,0,1368,111,1055,147,198,1,0,0,1512,2880
30,67,167,1055,109,56,0,0,0,1387,112,1009,114,218,0,0,0,1453,2840
30,68,154,1007,96,52,3,0,0,1312,94,968,116,233,1,0,0,1412,2724
30,69,138,1002,108,62,0,0,0,1310,65,917,118,250,2,0,0,1352,2662
30,70,124,956,100,56,0,0,0,1236,67,922,75,272,0,0,0,1336,2572
30,71,126,978,77,62,0,0,0,1243,62,901,79,278,0,0,0,1320,2563
30,72,108,937,58,55,3,0,0,1161,75,802,85,313,0,0,0,1275,2436
30,73,100,1023,80,90,3,0,0,1296,68,861,86,343,0,0,0,1358,2654
30,74,87,946,65,77,0,0,0,1175,56,882,76,376,0,0,0,1390,2565
30,75,107,1025,49,110,1,0,0,1292,64,880,73,457,0,0,0,1474,2766
30,76,87,996,65,118,0,0,0,1266,65,776,65,431,1,0,0,1338,2604
30,77,65,881,50,125,0,0,0,1121,58,717,62,487,0,0,0,1324,2445
30,78,58,611,39,84,0,0,0,792,49,453,37,383,1,0,0,923,1715
30,79,64,627,25,92,0,0,0,808,40,440,42,458,0,0,0,980,1788
30,80,60,630,17,99,0,0,0,806,47,474,37,502,0,0,0,1060,1866
30,81,42,596,24,103,0,0,0,765,29,402,35,510,0,0,0,976,1741
30,82,64,518,12,122,0,0,0,716,40,353,24,498,0,0,0,915,1631
30,83,47,529,18,131,0,0,0,725,38,354,21,611,0,0,0,1024,1749
30,84,62,480,13,112,0,1,0,668,41,317,31,669,0,0,0,1058,1726
30,85,39,476,15,136,0,0,0,666,30,243,16,662,0,0,0,951,1617
30,86,35,369,8,134,0,0,0,546,36,189,20,592,0,0,0,837,1383
30,87,29,282,8,128,0,0,0,447,39,110,10,548,0,0,0,707,1154
30,88,28,242,7,115,0,0,0,392,27,110,13,557,0,0,0,707,1099
30,89,23,203,7,122,0,0,0,355,18,78,8,477,0,0,0,581,936
30,90,10,150,3,105,0,0,0,268,28,53,5,390,0,0,0,476,744
30,91,11,109,1,91,0,0,0,212,20,54,5,393,0,0,0,472,684
30,92,12,79,0,47,0,0,0,138,22,32,5,346,0,0,0,405,543
30,93,7,62,4,55,0,0,0,128,17,15,5,328,0,0,0,365,493
30,94,5,41,1,47,0,0,0,94,18,16,3,245,0,0,0,282,376
30,95,7,29,0,33,0,0,0,69,18,15,2,170,0,0,0,205,274
30,96,3,9,0,22,0,0,0,34,9,4,1,119,0,0,0,133,167
30,97,2,12,0,17,0,0,0,31,11,3,1,86,0,0,0,101,132
30,98,1,8,0,8,0,0,0,17,5,2,1,63,0,0,0,71,88
30,99,2,2,0,7,0,0,0,11,3,0,0,43,0,0,0,46,57
30,100,0,2,0,10,0,0,0,12,4,1,2,71,0,0,0,78,90
30,999,47013,47241,4495,3134,102,4,0,101989,38000,47016,5839,14312,75,8,0,105250,207239
31,0,1158,0,0,0,0,0,0,1158,1060,0,0,0,0,0,0,1060,2218
31,1,1178,0,0,0,0,0,0,1178,1139,0,0,0,0,0,0,1139,2317
31,2,1191,0,0,0,0,0,0,1191,1065,0,0,0,0,0,0,1065,2256
31,3,1250,0,0,0,0,0,0,1250,1158,0,0,0,0,0,0,1158,2408
31,4,1267,0,0,0,0,0,0,1267,1197,0,0,0,0,0,0,1197,2464
31,5,1339,0,0,0,0,0,0,1339,1284,0,0,0,0,0,0,1284,2623
31,6,1400,0,0,0,0,0,0,1400,1396,0,0,0,0,0,0,1396,2796
31,7,1441,0,0,0,0,0,0,1441,1423,0,0,0,0,0,0,1423,2864
31,8,1565,0,0,0,0,0,0,1565,1392,0,0,0,0,0,0,1392,2957
31,9,1546,0,0,0,0,0,0,1546,1486,0,0,0,0,0,0,1486,3032
31,10,1624,0,0,0,0,0,0,1624,1485,0,0,0,0,0,0,1485,3109
31,11,1707,0,0,0,0,0,0,1707,1568,0,0,0,0,0,0,1568,3275
31,12,1707,0,0,0,0,0,0,1707,1631,0,0,0,0,0,0,1631,3338
31,13,1771,0,0,0,0,0,0,1771,1651,0,0,0,0,0,0,1651,3422
31,14,1796,0,0,0,0,0,0,1796,1702,0,0,0,0,0,0,1702,3498
31,15,1826,0,0,0,0,0,0,1826,1719,0,0,0,0,0,0,1719,3545
31,16,1818,0,0,0,0,0,0,1818,1718,0,0,0,0,0,0,1718,3536
31,17,1839,0,0,0,0,0,0,1839,1717,0,0,0,0,0,0,1717,3556
31,18,1835,1,0,0,0,0,0,1836,1624,1,0,0,0,0,0,1625,3461
31,19,1855,1,0,0,0,0,0,1856,1709,11,0,0,0,0,0,1720,3576
31,20,1868,2,0,0,0,0,0,1870,1630,13,0,0,0,0,0,1643,3513
31,21,1816,3,0,0,0,0,0,1819,1694,30,0,0,0,0,0,1724,3543
31,22,1860,13,1,0,0,0,0,1874,1643,44,2,0,0,0,0,1689,3563
31,23,1885,17,1,0,1,0,0,1904,1661,68,2,0,0,0,0,1731,3635
31,24,2039,35,1,0,0,0,0,2075,1638,108,0,0,0,0,0,1746,3821
31,25,1901,61,5,0,1,0,0,1968,1551,159,2,0,0,0,0,1712,3680
31,26,1928,71,4,0,1,0,0,2004,1536,234,8,1,0,0,0,1779,3783
31,27,1914,75,4,0,2,0,0,1995,1454,280,6,1,3,0,0,1744,3739
31,28,1869,146,2,0,1,0,0,2018,1422,333,7,1,0,0,0,1763,3781
31,29,1800,185,5,0,5,0,0,1995,1333,453,12,2,3,0,0,1803,3798
31,30,1801,252,9,0,2,0,0,2064,1352,522,7,0,0,0,0,1881,3945
31,31,1735,351,9,0,5,0,0,2100,1237,615,17,2,2,1,0,1874,3974
31,32,1633,407,5,1,0,0,0,2046,1225,660,32,2,2,0,0,1921,3967
31,33,1580,500,19,3,5,1,0,2108,1107,710,39,5,4,1,0,1866,3974
31,34,1438,575,31,3,2,1,0,2050,1057,844,43,4,1,0,0,1949,3999
31,35,1377,631,26,1,4,0,0,2039,982,981,45,3,2,0,0,2013,4052
31,36,1254,795,35,3,2,1,0,2090,799,999,65,9,4,1,0,1877,3967
31,37,1236,804,39,3,5,0,0,2087,850,1040,56,13,5,0,0,1964,4051
31,38,1196,896,42,2,5,2,0,2143,824,1127,94,20,4,1,0,2070,4213
31,39,1135,900,35,2,2,0,0,2074,773,1274,105,13,5,0,0,2170,4244
31,40,1072,1071,67,0,3,0,0,2213,804,1215,134,14,2,0,0,2169,4382
31,41,1106,1073,80,2,4,1,0,2266,744,1322,158,12,4,0,0,2240,4506
31,42,1028,1167,82,7,4,0,0,2288,719,1385,148,22,2,0,0,2276,4564
31,43,1070,1206,107,4,3,0,0,2390,705,1349,193,31,2,0,0,2280,4670
31,44,997,1259,107,12,0,0,0,2375,702,1473,160,32,1,1,0,2369,4744
31,45,1077,1424,115,10,7,0,0,2633,717,1649,207,40,1,0,0,2614,5247
31,46,1129,1508,159,12,2,0,1,2811,759,1774,244,39,6,0,0,2822,5633
31,47,1207,1586,163,17,2,0,0,2975,760,1909,243,58,4,0,0,2974,5949
31,48,1150,1688,185,11,3,0,0,3037,766,1943,324,52,0,4,0,3089,6126
31,49,1164,1763,232,15,5,1,0,3180,722,1960,319,57,4,1,0,3063,6243
31,50,1106,1792,224,11,4,0,0,3137,715,2014,306,89,3,0,0,3127,6264
31,51,1110,1905,284,14,6,0,0,3319,722,2089,362,92,0,0,0,3265,6584
31,52,1066,1933,294,22,5,0,0,3320,671,2276,387,88,2,0,0,3424,6744
31,53,951,2109,277,35,5,0,0,3377,563,2253,361,123,1,1,0,3302,6679
31,54,951,2135,329,27,9,0,0,3451,665,2352,459,163,2,0,0,3641,7092
31,55,880,2174,325,39,5,0,0,3423,539,2313,413,153,4,0,0,3422,6845
31,56,908,2278,340,42,3,0,0,3571,503,2411,453,174,3,1,0,3545,7116
31,57,848,2329,341,39,8,0,0,3565,484,2407,450,176,0,0,0,3517,7082
31,58,789,2379,372,49,6,0,0,3595,478,2416,455,207,1,0,0,3557,7152
31,59,726,2440,389,39,5,0,0,3599,467,2543,466,231,0,0,0,3707,7306
31,60,564,2398,362,60,4,0,0,3388,399,2349,395,242,0,0,0,3385,6773
31,61,564,2201,332,57,3,0,0,3157,366,2278,379,298,2,0,0,3323,6480
31,62,515,2262,332,72,7,0,0,3188,355,2135,409,363,0,0,0,3262,6450
31,63,490,2162,303,62,6,0,0,3023,305,2079,322,371,1,0,0,3078,6101
31,64,426,2132,277,80,3,0,0,2918,278,2024,355,346,3,0,0,3006,5924
31,65,376,2092,293,109,1,0,0,2871,247,2084,321,406,0,0,0,3058,5929
31,66,377,2164,264,107,2,0,0,2914,246,1950,278,382,1,0,0,2857,5771
31,67,319,2110,236,93,0,0,0,2758,186,1982,286,472,2,0,0,2928,5686
31,68,280,2015,227,105,5,0,0,2632,191,1845,254,475,1,0,0,2766,5398
31,69,274,1985,211,120,1,0,0,2591,167,1858,246,525,2,0,0,2798,5389
31,70,250,1903,197,127,4,0,0,2481,192,1682,196,589,1,0,0,2660,5141
31,71,259,1869,161,157,1,0,0,2447,174,1618,187,597,0,0,0,2576,5023
31,72,221,1875,150,165,1,0,0,2412,182,1680,159,615,0,0,0,2636,5048
31,73,210,1867,146,187,2,0,0,2412,160,1727,193,726,1,0,0,2807,5219
31,74,210,1883,134,164,3,0,0,2394,140,1569,166,788,1,0,0,2664,5058
31,75,204,1870,125,206,1,0,0,2406,153,1591,174,925,0,0,0,2843,5249
31,76,219,1773,115,266,1,0,0,2374,140,1579,157,982,0,0,0,2858,5232
31,77,162,1764,112,269,0,0,1,2308,137,1471,137,1038,1,0,0,2784,5092
31,78,118,1262,80,204,2,0,0,1666,112,1029,66,808,0,0,0,2015,3681
31,79,131,1353,62,224,0,0,0,1770,117,950,103,1027,0,0,0,2197,3967
31,80,118,1261,49,226,0,0,0,1654,124,909,76,1080,1,0,0,2190,3844
31,81,111,1158,52,256,0,0,0,1577,121,848,95,1143,1,0,0,2208,3785
31,82,131,1117,48,270,0,0,0,1566,108,782,68,1216,0,0,0,2174,3740
31,83,102,1110,49,296,0,0,0,1557,117,711,79,1355,0,0,0,2262,3819
31,84,111,1026,46,300,0,0,0,1483,104,674,49,1402,0,0,0,2229,3712
31,85,93,923,42,302,0,0,0,1360,93,491,60,1400,0,0,0,2044,3404
31,86,64,736,22,277,1,0,0,1100,79,377,38,1227,0,0,0,1721,2821
31,87,63,602,19,246,0,0,0,930,79,304,32,1114,0,0,0,1529,2459
31,88,71,464,23,246,1,0,0,805,106,224,32,1100,0,0,0,1462,2267
31,89,31,367,14,225,0,0,0,637,90,169,17,1018,0,0,0,1294,1931
31,90,36,306,8,170,0,0,0,520,89,111,15,943,0,0,0,1158,1678
31,91,25,234,6,138,0,0,0,403,76,81,7,813,0,0,0,977,1380
31,92,26,161,3,129,0,0,0,319,55,61,11,676,0,0,0,803,1122
31,93,16,118,5,112,0,0,0,251,56,46,6,676,0,0,0,784,1035
31,94,9,70,2,92,0,0,0,173,33,29,5,464,0,0,0,531,704
31,95,9,43,1,59,0,0,0,112,34,19,6,338,0,0,0,397,509
31,96,1,27,0,44,0,0,0,72,19,15,4,260,0,0,0,298,370
31,97,3,21,1,27,0,0,0,52,18,5,1,187,0,0,0,211,263
31,98,4,19,1,16,0,0,0,40,11,6,1,126,0,0,0,144,184
31,99,4,5,0,15,0,0,0,24,10,3,1,84,0,0,0,98,122
31,100,1,9,0,26,0,0,0,36,16,4,3,145,0,0,0,168,204
31,999,91911,90657,9255,6731,181,7,2,198744,73782,90908,12173,30671,95,12,0,207641,406385
32,0,367,0,0,0,0,0,0,367,357,0,0,0,0,0,0,357,724
32,1,405,0,0,0,0,0,0,405,382,0,0,0,0,0,0,382,787
32,2,402,0,0,0,0,0,0,402,358,0,0,0,0,0,0,358,760
32,3,386,0,0,0,0,0,0,386,405,0,0,0,0,0,0,405,791
32,4,403,0,0,0,0,0,0,403,409,0,0,0,0,0,0,409,812
32,5,490,0,0,0,0,0,0,490,407,0,0,0,0,0,0,407,897
32,6,482,0,0,0,0,0,0,482,412,0,0,0,0,0,0,412,894
32,7,512,0,0,0,0,0,0,512,448,0,0,0,0,0,0,448,960
32,8,503,0,0,0,0,0,0,503,482,0,0,0,0,0,0,482,985
32,9,562,0,0,0,0,0,0,562,499,0,0,0,0,0,0,499,1061
32,10,517,0,0,0,0,0,0,517,522,0,0,0,0,0,0,522,1039
32,11,588,0,0,0,0,0,0,588,559,0,0,0,0,0,0,559,1147
32,12,633,0,0,0,0,0,0,633,583,0,0,0,0,0,0,583,1216
32,13,592,0,0,0,0,0,0,592,579,0,0,0,0,0,0,579,1171
32,14,651,0,0,0,0,0,0,651,581,0,0,0,0,0,0,581,1232
32,15,634,0,0,0,0,0,0,634,600,0,0,0,0,0,0,600,1234
32,16,657,1,0,0,0,0,0,658,586,0,0,0,0,0,0,586,1244
32,17,667,0,0,0,0,0,0,667,597,0,0,0,0,0,0,597,1264
32,18,610,0,0,0,0,0,0,610,567,0,0,0,0,0,0,567,1177
32,19,608,0,1,0,0,0,0,609,595,0,2,0,0,0,0,597,1206
32,20,629,0,0,0,0,0,0,629,605,4,0,0,0,0,0,609,1238
32,21,623,0,0,0,0,0,0,623,531,7,0,0,0,0,0,538,1161
32,22,641,2,0,0,0,0,0,643,565,9,1,0,0,0,0,575,1218
32,23,658,1,0,0,0,0,0,659,588,22,1,0,0,0,0,611,1270
32,24,639,6,0,0,0,0,0,645,552,27,0,0,0,0,0,579,1224
32,25,625,12,0,0,0,0,0,637,541,34,1,0,1,0,0,577,1214
32,26,593,13,2,0,0,0,0,608,500,61,2,0,1,0,0,564,1172
32,27,612,28,1,0,0,0,0,641,512,68,2,0,0,0,0,582,1223
32,28,570,44,1,0,0,0,0,615,460,99,1,0,1,0,0,561,1176
32,29,531,60,1,0,0,0,0,592,425,113,2,0,1,0,0,541,1133
32,30,515,85,2,0,0,0,0,602,420,144,6,1,1,0,0,572,1174
32,31,556,96,2,0,0,0,0,654,414,196,7,0,1,0,0,618,1272
32,32,495,123,2,0,1,0,0,621,386,169,10,0,3,0,0,568,1189
32,33,469,135,6,0,0,0,0,610,395,248,12,1,1,0,0,657,1267
32,34,479,172,5,1,1,0,0,658,346,220,21,1,3,0,0,591,1249
32,35,464,197,5,0,0,0,0,666,331,278,21,1,1,0,0,632,1298
32,36,414,196,7,0,1,0,0,618,329,296,14,3,1,0,0,643,1261
32,37,375,227,11,1,0,0,0,614,293,337,23,5,2,0,0,660,1274
32,38,385,232,18,1,0,0,0,636,309,310,19,3,1,0,0,642,1278
32,39,382,278,13,2,0,0,0,675,296,323,23,1,0,0,0,643,1318
32,40,378,329,21,1,2,0,0,731,288,356,41,4,0,0,0,689,1420
32,41,341,332,22,0,0,0,0,695,278,389,43,5,1,1,0,717,1412
32,42,328,309,24,1,3,0,0,665,234,383,49,7,3,0,0,676,1341
32,43,351,379,30,2,0,0,0,762,231,411,49,8,1,0,0,700,1462
32,44,319,365,43,0,0,0,0,727,241,420,43,18,1,0,0,723,1450
32,45,418,420,39,3,1,0,0,881,303,469,63,5,0,0,0,840,1721
32,46,340,453,50,2,2,0,0,847,282,466,67,10,1,1,0,827,1674
32,47,369,437,53,1,1,0,0,861,284,549,76,15,0,0,0,924,1785
32,48,394,445,57,1,1,0,0,898,295,571,76,19,1,0,0,962,1860
32,49,401,505,63,2,0,0,0,971,291,567,111,11,1,0,0,981,1952
32,50,344,572,77,4,4,0,0,1001,257,595,130,21,2,0,0,1005,2006
32,51,359,566,66,6,3,0,0,1000,267,624,114,28,0,0,0,1033,2033
32,52,313,587,87,6,0,0,0,993,242,660,140,32,0,0,0,1074,2067
32,53,338,575,88,4,1,0,0,1006,235,629,156,38,0,0,0,1058,2064
32,54,319,622,122,7,2,0,0,1072,247,698,135,28,0,0,0,1108,2180
32,55,320,599,106,11,2,1,0,1039,210,657,164,37,2,0,0,1070,2109
32,56,297,600,134,10,2,0,0,1043,217,662,152,60,0,0,0,1091,2134
32,57,306,637,137,16,2,0,0,1098,191,698,150,49,1,0,0,1089,2187
32,58,235,662,115,10,0,0,0,1022,180,671,144,57,1,0,0,1053,2075
32,59,262,727,139,16,2,0,0,1146,202,702,162,48,1,0,0,1115,2261
32,60,226,665,127,24,1,0,0,1043,142,663,136,61,2,0,0,1004,2047
32,61,169,609,99,22,0,0,0,899,126,635,136,68,0,0,0,965,1864
32,62,186,640,122,20,3,0,0,971,126,596,126,77,0,0,0,925,1896
32,63,135,575,103,15,1,0,0,829,107,565,136,87,0,0,0,895,1724
32,64,132,632,92,15,0,0,0,871,107,603,117,104,0,0,0,931,1802
32,65,149,539,79,28,0,0,0,795,71,572,99,91,0,0,0,833,1628
32,66,122,560,82,19,1,0,0,784,94,504,114,103,0,0,0,815,1599
32,67,106,581,78,16,0,0,0,781,61,529,85,111,0,0,0,786,1567
32,68,95,502,70,33,1,0,0,701,66,542,89,155,1,0,0,853,1554
32,69,106,524,54,27,0,0,0,711,62,499,86,150,0,0,0,797,1508
32,70,99,564,54,35,0,0,0,752,54,471,63,168,0,0,0,756,1508
32,71,98,508,60,36,0,0,0,702,48,452,62,162,0,0,0,724,1426
32,72,74,499,60,47,0,0,0,680,46,465,53,172,0,0,0,736,1416
32,73,79,508,44,51,0,0,0,682,49,441,55,193,0,0,0,738,1420
32,74,64,507,51,39,0,0,0,661,50,459,55,214,0,0,0,778,1439
32,75,74,510,35,60,2,0,1,682,41,443,65,243,0,0,0,792,1474
32,76,55,523,39,58,0,0,1,676,27,371,51,259,0,0,0,708,1384
32,77,67,441,35,52,0,0,0,595,26,347,39,263,0,0,0,675,1270
32,78,49,299,21,46,0,0,0,415,25,276,29,210,0,0,0,540,955
32,79,45,356,25,65,0,0,0,491,20,226,33,248,0,0,0,527,1018
32,80,40,363,24,63,0,0,0,490,28,249,29,258,0,0,0,564,1054
32,81,45,332,17,68,0,0,0,462,23,205,20,314,0,0,0,562,1024
32,82,42,300,17,73,0,0,0,432,35,204,20,318,0,0,0,577,1009
32,83,43,281,15,75,0,0,0,414,33,179,23,347,0,0,0,582,996
32,84,32,269,7,69,0,0,0,377,32,165,17,332,0,0,0,546,923
32,85,13,240,4,81,0,0,0,338,33,134,13,341,0,0,0,521,859
32,86,17,170,8,74,0,0,0,269,26,104,9,312,0,0,0,451,720
32,87,17,142,3,55,1,0,0,218,14,62,13,290,0,0,0,379,597
32,88,9,124,6,50,0,0,0,189,20,52,11,250,0,0,0,333,522
32,89,14,87,6,44,0,0,0,151,21,35,6,243,0,0,0,305,456
32,90,9,76,1,40,0,0,0,126,18,33,3,216,0,0,0,270,396
32,91,7,48,5,41,0,0,0,101,21,19,3,179,0,0,0,222,323
32,92,6,28,0,33,0,0,0,67,13,13,4,182,0,0,0,212,279
32,93,5,28,1,29,0,0,0,63,12,12,3,150,0,0,0,177,240
32,94,1,21,0,26,0,0,0,48,10,7,1,116,0,0,0,134,182
32,95,4,16,1,8,0,0,0,29,7,6,1,95,0,0,0,109,138
32,96,1,8,0,9,0,0,0,18,7,0,0,57,0,0,0,64,82
32,97,0,4,0,7,0,0,0,11,8,1,1,51,0,0,0,61,72
32,98,1,3,1,6,0,0,0,11,0,0,0,30,0,0,0,30,41
32,99,0,1,0,4,0,0,0,5,2,0,0,16,0,0,0,18,23
32,100,0,0,0,2,0,0,0,2,2,0,1,34,0,0,0,37,39
32,999,30492,25112,2996,1673,41,1,2,60317,25414,25281,4040,7786,37,2,0,62560,122877
33,0,603,0,0,0,0,0,0,603,552,0,0,0,0,0,0,552,1155
33,1,617,0,0,0,0,0,0,617,624,0,0,0,0,0,0,624,1241
33,2,662,0,0,0,0,0,0,662,623,0,0,0,0,0,0,623,1285
33,3,681,0,0,0,0,0,0,681,680,0,0,0,0,0,0,680,1361
33,4,655,0,0,0,0,0,0,655,653,0,0,0,0,0,0,653,1308
33,5,717,0,0,0,0,0,0,717,654,0,0,0,0,0,0,654,1371
33,6,754,0,0,0,0,0,0,754,732,0,0,0,0,0,0,732,1486
33,7,789,0,0,0,0,0,0,789,739,0,0,0,0,0,0,739,1528
33,8,793,0,0,0,0,0,0,793,754,0,0,0,0,0,0,754,1547
33,9,832,0,0,0,0,0,0,832,764,0,0,0,0,0,0,764,1596
33,10,820,0,0,0,0,0,0,820,785,0,0,0,0,0,0,785,1605
33,11,859,0,0,0,0,0,0,859,812,0,0,0,0,0,0,812,1671
33,12,896,0,0,0,0,0,0,896,787,0,0,0,0,0,0,787,1683
33,13,899,0,0,0,0,0,0,899,821,0,0,0,0,0,0,821,1720
33,14,891,0,0,0,0,0,0,891,890,0,0,0,0,0,0,890,1781
33,15,935,0,0,0,0,0,0,935,908,0,0,0,0,0,0,908,1843
33,16,986,0,0,0,0,0,0,986,837,0,0,0,0,0,0,837,1823
33,17,873,0,0,0,0,0,0,873,874,0,0,0,0,0,0,874,1747
33,18,972,0,0,0,0,0,0,972,921,0,0,0,0,0,0,921,1893
33,19,979,0,0,0,0,0,0,979,901,4,0,0,0,0,0,905,1884
33,20,925,3,0,0,0,0,0,928,812,10,0,0,0,0,0,822,1750
33,21,976,2,0,0,0,0,0,978,773,23,0,0,0,0,0,796,1774
33,22,999,7,0,0,0,0,0,1006,924,25,3,0,0,0,0,952,1958
33,23,1027,7,1,0,0,0,0,1035,837,60,0,0,2,0,0,899,1934
33,24,1016,10,0,0,0,0,0,1026,899,65,3,1,1,0,0,969,1995
33,25,1119,17,3,0,0,0,0,1139,826,62,0,0,2,0,0,890,2029
33,26,1050,41,0,0,0,0,0,1091,791,116,4,0,1,0,0,912,2003
33,27,1079,44,1,2,2,0,0,1128,769,149,4,0,3,0,0,925,2053
33,28,980,84,5,0,0,0,0,1069,770,175,2,1,1,0,0,949,2018
33,29,922,99,4,0,3,0,0,1028,727,214,9,0,0,0,0,950,1978
33,30,969,114,8,0,1,0,0,1092,656,312,6,1,2,1,0,978,2070
33,31,956,169,6,0,0,0,0,1131,719,294,18,0,2,0,0,1033,2164
33,32,850,217,11,1,0,0,0,1079,627,354,19,1,2,0,0,1003,2082
33,33,824,273,8,0,1,0,0,1106,589,416,22,2,2,0,0,1031,2137
33,34,750,320,15,3,3,0,0,1091,578,421,25,1,4,0,0,1029,2120
33,35,739,305,14,0,3,0,0,1061,585,463,31,4,3,0,0,1086,2147
33,36,739,378,20,1,1,1,0,1140,530,461,28,2,2,0,0,1023,2163
33,37,695,420,27,2,3,0,0,1147,475,489,45,2,0,0,0,1011,2158
33,38,661,413,29,2,3,0,0,1108,468,575,56,11,3,0,0,1113,2221
33,39,582,506,32,4,0,0,0,1124,428,519,63,10,3,0,0,1023,2147
33,40,576,530,38,2,0,0,0,1146,421,576,66,8,4,0,0,1075,2221
33,41,566,508,38,4,2,0,0,1118,389,589,66,6,3,0,0,1053,2171
33,42,579,552,48,5,3,0,0,1187,389,642,90,11,0,0,1,1133,2320
33,43,561,547,55,5,2,0,0,1170,393,627,99,20,4,0,0,1143,2313
33,44,500,592,62,8,3,0,0,1165,361,694,83,10,1,0,0,1149,2314
33,45,552,623,69,9,0,0,0,1253,436,739,123,20,2,0,0,1320,2573
33,46,546,649,83,6,3,0,0,1287,425,754,136,28,2,0,0,1345,2632
33,47,542,739,89,2,2,0,0,1374,401,852,160,26,1,0,0,1440,2814
33,48,579,771,98,5,2,0,0,1455,415,893,152,23,2,0,0,1485,2940
33,49,547,847,127,4,2,0,0,1527,448,916,196,44,1,0,0,1605,3132
33,50,587,844,119,9,1,0,0,1560,396,958,178,35,3,0,0,1570,3130
33,51,609,939,155,13,1,0,1,1718,400,992,240,34,3,0,0,1669,3387
33,52,551,942,139,11,3,0,0,1646,346,1014,228,47,2,0,0,1637,3283
33,53,559,953,155,14,3,0,0,1684,373,1041,254,72,1,0,0,1741,3425
33,54,505,1044,174,13,4,0,0,1740,327,1064,237,71,3,0,0,1702,3442
33,55,491,1113,170,19,2,0,0,1795,343,1078,274,75,1,0,0,1771,3566
33,56,444,1027,199,7,4,0,0,1681,321,1161,257,83,2,0,0,1824,3505
33,57,490,1070,199,21,0,0,0,1780,304,1161,275,99,2,0,0,1841,3621
33,58,405,1154,229,31,6,0,0,1825,319,1253,273,100,0,0,0,1945,3770
33,59,402,1133,219,25,3,0,0,1782,273,1270,285,121,1,0,0,1950,3732
33,60,347,1084,215,25,2,0,0,1673,252,1159,246,130,1,0,0,1788,3461
33,61,332,1127,196,25,3,0,0,1683,232,1139,254,127,1,0,0,1753,3436
33,62,304,1079,199,39,2,0,0,1623,182,1122,232,156,0,0,0,1692,3315
33,63,223,1136,204,47,1,0,0,1611,203,1037,231,158,1,0,0,1630,3241
33,64,250,1064,204,38,2,0,0,1558,175,1053,238,193,0,0,0,1659,3217
33,65,204,998,165,50,3,0,0,1420,158,1016,225,193,0,0,0,1592,3012
33,66,235,1038,182,48,2,0,1,1506,162,980,175,207,0,0,0,1524,3030
33,67,191,964,173,57,1,0,0,1386,136,942,177,198,0,0,1,1454,2840
33,68,165,951,144,47,2,0,0,1309,145,870,168,252,0,0,0,1435,2744
33,69,150,940,136,61,0,0,0,1287,119,863,149,262,0,0,0,1393,2680
33,70,145,952,118,63,3,0,0,1281,106,858,164,289,0,0,0,1417,2698
33,71,136,869,116,65,4,0,0,1190,100,787,142,257,0,0,0,1286,2476
33,72,105,846,97,69,1,0,0,1118,89,793,134,311,0,0,0,1327,2445
33,73,106,866,93,89,1,0,0,1155,100,800,120,361,0,0,0,1381,2536
33,74,92,905,85,79,0,0,0,1161,92,770,128,436,1,0,0,1427,2588
33,75,118,875,111,112,1,0,0,1217,93,816,116,452,1,0,0,1478,2695
33,76,95,917,85,102,0,0,0,1199,97,755,117,484,0,0,0,1453,2652
33,77,89,867,72,107,1,0,0,1136,82,751,110,515,1,0,0,1459,2595
33,78,72,616,57,95,1,0,0,841,58,523,73,452,0,0,0,1106,1947
33,79,82,662,58,126,0,0,0,928,74,516,68,497,0,0,0,1155,2083
33,80,66,590,50,119,1,0,0,826,72,462,61,484,0,0,0,1079,1905
33,81,68,603,53,120,0,0,0,844,55,423,68,550,0,0,0,1096,1940
33,82,52,591,32,155,0,0,0,830,60,432,62,596,0,0,0,1150,1980
33,83,52,583,34,145,0,0,0,814,71,438,62,675,0,0,0,1246,2060
33,84,53,496,40,127,0,0,0,716,57,325,57,681,0,0,0,1120,1836
33,85,38,486,27,137,0,0,0,688,57,272,49,627,0,0,0,1005,1693
33,86,45,403,21,119,0,0,0,588,45,214,50,615,0,0,0,924,1512
33,87,31,339,15,127,0,0,0,512,50,186,32,572,0,0,0,840,1352
33,88,30,271,22,133,0,0,0,456,50,143,27,556,0,0,0,776,1232
33,89,19,204,10,110,0,0,0,343,35,103,32,458,0,0,0,628,971
33,90,8,184,9,97,0,0,0,298,28,74,19,431,0,0,0,552,850
33,91,19,114,4,85,0,0,0,222,27,57,18,416,0,0,0,518,740
33,92,5,79,3,59,0,0,0,146,30,39,12,312,0,0,0,393,539
33,93,11,66,3,63,0,0,0,143,29,22,6,323,0,0,0,380,523
33,94,8,44,2,38,0,0,0,92,22,16,7,224,0,0,0,269,361
33,95,6,34,1,39,0,0,0,80,18,13,7,182,0,0,0,220,300
33,96,3,21,0,23,0,0,0,47,9,6,5,107,0,0,0,127,174
33,97,2,6,1,8,0,0,0,17,9,5,1,98,0,0,0,113,130
33,98,2,6,0,8,0,0,0,16,4,6,2,65,0,0,0,77,93
33,99,1,3,3,10,0,0,0,17,7,4,2,42,0,0,0,55,72
33,100,3,2,0,14,0,0,0,19,8,3,2,94,0,0,0,107,126
33,999,48625,43887,5689,3308,97,1,2,101609,39972,44274,7858,15007,77,1,2,107191,208800
34,0,703,0,0,0,0,0,0,703,658,0,0,0,0,0,0,658,1361
34,1,743,0,0,0,0,0,0,743,685,0,0,0,0,0,0,685,1428
34,2,726,0,0,0,0,0,0,726,694,0,0,0,0,0,0,694,1420
34,3,734,0,0,0,0,0,0,734,770,0,0,0,0,0,0,770,1504
34,4,750,0,0,0,0,0,0,750,740,0,0,0,0,0,0,740,1490
34,5,810,0,0,0,0,0,0,810,828,0,0,0,0,0,0,828,1638
34,6,896,0,0,0,0,0,0,896,775,0,0,0,0,0,0,775,1671
34,7,905,0,0,0,0,0,0,905,870,0,0,0,0,0,0,870,1775
34,8,949,0,0,0,0,0,0,949,965,0,0,0,0,0,0,965,1914
34,9,1072,0,0,0,0,0,0,1072,921,0,0,0,0,0,0,921,1993
34,10,1027,0,0,0,0,0,0,1027,935,0,0,0,0,0,0,935,1962
34,11,1107,0,0,0,0,0,0,1107,1057,0,0,0,0,0,0,1057,2164
34,12,1064,0,0,0,0,0,0,1064,1056,0,0,0,0,0,0,1056,2120
34,13,1116,0,0,0,0,0,0,1116,1032,0,0,0,0,0,0,1032,2148
34,14,1156,0,0,0,0,0,0,1156,1109,0,0,0,0,0,0,1109,2265
34,15,1220,0,0,0,0,0,0,1220,1132,0,0,0,0,0,0,1132,2352
34,16,1218,0,0,0,0,0,0,1218,1119,0,0,0,0,0,0,1119,2337
34,17,1231,0,0,0,0,0,0,1231,1128,0,0,0,0,0,0,1128,2359
34,18,1297,0,0,0,0,0,0,1297,1124,2,0,0,0,0,0,1126,2423
34,19,1239,0,0,0,0,0,0,1239,1139,3,0,0,0,0,0,1142,2381
34,20,1282,0,0,0,0,0,0,1282,1130,9,0,0,0,0,0,1139,2421
34,21,1268,0,0,0,0,0,0,1268,1133,20,0,0,0,0,0,1153,2421
34,22,1221,5,0,0,0,0,0,1226,1087,32,2,0,0,0,0,1121,2347
34,23,1302,6,0,0,0,0,0,1308,1150,56,1,1,1,0,0,1209,2517
34,24,1249,15,1,0,2,0,0,1267,1059,63,2,0,2,0,0,1126,2393
34,25,1288,20,0,0,1,0,0,1309,1087,90,0,0,2,0,0,1179,2488
34,26,1242,30,1,0,2,0,0,1275,1015,121,3,0,1,0,0,1140,2415
34,27,1231,41,1,0,0,0,0,1273,955,140,5,0,0,0,0,1100,2373
34,28,1151,81,0,0,0,0,0,1232,875,187,4,0,0,0,0,1066,2298
34,29,1080,99,1,0,2,0,0,1182,866,246,12,0,0,0,0,1124,2306
34,30,1044,158,5,0,2,0,0,1209,830,306,11,0,0,0,0,1147,2356
34,31,1130,199,3,0,1,0,0,1333,812,342,9,0,0,0,0,1163,2496
34,32,998,204,8,2,1,0,0,1213,731,425,14,1,2,0,0,1173,2386
34,33,1020,278,13,1,2,0,0,1314,679,475,19,3,3,0,0,1179,2493
34,34,959,312,10,1,3,0,0,1285,702,522,23,2,2,0,0,1251,2536
34,35,860,427,23,1,1,0,0,1312,644,576,36,6,4,0,0,1266,2578
34,36,804,436,24,2,1,0,0,1267,552,561,34,2,3,0,0,1152,2419
34,37,760,475,16,1,1,0,0,1253,524,599,48,5,5,0,0,1181,2434
34,38,719,495,35,2,2,0,0,1253,510,660,68,11,2,0,0,1251,2504
34,39,705,596,44,1,0,0,0,1346,507,669,85,7,2,0,0,1270,2616
34,40,712,609,36,2,3,0,0,1362,502,702,73,4,1,0,0,1282,2644
34,41,675,672,56,1,2,0,0,1406,477,740,82,18,2,0,0,1319,2725
34,42,670,622,48,8,1,0,0,1349,512,762,82,16,3,0,0,1375,2724
34,43,608,680,43,7,2,0,0,1340,483,769,99,10,1,0,0,1362,2702
34,44,633,744,67,17,0,0,0,1461,514,864,101,11,6,0,0,1496,2957
34,45,657,776,72,12,1,0,0,1518,520,947,139,23,2,0,0,1631,3149
34,46,692,871,106,7,2,0,0,1678,510,1021,151,26,4,0,0,1712,3390
34,47,767,917,105,7,2,0,0,1798,542,1105,154,28,1,0,0,1830,3628
34,48,745,1046,106,9,3,0,0,1909,591,1179,194,34,1,0,0,1999,3908
34,49,772,1105,147,11,2,0,0,2037,541,1289,205,38,2,0,0,2075,4112
34,50,793,1121,142,3,6,0,0,2065,518,1305,219,44,2,0,0,2088,4153
34,51,784,1228,157,14,5,0,0,2188,505,1403,266,55,0,0,0,2229,4417
34,52,740,1285,181,20,4,0,0,2230,502,1416,277,76,1,0,0,2272,4502
34,53,670,1379,208,18,7,0,0,2282,508,1446,284,62,1,0,1,2302,4584
34,54,678,1418,211,20,4,0,0,2331,456,1587,332,62,1,0,0,2438,4769
34,55,633,1468,258,25,3,0,0,2387,485,1544,307,81,1,0,0,2418,4805
34,56,631,1391,266,21,3,0,0,2312,459,1557,347,91,0,0,0,2454,4766
34,57,542,1494,258,21,3,0,0,2318,433,1645,331,101,0,0,0,2510,4828
34,58,564,1571,265,33,3,0,0,2436,398,1636,341,130,0,0,0,2505,4941
34,59,523,1614,296,30,3,0,0,2466,367,1605,318,136,5,0,0,2431,4897
34,60,428,1616,265,25,1,0,1,2336,290,1539,338,139,1,0,0,2307,4643
34,61,399,1497,227,39,4,0,0,2166,272,1524,284,174,1,0,0,2255,4421
34,62,368,1432,218,38,4,0,0,2060,241,1522,283,172,0,0,1,2219,4279
34,63,307,1347,202,39,2,0,0,1897,237,1363,256,197,1,0,0,2054,3951
34,64,276,1397,198,43,1,0,0,1915,221,1407,250,243,3,0,0,2124,4039
34,65,264,1340,213,52,1,0,0,1870,196,1337,227,221,2,0,0,1983,3853
34,66,240,1361,171,58,0,0,0,1830,163,1297,206,253,0,0,1,1920,3750
34,67,221,1291,168,71,3,0,0,1754,170,1246,199,284,1,0,0,1900,3654
34,68,188,1310,172,83,3,0,0,1756,163,1209,192,293,0,0,0,1857,3613
34,69,207,1265,147,64,3,0,0,1686,137,1152,171,332,0,0,0,1792,3478
34,70,164,1179,149,77,1,0,0,1570,137,1108,152,331,0,0,0,1728,3298
34,71,156,1171,127,76,1,0,0,1531,127,1070,154,350,0,0,0,1701,3232
34,72,117,1165,121,81,1,0,0,1485,87,1111,136,409,1,0,0,1744,3229
34,73,116,1201,120,106,1,0,0,1544,109,1118,156,477,0,0,0,1860,3404
34,74,143,1173,106,111,1,0,0,1534,115,1112,145,503,0,0,0,1875,3409
34,75,134,1232,93,150,4,0,0,1613,91,1091,122,538,0,0,0,1842,3455
34,76,123,1242,83,135,1,0,0,1584,106,1132,128,639,0,0,0,2005,3589
34,77,105,1256,84,136,1,0,1,1583,107,1008,125,719,0,0,0,1959,3542
34,78,94,886,68,140,0,0,1,1189,76,730,76,639,0,0,0,1521,2710
34,79,99,938,63,168,0,0,0,1268,92,788,90,698,0,0,0,1668,2936
34,80,86,860,50,174,0,0,1,1171,88,658,86,735,0,0,0,1567,2738
34,81,77,826,37,159,0,0,0,1099,87,699,60,841,0,0,0,1687,2786
34,82,65,861,41,188,1,0,0,1156,103,590,62,818,0,0,0,1573,2729
34,83,68,857,47,202,0,0,0,1174,68,585,60,929,0,0,0,1642,2816
34,84,71,796,35,203,0,0,0,1105,84,481,48,918,0,0,0,1531,2636
34,85,72,654,32,222,0,0,0,980,91,411,53,972,0,0,0,1527,2507
34,86,43,534,22,208,0,0,0,807,91,334,35,919,0,0,0,1379,2186
34,87,34,435,23,188,0,0,0,680,54,260,29,822,0,0,0,1165,1845
34,88,38,387,23,165,0,0,0,613,58,193,29,784,0,0,0,1064,1677
34,89,33,328,11,136,1,0,0,509,64,128,25,726,0,0,0,943,1452
34,90,23,239,10,151,0,0,0,423,59,93,27,638,0,0,0,817,1240
34,91,18,191,3,131,0,0,0,343,48,75,10,583,0,0,0,716,1059
34,92,14,130,7,115,0,0,0,266,36,54,12,516,0,0,0,618,884
34,93,8,97,3,90,0,0,0,198,44,30,9,449,0,0,0,532,730
34,94,8,64,2,59,0,0,0,133,22,27,2,344,0,0,0,395,528
34,95,2,48,0,48,0,0,0,98,23,12,6,245,0,0,0,286,384
34,96,1,29,0,39,0,0,0,69,13,6,4,189,0,0,0,212,281
34,97,6,13,0,27,0,0,0,46,10,3,3,137,0,0,0,153,199
34,98,1,10,0,20,0,0,0,31,7,4,0,99,0,0,0,110,141
34,99,1,3,1,4,0,0,0,9,13,1,2,62,0,0,0,78,87
34,100,1,2,0,8,0,0,0,11,11,2,2,102,0,0,0,117,128
34,999,59584,58551,6555,4526,115,0,4,129335,49619,59136,8932,20523,73,0,3,138286,267621
35,0,2368,0,0,0,0,0,0,2368,2258,0,0,0,0,0,0,2258,4626
35,1,2490,0,0,0,0,0,0,2490,2239,0,0,0,0,0,0,2239,4729
35,2,2527,0,0,0,0,0,0,2527,2280,0,0,0,0,0,0,2280,4807
35,3,2565,0,0,0,0,0,0,2565,2435,0,0,0,0,0,0,2435,5000
35,4,2637,0,0,0,0,0,0,2637,2420,0,0,0,0,0,0,2420,5057
35,5,2643,0,0,0,0,0,0,2643,2523,0,0,0,0,0,0,2523,5166
35,6,2882,0,0,0,0,0,0,2882,2701,0,0,0,0,0,0,2701,5583
35,7,2892,0,0,0,0,0,0,2892,2728,0,0,0,0,0,0,2728,5620
35,8,3018,0,0,0,0,0,0,3018,2793,0,0,0,0,0,0,2793,5811
35,9,3208,0,0,0,0,0,0,3208,3005,0,0,0,0,0,0,3005,6213
35,10,3237,0,0,0,0,0,0,3237,3005,0,0,0,0,0,0,3005,6242
35,11,3385,0,0,0,0,0,0,3385,3156,0,0,0,0,0,0,3156,6541
35,12,3292,0,0,0,0,0,0,3292,3172,0,0,0,0,0,0,3172,6464
35,13,3478,0,0,0,0,0,0,3478,3377,0,0,0,0,0,0,3377,6855
35,14,3614,0,0,0,0,0,0,3614,3547,0,0,0,0,0,0,3547,7161
35,15,3703,0,0,0,0,0,0,3703,3530,0,0,0,0,0,0,3530,7233
35,16,3689,0,0,0,0,0,0,3689,3357,0,0,0,0,0,0,3357,7046
35,17,3734,0,0,0,0,0,0,3734,3489,0,0,0,0,0,0,3489,7223
35,18,3799,0,0,0,0,0,0,3799,3415,3,0,0,0,0,0,3418,7217
35,19,3802,2,1,0,0,0,0,3805,3475,10,0,0,0,0,0,3485,7290
35,20,3820,1,0,0,0,0,0,3821,3388,21,0,0,0,0,0,3409,7230
35,21,3873,7,0,0,0,0,0,3880,3514,28,0,0,0,0,0,3542,7422
35,22,3939,11,4,0,0,0,0,3954,3465,54,2,0,2,0,0,3523,7477
35,23,3972,26,3,0,0,0,0,4001,3476,135,3,0,0,0,0,3614,7615
35,24,4085,47,4,1,2,0,0,4139,3337,145,3,0,0,0,0,3485,7624
35,25,4062,63,2,0,1,0,0,4128,3375,211,6,0,2,0,0,3594,7722
35,26,3953,106,1,0,1,0,0,4061,3329,272,7,0,4,0,0,3612,7673
35,27,4136,177,12,0,1,0,0,4326,3243,432,15,1,2,0,0,3693,8019
35,28,3845,234,5,0,4,0,0,4088,3111,519,15,0,6,0,0,3651,7739
35,29,3781,304,6,0,2,1,0,4094,3020,744,27,3,6,0,0,3800,7894
35,30,3638,510,7,0,4,0,0,4159,2976,903,30,3,6,0,0,3918,8077
35,31,3584,605,20,1,6,0,0,4216,2749,1124,33,2,8,1,0,3917,8133
35,32,3434,798,27,1,6,0,0,4266,2637,1357,49,3,10,0,0,4056,8322
35,33,3131,1000,31,5,6,0,0,4173,2428,1447,71,3,8,1,0,3958,8131
35,34,3002,1089,27,7,6,0,0,4131,2297,1664,91,9,10,0,0,4071,8202
35,35,2835,1350,50,6,8,2,0,4251,2134,1820,99,11,12,0,0,4076,8327
35,36,2731,1429,76,5,7,0,0,4248,1937,1880,112,13,10,1,0,3953,8201
35,37,2407,1547,90,2,9,0,0,4055,1790,1887,163,19,10,0,0,3869,7924
35,38,2384,1738,95,6,7,0,0,4230,1773,2066,167,26,10,1,0,4043,8273
35,39,2316,1774,99,7,4,0,0,4200,1738,2153,166,22,12,0,0,4091,8291
35,40,2157,2020,130,5,7,0,0,4319,1629,2311,231,25,8,0,0,4204,8523
35,41,2002,2083,151,7,5,0,0,4248,1512,2328,250,30,10,0,0,4130,8378
35,42,1984,2224,188,12,8,1,0,4417,1521,2484,296,35,9,0,0,4345,8762
35,43,1986,2140,182,16,10,0,0,4334,1437,2577,306,55,6,0,0,4381,8715
35,44,1903,2288,177,18,12,0,0,4398,1497,2759,355,53,11,1,0,4676,9074
35,45,2026,2376,228,31,11,0,0,4672,1496,3036,410,66,9,0,0,5017,9689
35,46,2052,2687,271,24,13,0,0,5047,1522,3147,483,70,5,0,0,5227,10274
35,47,2132,2996,293,25,12,0,0,5458,1533,3328,497,100,6,0,0,5464,10922
35,48,2218,3199,370,26,13,0,0,5826,1645,3636,590,92,4,0,0,5967,11793
35,49,2228,3376,431,32,15,0,0,6082,1642,4020,655,109,6,0,0,6432,12514
35,50,2156,3641,448,36,6,0,0,6287,1519,4063,697,115,7,0,0,6401,12688
35,51,2239,3744,577,26,16,0,0,6602,1542,4263,822,138,12,0,0,6777,13379
35,52,2147,3929,577,37,17,1,0,6708,1536,4272,823,161,7,0,0,6799,13507
35,53,1902,4026,586,44,12,0,0,6570,1391,4381,902,208,7,1,0,6890,13460
35,54,1878,4099,659,32,16,0,0,6684,1376,4476,905,213,7,0,0,6977,13661
35,55,1796,4183,651,49,14,1,0,6694,1276,4546,894,269,6,1,0,6992,13686
35,56,1680,4096,677,60,13,0,0,6526,1186,4569,925,266,9,0,0,6955,13481
35,57,1624,4458,793,74,17,0,0,6966,1155,4724,1012,323,9,0,0,7223,14189
35,58,1580,4558,819,89,12,1,0,7059,1070,4829,1032,371,6,0,0,7308,14367
35,59,1474,4719,815,84,9,0,0,7101,1052,4913,1061,401,4,0,0,7431,14532
35,60,1222,4357,781,110,17,1,0,6488,927,4818,984,457,8,0,0,7194,13682
35,61,1146,4290,688,116,6,0,0,6246,863,4572,904,469,4,0,0,6812,13058
35,62,1055,4132,649,113,5,0,0,5954,744,4393,863,549,5,0,0,6554,12508
35,63,912,4212,638,122,13,0,0,5897,727,4298,801,552,3,0,0,6381,12278
35,64,891,4142,625,125,10,0,0,5793,644,4232,778,634,4,0,0,6292,12085
35,65,794,3962,541,142,7,0,0,5446,589,4053,726,709,1,0,0,6078,11524
35,66,736,3989,535,165,5,0,0,5430,559,3916,715,721,4,0,0,5915,11345
35,67,659,3897,476,169,3,0,0,5204,504,3763,681,801,2,0,0,5751,10955
35,68,600,3645,470,200,8,0,0,4923,445,3683,589,909,0,0,0,5626,10549
35,69,586,3809,426,202,5,0,0,5028,461,3620,552,983,1,0,0,5617,10645
35,70,501,3594,334,254,5,0,0,4688,424,3465,486,1051,2,0,0,5428,10116
35,71,498,3458,351,225,4,0,0,4536,382,3292,480,1068,3,0,1,5226,9762
35,72,451,3397,329,270,2,0,0,4449,391,3220,399,1187,2,0,0,5199,9648
35,73,469,3739,304,321,5,0,0,4838,405,3301,431,1339,2,0,0,5478,10316
35,74,398,3580,276,316,6,0,1,4577,359,3298,411,1434,1,0,0,5503,10080
35,75,394,3741,286,365,1,0,0,4787,407,3402,409,1698,0,0,0,5916,10703
35,76,369,3838,264,411,3,0,0,4885,409,3286,422,1856,0,0,0,5973,10858
35,77,342,3677,236,471,2,0,0,4728,349,3351,360,2065,1,0,0,6126,10854
35,78,262,2492,133,395,3,0,0,3285,246,2032,245,1622,3,0,0,4148,7433
35,79,225,2778,158,436,4,0,0,3601,258,2198,246,2015,2,0,0,4719,8320
35,80,223,2608,129,421,1,0,0,3382,276,2064,227,2011,0,0,0,4578,7960
35,81,217,2467,124,456,3,0,0,3267,271,1775,223,2273,1,0,0,4543,7810
35,82,210,2327,125,551,2,0,0,3215,275,1817,203,2368,0,0,0,4663,7878
35,83,207,2365,115,584,5,0,0,3276,284,1756,171,2725,0,0,0,4936,8212
35,84,182,2186,88,646,2,0,0,3104,300,1462,186,2822,0,0,0,4770,7874
35,85,173,1889,86,607,3,0,0,2758,268,1224,167,2807,0,0,0,4466,7224
35,86,143,1630,61,562,2,0,0,2398,216,956,118,2609,0,0,0,3899,6297
35,87,102,1279,46,513,0,0,0,1940,200,672,101,2362,0,0,0,3335,5275
35,88,95,1077,30,480,1,0,0,1683,187,578,100,2365,0,0,0,3230,4913
35,89,86,844,36,463,1,0,0,1430,182,431,62,2177,0,0,0,2852,4282
35,90,77,714,18,368,0,0,0,1177,156,351,70,1881,0,0,0,2458,3635
35,91,48,565,17,349,0,0,0,979,179,237,57,1809,0,0,0,2282,3261
35,92,36,436,15,290,1,0,0,778,152,195,37,1480,0,0,0,1864,2642
35,93,30,312,9,239,0,0,0,590,118,142,37,1357,0,0,0,1654,2244
35,94,28,189,8,200,0,0,0,425,107,71,17,1033,0,0,0,1228,1653
35,95,15,143,4,147,0,0,0,309,78,36,14,799,0,0,0,927,1236
35,96,12,85,2,102,0,0,0,201,74,32,13,573,0,0,0,692,893
35,97,8,46,2,72,0,0,0,128,45,18,8,445,0,0,0,516,644
35,98,6,34,0,49,0,0,0,89,33,5,2,336,0,0,0,376,465
35,99,6,17,2,26,0,0,0,51,22,9,3,197,0,0,0,231,282
35,100,2,16,0,53,0,0,0,71,33,5,5,341,0,0,0,384,455
35,999,185471,175618,19000,12874,447,8,1,393419,156708,179566,27508,60104,315,7,1,424209,817628
36,0,663,0,0,0,0,0,0,663,570,0,0,0,0,0,0,570,1233
36,1,631,0,0,0,0,0,0,631,589,0,0,0,0,0,0,589,1220
36,2,629,0,0,0,0,0,0,629,682,0,0,0,0,0,0,682,1311
36,3,700,0,0,0,0,0,0,700,651,0,0,0,0,0,0,651,1351
36,4,711,0,0,0,0,0,0,711,674,0,0,0,0,0,0,674,1385
36,5,772,0,0,0,0,0,0,772,660,0,0,0,0,0,0,660,1432
36,6,827,0,0,0,0,0,0,827,754,0,0,0,0,0,0,754,1581
36,7,862,0,0,0,0,0,0,862,720,0,0,0,0,0,0,720,1582
36,8,812,0,0,0,0,0,0,812,757,0,0,0,0,0,0,757,1569
36,9,822,0,0,0,0,0,0,822,786,0,0,0,0,0,0,786,1608
36,10,904,0,0,0,0,0,0,904,820,0,0,0,0,0,0,820,1724
36,11,886,0,0,0,0,0,0,886,876,0,0,0,0,0,0,876,1762
36,12,927,0,0,0,0,0,0,927,835,0,0,0,0,0,0,835,1762
36,13,861,0,0,0,0,0,0,861,922,0,0,0,0,0,0,922,1783
36,14,931,0,0,0,0,0,0,931,904,0,0,0,0,0,0,904,1835
36,15,919,0,0,0,0,0,0,919,964,0,0,0,0,0,0,964,1883
36,16,991,0,0,0,0,0,0,991,842,0,0,0,0,0,0,842,1833
36,17,989,0,0,0,0,0,0,989,958,0,0,0,0,0,0,958,1947
36,18,959,0,0,0,0,0,0,959,832,0,0,0,0,0,0,832,1791
36,19,1067,2,0,0,0,0,0,1069,905,2,0,0,0,0,0,907,1976
36,20,979,0,0,0,0,0,0,979,884,4,1,0,0,0,0,889,1868
36,21,979,3,0,0,0,0,0,982,903,10,0,0,0,0,0,913,1895
36,22,949,2,2,0,0,0,0,953,944,12,2,0,0,0,0,958,1911
36,23,1022,4,0,0,1,0,0,1027,888,29,1,0,1,0,0,919,1946
36,24,1102,6,1,0,0,0,0,1109,848,33,3,0,0,0,0,884,1993
36,25,1093,16,0,1,0,0,0,1110,834,55,0,0,0,0,0,889,1999
36,26,1057,30,0,0,0,0,0,1087,879,66,1,0,2,0,0,948,2035
36,27,1029,37,4,0,0,0,0,1070,905,94,3,0,1,0,0,1003,2073
36,28,1010,42,3,0,0,0,0,1055,810,155,6,0,1,0,0,972,2027
36,29,990,85,2,0,0,0,0,1077,748,162,10,1,2,0,0,923,2000
36,30,972,108,6,0,0,0,0,1086,717,203,10,0,2,0,0,932,2018
36,31,988,158,3,0,0,0,0,1149,704,274,7,0,0,0,0,985,2134
36,32,879,185,11,3,3,0,0,1081,625,345,15,1,0,0,0,986,2067
36,33,894,248,10,2,2,0,0,1156,641,428,21,0,1,1,0,1092,2248
36,34,789,286,13,0,1,0,0,1089,645,406,25,1,4,0,0,1081,2170
36,35,797,354,19,4,2,1,0,1177,577,538,29,1,0,0,0,1145,2322
36,36,742,413,18,2,3,0,0,1178,519,496,35,0,2,0,0,1052,2230
36,37,685,429,28,1,2,0,0,1145,544,566,41,8,5,0,0,1164,2309
36,38,719,466,36,2,3,0,0,1226,470,580,54,7,2,0,0,1113,2339
36,39,661,490,28,2,1,0,0,1182,464,610,61,9,1,0,0,1145,2327
36,40,638,544,43,0,1,0,0,1226,431,607,65,7,4,0,0,1114,2340
36,41,608,606,38,4,2,0,0,1258,445,662,79,10,3,0,0,1199,2457
36,42,576,597,51,13,3,0,0,1240,421,718,67,12,2,1,0,1221,2461
36,43,582,625,47,6,1,0,0,1261,366,723,95,9,0,0,0,1193,2454
36,44,559,663,53,5,1,0,0,1281,414,750,84,18,1,1,0,1268,2549
36,45,596,775,63,9,2,0,0,1445,429,832,105,22,3,0,0,1391,2836
36,46,601,731,88,6,1,0,0,1427,435,908,117,15,4,0,0,1479,2906
36,47,599,796,84,9,3,0,0,1491,433,919,129,20,5,0,0,1506,2997
36,48,605,864,101,15,1,0,0,1586,389,968,143,25,2,0,0,1527,3113
36,49,592,952,115,12,2,0,0,1673,404,1071,171,29,4,0,0,1679,3352
36,50,601,995,110,9,0,0,0,1715,400,1107,171,53,4,0,0,1735,3450
36,51,561,1031,126,9,2,1,0,1730,347,1165,187,40,0,1,0,1740,3470
36,52,546,1059,139,8,3,0,0,1755,371,1164,206,43,1,0,0,1785,3540
36,53,514,1031,158,16,1,0,0,1720,333,1180,207,47,4,0,0,1771,3491
36,54,509,1100,164,9,4,0,0,1786,341,1226,237,72,2,0,0,1878,3664
36,55,462,1176,178,11,2,0,0,1829,323,1260,212,63,1,0,0,1859,3688
36,56,419,1181,158,17,6,1,0,1782,307,1281,243,83,1,0,0,1915,3697
36,57,432,1311,164,20,1,0,0,1928,300,1328,228,92,2,0,0,1950,3878
36,58,377,1242,210,23,1,0,1,1854,253,1393,247,92,3,0,0,1988,3842
36,59,370,1381,222,26,3,0,0,2002,245,1334,244,105,3,0,0,1931,3933
36,60,325,1240,171,20,3,0,0,1759,210,1264,235,100,2,0,0,1811,3570
36,61,276,1175,184,35,2,0,0,1672,205,1208,228,144,0,0,0,1785,3457
36,62,258,1236,166,29,2,0,0,1691,175,1212,214,125,0,1,0,1727,3418
36,63,226,1138,150,40,2,0,0,1556,128,1164,186,186,2,0,0,1666,3222
36,64,208,1104,153,31,1,0,0,1497,125,1082,183,134,0,0,0,1524,3021
36,65,206,1067,142,50,1,0,0,1466,130,1045,151,186,0,0,0,1512,2978
36,66,174,1031,131,44,2,0,0,1382,114,1021,155,190,1,0,0,1481,2863
36,67,142,1077,134,30,1,0,0,1384,98,991,149,207,0,0,0,1445,2829
36,68,138,980,94,61,0,0,0,1273,81,934,131,240,0,0,0,1386,2659
36,69,131,969,107,45,0,0,0,1252,81,948,130,269,0,0,0,1428,2680
36,70,93,975,69,57,0,0,0,1194,83,853,93,258,0,0,0,1287,2481
36,71,87,884,82,69,1,0,0,1123,60,882,106,244,0,0,0,1292,2415
36,72,94,889,79,50,0,0,0,1112,67,842,102,287,0,0,0,1298,2410
36,73,100,940,80,68,1,0,0,1189,63,873,66,319,0,0,0,1321,2510
36,74,98,962,68,95,1,0,0,1224,56,917,73,388,0,0,0,1434,2658
36,75,96,1065,50,105,0,0,0,1316,67,885,63,410,0,0,0,1425,2741
36,76,72,999,60,90,0,0,0,1221,64,882,83,498,0,0,0,1527,2748
36,77,77,1006,49,100,1,0,0,1233,62,846,76,527,0,0,0,1511,2744
36,78,50,627,28,106,0,0,0,811,45,545,41,392,0,0,0,1023,1834
36,79,62,721,37,107,0,0,0,927,51,603,53,536,0,1,0,1244,2171
36,80,56,706,29,106,0,0,0,897,28,498,49,563,0,0,0,1138,2035
36,81,36,685,32,114,0,0,0,867,49,510,29,584,0,0,0,1172,2039
36,82,44,663,27,141,0,0,0,875,48,492,42,622,0,0,0,1204,2079
36,83,61,657,20,142,1,0,0,881,51,439,44,697,0,0,0,1231,2112
36,84,39,564,16,147,0,0,0,766,41,388,36,678,0,0,0,1143,1909
36,85,47,509,16,131,0,0,0,703,51,292,33,685,0,0,0,1061,1764
36,86,34,396,15,121,0,0,0,566,40,225,26,628,0,0,0,919,1485
36,87,30,313,12,134,0,0,0,489,32,170,15,607,0,0,0,824,1313
36,88,27,257,5,112,0,0,0,401,40,110,14,542,0,0,0,706,1107
36,89,17,244,5,84,0,0,0,350,18,101,7,531,0,0,0,657,1007
36,90,17,166,5,85,0,0,0,273,26,68,7,445,0,0,0,546,819
36,91,14,130,5,83,0,0,0,232,23,56,8,434,0,0,0,521,753
36,92,17,102,4,53,0,0,0,176,31,45,6,387,0,0,0,469,645
36,93,7,90,2,66,0,0,0,165,18,29,2,366,0,0,0,415,580
36,94,8,56,2,50,0,0,0,116,13,10,4,291,0,0,0,318,434
36,95,5,31,0,35,0,0,0,71,13,15,0,215,0,0,0,243,314
36,96,3,25,0,19,0,0,0,47,19,7,1,166,0,0,0,193,240
36,97,0,14,0,15,0,0,0,29,7,4,5,100,0,0,0,116,145
36,98,1,8,1,13,0,0,0,23,3,0,1,74,0,0,0,78,101
36,99,0,4,0,6,0,0,0,10,6,4,1,57,0,0,0,68,78
36,100,2,5,1,11,0,0,0,19,10,2,2,93,0,0,0,107,126
36,999,49324,47734,4727,3144,77,3,1,105010,40169,48126,6412,15290,78,6,0,110081,215091
37,0,2819,0,0,0,0,0,0,2819,2698,0,0,0,0,0,0,2698,5517
37,1,2984,0,0,0,0,0,0,2984,2839,0,0,0,0,0,0,2839,5823
37,2,3155,0,0,0,0,0,0,3155,3034,0,0,0,0,0,0,3034,6189
37,3,3084,0,0,0,0,0,0,3084,2943,0,0,0,0,0,0,2943,6027
37,4,3303,0,0,0,0,0,0,3303,3256,0,0,0,0,0,0,3256,6559
37,5,3489,0,0,0,0,0,0,3489,3328,0,0,0,0,0,0,3328,6817
37,6,3562,0,0,0,0,0,0,3562,3358,0,0,0,0,0,0,3358,6920
37,7,3683,0,0,0,0,0,0,3683,3555,0,0,0,0,0,0,3555,7238
37,8,3966,0,0,0,0,0,0,3966,3744,0,0,0,0,0,0,3744,7710
37,9,4098,0,0,0,0,0,0,4098,3836,0,0,0,0,0,0,3836,7934
37,10,4141,0,0,0,0,0,0,4141,4008,0,0,0,0,0,0,4008,8149
37,11,4219,0,0,0,0,0,0,4219,4007,0,0,0,0,0,0,4007,8226
37,12,4417,0,0,0,0,0,0,4417,4128,0,0,0,0,0,0,4128,8545
37,13,4376,0,0,0,0,0,0,4376,4121,0,0,0,0,0,0,4121,8497
37,14,4600,0,0,0,0,0,0,4600,4337,0,0,0,0,0,0,4337,8937
37,15,4544,0,0,0,0,0,0,4544,4213,0,0,0,0,0,0,4213,8757
37,16,4616,0,0,0,0,0,0,4616,4076,0,0,0,0,0,0,4076,8692
37,17,4497,0,0,0,0,0,0,4497,4327,0,0,0,0,0,0,4327,8824
37,18,4458,0,0,0,0,0,0,4458,4089,2,0,0,0,0,0,4091,8549
37,19,4523,1,0,0,0,0,0,4524,4206,9,0,0,0,0,0,4215,8739
37,20,4274,4,0,0,0,0,0,4278,4028,20,0,0,0,0,0,4048,8326
37,21,4312,3,0,0,0,0,0,4315,3975,42,0,0,0,0,0,4017,8332
37,22,4378,14,0,0,1,0,0,4393,3915,93,2,0,1,0,0,4011,8404
37,23,4452,27,1,0,0,0,0,4480,3990,146,2,0,1,0,0,4139,8619
37,24,4349,63,1,0,0,0,0,4413,3929,187,4,0,2,0,0,4122,8535
37,25,4384,93,6,0,1,0,0,4484,3955,261,6,2,1,0,0,4225,8709
37,26,4434,133,5,1,0,0,0,4573,3733,380,8,0,2,1,0,4124,8697
37,27,4356,188,8,0,2,0,0,4554,3545,507,7,0,2,0,0,4061,8615
37,28,4009,307,5,0,2,0,0,4323,3479,698,14,2,2,1,0,4196,8519
37,29,4021,407,11,0,8,0,0,4447,3239,977,24,2,3,0,0,4245,8692
37,30,3868,621,7,0,6,2,0,4504,3183,1157,28,3,6,0,0,4377,8881
37,31,3891,795,14,1,3,1,0,4705,3052,1468,38,3,5,0,0,4566,9271
37,32,3740,1000,21,1,11,0,0,4773,2769,1668,49,7,9,0,0,4502,9275
37,33,3431,1274,40,3,7,0,0,4755,2699,1972,82,4,8,0,0,4765,9520
37,34,3184,1467,43,5,11,0,0,4710,2415,2161,88,6,6,0,0,4676,9386
37,35,3244,1634,56,2,12,0,0,4948,2321,2346,118,13,10,1,0,4809,9757
37,36,2936,1809,88,4,6,0,0,4843,2091,2421,139,8,9,0,0,4668,9511
37,37,2622,1989,73,4,8,0,1,4697,1890,2618,180,17,16,1,0,4722,9419
37,38,2667,2271,94,1,6,1,0,5040,1969,2818,195,23,8,0,0,5013,10053
37,39,2547,2421,124,4,7,2,0,5105,1789,2856,227,24,9,1,0,4906,10011
37,40,2442,2578,126,1,5,0,0,5152,1770,3098,232,32,8,1,0,5141,10293
37,41,2436,2706,172,8,5,1,0,5328,1724,3282,266,30,8,1,0,5311,10639
37,42,2287,2887,190,13,6,0,0,5383,1639,3287,331,41,10,1,0,5309,10692
37,43,2271,2955,212,19,11,0,0,5468,1630,3411,374,43,5,0,0,5463,10931
37,44,2239,3163,256,20,11,0,0,5689,1527,3688,409,61,9,0,0,5694,11383
37,45,2266,3481,293,18,15,1,0,6074,1599,3883,475,77,7,1,0,6042,12116
37,46,2270,3711,348,18,12,0,0,6359,1591,4171,518,68,8,0,0,6356,12715
37,47,2284,3891,394,33,11,0,0,6613,1583,4326,536,96,7,0,0,6548,13161
37,48,2383,4255,433,21,16,1,0,7109,1624,4655,604,115,13,0,0,7011,14120
37,49,2318,4380,487,37,13,0,1,7236,1546,4683,663,113,9,0,0,7014,14250
37,50,2251,4378,517,30,11,0,0,7187,1506,4678,729,106,5,1,0,7025,14212
37,51,2079,4613,523,46,8,0,0,7269,1414,5007,745,166,5,1,0,7338,14607
37,52,2010,4630,575,40,8,0,0,7263,1287,4934,780,186,6,0,0,7193,14456
37,53,1808,4657,601,39,15,1,0,7121,1181,4967,797,198,7,1,0,7151,14272
37,54,1707,4829,680,55,6,1,0,7278,1171,5233,818,216,5,1,1,7445,14723
37,55,1697,5098,633,62,9,0,0,7499,1081,5125,868,225,4,0,0,7303,14802
37,56,1529,5018,682,70,9,0,0,7308,1050,5130,867,267,4,0,0,7318,14626
37,57,1365,5204,709,77,10,0,0,7365,937,5348,877,313,0,1,0,7476,14841
37,58,1251,5353,747,83,15,0,0,7449,958,5441,876,395,3,0,0,7673,15122
37,59,1169,5375,662,99,10,0,1,7316,866,5348,792,395,4,0,0,7405,14721
37,60,1028,5056,660,99,11,0,0,6854,754,5014,781,405,1,0,0,6955,13809
37,61,900,4722,558,94,6,0,0,6280,675,4781,659,480,5,0,0,6600,12880
37,62,765,4536,576,130,5,0,0,6012,639,4650,612,495,4,0,0,6400,12412
37,63,698,4494,480,143,10,0,1,5826,596,4285,609,556,3,0,0,6049,11875
37,64,615,4317,448,143,4,0,1,5528,527,4456,573,652,2,0,0,6210,11738
37,65,519,4159,421,138,3,0,2,5242,533,3991,535,631,2,0,0,5692,10934
37,66,568,4025,414,167,6,0,0,5180,467,3912,443,731,2,0,0,5555,10735
37,67,449,3987,366,171,2,0,0,4975,451,3871,419,755,0,0,0,5496,10471
37,68,429,3962,337,183,1,0,0,4912,425,3811,424,858,0,0,0,5518,10430
37,69,428,3814,293,209,3,0,0,4747,383,3656,371,976,0,0,0,5386,10133
37,70,399,3733,263,250,1,0,1,4647,355,3563,333,993,0,0,0,5244,9891
37,71,351,3670,257,269,2,0,0,4549,338,3488,280,1102,0,0,0,5208,9757
37,72,336,3694,221,238,2,0,0,4491,313,3362,266,1191,0,0,0,5132,9623
37,73,352,3709,198,274,1,0,0,4534,307,3402,241,1287,0,0,0,5237,9771
37,74,302,3698,181,350,0,0,0,4531,272,3405,256,1485,2,0,0,5420,9951
37,75,296,3724,189,353,1,0,0,4563,297,3284,239,1644,0,0,0,5464,10027
37,76,277,3474,162,391,1,0,1,4306,288,2996,235,1722,0,0,0,5241,9547
37,77,247,3647,128,426,2,0,0,4450,282,2947,252,2004,0,0,0,5485,9935
37,78,199,2606,99,332,1,0,0,3237,215,2099,152,1558,0,0,0,4024,7261
37,79,204,2550,73,374,0,0,0,3201,230,2022,134,1722,0,0,0,4108,7309
37,80,158,2503,65,436,0,0,0,3162,200,1801,122,1815,0,0,0,3938,7100
37,81,148,2366,64,411,0,0,0,2989,210,1738,113,2068,0,0,0,4129,7118
37,82,161,2343,61,477,0,0,0,3042,248,1625,118,2159,0,0,0,4150,7192
37,83,158,2262,58,498,0,0,0,2976,252,1488,130,2395,2,0,0,4267,7243
37,84,122,2104,47,518,0,0,0,2791,235,1263,92,2523,0,0,0,4113,6904
37,85,116,1846,44,507,1,0,0,2514,230,1042,70,2358,0,0,0,3700,6214
37,86,99,1406,33,463,0,0,0,2001,225,795,62,2209,0,0,0,3291,5292
37,87,69,1191,22,390,0,0,0,1672,171,544,57,2004,0,0,0,2776,4448
37,88,67,963,13,416,0,0,0,1459,178,462,39,1907,0,0,0,2586,4045
37,89,53,763,13,374,0,0,0,1203,172,301,31,1778,0,0,0,2282,3485
37,90,28,579,16,307,0,0,0,930,141,248,31,1507,0,0,0,1927,2857
37,91,32,412,5,274,0,0,0,723,122,162,19,1389,0,0,0,1692,2415
37,92,27,339,5,222,0,0,0,593,112,92,17,1202,0,0,0,1423,2016
37,93,19,232,1,168,0,0,0,420,98,55,6,982,0,0,0,1141,1561
37,94,9,147,1,136,0,0,0,293,65,34,14,785,0,0,0,898,1191
37,95,11,99,0,93,0,0,0,203,51,26,6,574,0,0,0,657,860
37,96,6,57,1,76,0,0,0,140,44,15,7,455,0,0,0,521,661
37,97,3,33,1,56,0,0,0,93,38,10,3,335,0,0,0,386,479
37,98,1,22,0,47,0,0,0,70,23,3,0,237,0,0,0,263,333
37,99,0,7,0,17,0,0,0,24,13,2,0,147,0,0,0,162,186
37,100,2,15,0,41,0,0,0,58,26,4,1,216,0,0,0,247,305
37,999,204346,196949,16611,11476,360,11,9,429762,174954,199207,22520,53549,250,14,1,450495,880257
38,0,1910,0,0,0,0,0,0,1910,1871,0,0,0,0,0,0,1871,3781
38,1,2019,0,0,0,0,0,0,2019,1837,0,0,0,0,0,0,1837,3856
38,2,1955,0,0,0,0,0,0,1955,2064,0,0,0,0,0,0,2064,4019
38,3,2163,0,0,0,0,0,0,2163,2013,0,0,0,0,0,0,2013,4176
38,4,2252,0,0,0,0,0,0,2252,2133,0,0,0,0,0,0,2133,4385
38,5,2306,0,0,0,0,0,0,2306,2186,0,0,0,0,0,0,2186,4492
38,6,2436,0,0,0,0,0,0,2436,2301,0,0,0,0,0,0,2301,4737
38,7,2556,0,0,0,0,0,0,2556,2507,0,0,0,0,0,0,2507,5063
38,8,2651,0,0,0,0,0,0,2651,2525,0,0,0,0,0,0,2525,5176
38,9,2694,0,0,0,0,0,0,2694,2515,0,0,0,0,0,0,2515,5209
38,10,2808,0,0,0,0,0,0,2808,2557,0,0,0,0,0,0,2557,5365
38,11,2903,0,0,0,0,0,0,2903,2697,0,0,0,0,0,0,2697,5600
38,12,2878,0,0,0,0,0,0,2878,2732,0,0,0,0,0,0,2732,5610
38,13,2934,0,0,0,0,0,0,2934,2804,0,0,0,0,0,0,2804,5738
38,14,3132,0,0,0,0,0,0,3132,2802,0,0,0,0,0,0,2802,5934
38,15,3039,0,0,0,0,0,0,3039,2901,0,0,0,0,0,0,2901,5940
38,16,2976,0,0,0,0,0,0,2976,2859,0,0,0,0,0,0,2859,5835
38,17,3005,2,1,0,0,0,0,3008,2833,1,0,0,0,0,0,2834,5842
38,18,3052,0,0,0,0,0,0,3052,2796,1,0,0,0,0,0,2797,5849
38,19,3082,2,0,0,0,0,0,3084,2839,2,0,0,0,0,0,2841,5925
38,20,2992,5,0,0,0,0,0,2997,2711,16,0,0,1,0,0,2728,5725
38,21,2857,7,0,0,0,0,0,2864,2640,28,0,0,0,0,0,2668,5532
38,22,3036,8,2,0,0,0,0,3046,2684,42,1,0,0,0,0,2727,5773
38,23,3179,17,2,0,0,0,0,3198,2727,77,1,0,0,0,0,2805,6003
38,24,3105,29,4,0,0,0,0,3138,2761,127,6,0,0,0,0,2894,6032
38,25,3185,63,0,0,1,0,0,3249,2617,163,4,0,2,0,0,2786,6035
38,26,3104,77,1,0,1,0,0,3183,2617,256,5,0,1,0,0,2879,6062
38,27,3031,137,2,0,1,0,0,3171,2542,339,4,1,1,0,0,2887,6058
38,28,2978,178,5,0,2,0,0,3163,2426,455,16,0,2,0,0,2899,6062
38,29,2905,283,8,0,1,0,0,3197,2360,610,11,0,2,1,0,2984,6181
38,30,2830,403,16,1,5,0,0,3255,2167,805,27,0,2,0,0,3001,6256
38,31,2725,528,13,0,1,0,0,3267,2070,970,27,3,8,0,0,3078,6345
38,32,2633,691,16,4,5,0,0,3349,2025,1186,28,0,4,0,0,3243,6592
38,33,2534,823,19,2,3,0,0,3381,1844,1301,60,2,3,0,0,3210,6591
38,34,2360,982,28,0,4,0,0,3374,1730,1373,59,7,8,0,0,3177,6551
38,35,2242,1141,25,1,6,1,0,3416,1564,1555,64,5,8,0,0,3196,6612
38,36,1988,1214,48,1,5,0,0,3256,1423,1704,75,3,8,0,0,3213,6469
38,37,1970,1343,48,3,3,0,0,3367,1402,1783,117,10,2,0,0,3314,6681
38,38,1887,1491,77,5,3,0,1,3464,1337,1843,139,16,2,1,0,3338,6802
38,39,1719,1654,75,4,7,0,0,3459,1268,2065,146,9,8,1,0,3497,6956
38,40,1750,1766,93,4,7,0,0,3620,1227,2184,172,20,3,0,0,3606,7226
38,41,1740,1872,108,2,6,0,0,3728,1269,2200,160,21,7,0,0,3657,7385
38,42,1613,1864,133,13,7,0,0,3630,1134,2319,195,19,2,1,1,3671,7301
38,43,1658,2026,135,7,3,0,0,3829,1111,2313,222,27,10,0,0,3683,7512
38,44,1521,2181,168,12,11,0,0,3893,1062,2488,246,40,2,0,0,3838,7731
38,45,1561,2485,193,10,8,0,0,4257,1022,2702,306,48,4,0,0,4082,8339
38,46,1646,2511,230,12,7,0,0,4406,1132,2840,315,49,7,0,0,4343,8749
38,47,1659,2682,247,17,5,1,0,4611,1101,3018,345,58,3,0,0,4525,9136
38,48,1684,2938,285,19,12,0,0,4938,1127,3172,392,76,8,0,0,4775,9713
38,49,1690,3067,300,20,5,0,0,5082,996,3317,460,76,1,1,0,4851,9933
38,50,1512,3045,359,33,6,0,0,4955,1018,3369,454,85,3,0,0,4929,9884
38,51,1473,3262,351,27,11,0,0,5124,941,3410,484,94,6,0,0,4935,10059
38,52,1407,3338,373,21,7,0,1,5147,869,3356,473,108,3,0,0,4809,9956
38,53,1228,3181,367,29,4,0,1,4810,826,3354,505,132,5,0,0,4822,9632
38,54,1253,3420,407,23,6,0,0,5109,839,3647,490,153,4,0,0,5133,10242
38,55,1176,3377,417,46,12,0,0,5028,815,3474,507,177,0,0,0,4973,10001
38,56,1081,3623,441,36,13,0,0,5194,696,3542,529,168,6,0,0,4941,10135
38,57,1010,3819,404,47,8,0,0,5288,706,3681,502,194,4,0,0,5087,10375
38,58,947,3600,475,54,10,0,0,5086,684,3621,481,220,1,0,0,5007,10093
38,59,857,3703,421,66,7,0,0,5054,648,3609,490,283,1,0,0,5031,10085
38,60,744,3295,404,62,6,0,0,4511,546,3406,480,297,4,0,0,4733,9244
38,61,712,3257,353,76,3,0,0,4401,512,3167,426,283,1,0,0,4389,8790
38,62,545,3214,336,80,3,0,0,4178,488,3119,455,333,2,0,0,4397,8575
38,63,509,3027,341,78,3,0,0,3958,430,3066,366,361,4,0,0,4227,8185
38,64,513,3033,283,97,6,0,0,3932,399,2903,372,377,1,0,0,4052,7984
38,65,418,2792,267,89,1,0,0,3567,339,2729,306,446,1,0,0,3821,7388
38,66,400,2770,231,105,2,1,0,3509,306,2697,308,494,3,0,0,3808,7317
38,67,321,2686,283,140,5,0,0,3435,328,2619,279,531,0,0,0,3757,7192
38,68,329,2558,196,126,4,1,0,3214,292,2570,211,551,0,0,0,3624,6838
38,69,312,2528,163,148,4,0,0,3155,271,2427,219,610,0,0,0,3527,6682
38,70,283,2509,183,172,1,0,0,3148,230,2376,202,648,2,0,0,3458,6606
38,71,283,2540,180,161,2,0,0,3166,264,2389,180,703,0,0,0,3536,6702
38,72,271,2488,156,172,1,0,0,3088,221,2207,193,791,0,0,0,3412,6500
38,73,245,2488,126,190,2,0,0,3051,251,2330,179,836,1,0,1,3598,6649
38,74,239,2655,132,214,0,0,2,3242,253,2203,182,926,0,0,0,3564,6806
38,75,251,2542,122,235,0,0,0,3150,249,2075,167,1061,0,0,0,3552,6702
38,76,208,2473,99,263,2,0,0,3045,230,1952,140,1146,1,0,0,3469,6514
38,77,212,2260,116,258,3,0,0,2849,248,1924,142,1261,0,0,0,3575,6424
38,78,133,1750,59,239,1,0,0,2182,163,1242,87,981,0,0,0,2473,4655
38,79,129,1696,70,255,0,0,0,2150,163,1271,105,1121,0,0,0,2660,4810
38,80,125,1547,39,260,0,0,0,1971,180,1112,66,1251,0,0,0,2609,4580
38,81,139,1485,53,271,1,0,0,1949,172,1019,62,1252,1,0,0,2506,4455
38,82,122,1464,29,314,1,0,0,1930,136,965,60,1416,1,0,0,2578,4508
38,83,96,1513,33,358,0,0,0,2000,184,881,67,1551,0,0,0,2683,4683
38,84,94,1322,28,342,1,0,0,1787,173,797,55,1620,0,0,0,2645,4432
38,85,100,1104,24,345,0,0,0,1573,160,652,40,1532,0,0,0,2384,3957
38,86,61,883,16,300,0,0,0,1260,167,446,38,1380,1,0,0,2032,3292
38,87,61,698,16,273,0,0,0,1048,147,381,32,1215,0,0,0,1775,2823
38,88,54,634,14,241,0,0,0,943,122,272,24,1253,0,0,0,1671,2614
38,89,35,460,7,225,0,0,0,727,138,227,20,1190,0,0,0,1575,2302
38,90,30,350,7,188,0,0,0,575,88,124,9,1048,0,0,0,1269,1844
38,91,22,259,3,175,0,0,0,459,102,78,14,923,0,0,0,1117,1576
38,92,13,218,4,139,0,0,0,374,80,68,15,762,0,0,0,925,1299
38,93,8,162,2,130,0,0,0,302,83,42,5,683,0,0,0,813,1115
38,94,7,83,0,76,0,0,0,166,55,25,9,556,0,0,0,645,811
38,95,9,62,1,68,0,0,0,140,49,15,1,346,0,0,0,411,551
38,96,2,23,1,45,0,0,0,71,33,11,2,291,0,0,0,337,408
38,97,1,14,0,29,0,0,0,44,22,3,1,213,0,0,0,239,283
38,98,0,6,1,19,0,0,0,26,18,3,3,135,0,0,0,159,185
38,99,1,2,1,10,0,0,0,14,8,3,2,94,0,0,0,107,121
38,100,2,2,0,16,0,0,0,20,21,6,4,159,0,0,0,190,210
38,999,142516,133690,10676,7503,255,4,5,294649,120231,134120,14046,34731,165,5,2,303300,597949
39,0,582,0,0,0,0,0,0,582,560,0,0,0,0,0,0,560,1142
39,1,609,0,0,0,0,0,0,609,595,0,0,0,0,0,0,595,1204
39,2,608,0,0,0,0,0,0,608,614,0,0,0,0,0,0,614,1222
39,3,622,0,0,0,0,0,0,622,604,0,0,0,0,0,0,604,1226
39,4,694,0,0,0,0,0,0,694,649,0,0,0,0,0,0,649,1343
39,5,718,0,0,0,0,0,0,718,673,0,0,0,0,0,0,673,1391
39,6,747,0,0,0,0,0,0,747,720,0,0,0,0,0,0,720,1467
39,7,800,0,0,0,0,0,0,800,694,0,0,0,0,0,0,694,1494
39,8,746,0,0,0,0,0,0,746,736,0,0,0,0,0,0,736,1482
39,9,825,0,0,0,0,0,0,825,741,0,0,0,0,0,0,741,1566
39,10,804,0,0,0,0,0,0,804,731,0,0,0,0,0,0,731,1535
39,11,862,0,0,0,0,0,0,862,769,0,0,0,0,0,0,769,1631
39,12,868,0,0,0,0,0,0,868,795,0,0,0,0,0,0,795,1663
39,13,901,0,0,0,0,0,0,901,773,0,0,0,0,0,0,773,1674
39,14,800,0,0,0,0,0,0,800,772,0,0,0,0,0,0,772,1572
39,15,925,0,0,0,0,0,0,925,801,0,0,0,0,0,0,801,1726
39,16,836,0,0,0,0,0,0,836,804,0,0,0,0,0,0,804,1640
39,17,910,0,0,0,0,0,0,910,845,0,0,0,0,0,0,845,1755
39,18,855,1,0,0,0,0,0,856,831,2,0,0,0,0,0,833,1689
39,19,879,1,0,0,0,0,0,880,831,3,0,0,0,0,0,834,1714
39,20,903,0,0,0,1,0,0,904,865,4,0,0,0,0,0,869,1773
39,21,933,0,0,0,0,0,0,933,802,11,0,0,0,0,0,813,1746
39,22,894,3,0,0,1,0,0,898,807,24,0,0,0,0,0,831,1729
39,23,967,5,0,0,0,0,0,972,872,27,1,0,1,0,0,901,1873
39,24,979,13,0,0,1,0,0,993,830,35,0,0,0,0,0,865,1858
39,25,965,38,2,0,0,0,0,1005,807,64,0,0,0,0,0,871,1876
39,26,974,30,0,0,0,0,0,1004,786,107,3,0,0,0,0,896,1900
39,27,973,45,1,0,0,0,0,1019,797,149,2,1,0,0,0,949,1968
39,28,907,103,3,0,0,0,0,1013,660,164,3,0,0,0,0,827,1840
39,29,834,97,2,0,1,0,0,934,650,194,6,0,0,1,0,851,1785
39,30,826,137,0,0,1,0,0,964,631,260,5,1,0,0,0,897,1861
39,31,804,186,6,0,0,0,0,996,551,323,7,1,1,0,0,883,1879
39,32,806,188,3,1,0,0,0,998,513,312,12,2,0,0,0,839,1837
39,33,745,263,7,0,0,0,0,1015,542,363,12,0,2,0,0,919,1934
39,34,655,306,9,0,2,1,0,973,455,397,17,1,1,0,0,871,1844
39,35,606,313,9,1,0,0,0,929,431,442,22,3,1,1,0,900,1829
39,36,572,340,11,0,2,0,0,925,400,478,17,3,2,0,0,900,1825
39,37,547,411,21,0,0,0,0,979,370,529,24,1,1,0,0,925,1904
39,38,551,371,18,0,1,0,0,941,372,527,36,3,0,0,0,938,1879
39,39,527,444,22,2,0,0,0,995,355,569,48,4,1,0,0,977,1972
39,40,547,480,29,2,2,0,0,1060,350,542,51,6,1,0,0,950,2010
39,41,512,496,27,1,0,0,0,1036,344,633,44,5,2,0,0,1028,2064
39,42,483,547,28,1,4,0,0,1063,340,600,61,8,1,0,0,1010,2073
39,43,480,582,44,5,2,0,0,1113,302,656,67,9,2,0,0,1036,2149
39,44,456,546,42,1,1,0,0,1046,287,690,76,18,1,0,0,1072,2118
39,45,465,654,54,4,0,0,0,1177,281,737,81,15,1,0,0,1115,2292
39,46,492,629,59,3,2,0,0,1185,297,765,82,11,0,1,0,1156,2341
39,47,480,731,52,9,2,0,0,1274,279,845,96,25,1,0,0,1246,2520
39,48,476,754,77,5,1,0,0,1313,324,913,128,27,1,0,0,1393,2706
39,49,471,792,102,7,0,0,0,1372,310,849,138,24,1,0,0,1322,2694
39,50,482,821,79,4,2,0,0,1388,267,978,125,39,0,0,0,1409,2797
39,51,451,866,95,5,3,0,0,1420,289,955,118,34,1,0,1,1398,2818
39,52,422,891,108,9,1,0,0,1431,262,1013,135,39,2,0,0,1451,2882
39,53,377,927,104,12,0,0,0,1420,257,982,122,38,2,0,0,1401,2821
39,54,393,915,122,11,1,0,0,1442,269,1028,145,54,0,0,0,1496,2938
39,55,405,988,109,10,1,0,0,1513,231,1033,149,59,2,0,0,1474,2987
39,56,363,1007,122,12,0,0,0,1504,226,1056,154,67,2,0,0,1505,3009
39,57,355,1028,133,28,2,0,0,1546,235,1115,129,80,1,0,0,1560,3106
39,58,342,1026,143,19,0,0,0,1530,201,1061,159,83,2,0,0,1506,3036
39,59,305,1075,128,20,0,0,0,1528,213,1069,152,107,0,0,0,1541,3069
39,60,260,1063,136,17,1,0,0,1477,184,1059,127,111,2,0,0,1483,2960
39,61,222,989,118,17,2,0,0,1348,165,1037,110,115,0,0,0,1427,2775
39,62,239,965,128,22,0,0,0,1354,173,1025,127,132,1,0,0,1458,2812
39,63,219,950,105,33,0,0,0,1307,157,957,136,140,1,0,0,1391,2698
39,64,214,966,101,34,0,0,0,1315,127,974,86,184,0,0,0,1371,2686
39,65,175,939,112,44,0,0,0,1270,133,874,90,187,1,0,0,1285,2555
39,66,147,914,78,39,1,0,0,1179,115,848,79,194,0,0,0,1236,2415
39,67,182,869,92,39,0,0,0,1182,118,801,76,188,0,0,0,1183,2365
39,68,140,824,67,45,1,0,0,1077,108,790,76,214,0,0,0,1188,2265
39,69,139,834,72,46,2,0,0,1093,98,754,84,226,0,0,0,1162,2255
39,70,115,819,53,54,0,0,0,1041,104,728,57,235,0,0,0,1124,2165
39,71,120,787,53,51,1,0,0,1012,80,667,66,246,0,0,0,1059,2071
39,72,112,809,51,74,0,0,0,1046,83,677,48,284,0,0,0,1092,2138
39,73,107,824,46,60,0,0,0,1037,71,646,51,332,0,0,0,1100,2137
39,74,97,806,41,77,0,0,0,1021,69,590,30,306,0,0,0,995,2016
39,75,81,726,32,66,0,0,0,905,66,617,43,375,0,0,0,1101,2006
39,76,91,658,25,96,0,0,0,870,80,525,31,370,0,0,0,1006,1876
39,77,85,633,33,107,0,0,0,858,84,534,32,423,0,0,0,1073,1931
39,78,58,492,20,66,0,0,0,636,32,339,23,361,0,0,0,755,1391
39,79,56,501,21,66,0,0,0,644,45,336,24,401,0,0,0,806,1450
39,80,65,461,21,82,0,0,0,629,59,306,21,400,0,0,0,786,1415
39,81,49,479,11,74,0,0,0,613,57,274,16,447,0,0,0,794,1407
39,82,57,406,16,99,0,0,0,578,39,283,19,450,0,0,0,791,1369
39,83,54,405,8,89,0,0,0,556,42,225,17,512,0,0,0,796,1352
39,84,47,362,10,89,0,0,0,508,52,212,9,503,0,0,0,776,1284
39,85,46,311,8,101,0,0,0,466,40,186,13,470,0,0,0,709,1175
39,86,31,255,7,84,0,0,0,377,33,124,12,448,0,0,0,617,994
39,87,25,213,4,87,0,0,0,329,39,91,12,411,0,0,0,553,882
39,88,27,187,4,77,0,0,0,295,27,82,7,425,0,0,0,541,836
39,89,22,137,4,80,0,0,0,243,30,60,5,362,0,0,0,457,700
39,90,9,115,3,58,0,0,0,185,40,34,8,345,0,0,0,427,612
39,91,11,84,2,60,0,0,0,157,33,34,3,295,0,0,0,365,522
39,92,10,67,1,36,0,0,0,114,23,20,5,275,0,0,0,323,437
39,93,5,28,1,41,0,0,0,75,18,15,4,242,0,0,0,279,354
39,94,4,33,2,24,0,0,0,63,14,9,1,165,0,0,0,189,252
39,95,2,19,0,23,0,0,0,44,10,2,1,145,0,0,0,158,202
39,96,1,8,0,16,0,0,0,25,12,2,0,111,0,0,0,125,150
39,97,2,4,0,14,0,0,0,20,7,2,0,75,0,0,0,84,104
39,98,1,3,0,6,0,0,0,10,8,1,0,43,0,0,0,52,62
39,99,0,2,0,4,0,0,0,6,1,1,1,40,0,0,0,43,49
39,100,1,2,0,4,0,0,0,7,8,1,0,54,0,0,0,63,70
39,999,43644,38999,3257,2373,42,1,0,88316,35282,39246,3977,12010,38,3,1,90557,178873
40,0,11398,0,0,0,0,0,0,11398,10452,0,0,0,0,0,0,10452,21850
40,1,11716,0,0,0,0,0,0,11716,11008,0,0,0,0,0,0,11008,22724
40,2,11985,0,0,0,0,0,0,11985,11290,0,0,0,0,0,0,11290,23275
40,3,11845,0,0,0,0,0,0,11845,11370,0,0,0,0,0,0,11370,23215
40,4,12574,0,0,0,0,0,0,12574,11870,0,0,0,0,0,0,11870,24444
40,5,13154,0,0,0,0,0,0,13154,12564,0,0,0,0,0,0,12564,25718
40,6,13596,0,0,0,0,0,0,13596,12841,0,0,0,0,0,0,12841,26437
40,7,14108,0,0,0,0,0,0,14108,13274,0,0,0,0,0,0,13274,27382
40,8,14667,0,0,0,0,0,0,14667,13541,0,0,0,0,0,0,13541,28208
40,9,14688,0,0,0,0,0,0,14688,14052,0,0,0,0,0,0,14052,28740
40,10,14876,0,0,0,0,0,0,14876,13981,0,0,0,0,0,0,13981,28857
40,11,15455,0,0,0,0,0,0,15455,14431,0,0,0,0,0,0,14431,29886
40,12,15604,0,0,0,0,0,0,15604,14527,0,0,0,0,0,0,14527,30131
40,13,16147,0,0,0,0,0,0,16147,14792,0,0,0,0,0,0,14792,30939
40,14,16189,0,0,0,0,0,0,16189,15412,0,0,0,0,0,0,15412,31601
40,15,16424,0,0,0,0,0,0,16424,15541,0,0,0,0,0,0,15541,31965
40,16,16231,0,0,0,0,0,0,16231,15203,0,0,0,0,0,0,15203,31434
40,17,16583,0,0,0,0,0,0,16583,15297,3,0,0,0,0,0,15300,31883
40,18,16447,0,0,1,0,0,0,16448,14939,4,1,0,0,0,0,14944,31392
40,19,17058,1,1,0,0,0,0,17060,15407,15,0,0,0,0,0,15422,32482
40,20,16906,8,0,0,0,0,0,16914,14582,61,0,0,0,0,0,14643,31557
40,21,16674,14,0,0,1,0,0,16689,14540,123,1,0,0,0,0,14664,31353
40,22,16748,47,10,0,2,0,0,16807,14744,246,10,0,0,0,0,15000,31807
40,23,17300,63,10,0,0,0,0,17373,14770,415,12,0,1,0,0,15198,32571
40,24,17443,163,21,0,1,0,0,17628,14557,604,17,2,2,0,0,15182,32810
40,25,17727,263,18,1,4,0,0,18013,14871,859,13,0,1,0,0,15744,33757
40,26,17761,390,16,0,10,0,0,18177,15024,1219,21,1,7,2,0,16274,34451
40,27,17873,577,31,0,17,2,0,18500,15130,1707,38,3,14,0,0,16892,35392
40,28,17476,963,25,0,22,1,0,18487,14805,2324,47,2,12,2,0,17192,35679
40,29,17516,1387,28,0,29,2,0,18962,14589,3167,72,9,13,1,0,17851,36813
40,30,17196,1984,35,1,31,3,0,19250,14539,3844,90,7,27,1,0,18508,37758
40,31,17121,2724,57,1,38,1,0,19942,14053,4944,130,9,27,0,0,19163,39105
40,32,16362,3524,69,14,54,0,0,20023,13156,5863,175,30,26,3,0,19253,39276
40,33,15850,4407,102,12,63,2,0,20436,12585,6810,237,21,34,0,0,19687,40123
40,34,14910,5297,145,17,57,5,0,20431,12059,7636,252,28,37,6,0,20018,40449
40,35,14571,6177,146,21,87,6,1,21009,10977,8550,343,41,50,3,0,19964,40973
40,36,13042,6893,208,11,90,4,0,20248,9831,9095,420,36,39,6,0,19427,39675
40,37,12109,7712,266,25,88,4,2,20206,9137,9561,539,85,51,5,0,19378,39584
40,38,11708,8295,339,24,86,3,0,20455,8526,10327,692,98,53,3,0,19699,40154
40,39,11110,9142,382,20,71,3,0,20728,8348,10680,705,103,51,6,1,19894,40622
40,40,10617,9839,472,25,85,4,1,21043,8199,11153,814,136,42,2,0,20346,41389
40,41,10283,10611,524,32,87,4,0,21541,7940,12149,915,144,46,3,0,21197,42738
40,42,9746,10767,655,76,86,9,1,21340,7615,11963,1046,224,36,5,1,20890,42230
40,43,9582,11046,648,101,65,3,0,21445,7134,12203,1154,203,40,4,1,20739,42184
40,44,9152,11588,761,99,89,4,0,21693,7075,12654,1205,228,40,2,0,21204,42897
40,45,9246,12319,827,92,73,1,1,22559,7056,13151,1406,256,39,4,1,21913,44472
40,46,9225,12989,894,90,89,1,1,23289,7301,14004,1559,302,43,2,0,23211,46500
40,47,9291,13344,1143,107,70,2,2,23959,7218,14734,1737,362,43,5,1,24100,48059
40,48,9421,14390,1272,107,89,1,2,25282,7320,15674,2073,403,29,2,0,25501,50783
40,49,9460,15298,1447,142,106,2,2,26457,7323,16599,2089,433,35,2,0,26481,52938
40,50,8992,15865,1487,152,97,1,1,26595,7152,16858,2288,468,30,2,0,26798,53393
40,51,8500,16077,1629,147,109,2,1,26465,6658,17266,2563,489,32,3,0,27011,53476
40,52,8181,16630,1789,155,96,2,2,26855,6236,17453,2594,633,41,2,0,26959,53814
40,53,7520,16751,1863,171,100,0,5,26410,5940,17488,2746,679,38,3,0,26894,53304
40,54,7121,17254,2062,181,89,2,0,26709,5717,17923,2792,780,22,1,0,27235,53944
40,55,6652,17283,2046,194,99,2,2,26278,5234,17813,2854,861,32,2,0,26796,53074
40,56,6252,17203,2045,221,72,1,4,25798,5085,17774,2900,938,30,0,0,26727,52525
40,57,6096,17558,2172,316,85,5,2,26234,4757,18232,3021,1082,17,2,0,27111,53345
40,58,5577,17739,2260,308,88,1,2,25975,4533,18071,3007,1192,26,0,0,26829,52804
40,59,4959,17915,2243,339,69,1,3,25529,4339,17899,2952,1261,26,1,0,26478,52007
40,60,4194,16697,2026,346,75,2,3,23343,3682,16732,2809,1405,15,0,1,24644,47987
40,61,3625,15739,1902,398,80,0,1,21745,3369,15993,2607,1534,21,0,1,23525,45270
40,62,3335,15287,1813,419,81,0,5,20940,3020,15406,2378,1635,15,0,0,22454,43394
40,63,2920,14917,1584,479,44,0,2,19946,2755,14657,2269,1837,24,0,0,21542,41488
40,64,2618,14109,1482,442,47,0,3,18701,2513,14221,2145,2027,12,0,1,20919,39620
40,65,2398,13579,1335,506,62,1,1,17882,2370,13400,1894,2074,9,0,2,19749,37631
40,66,2109,13413,1240,514,36,1,0,17313,2217,13131,1888,2307,13,0,1,19557,36870
40,67,1998,13028,1219,628,25,0,5,16903,1985,12469,1754,2480,8,0,0,18696,35599
40,68,1605,12631,1064,584,28,1,0,15913,1742,12426,1679,2775,14,0,0,18636,34549
40,69,1604,12299,1028,702,26,1,2,15662,1689,11812,1499,2874,8,0,0,17882,33544
40,70,1454,11601,890,679,25,0,3,14652,1474,11222,1412,3085,5,0,0,17198,31850
40,71,1349,11471,804,716,28,1,1,14370,1452,11109,1374,3321,7,0,1,17264,31634
40,72,1220,10975,773,824,16,0,2,13810,1314,10895,1281,3682,8,0,2,17182,30992
40,73,1187,11450,701,933,17,0,0,14288,1297,11048,1223,4075,6,0,0,17649,31937
40,74,1131,11547,618,1020,24,0,1,14341,1315,10803,1214,4592,6,0,0,17930,32271
40,75,1071,12201,658,1230,28,0,1,15189,1284,10935,1269,5335,5,0,0,18828,34017
40,76,1037,11722,565,1316,24,0,2,14666,1236,10442,1157,5823,3,0,0,18661,33327
40,77,968,12094,577,1483,14,0,2,15138,1192,10324,1133,6521,3,0,0,19173,34311
40,78,670,8663,421,1179,3,0,2,10938,933,7137,759,5324,0,0,0,14153,25091
40,79,680,8894,383,1302,14,0,1,11274,934,7316,764,5986,3,0,0,15003,26277
40,80,585,8235,358,1372,8,1,2,10561,935,6749,714,6206,1,0,0,14605,25166
40,81,615,7996,297,1420,10,0,0,10338,889,6099,718,6920,1,0,0,14627,24965
40,82,520,7611,274,1630,9,0,1,10045,905,5674,632,7475,0,0,0,14686,24731
40,83,511,7958,258,1826,6,0,1,10560,968,5485,592,8500,1,0,0,15546,26106
40,84,446,7156,217,1849,9,0,0,9677,897,4781,481,8382,1,0,0,14542,24219
40,85,349,6426,168,1849,4,0,0,8796,887,3807,470,8278,0,0,0,13442,22238
40,86,286,5041,134,1733,5,0,1,7200,715,2918,325,7788,0,0,0,11746,18946
40,87,215,4051,105,1510,2,0,0,5883,603,2157,316,6906,1,0,0,9983,15866
40,88,198,3471,96,1443,1,0,0,5209,631,1732,248,6868,0,0,0,9479,14688
40,89,200,2721,63,1291,2,0,0,4277,565,1261,209,6239,0,0,0,8274,12551
40,90,132,2064,50,1089,3,0,0,3338,460,917,156,5352,1,0,0,6886,10224
40,91,108,1549,29,963,2,0,0,2651,434,615,137,4799,0,0,0,5985,8636
40,92,69,1220,24,819,3,0,0,2135,376,416,88,4097,0,0,0,4977,7112
40,93,41,844,17,672,1,0,1,1576,332,276,99,3430,0,0,0,4137,5713
40,94,37,558,13,512,0,0,0,1120,264,199,56,2740,0,0,0,3259,4379
40,95,25,347,1,370,1,0,0,744,200,93,43,2028,0,0,0,2364,3108
40,96,20,204,7,284,0,0,0,515,136,60,36,1502,0,0,0,1734,2249
40,97,15,111,0,205,0,0,0,331,83,30,26,1141,0,0,0,1280,1611
40,98,5,69,4,131,0,0,0,209,62,24,10,828,0,0,0,924,1133
40,99,4,22,1,61,0,0,0,88,47,12,10,509,0,0,0,578,666
40,100,10,43,1,101,0,0,0,155,82,20,7,881,0,0,0,990,1145
40,999,815585,672511,53348,40033,3257,92,78,1584904,710691,683921,83411,181110,1323,85,14,1660555,3245459
41,0,3835,0,0,0,0,0,0,3835,3549,0,0,0,0,0,0,3549,7384
41,1,3955,0,0,0,0,0,0,3955,3671,0,0,0,0,0,0,3671,7626
41,2,4141,0,0,0,0,0,0,4141,3755,0,0,0,0,0,0,3755,7896
41,3,4129,0,0,0,0,0,0,4129,3852,0,0,0,0,0,0,3852,7981
41,4,4297,0,0,0,0,0,0,4297,4276,0,0,0,0,0,0,4276,8573
41,5,4558,0,0,0,0,0,0,4558,4307,0,0,0,0,0,0,4307,8865
41,6,4840,0,0,0,0,0,0,4840,4614,0,0,0,0,0,0,4614,9454
41,7,5019,0,0,0,0,0,0,5019,4700,0,0,0,0,0,0,4700,9719
41,8,5104,0,0,0,0,0,0,5104,4764,0,0,0,0,0,0,4764,9868
41,9,5331,0,0,0,0,0,0,5331,5099,0,0,0,0,0,0,5099,10430
41,10,5594,0,0,0,0,0,0,5594,4978,0,0,0,0,0,0,4978,10572
41,11,5707,0,0,0,0,0,0,5707,5324,0,0,0,0,0,0,5324,11031
41,12,5851,0,0,0,0,0,0,5851,5595,0,0,0,0,0,0,5595,11446
41,13,5991,0,0,0,0,0,0,5991,5672,0,0,0,0,0,0,5672,11663
41,14,6104,0,0,0,0,0,0,6104,5920,0,0,0,0,0,0,5920,12024
41,15,6128,0,0,0,0,0,0,6128,5779,0,0,0,0,0,0,5779,11907
41,16,6049,0,0,0,0,0,0,6049,5798,0,0,0,0,0,0,5798,11847
41,17,6222,0,0,0,0,0,0,6222,5657,1,0,0,0,0,0,5658,11880
41,18,6098,0,1,0,0,0,0,6099,5608,2,0,0,0,0,0,5610,11709
41,19,6082,2,0,0,0,0,0,6084,5673,10,0,0,0,0,0,5683,11767
41,20,6109,4,0,0,0,0,0,6113,5698,36,2,0,1,0,0,5737,11850
41,21,6170,15,1,0,0,0,0,6186,5493,78,1,0,1,0,0,5573,11759
41,22,6289,23,1,0,0,0,0,6313,5436,144,3,0,1,0,0,5584,11897
41,23,6265,41,0,0,2,0,0,6308,5596,217,10,0,1,0,0,5824,12132
41,24,6018,74,7,0,0,0,0,6099,5347,306,11,0,1,0,0,5665,11764
41,25,6166,124,14,0,0,0,0,6304,5179,419,12,0,1,1,0,5612,11916
41,26,6118,174,12,0,3,0,0,6307,4983,585,11,0,3,3,0,5585,11892
41,27,5599,274,7,0,3,0,0,5883,4751,803,17,0,3,1,0,5575,11458
41,28,5532,442,11,0,4,1,0,5990,4502,1115,22,0,1,1,0,5641,11631
41,29,5276,583,13,0,1,0,0,5873,4122,1326,29,2,4,0,0,5483,11356
41,30,5141,819,18,0,8,0,0,5986,3852,1645,43,2,5,2,0,5549,11535
41,31,5106,1083,32,1,5,0,0,6227,3680,2027,43,2,6,0,0,5758,11985
41,32,4609,1373,34,4,5,1,0,6026,3491,2348,65,7,16,0,0,5927,11953
41,33,4608,1550,50,3,8,1,0,6220,3227,2672,86,8,15,0,0,6008,12228
41,34,4153,1830,49,10,14,1,0,6057,3016,2746,117,15,10,2,0,5906,11963
41,35,4089,2255,76,9,13,0,0,6442,2878,3176,144,18,6,0,0,6222,12664
41,36,3843,2393,68,5,15,0,0,6324,2517,3382,188,19,8,1,0,6115,12439
41,37,3419,2616,90,11,7,2,1,6146,2350,3419,210,23,12,1,0,6015,12161
41,38,3377,2866,124,6,10,0,0,6383,2336,3753,252,29,10,2,0,6382,12765
41,39,3395,3095,137,9,8,0,0,6644,2236,3994,281,27,11,0,0,6549,13193
41,40,3140,3365,172,16,10,1,0,6704,2096,4216,326,44,8,0,0,6690,13394
41,41,3157,3588,188,5,12,0,0,6950,1975,4346,339,44,5,2,0,6711,13661
41,42,3100,3795,231,31,11,2,2,7172,1917,4442,370,66,7,1,0,6803,13975
41,43,2962,4049,232,28,18,0,0,7289,1880,4676,422,81,7,0,0,7066,14355
41,44,2792,4171,308,23,18,0,0,7312,1849,4830,518,72,5,0,0,7274,14586
41,45,3023,4596,356,21,8,1,0,8005,1886,5181,582,101,4,0,0,7754,15759
41,46,2915,4818,376,28,15,0,0,8152,1828,5330,635,107,9,0,0,7909,16061
41,47,2895,5110,491,36,13,0,0,8545,1719,5569,625,132,6,1,0,8052,16597
41,48,3025,5556,497,44,22,0,0,9144,1794,6053,728,146,9,0,0,8730,17874
41,49,2914,5756,591,44,23,1,0,9329,1729,6083,777,140,9,1,1,8740,18069
41,50,2693,5774,649,59,14,0,0,9189,1629,6244,849,161,13,0,0,8896,18085
41,51,2655,6081,633,63,11,0,0,9443,1548,6162,822,189,7,0,0,8728,18171
41,52,2334,6110,661,64,21,1,0,9191,1404,6253,798,225,8,0,0,8688,17879
41,53,2327,6255,724,55,15,1,0,9377,1327,6338,854,237,6,0,0,8762,18139
41,54,2239,6347,705,58,17,0,0,9366,1320,6354,881,298,6,0,0,8859,18225
41,55,2104,6432,682,80,18,0,0,9316,1181,6500,896,316,3,1,0,8897,18213
41,56,1923,6409,726,81,16,0,0,9155,1258,6636,795,387,3,0,0,9079,18234
41,57,1917,6849,754,120,23,0,0,9663,1149,6781,828,410,9,0,0,9177,18840
41,58,1785,6779,750,133,10,1,0,9458,1146,6693,785,505,7,1,0,9137,18595
41,59,1613,6996,756,135,15,0,1,9516,1061,6722,850,550,2,0,0,9185,18701
41,60,1375,6409,678,143,10,0,0,8615,951,6336,793,547,2,0,1,8630,17245
41,61,1178,6175,637,139,23,1,0,8153,851,6040,692,623,6,0,0,8212,16365
41,62,1072,5903,585,154,4,1,0,7719,777,5722,624,687,5,0,0,7815,15534
41,63,1034,5892,567,190,6,0,0,7689,710,5586,584,773,3,0,0,7656,15345
41,64,854,5776,531,192,10,0,0,7363,713,5388,534,787,4,0,0,7426,14789
41,65,876,5472,446,212,7,0,0,7013,589,5156,501,900,2,0,0,7148,14161
41,66,728,5231,405,227,5,0,0,6596,546,4833,437,928,1,0,0,6745,13341
41,67,635,5114,352,264,6,0,0,6371,528,4796,455,1011,1,0,0,6791,13162
41,68,661,4947,321,257,2,0,0,6188,464,4604,352,1128,0,0,0,6548,12736
41,69,578,4927,305,268,4,1,0,6083,426,4308,375,1213,1,0,0,6323,12406
41,70,561,4711,273,311,3,0,0,5859,404,4169,316,1269,1,0,0,6159,12018
41,71,537,4569,237,320,0,0,0,5663,420,3948,308,1366,0,0,0,6042,11705
41,72,511,4381,214,331,5,0,1,5443,380,3965,294,1464,1,0,0,6104,11547
41,73,559,4635,205,418,6,0,0,5823,399,3971,250,1659,1,0,0,6280,12103
41,74,469,4574,180,431,3,0,0,5657,355,3777,225,1840,0,0,0,6197,11854
41,75,444,4427,194,447,0,0,0,5512,378,3649,206,2036,3,0,0,6272,11784
41,76,346,4057,176,425,2,0,0,5006,332,3223,198,1958,0,0,0,5711,10717
41,77,345,4065,128,519,1,0,1,5059,335,3022,172,2207,0,0,0,5736,10795
41,78,269,2875,84,410,0,0,0,3638,276,2079,94,1925,0,0,0,4374,8012
41,79,271,2893,83,450,3,0,1,3701,253,2113,90,2142,0,0,0,4598,8299
41,80,253,2636,68,465,2,0,0,3424,281,1932,110,2166,0,0,0,4489,7913
41,81,244,2543,84,522,0,0,0,3393,246,1795,89,2341,0,0,0,4471,7864
41,82,227,2350,52,509,0,0,0,3138,291,1483,86,2446,0,0,0,4306,7444
41,83,200,2424,50,629,0,0,0,3303,310,1471,69,2807,0,0,0,4657,7960
41,84,198,2045,50,623,0,0,0,2916,320,1130,67,2641,0,0,0,4158,7074
41,85,150,1797,34,585,0,0,0,2566,266,929,54,2591,0,0,0,3840,6406
41,86,127,1444,37,504,0,0,0,2112,230,712,47,2305,0,0,0,3294,5406
41,87,96,1022,14,467,0,0,0,1599,228,481,27,2057,0,0,0,2793,4392
41,88,85,934,25,430,1,0,0,1475,249,382,31,2042,0,0,0,2704,4179
41,89,59,689,6,377,0,0,0,1131,202,269,18,1808,0,0,0,2297,3428
41,90,51,524,4,332,0,0,0,911,168,176,11,1586,0,0,0,1941,2852
41,91,45,361,5,305,0,0,0,716,167,118,12,1412,0,0,0,1709,2425
41,92,33,253,2,214,0,0,0,502,146,101,11,1236,0,0,0,1494,1996
41,93,26,218,4,200,0,0,0,448,150,41,7,1043,0,0,0,1241,1689
41,94,13,126,4,126,0,0,0,269,112,20,2,766,0,0,0,900,1169
41,95,11,84,1,88,0,0,0,184,78,25,2,597,1,0,0,703,887
41,96,6,49,0,69,0,0,0,124,55,10,4,426,0,0,0,495,619
41,97,6,25,0,55,0,0,0,86,46,4,0,307,0,0,0,357,443
41,98,2,12,0,30,0,0,0,44,31,6,2,209,0,0,0,248,292
41,99,5,5,2,20,0,0,0,32,14,5,1,158,0,0,0,178,210
41,100,4,6,0,23,0,0,0,33,32,1,1,198,0,0,0,232,265
41,999,272974,247052,18270,13863,519,17,7,552702,224686,247389,23378,61968,281,21,2,557725,1110427
42,0,4359,0,0,0,0,0,0,4359,4263,0,0,0,0,0,0,4263,8622
42,1,4605,0,0,0,0,0,0,4605,4210,0,0,0,0,0,0,4210,8815
42,2,4594,0,0,0,0,0,0,4594,4443,0,0,0,0,0,0,4443,9037
42,3,4871,0,0,0,0,0,0,4871,4504,0,0,0,0,0,0,4504,9375
42,4,4993,0,0,0,0,0,0,4993,4703,0,0,0,0,0,0,4703,9696
42,5,5240,0,0,0,0,0,0,5240,4916,0,0,0,0,0,0,4916,10156
42,6,5428,0,0,0,0,0,0,5428,5115,0,0,0,0,0,0,5115,10543
42,7,5560,0,0,0,0,0,0,5560,5442,0,0,0,0,0,0,5442,11002
42,8,5800,0,0,0,0,0,0,5800,5516,0,0,0,0,0,0,5516,11316
42,9,5866,0,0,0,0,0,0,5866,5613,0,0,0,0,0,0,5613,11479
42,10,6031,0,0,0,0,0,0,6031,5730,0,0,0,0,0,0,5730,11761
42,11,6084,0,0,0,0,0,0,6084,5980,0,0,0,0,0,0,5980,12064
42,12,6505,0,0,0,0,0,0,6505,6055,0,0,0,0,0,0,6055,12560
42,13,6878,0,0,0,0,0,0,6878,6316,0,0,0,0,0,0,6316,13194
42,14,6810,0,0,0,0,0,0,6810,6478,0,0,0,0,0,0,6478,13288
42,15,6925,0,0,0,0,0,0,6925,6440,0,0,0,0,0,0,6440,13365
42,16,6904,0,0,0,0,0,0,6904,6429,0,0,0,0,0,0,6429,13333
42,17,6872,0,0,0,0,0,0,6872,6415,0,0,0,0,0,0,6415,13287
42,18,6570,2,0,0,0,0,0,6572,6156,7,0,0,0,0,0,6163,12735
42,19,6801,0,0,0,0,0,0,6801,6247,18,0,0,0,0,0,6265,13066
42,20,6763,2,0,0,0,0,0,6765,6045,76,0,0,0,0,0,6121,12886
42,21,6801,7,0,0,0,0,0,6808,5862,100,1,0,0,0,0,5963,12771
42,22,6974,45,6,0,0,0,0,7025,6016,217,6,1,0,0,0,6240,13265
42,23,6976,65,3,0,0,0,0,7044,5887,310,7,0,0,0,0,6204,13248
42,24,6894,110,5,0,2,0,0,7011,5773,444,5,1,0,2,0,6225,13236
42,25,6843,187,13,0,4,0,0,7047,5535,628,9,1,2,1,0,6176,13223
42,26,6618,315,8,0,2,1,0,6944,5454,814,17,0,2,0,0,6287,13231
42,27,6424,412,10,0,8,0,0,6854,5203,999,20,1,7,0,0,6230,13084
42,28,6262,565,14,0,6,0,0,6847,4871,1374,31,2,7,0,0,6285,13132
42,29,5965,750,19,0,9,1,0,6744,4597,1713,37,5,8,1,0,6361,13105
42,30,5844,1065,23,0,8,0,0,6940,4376,2035,54,3,12,1,0,6481,13421
42,31,5688,1339,25,0,12,0,0,7064,4165,2351,68,6,6,1,0,6597,13661
42,32,5026,1684,43,3,13,0,0,6769,3830,2722,81,11,9,2,0,6655,13424
42,33,4987,2002,56,2,6,1,0,7054,3651,3123,104,10,11,1,0,6900,13954
42,34,4828,2172,61,6,7,2,0,7076,3321,3298,138,12,13,0,0,6782,13858
42,35,4642,2717,83,3,12,0,0,7457,3185,3666,159,16,5,1,0,7032,14489
42,36,4165,2791,85,11,13,3,0,7068,2865,3841,183,19,9,1,0,6918,13986
42,37,3962,3007,113,8,20,1,0,7111,2681,4078,237,29,6,0,0,7031,14142
42,38,3994,3341,149,6,23,0,0,7513,2598,4229,299,40,14,1,0,7181,14694
42,39,3742,3722,189,9,8,0,0,7670,2430,4557,326,35,19,0,0,7367,15037
42,40,3658,3974,221,10,16,2,0,7881,2507,4669,426,49,13,0,0,7664,15545
42,41,3588,4279,248,11,19,0,0,8145,2373,4971,426,64,12,0,0,7846,15991
42,42,3513,4337,294,18,14,0,0,8176,2301,5063,519,95,14,0,0,7992,16168
42,43,3327,4625,325,22,15,5,0,8319,2251,5326,595,79,13,1,0,8265,16584
42,44,3240,4761,369,26,19,1,0,8416,2137,5372,595,95,20,2,0,8221,16637
42,45,3201,5310,445,29,19,1,1,9006,2174,5803,687,99,10,0,0,8773,17779
42,46,3511,5476,465,28,28,2,0,9510,2054,6012,832,121,12,0,0,9031,18541
42,47,3338,5640,568,35,24,1,1,9607,2140,6276,861,150,8,0,0,9435,19042
42,48,3430,6381,639,53,19,0,0,10522,2122,6761,967,184,17,0,0,10051,20573
42,49,3369,6566,749,47,25,0,0,10756,2067,7012,1018,183,10,0,0,10290,21046
42,50,3031,6556,769,50,28,1,0,10435,1868,6889,1027,188,8,1,0,9981,20416
42,51,2900,6786,853,56,20,1,0,10616,1783,6960,1017,259,10,0,0,10029,20645
42,52,2733,6838,934,59,12,1,0,10577,1690,6898,1071,260,11,1,0,9931,20508
42,53,2525,7055,869,67,17,0,0,10533,1578,6982,1096,264,11,0,0,9931,20464
42,54,2415,7225,931,69,29,1,0,10670,1552,7135,1136,325,6,0,0,10154,20824
42,55,2259,7313,909,81,24,2,1,10589,1424,7295,1081,370,7,0,1,10178,20767
42,56,2124,7389,934,97,15,0,0,10559,1480,7212,1133,425,7,1,1,10259,20818
42,57,2011,7392,1017,125,20,0,0,10565,1379,7270,1123,469,5,0,0,10246,20811
42,58,1851,7264,928,112,19,1,2,10177,1280,7322,1102,494,7,0,1,10206,20383
42,59,1680,7639,909,136,26,0,0,10390,1257,7289,1089,571,7,0,0,10213,20603
42,60,1499,6974,841,151,16,0,0,9481,1073,6965,1002,637,8,0,0,9685,19166
42,61,1347,6781,824,169,12,0,0,9133,998,6579,878,664,5,1,0,9125,18258
42,62,1232,6734,739,175,16,0,0,8896,975,6417,838,772,10,1,0,9013,17909
42,63,1094,6452,677,195,19,0,0,8437,894,6070,784,848,5,0,0,8601,17038
42,64,992,6093,626,219,11,0,1,7942,787,5927,674,855,7,0,0,8250,16192
42,65,917,5954,559,200,6,0,0,7636,705,5506,623,1024,4,0,0,7862,15498
42,66,847,5757,540,237,3,0,1,7385,670,5493,606,1009,5,0,0,7783,15168
42,67,825,5748,475,267,6,0,2,7323,658,5241,561,1147,2,0,0,7609,14932
42,68,715,5407,456,252,8,0,0,6838,564,5007,525,1184,3,0,1,7284,14122
42,69,678,5352,402,276,8,1,0,6717,539,4861,486,1181,3,0,0,7070,13787
42,70,605,5176,334,316,5,0,0,6436,469,4688,431,1280,1,0,0,6869,13305
42,71,613,4893,335,338,10,0,0,6189,491,4556,356,1484,1,0,1,6889,13078
42,72,579,4856,300,356,7,0,0,6098,433,4433,346,1629,0,0,0,6841,12939
42,73,529,5127,280,386,6,0,0,6328,448,4427,319,1785,0,0,1,6980,13308
42,74,546,4971,251,486,5,1,0,6260,437,4283,310,1949,0,0,0,6979,13239
42,75,520,5158,239,505,5,0,0,6427,434,4199,286,2230,1,0,0,7150,13577
42,76,414,4738,222,521,3,0,0,5898,421,3786,276,2282,3,0,0,6768,12666
42,77,447,4730,187,523,3,0,0,5890,400,3686,270,2547,0,0,0,6903,12793
42,78,303,3179,121,445,2,0,0,4050,284,2429,171,2018,1,0,0,4903,8953
42,79,342,3436,107,521,0,0,0,4406,337,2479,180,2401,1,0,0,5398,9804
42,80,283,3174,97,577,4,0,0,4135,288,2352,128,2554,0,0,0,5322,9457
42,81,319,3083,69,599,2,0,1,4073,314,2184,132,2608,0,0,0,5238,9311
42,82,321,2892,71,597,2,0,0,3883,320,1945,127,2877,0,0,0,5269,9152
42,83,278,2824,62,681,0,0,0,3845,349,1794,118,3183,0,0,0,5444,9289
42,84,249,2617,55,665,1,0,0,3587,346,1455,95,3218,0,0,0,5114,8701
42,85,220,2204,51,675,0,0,0,3150,309,1200,74,3154,0,0,0,4737,7887
42,86,145,1749,29,551,1,0,0,2475,283,853,66,2710,0,0,0,3912,6387
42,87,120,1270,13,495,1,0,0,1899,244,635,39,2460,0,0,0,3378,5277
42,88,103,1054,21,513,0,0,0,1691,218,538,37,2492,0,0,0,3285,4976
42,89,94,776,11,450,0,0,0,1331,205,308,28,2127,0,0,0,2668,3999
42,90,74,623,6,375,1,0,0,1079,187,229,21,2033,0,0,0,2470,3549
42,91,61,522,9,322,0,0,0,914,146,189,18,1749,0,0,0,2102,3016
42,92,33,322,4,253,0,0,0,612,147,109,10,1503,0,0,1,1770,2382
42,93,31,235,1,237,0,0,0,504,131,78,20,1329,0,0,0,1558,2062
42,94,22,156,1,164,0,0,0,343,114,51,5,1056,0,0,0,1226,1569
42,95,11,100,0,123,0,0,0,234,88,31,7,781,0,0,0,907,1141
42,96,6,72,1,78,0,0,0,157,59,9,7,588,0,0,0,663,820
42,97,6,26,1,52,0,0,0,85,49,5,4,392,0,0,0,450,535
42,98,1,20,0,43,0,0,0,64,33,14,2,283,0,0,0,332,396
42,99,2,9,1,25,0,0,0,37,21,4,0,183,0,0,0,208,245
42,100,3,9,0,32,0,0,0,44,37,4,4,297,0,0,0,342,386
42,999,306224,280359,23299,15224,724,30,10,625870,252638,280136,30447,71439,398,20,7,635085,1260955
43,0,1711,0,0,0,0,0,0,1711,1580,0,0,0,0,0,0,1580,3291
43,1,1745,0,0,0,0,0,0,1745,1737,0,0,0,0,0,0,1737,3482
43,2,1793,0,0,0,0,0,0,1793,1701,0,0,0,0,0,0,1701,3494
43,3,1828,0,0,0,0,0,0,1828,1767,0,0,0,0,0,0,1767,3595
43,4,1915,0,0,0,0,0,0,1915,1900,0,0,0,0,0,0,1900,3815
43,5,2087,0,0,0,0,0,0,2087,1911,0,0,0,0,0,0,1911,3998
43,6,2132,0,0,0,0,0,0,2132,1939,0,0,0,0,0,0,1939,4071
43,7,2192,0,0,0,0,0,0,2192,2080,0,0,0,0,0,0,2080,4272
43,8,2291,0,0,0,0,0,0,2291,2187,0,0,0,0,0,0,2187,4478
43,9,2321,0,0,0,0,0,0,2321,2080,0,0,0,0,0,0,2080,4401
43,10,2331,0,0,0,0,0,0,2331,2194,0,0,0,0,0,0,2194,4525
43,11,2335,0,0,0,0,0,0,2335,2334,0,0,0,0,0,0,2334,4669
43,12,2409,0,0,0,0,0,0,2409,2298,0,0,0,0,0,0,2298,4707
43,13,2492,0,0,0,0,0,0,2492,2361,0,0,0,0,0,0,2361,4853
43,14,2662,0,0,0,0,0,0,2662,2412,0,0,0,0,0,0,2412,5074
43,15,2560,0,0,0,0,0,0,2560,2529,0,0,0,0,0,0,2529,5089
43,16,2516,0,0,0,0,0,0,2516,2391,0,0,0,0,0,0,2391,4907
43,17,2580,0,0,0,0,0,0,2580,2353,0,0,0,0,0,0,2353,4933
43,18,2611,2,0,0,0,0,0,2613,2370,1,0,0,0,0,0,2371,4984
43,19,2623,0,0,0,0,0,0,2623,2305,9,0,0,0,0,0,2314,4937
43,20,2602,5,0,0,0,0,0,2607,2182,23,0,0,0,0,0,2205,4812
43,21,2510,4,0,1,0,0,0,2515,2305,38,1,0,0,0,0,2344,4859
43,22,2597,8,2,0,0,0,0,2607,2372,62,1,0,0,1,0,2436,5043
43,23,2723,25,3,0,0,0,0,2751,2290,107,1,0,0,0,0,2398,5149
43,24,2665,46,0,0,0,0,0,2711,2303,176,4,0,0,0,0,2483,5194
43,25,2790,76,1,0,1,0,0,2868,2329,200,2,0,1,0,0,2532,5400
43,26,2715,101,2,0,1,0,0,2819,2234,307,5,0,1,0,0,2547,5366
43,27,2695,118,2,0,2,0,0,2817,2122,380,11,1,4,0,0,2518,5335
43,28,2597,194,3,1,2,0,0,2797,2098,433,7,1,2,0,0,2541,5338
43,29,2472,276,5,0,0,0,0,2753,1983,597,19,1,6,0,0,2606,5359
43,30,2428,394,6,1,1,0,0,2830,1941,723,17,1,8,0,0,2690,5520
43,31,2441,472,15,2,4,2,0,2936,1818,885,24,2,5,0,0,2734,5670
43,32,2340,558,19,4,2,0,0,2923,1704,1009,29,6,5,0,0,2753,5676
43,33,2318,789,25,2,5,0,1,3140,1669,1132,52,10,6,0,0,2869,6009
43,34,2096,860,25,3,5,0,0,2989,1479,1265,52,2,8,0,0,2806,5795
43,35,1951,1053,29,3,3,1,0,3040,1389,1433,76,14,9,1,0,2922,5962
43,36,1905,1081,49,6,4,0,0,3045,1287,1539,88,9,3,1,0,2927,5972
43,37,1750,1243,46,2,2,0,0,3043,1200,1570,105,9,5,0,0,2889,5932
43,38,1608,1271,67,3,6,0,0,2955,1192,1663,120,14,8,0,0,2997,5952
43,39,1559,1447,82,1,4,0,0,3093,1140,1704,144,17,3,0,0,3008,6101
43,40,1564,1509,62,3,5,0,0,3143,1113,1859,152,20,8,0,0,3152,6295
43,41,1556,1656,114,7,3,0,0,3336,1057,1892,187,18,4,1,0,3159,6495
43,42,1498,1653,112,6,3,1,0,3273,1082,1944,208,40,3,1,0,3278,6551
43,43,1474,1754,127,8,2,0,0,3365,962,2104,228,25,8,0,0,3327,6692
43,44,1503,1941,151,6,9,0,0,3610,1051,2158,256,43,1,0,0,3509,7119
43,45,1558,2017,201,7,3,0,0,3786,1024,2294,265,44,4,0,0,3631,7417
43,46,1524,2236,219,12,6,1,1,3999,1054,2290,296,45,6,0,0,3691,7690
43,47,1570,2368,228,16,12,0,0,4194,975,2604,354,58,2,0,0,3993,8187
43,48,1616,2381,258,19,10,0,0,4284,1058,2675,396,64,8,0,1,4202,8486
43,49,1523,2696,317,21,5,0,0,4562,1014,2845,448,90,2,0,0,4399,8961
43,50,1435,2698,353,30,8,0,0,4524,1004,2960,460,91,5,0,0,4520,9044
43,51,1425,2751,371,18,5,2,1,4573,882,2961,476,106,9,0,0,4434,9007
43,52,1408,2783,393,25,5,0,0,4614,816,2894,495,103,3,0,0,4311,8925
43,53,1306,2866,342,24,12,0,2,4552,788,2924,493,139,3,0,0,4347,8899
43,54,1147,2972,414,51,7,0,1,4592,784,3085,575,153,3,0,0,4600,9192
43,55,1186,2957,419,42,13,0,0,4617,707,3081,485,181,4,0,0,4458,9075
43,56,1109,3115,456,48,4,0,0,4732,719,3054,571,198,2,0,0,4544,9276
43,57,1077,3179,438,63,8,0,0,4765,693,3192,517,226,1,0,0,4629,9394
43,58,966,3103,485,54,7,0,0,4615,619,3029,518,247,1,0,0,4414,9029
43,59,811,3143,476,65,2,0,0,4497,567,3256,467,262,1,0,0,4553,9050
43,60,802,3007,422,77,6,0,1,4315,521,3090,463,288,1,0,0,4363,8678
43,61,719,3004,385,58,6,0,0,4172,469,2952,437,332,3,0,0,4193,8365
43,62,620,2884,348,85,6,0,0,3943,458,2788,409,384,1,0,0,4040,7983
43,63,554,2696,335,85,6,0,0,3676,449,2734,383,391,0,0,0,3957,7633
43,64,534,2756,331,105,3,0,1,3730,364,2650,346,424,2,0,0,3786,7516
43,65,473,2620,294,112,1,0,0,3500,336,2518,321,458,2,0,1,3636,7136
43,66,405,2597,291,112,1,0,0,3406,364,2465,288,521,1,0,0,3639,7045
43,67,410,2586,275,116,0,0,0,3387,294,2389,278,553,0,0,0,3514,6901
43,68,350,2445,237,137,5,0,0,3174,306,2264,275,587,0,0,0,3432,6606
43,69,328,2292,248,149,1,0,0,3018,255,2219,233,657,1,0,0,3365,6383
43,70,331,2340,205,146,2,0,1,3025,211,2030,231,682,0,0,1,3155,6180
43,71,304,2216,161,173,2,0,0,2856,223,1969,206,706,1,0,0,3105,5961
43,72,267,2260,180,167,4,0,0,2878,187,1973,188,819,0,0,0,3167,6045
43,73,296,2282,169,221,3,0,0,2971,213,2038,192,891,0,0,0,3334,6305
43,74,261,2197,136,210,2,0,0,2806,182,1877,167,982,0,0,0,3208,6014
43,75,263,2233,130,241,3,0,0,2870,208,1893,166,1118,0,0,0,3385,6255
43,76,214,2186,110,257,2,0,0,2769,182,1747,168,1136,0,0,0,3233,6002
43,77,199,1964,103,282,1,0,0,2549,181,1580,150,1256,0,0,0,3167,5716
43,78,142,1383,70,202,0,0,1,1798,122,1048,97,1012,0,0,0,2279,4077
43,79,138,1471,56,229,0,0,1,1895,115,1083,84,1165,0,0,0,2447,4342
43,80,137,1391,60,253,0,0,0,1841,137,969,92,1227,0,0,0,2425,4266
43,81,132,1319,50,270,0,0,0,1771,140,966,73,1241,0,0,0,2420,4191
43,82,120,1227,48,295,0,0,0,1690,120,863,62,1365,0,0,0,2410,4100
43,83,149,1317,50,344,0,0,0,1860,161,801,67,1607,0,0,0,2636,4496
43,84,136,1142,29,340,0,0,0,1647,125,708,50,1559,1,0,0,2443,4090
43,85,112,994,34,344,0,0,0,1484,139,570,60,1636,0,0,0,2405,3889
43,86,81,777,23,308,1,0,0,1190,109,388,38,1507,0,0,0,2042,3232
43,87,81,585,22,274,0,0,0,962,95,300,35,1374,0,0,0,1804,2766
43,88,69,519,17,301,0,0,0,906,90,267,34,1348,0,0,0,1739,2645
43,89,53,416,13,244,0,0,0,726,71,204,17,1238,0,0,0,1530,2256
43,90,35,327,5,205,0,0,0,572,76,132,24,1106,0,0,0,1338,1910
43,91,39,233,7,185,0,0,0,464,79,85,18,991,0,0,0,1173,1637
43,92,25,170,2,148,0,0,0,345,61,76,11,904,0,0,0,1052,1397
43,93,14,122,5,133,1,0,0,275,65,42,7,734,0,0,0,848,1123
43,94,10,77,4,83,0,0,0,174,50,28,6,501,0,0,0,585,759
43,95,12,50,3,65,0,0,0,130,27,22,3,415,0,0,0,467,597
43,96,5,33,0,56,0,0,0,94,31,11,0,295,0,0,0,337,431
43,97,2,17,1,41,0,0,0,61,13,7,4,236,0,0,0,260,321
43,98,0,12,0,16,0,0,0,28,14,4,3,147,0,0,0,168,196
43,99,2,2,0,14,0,0,0,18,13,3,2,128,0,0,0,146,164
43,100,2,4,0,25,0,0,0,31,11,3,0,175,0,0,0,189,220
43,999,127978,117954,11176,7662,227,7,11,265015,104702,118113,14293,36336,165,5,3,273617,538632
44,0,1191,0,0,0,0,0,0,1191,1063,0,0,0,0,0,0,1063,2254
44,1,1207,0,0,0,0,0,0,1207,1089,0,0,0,0,0,0,1089,2296
44,2,1255,0,0,0,0,0,0,1255,1227,0,0,0,0,0,0,1227,2482
44,3,1286,0,0,0,0,0,0,1286,1174,0,0,0,0,0,0,1174,2460
44,4,1387,0,0,0,0,0,0,1387,1269,0,0,0,0,0,0,1269,2656
44,5,1361,0,0,0,0,0,0,1361,1229,0,0,0,0,0,0,1229,2590
44,6,1454,0,0,0,0,0,0,1454,1362,0,0,0,0,0,0,1362,2816
44,7,1401,0,0,0,0,0,0,1401,1399,0,0,0,0,0,0,1399,2800
44,8,1546,0,0,0,0,0,0,1546,1372,0,0,0,0,0,0,1372,2918
44,9,1557,0,0,0,0,0,0,1557,1479,0,0,0,0,0,0,1479,3036
44,10,1590,0,0,0,0,0,0,1590,1481,0,0,0,0,0,0,1481,3071
44,11,1650,0,0,0,0,0,0,1650,1520,0,0,0,0,0,0,1520,3170
44,12,1646,0,0,0,0,0,0,1646,1492,0,0,0,0,0,0,1492,3138
44,13,1775,0,0,0,0,0,0,1775,1584,0,0,0,0,0,0,1584,3359
44,14,1746,0,0,0,0,0,0,1746,1595,0,0,0,0,0,0,1595,3341
44,15,1818,0,0,0,0,0,0,1818,1677,0,0,0,0,0,0,1677,3495
44,16,1751,0,0,0,0,0,0,1751,1592,0,0,0,0,0,0,1592,3343
44,17,1747,0,0,0,0,0,0,1747,1576,0,0,0,0,0,0,1576,3323
44,18,1773,0,0,0,0,0,0,1773,1592,3,0,0,0,0,0,1595,3368
44,19,1747,0,0,0,0,0,0,1747,1558,3,0,0,0,0,0,1561,3308
44,20,1777,2,0,0,0,0,0,1779,1506,13,0,0,0,0,0,1519,3298
44,21,1759,2,0,0,0,0,0,1761,1498,21,0,0,0,0,0,1519,3280
44,22,1742,8,0,0,0,0,0,1750,1612,53,1,0,0,0,0,1666,3416
44,23,1846,15,0,0,0,0,0,1861,1589,82,4,0,1,0,0,1676,3537
44,24,1803,26,2,0,0,0,0,1831,1508,119,4,0,0,0,0,1631,3462
44,25,1851,36,4,0,0,0,0,1891,1553,145,4,0,0,0,0,1702,3593
44,26,1827,84,3,0,1,0,0,1915,1431,194,4,0,1,0,0,1630,3545
44,27,1741,107,2,0,1,0,0,1851,1441,221,4,1,1,0,0,1668,3519
44,28,1761,137,5,0,1,0,0,1904,1333,337,11,1,2,0,0,1684,3588
44,29,1654,212,7,0,2,0,0,1875,1288,403,12,2,0,0,0,1705,3580
44,30,1582,260,6,0,0,0,0,1848,1203,549,16,1,3,0,0,1772,3620
44,31,1544,349,9,0,2,0,0,1904,1133,694,20,1,4,0,0,1852,3756
44,32,1466,473,11,0,0,0,0,1950,1054,721,24,1,3,0,0,1803,3753
44,33,1352,503,13,3,3,0,0,1874,993,823,42,5,3,0,0,1866,3740
44,34,1318,615,15,4,2,1,0,1955,966,930,35,5,5,0,0,1941,3896
44,35,1256,697,21,1,3,0,0,1978,788,983,43,0,1,0,0,1815,3793
44,36,1150,745,26,1,1,0,0,1923,736,1087,48,8,5,0,0,1884,3807
44,37,1116,782,21,2,3,1,0,1925,713,1145,51,6,3,0,0,1918,3843
44,38,1078,905,48,3,4,0,0,2038,753,1085,75,8,5,0,0,1926,3964
44,39,1043,1000,59,3,4,0,0,2109,672,1179,93,16,1,0,0,1961,4070
44,40,963,1042,56,1,3,0,1,2066,632,1247,89,9,4,0,0,1981,4047
44,41,1017,1143,67,2,6,0,1,2236,641,1353,99,14,3,0,0,2110,4346
44,42,937,1203,68,6,5,2,0,2221,630,1377,107,16,2,0,0,2132,4353
44,43,894,1250,81,5,4,1,0,2235,617,1448,105,24,4,0,0,2198,4433
44,44,923,1344,94,10,0,0,0,2371,615,1460,118,25,4,0,0,2222,4593
44,45,957,1384,101,11,7,0,0,2460,570,1607,193,31,3,0,0,2404,4864
44,46,986,1468,121,15,6,0,0,2596,612,1655,186,25,1,1,0,2480,5076
44,47,967,1558,137,13,4,0,0,2679,638,1748,193,49,1,0,0,2629,5308
44,48,996,1695,155,16,2,0,0,2864,579,1852,248,41,2,0,0,2722,5586
44,49,949,1704,181,10,5,0,0,2849,557,1860,244,43,5,0,0,2709,5558
44,50,838,1712,189,19,4,0,1,2763,535,1878,285,58,3,0,0,2759,5522
44,51,864,1855,189,15,5,0,1,2929,542,1845,220,52,2,0,0,2661,5590
44,52,846,1858,211,19,4,0,1,2939,493,1939,275,73,2,0,0,2782,5721
44,53,736,1791,226,24,3,0,0,2780,415,1960,299,92,1,1,0,2768,5548
44,54,744,1989,247,22,5,0,0,3007,466,2012,262,112,3,0,0,2855,5862
44,55,724,2006,257,28,6,0,0,3021,425,2046,274,118,3,0,0,2866,5887
44,56,650,1978,222,24,7,0,0,2881,401,2008,261,131,0,0,0,2801,5682
44,57,645,2134,256,24,6,0,0,3065,399,2073,281,131,3,0,0,2887,5952
44,58,588,2098,242,45,5,0,0,2978,402,2086,285,149,1,0,0,2923,5901
44,59,586,2007,245,46,1,0,1,2886,343,2041,268,191,1,0,0,2844,5730
44,60,500,2008,221,43,3,0,0,2775,340,2062,224,204,1,0,0,2831,5606
44,61,433,1888,207,43,8,0,0,2579,303,1925,226,188,1,0,0,2643,5222
44,62,396,1894,197,53,3,0,0,2543,268,1849,186,263,0,0,0,2566,5109
44,63,371,1853,155,63,5,0,0,2447,241,1868,192,250,1,0,0,2552,4999
44,64,348,1816,176,67,3,0,0,2410,224,1771,184,277,0,0,0,2456,4866
44,65,335,1766,151,87,1,0,0,2340,257,1702,183,290,0,0,1,2433,4773
44,66,306,1651,151,59,1,0,0,2168,199,1624,192,297,1,0,0,2313,4481
44,67,270,1680,101,89,4,0,1,2145,157,1587,142,361,0,0,0,2247,4392
44,68,271,1628,120,80,1,0,0,2100,167,1636,152,386,0,0,0,2341,4441
44,69,243,1605,104,115,2,0,0,2069,144,1458,104,428,0,0,0,2134,4203
44,70,223,1517,96,105,4,0,0,1945,153,1418,134,428,0,0,0,2133,4078
44,71,218,1535,96,108,3,0,0,1960,144,1358,99,488,1,0,0,2090,4050
44,72,218,1538,73,97,1,0,0,1927,133,1301,103,500,0,0,0,2037,3964
44,73,223,1605,76,154,3,0,0,2061,129,1377,87,535,0,0,0,2128,4189
44,74,215,1533,76,163,2,0,0,1989,147,1284,92,686,0,0,0,2209,4198
44,75,218,1575,67,145,1,0,0,2006,120,1323,84,737,0,0,0,2264,4270
44,76,178,1485,68,169,0,0,0,1900,115,1158,62,754,0,0,1,2090,3990
44,77,153,1447,50,176,1,0,0,1827,143,1121,65,810,1,0,0,2140,3967
44,78,115,923,27,141,1,0,0,1207,111,668,47,602,0,0,1,1429,2636
44,79,115,917,26,176,0,0,0,1234,109,714,43,754,0,0,0,1620,2854
44,80,122,879,26,181,1,0,0,1209,98,663,39,782,0,0,0,1582,2791
44,81,123,888,18,201,0,0,0,1230,114,607,41,876,0,0,0,1638,2868
44,82,118,841,21,184,0,0,0,1164,111,566,35,918,0,0,0,1630,2794
44,83,131,795,23,236,0,0,0,1185,105,501,39,1003,0,0,0,1648,2833
44,84,95,785,12,270,0,0,0,1162,91,454,25,1033,0,0,0,1603,2765
44,85,97,657,7,210,0,0,0,971,109,390,24,1051,1,0,0,1575,2546
44,86,78,538,9,182,0,0,0,807,92,227,19,924,0,0,0,1262,2069
44,87,57,425,9,160,0,0,0,651,85,213,9,860,0,0,0,1167,1818
44,88,53,350,5,174,0,0,0,582,74,153,20,823,0,0,0,1070,1652
44,89,40,276,5,140,0,0,0,461,60,123,6,739,0,0,0,928,1389
44,90,27,192,4,118,0,0,0,341,73,71,4,669,0,0,0,817,1158
44,91,26,145,1,118,0,0,0,290,43,47,10,614,0,0,0,714,1004
44,92,20,102,0,74,0,0,0,196,57,37,2,493,0,0,0,589,785
44,93,9,68,0,85,0,0,0,162,44,26,2,439,0,0,0,511,673
44,94,7,52,1,47,0,0,0,107,50,21,3,313,0,0,0,387,494
44,95,6,33,0,37,0,0,0,76,21,11,2,250,0,0,0,284,360
44,96,1,24,0,34,0,0,0,59,15,4,2,174,0,0,0,195,254
44,97,0,9,0,25,0,0,0,34,15,7,0,159,0,0,0,181,215
44,98,4,7,0,15,0,0,0,26,14,0,1,101,0,0,0,116,142
44,99,0,5,0,6,0,0,0,11,12,0,0,67,0,0,0,79,90
44,100,3,3,0,17,0,0,0,23,6,4,0,101,0,0,0,111,134
44,999,84730,79115,5976,5019,163,5,7,175015,67505,79614,7667,23066,93,2,3,177950,352965
45,0,1367,0,0,0,0,0,0,1367,1245,0,0,0,0,0,0,1245,2612
45,1,1411,0,0,0,0,0,0,1411,1251,0,0,0,0,0,0,1251,2662
45,2,1412,0,0,0,0,0,0,1412,1362,0,0,0,0,0,0,1362,2774
45,3,1470,0,0,0,0,0,0,1470,1391,0,0,0,0,0,0,1391,2861
45,4,1542,0,0,0,0,0,0,1542,1535,0,0,0,0,0,0,1535,3077
45,5,1613,0,0,0,0,0,0,1613,1565,0,0,0,0,0,0,1565,3178
45,6,1692,0,0,0,0,0,0,1692,1555,0,0,0,0,0,0,1555,3247
45,7,1708,0,0,0,0,0,0,1708,1657,0,0,0,0,0,0,1657,3365
45,8,1853,0,0,0,0,0,0,1853,1646,0,0,0,0,0,0,1646,3499
45,9,1867,0,0,0,0,0,0,1867,1765,0,0,0,0,0,0,1765,3632
45,10,1856,0,0,0,0,0,0,1856,1776,0,0,0,0,0,0,1776,3632
45,11,1959,0,0,0,0,0,0,1959,1794,0,0,0,0,0,0,1794,3753
45,12,2051,0,0,0,0,0,0,2051,1871,0,0,0,0,0,0,1871,3922
45,13,2142,0,0,0,0,0,0,2142,1925,0,0,0,0,0,0,1925,4067
45,14,2056,0,0,0,0,0,0,2056,1984,0,0,0,0,0,0,1984,4040
45,15,2115,0,0,0,0,0,0,2115,1901,0,0,0,0,0,0,1901,4016
45,16,2071,0,0,0,0,0,0,2071,1963,1,0,0,0,0,0,1964,4035
45,17,2090,0,0,0,0,0,0,2090,1878,0,0,0,0,0,0,1878,3968
45,18,2037,0,0,0,0,0,0,2037,1848,3,0,0,0,0,0,1851,3888
45,19,1963,1,0,0,0,0,0,1964,1933,8,0,0,0,0,0,1941,3905
45,20,1967,3,0,0,0,1,0,1971,1674,30,1,0,0,0,0,1705,3676
45,21,2035,7,1,0,0,0,0,2043,1694,47,0,0,0,0,0,1741,3784
45,22,2008,11,4,0,0,0,0,2023,1716,81,0,0,0,0,0,1797,3820
45,23,2098,16,4,0,1,0,0,2119,1710,122,2,0,0,0,0,1834,3953
45,24,2158,54,2,0,0,0,0,2214,1728,153,3,0,1,0,0,1885,4099
45,25,2111,72,4,0,2,0,0,2189,1686,231,2,0,0,0,0,1919,4108
45,26,2004,110,3,0,1,0,0,2118,1560,265,7,0,0,0,0,1832,3950
45,27,1952,144,9,0,0,0,0,2105,1506,417,10,2,0,0,0,1935,4040
45,28,1804,198,8,0,1,0,0,2011,1402,438,10,0,3,0,0,1853,3864
45,29,1893,274,12,0,0,1,0,2180,1397,542,11,1,2,0,0,1953,4133
45,30,1770,338,17,1,1,0,0,2127,1283,660,17,0,2,0,0,1962,4089
45,31,1741,422,8,1,4,0,0,2176,1217,808,31,0,3,0,0,2059,4235
45,32,1614,500,12,2,4,1,0,2133,1074,905,32,2,7,1,0,2021,4154
45,33,1603,610,21,2,2,0,0,2238,1056,983,39,6,1,0,0,2085,4323
45,34,1463,739,21,3,2,0,0,2228,1008,1054,47,1,3,1,0,2114,4342
45,35,1444,855,40,0,2,1,0,2342,976,1173,47,11,1,0,0,2208,4550
45,36,1321,972,24,1,4,1,0,2323,873,1234,55,5,5,0,0,2172,4495
45,37,1274,1011,44,2,6,2,0,2339,827,1289,89,8,4,0,0,2217,4556
45,38,1213,1041,63,3,4,0,0,2324,890,1302,74,8,2,0,0,2276,4600
45,39,1253,1128,45,2,2,0,0,2430,812,1398,72,22,2,1,0,2307,4737
45,40,1181,1213,68,5,4,0,0,2471,753,1330,130,11,4,0,0,2228,4699
45,41,1180,1312,67,2,2,0,0,2563,749,1476,131,24,3,0,0,2383,4946
45,42,1169,1386,105,11,3,0,0,2674,765,1583,156,24,2,0,0,2530,5204
45,43,1173,1470,94,13,4,0,1,2755,824,1740,166,29,3,0,0,2762,5517
45,44,1095,1588,100,6,5,1,0,2795,764,1731,185,35,3,0,0,2718,5513
45,45,1199,1674,148,23,1,0,0,3045,796,1842,228,30,1,0,0,2897,5942
45,46,1220,1777,173,19,4,0,0,3193,813,1930,250,43,2,0,0,3038,6231
45,47,1205,1831,189,17,0,0,0,3242,785,1906,256,41,2,0,0,2990,6232
45,48,1219,1967,218,13,5,0,0,3422,774,2113,261,56,1,0,0,3205,6627
45,49,1180,2048,214,17,6,0,0,3465,763,2170,309,57,0,0,0,3299,6764
45,50,1116,2106,231,13,2,0,0,3468,768,2161,351,69,2,1,0,3352,6820
45,51,1070,2163,254,20,4,0,0,3511,695,2248,317,80,5,0,0,3345,6856
45,52,948,2111,246,27,4,0,0,3336,669,2302,340,83,3,0,0,3397,6733
45,53,947,2164,277,28,3,0,0,3419,586,2172,337,94,0,0,0,3189,6608
45,54,882,2270,307,26,0,0,0,3485,554,2251,385,100,3,0,0,3293,6778
45,55,808,2287,283,31,4,0,0,3413,578,2293,364,132,2,0,0,3369,6782
45,56,774,2234,305,30,5,0,0,3348,493,2299,374,123,2,0,0,3291,6639
45,57,670,2290,313,42,6,0,0,3321,480,2290,309,140,2,0,0,3221,6542
45,58,686,2427,313,45,3,0,1,3475,439,2284,359,167,2,0,0,3251,6726
45,59,595,2390,313,47,3,0,1,3349,391,2278,400,192,2,0,0,3263,6612
45,60,513,2231,281,56,4,0,0,3085,396,2156,312,187,2,0,0,3053,6138
45,61,452,2120,275,56,1,0,0,2904,348,2106,324,235,2,0,0,3015,5919
45,62,446,2202,270,78,2,0,0,2998,292,2123,298,265,1,0,0,2979,5977
45,63,385,2066,247,66,3,0,2,2769,320,1992,269,285,2,0,0,2868,5637
45,64,333,2041,232,66,4,0,0,2676,263,1934,254,304,4,0,0,2759,5435
45,65,288,1835,191,91,3,0,0,2408,224,1812,227,350,1,0,0,2614,5022
45,66,284,1917,211,80,3,0,0,2495,222,1833,214,352,0,0,0,2621,5116
45,67,246,1891,183,77,5,0,0,2402,184,1769,184,416,0,0,0,2553,4955
45,68,218,1792,159,99,5,0,0,2273,219,1786,173,378,1,0,0,2557,4830
45,69,229,1793,131,121,2,0,0,2276,201,1662,175,467,0,0,0,2505,4781
45,70,177,1674,106,119,1,0,0,2077,137,1584,145,473,1,0,0,2340,4417
45,71,190,1618,130,142,2,0,0,2082,161,1560,143,541,0,0,0,2405,4487
45,72,161,1604,112,157,2,0,0,2036,138,1484,135,523,0,0,0,2280,4316
45,73,166,1705,96,144,0,0,1,2112,127,1529,112,617,1,0,0,2386,4498
45,74,161,1720,83,156,0,0,1,2121,127,1465,112,668,0,0,0,2372,4493
45,75,155,1742,78,178,1,0,0,2154,138,1449,126,809,0,0,0,2522,4676
45,76,162,1747,72,193,1,0,1,2176,127,1449,94,884,1,0,0,2555,4731
45,77,186,1668,62,242,0,0,0,2158,124,1341,96,908,0,0,0,2469,4627
45,78,81,1006,36,148,0,0,0,1271,78,780,65,707,0,0,0,1630,2901
45,79,109,1152,38,174,1,0,1,1475,95,846,44,884,0,0,0,1869,3344
45,80,103,1017,27,174,1,0,0,1322,96,843,55,879,0,0,0,1873,3195
45,81,90,983,40,180,1,0,0,1294,107,697,41,909,0,0,0,1754,3048
45,82,104,910,17,181,2,0,0,1214,80,660,44,1006,0,0,0,1790,3004
45,83,106,982,26,253,0,0,0,1367,115,612,24,1123,0,0,0,1874,3241
45,84,94,865,17,228,1,0,0,1205,83,510,34,1130,0,0,0,1757,2962
45,85,60,800,12,234,0,0,0,1106,69,474,26,1197,0,0,0,1766,2872
45,86,77,674,7,205,0,0,0,963,81,305,21,1038,0,0,0,1445,2408
45,87,46,454,9,196,0,0,0,705,71,217,15,934,0,0,0,1237,1942
45,88,46,423,7,200,0,0,0,676,61,190,9,962,0,0,0,1222,1898
45,89,29,338,5,216,0,0,0,588,76,124,13,868,0,0,0,1081,1669
45,90,26,259,4,148,0,0,0,437,44,96,5,757,0,0,0,902,1339
45,91,21,188,3,128,0,0,0,340,41,52,4,687,0,0,0,784,1124
45,92,16,144,0,105,0,0,0,265,33,31,3,575,0,0,0,642,907
45,93,10,92,2,83,0,0,0,187,30,27,5,489,0,0,0,551,738
45,94,4,59,1,55,0,0,0,119,28,10,1,385,0,0,0,424,543
45,95,2,33,0,36,0,0,0,71,24,12,2,319,0,0,0,357,428
45,96,3,20,0,36,0,0,0,59,14,8,3,222,0,0,0,247,306
45,97,4,14,0,21,0,0,0,39,9,2,0,184,0,0,0,195,234
45,98,3,13,0,11,0,0,0,27,10,2,0,118,0,0,0,130,157
45,99,1,5,0,11,0,0,0,17,12,0,2,75,0,0,0,89,106
45,100,5,6,0,14,0,0,0,25,12,2,0,130,0,0,0,144,169
45,999,97110,91017,7730,5610,149,8,9,201633,78390,91077,9966,25836,96,4,0,205369,407002
47,0,1984,0,0,0,0,0,0,1984,1817,0,0,0,0,0,0,1817,3801
47,1,2158,0,0,0,0,0,0,2158,1880,0,0,0,0,0,0,1880,4038
47,2,2174,0,0,0,0,0,0,2174,2070,0,0,0,0,0,0,2070,4244
47,3,2164,0,0,0,0,0,0,2164,1992,0,0,0,0,0,0,1992,4156
47,4,2289,0,0,0,0,0,0,2289,2047,0,0,0,0,0,0,2047,4336
47,5,2242,0,0,0,0,0,0,2242,2197,0,0,0,0,0,0,2197,4439
47,6,2400,0,0,0,0,0,0,2400,2259,0,0,0,0,0,0,2259,4659
47,7,2479,0,0,0,0,0,0,2479,2356,0,0,0,0,0,0,2356,4835
47,8,2541,0,0,0,0,0,0,2541,2371,0,0,0,0,0,0,2371,4912
47,9,2603,0,0,0,0,0,0,2603,2432,0,0,0,0,0,0,2432,5035
47,10,2713,0,0,0,0,0,0,2713,2554,0,0,0,0,0,0,2554,5267
47,11,2778,0,0,0,0,0,0,2778,2590,0,0,0,0,0,0,2590,5368
47,12,2774,0,0,0,0,0,0,2774,2683,0,0,0,0,0,0,2683,5457
47,13,2916,0,0,0,0,0,0,2916,2738,0,0,0,0,0,0,2738,5654
47,14,2894,0,0,0,0,0,0,2894,2727,0,0,0,0,0,0,2727,5621
47,15,2908,0,0,0,0,0,0,2908,2768,0,0,0,0,0,0,2768,5676
47,16,2819,0,0,0,0,0,0,2819,2700,0,0,0,0,0,0,2700,5519
47,17,2926,0,0,0,0,0,0,2926,2669,0,0,0,0,0,0,2669,5595
47,18,3025,0,0,0,0,0,0,3025,2669,2,0,0,0,0,0,2671,5696
47,19,3045,0,0,0,0,0,0,3045,2789,7,0,0,0,0,0,2796,5841
47,20,2942,1,0,0,0,0,0,2943,2685,12,0,0,0,0,0,2697,5640
47,21,2959,6,0,0,0,0,0,2965,2656,27,0,0,0,0,0,2683,5648
47,22,3030,14,1,0,0,0,0,3045,2636,63,0,0,0,0,0,2699,5744
47,23,3047,21,3,0,0,0,0,3071,2764,114,4,0,1,0,0,2883,5954
47,24,3025,38,2,0,0,0,0,3065,2667,134,1,0,0,0,0,2802,5867
47,25,3077,56,2,0,0,0,0,3135,2687,210,9,0,0,0,0,2906,6041
47,26,2980,100,2,0,0,0,0,3082,2526,272,7,0,0,0,0,2805,5887
47,27,2970,182,2,0,3,0,0,3157,2448,369,7,0,0,0,0,2824,5981
47,28,2832,253,2,0,1,0,0,3088,2334,516,15,0,1,0,0,2866,5954
47,29,2796,286,12,0,5,0,0,3099,2193,635,12,0,1,0,0,2841,5940
47,30,2719,429,10,1,3,0,0,3162,2112,773,16,2,3,0,0,2906,6068
47,31,2683,541,11,0,2,0,0,3237,2037,940,30,1,7,0,0,3015,6252
47,32,2494,656,21,1,6,0,0,3178,1838,1040,37,4,4,1,0,2924,6102
47,33,2456,726,18,2,6,0,0,3208,1722,1187,51,6,6,0,0,2972,6180
47,34,2132,853,46,1,5,0,0,3037,1610,1287,47,3,5,1,0,2953,5990
47,35,2101,1004,31,2,8,0,1,3147,1543,1427,67,5,6,0,0,3048,6195
47,36,1870,1141,31,3,5,1,0,3051,1455,1452,79,9,5,0,0,3000,6051
47,37,1784,1199,56,0,9,0,0,3048,1284,1549,100,15,7,0,0,2955,6003
47,38,1814,1222,57,2,8,0,0,3103,1268,1647,121,11,4,1,0,3052,6155
47,39,1671,1425,66,3,6,0,0,3171,1157,1749,135,11,4,1,0,3057,6228
47,40,1607,1508,92,3,7,0,0,3217,1174,1807,137,15,2,0,0,3135,6352
47,41,1499,1667,84,5,5,1,0,3261,1067,1919,163,19,1,0,0,3169,6430
47,42,1388,1700,100,10,5,0,0,3203,1020,1873,181,17,2,0,0,3093,6296
47,43,1378,1715,116,8,5,1,0,3223,982,2051,199,27,5,1,0,3265,6488
47,44,1352,1795,114,6,5,0,0,3272,898,2181,241,28,1,0,0,3349,6621
47,45,1423,1991,139,8,4,0,0,3565,1017,2319,251,43,2,0,0,3632,7197
47,46,1357,2118,189,6,6,0,0,3676,961,2362,287,51,3,0,0,3664,7340
47,47,1335,2225,193,16,4,1,0,3774,958,2551,330,46,1,1,0,3887,7661
47,48,1338,2296,203,9,7,1,0,3854,932,2765,340,60,2,0,0,4099,7953
47,49,1376,2567,258,13,12,0,0,4226,913,2853,351,73,2,0,0,4192,8418
47,50,1240,2538,307,20,7,0,0,4112,831,2896,418,80,4,1,0,4230,8342
47,51,1173,2629,278,22,7,0,0,4109,784,2866,397,77,1,0,0,4125,8234
47,52,1196,2690,314,25,5,0,0,4230,746,3040,455,120,1,1,0,4363,8593
47,53,1016,2701,344,20,7,0,0,4088,765,2875,433,104,2,0,0,4179,8267
47,54,1068,2937,338,34,5,0,0,4382,801,2961,475,125,2,1,0,4365,8747
47,55,1023,2961,335,30,12,0,0,4361,664,2988,497,134,2,0,0,4285,8646
47,56,962,2911,406,33,3,0,1,4316,687,3124,493,144,5,0,0,4453,8769
47,57,988,2994,376,19,4,0,0,4381,634,3164,492,173,1,0,0,4464,8845
47,58,918,3133,422,43,3,0,0,4519,625,3152,474,197,1,0,0,4449,8968
47,59,804,3147,411,65,8,0,1,4436,553,3204,514,237,1,0,0,4509,8945
47,60,721,3000,393,56,7,0,0,4177,523,3008,427,254,2,0,0,4214,8391
47,61,623,2798,367,69,6,0,0,3863,468,2845,400,281,0,0,0,3994,7857
47,62,595,2899,341,85,3,0,0,3923,481,2839,438,315,3,0,0,4076,7999
47,63,580,2778,351,72,4,0,1,3786,419,2756,356,317,3,0,0,3851,7637
47,64,494,2788,300,69,3,0,0,3654,365,2728,316,359,1,0,0,3769,7423
47,65,468,2555,269,88,1,0,0,3381,376,2489,292,408,1,0,0,3566,6947
47,66,423,2570,248,88,1,0,0,3330,324,2491,309,410,3,0,0,3537,6867
47,67,437,2574,233,106,3,0,0,3353,289,2367,264,479,0,0,1,3400,6753
47,68,397,2443,221,100,2,0,0,3163,312,2315,247,428,2,0,0,3304,6467
47,69,374,2383,193,112,2,0,0,3064,266,2154,226,546,1,0,0,3193,6257
47,70,367,2318,186,109,1,0,0,2981,291,2065,210,544,0,0,0,3110,6091
47,71,297,2306,176,141,0,0,0,2920,240,1981,180,654,0,0,0,3055,5975
47,72,324,2208,156,130,2,0,0,2820,225,1894,176,666,0,0,0,2961,5781
47,73,298,2279,147,140,2,0,0,2866,225,1953,169,763,1,0,0,3111,5977
47,74,275,2149,126,190,1,0,0,2741,207,1721,160,764,0,0,0,2852,5593
47,75,271,2138,123,209,0,0,0,2741,185,1712,142,850,1,0,0,2890,5631
47,76,252,1997,109,198,2,0,0,2558,204,1652,127,926,0,0,0,2909,5467
47,77,231,2104,82,206,0,0,0,2623,222,1705,120,1060,0,0,0,3107,5730
47,78,134,1407,78,198,0,0,0,1817,136,1080,84,815,0,0,0,2115,3932
47,79,144,1562,60,195,0,0,0,1961,175,1122,71,986,1,0,0,2355,4316
47,80,186,1429,49,220,1,0,0,1885,186,1114,64,1069,0,0,0,2433,4318
47,81,157,1408,68,227,0,0,0,1860,167,944,61,1155,0,0,0,2327,4187
47,82,151,1253,54,241,0,0,0,1699,168,890,55,1209,0,0,0,2322,4021
47,83,156,1177,35,255,0,0,0,1623,182,767,59,1312,0,0,0,2320,3943
47,84,138,1076,30,251,0,0,0,1495,185,619,46,1284,0,0,0,2134,3629
47,85,110,938,24,239,0,0,0,1311,195,531,34,1214,0,0,0,1974,3285
47,86,84,779,21,212,0,0,0,1096,150,387,27,1133,0,0,0,1697,2793
47,87,77,661,16,208,0,0,0,962,125,322,25,1062,0,0,0,1534,2496
47,88,76,547,11,177,0,0,0,811,135,216,21,1094,0,0,0,1466,2277
47,89,56,403,9,158,0,0,0,626,120,143,23,1032,0,0,0,1318,1944
47,90,41,306,7,155,0,0,0,509,104,113,13,905,0,0,0,1135,1644
47,91,34,253,9,144,0,0,0,440,93,93,9,779,0,0,0,974,1414
47,92,24,205,5,117,0,0,0,351,79,60,7,695,0,0,0,841,1192
47,93,18,153,4,97,0,0,0,272,87,51,5,649,0,0,0,792,1064
47,94,19,99,2,70,0,0,0,190,74,26,5,493,0,0,0,598,788
47,95,15,64,0,71,0,0,0,150,45,22,4,383,0,0,0,454,604
47,96,11,44,0,42,0,0,0,97,46,10,5,269,0,0,0,330,427
47,97,6,26,0,29,0,0,0,61,39,3,2,212,0,0,0,256,317
47,98,2,11,0,14,0,0,0,27,29,2,2,143,0,0,0,176,203
47,99,2,7,0,17,0,0,0,26,19,2,0,98,0,0,0,119,145
47,100,3,8,0,24,0,0,0,35,25,2,1,183,0,0,0,211,246
47,999,136726,116479,9895,5939,229,5,4,269277,115128,117557,13048,30035,114,9,1,275892,545169
48,0,3194,0,0,0,0,0,0,3194,3039,0,0,0,0,0,0,3039,6233
48,1,3344,0,0,0,0,0,0,3344,3193,0,0,0,0,0,0,3193,6537
48,2,3457,0,0,0,0,0,0,3457,3355,0,0,0,0,0,0,3355,6812
48,3,3614,0,0,0,0,0,0,3614,3382,0,0,0,0,0,0,3382,6996
48,4,3754,0,0,0,0,0,0,3754,3485,0,0,0,0,0,0,3485,7239
48,5,3941,0,0,0,0,0,0,3941,3698,0,0,0,0,0,0,3698,7639
48,6,4033,0,0,0,0,0,0,4033,3816,0,0,0,0,0,0,3816,7849
48,7,4169,0,0,0,0,0,0,4169,3895,0,0,0,0,0,0,3895,8064
48,8,4305,0,0,0,0,0,0,4305,4027,0,0,0,0,0,0,4027,8332
48,9,4313,0,0,0,0,0,0,4313,4086,0,0,0,0,0,0,4086,8399
48,10,4278,0,0,0,0,0,0,4278,4082,0,0,0,0,0,0,4082,8360
48,11,4533,0,0,0,0,0,0,4533,4194,0,0,0,0,0,0,4194,8727
48,12,4597,0,0,0,0,0,0,4597,4302,0,0,0,0,0,0,4302,8899
48,13,4776,0,0,0,0,0,0,4776,4478,0,0,0,0,0,0,4478,9254
48,14,4835,0,0,0,0,0,0,4835,4464,0,0,0,0,0,0,4464,9299
48,15,4800,0,0,0,0,0,0,4800,4633,0,0,0,0,0,0,4633,9433
48,16,4777,0,0,0,0,0,0,4777,4488,0,0,0,0,0,0,4488,9265
48,17,4746,0,0,0,0,0,0,4746,4496,0,0,0,0,0,0,4496,9242
48,18,4830,1,0,0,0,0,0,4831,4476,3,0,0,0,0,0,4479,9310
48,19,4818,1,0,0,0,0,0,4819,4476,10,0,0,0,0,0,4486,9305
48,20,4637,1,0,0,0,0,0,4638,4336,22,0,0,0,0,0,4358,8996
48,21,4741,9,0,0,0,0,0,4750,4249,58,1,0,0,0,0,4308,9058
48,22,4687,11,1,0,1,0,0,4700,4268,90,5,0,0,0,0,4363,9063
48,23,4757,36,5,0,1,0,0,4799,4363,175,6,0,1,0,0,4545,9344
48,24,4985,56,3,0,0,0,0,5044,4330,260,8,0,0,0,0,4598,9642
48,25,4907,104,8,0,1,0,0,5020,4215,354,7,1,0,0,0,4577,9597
48,26,4767,150,8,0,2,0,0,4927,4131,505,13,0,1,0,0,4650,9577
48,27,4757,272,10,1,1,0,0,5041,3856,712,22,1,4,0,0,4595,9636
48,28,4633,429,14,0,9,1,0,5086,3722,973,20,2,2,0,0,4719,9805
48,29,4416,544,19,1,6,0,0,4986,3622,1241,24,0,7,0,0,4894,9880
48,30,4256,773,18,0,4,0,0,5051,3377,1479,32,2,5,0,0,4895,9946
48,31,4221,1034,26,0,4,0,0,5285,3188,1787,55,3,7,1,0,5041,10326
48,32,3876,1261,30,4,2,1,0,5174,2994,2054,67,7,8,0,0,5130,10304
48,33,3795,1503,39,1,7,0,0,5345,2754,2287,79,8,8,0,0,5136,10481
48,34,3573,1773,43,1,14,0,0,5404,2574,2441,120,8,15,1,0,5159,10563
48,35,3477,2034,62,5,11,0,0,5589,2392,2796,132,17,11,2,0,5350,10939
48,36,3055,2186,62,7,7,1,0,5318,2207,2914,151,15,14,2,0,5303,10621
48,37,2892,2258,82,6,11,0,0,5249,2063,3020,188,19,6,0,0,5296,10545
48,38,2915,2581,131,3,15,1,0,5646,1977,3270,235,25,10,1,0,5518,11164
48,39,2682,2684,108,6,7,1,0,5488,1853,3423,260,27,6,0,0,5569,11057
48,40,2510,2946,162,6,8,1,0,5633,1880,3369,271,35,10,0,0,5565,11198
48,41,2559,3087,169,7,7,2,0,5831,1748,3627,331,29,9,0,0,5744,11575
48,42,2539,3285,198,23,7,0,0,6052,1744,3714,342,63,7,0,0,5870,11922
48,43,2355,3575,250,25,10,1,0,6216,1599,3842,387,52,8,0,0,5888,12104
48,44,2394,3570,275,17,9,1,1,6267,1698,4041,468,62,10,3,0,6282,12549
48,45,2445,3714,327,28,7,0,0,6521,1674,4253,497,74,6,1,0,6505,13026
48,46,2442,3938,350,24,13,0,0,6767,1562,4372,551,92,7,1,0,6585,13352
48,47,2408,4196,398,24,11,1,0,7038,1547,4626,624,106,5,0,0,6908,13946
48,48,2378,4485,455,35,14,0,0,7367,1516,4921,704,120,5,1,0,7267,14634
48,49,2428,4732,511,31,13,0,0,7715,1540,5067,747,154,8,0,0,7516,15231
48,50,2230,4661,599,37,12,0,0,7539,1498,4934,781,142,12,0,0,7367,14906
48,51,2169,4947,559,49,22,0,0,7746,1342,5103,844,153,8,2,0,7452,15198
48,52,2103,4987,622,49,17,0,0,7778,1353,5115,868,195,9,0,0,7540,15318
48,53,2006,5030,616,43,6,0,0,7701,1252,5020,870,223,1,0,0,7366,15067
48,54,1818,5252,698,55,11,1,1,7836,1195,5361,896,258,7,0,0,7717,15553
48,55,1681,5187,715,59,9,0,0,7651,1103,5299,821,271,1,0,1,7496,15147
48,56,1493,5386,710,62,7,0,0,7658,1099,5233,869,298,6,0,0,7505,15163
48,57,1461,5341,724,79,10,0,0,7615,1016,5385,898,337,5,1,0,7642,15257
48,58,1310,5391,764,86,10,0,0,7561,977,5346,883,354,10,0,1,7571,15132
48,59,1228,5422,782,76,4,0,0,7512,929,5335,904,444,0,1,0,7613,15125
48,60,1199,5154,681,89,13,0,0,7136,791,5047,783,451,7,0,0,7079,14215
48,61,986,4898,631,116,15,0,0,6646,721,4702,753,489,3,1,0,6669,13315
48,62,862,4808,583,127,13,0,0,6393,690,4608,715,571,5,0,0,6589,12982
48,63,859,4536,516,122,8,0,0,6041,575,4386,636,605,6,1,0,6209,12250
48,64,746,4466,532,135,11,0,0,5890,556,4448,499,629,4,0,0,6136,12026
48,65,648,4317,454,137,7,0,0,5563,508,4197,491,684,1,0,0,5881,11444
48,66,633,4136,406,156,7,0,0,5338,505,4054,462,768,3,0,0,5792,11130
48,67,578,4148,421,177,1,0,0,5325,466,3880,453,841,0,0,0,5640,10965
48,68,497,4049,341,174,6,0,0,5067,371,3829,399,865,4,0,0,5468,10535
48,69,472,3893,336,191,6,0,1,4899,382,3630,373,908,0,0,0,5293,10192
48,70,425,3801,260,209,6,0,0,4701,318,3389,321,926,0,0,0,4954,9655
48,71,406,3636,251,224,8,0,0,4525,313,3313,281,987,0,0,0,4894,9419
48,72,340,3628,213,236,2,0,0,4419,310,3256,302,1064,1,0,0,4933,9352
48,73,356,3710,192,253,0,0,0,4511,290,3316,277,1236,1,0,0,5120,9631
48,74,316,3528,173,284,3,1,0,4305,296,3140,271,1362,1,0,0,5070,9375
48,75,324,3667,171,340,1,0,1,4504,274,3232,225,1520,1,0,0,5252,9756
48,76,315,3503,138,353,1,0,0,4310,291,2885,231,1701,0,0,0,5108,9418
48,77,371,3704,178,398,2,0,0,4653,348,3058,224,1937,0,0,0,5567,10220
48,78,194,2331,87,312,2,0,0,2926,218,1801,143,1332,2,0,0,3496,6422
48,79,236,2560,106,343,3,0,0,3248,272,2015,112,1714,0,0,0,4113,7361
48,80,239,2557,89,377,2,0,0,3264,275,1892,149,1909,0,0,0,4225,7489
48,81,223,2309,73,398,2,0,0,3005,265,1703,138,1952,1,0,0,4059,7064
48,82,164,2210,66,426,3,0,0,2869,269,1458,103,1999,0,0,1,3830,6699
48,83,195,2074,62,493,2,0,0,2826,256,1345,83,2191,1,0,0,3876,6702
48,84,163,2061,43,472,0,0,0,2739,286,1158,82,2385,0,0,0,3911,6650
48,85,168,1703,40,431,0,0,0,2342,235,988,73,2261,0,0,0,3557,5899
48,86,125,1449,35,443,0,0,0,2052,218,667,54,2151,0,0,0,3090,5142
48,87,101,1157,14,397,0,0,0,1669,182,499,32,1916,0,0,0,2629,4298
48,88,95,943,26,340,1,0,0,1405,222,382,35,1888,0,0,0,2527,3932
48,89,76,758,13,370,0,0,0,1217,185,298,27,1733,0,0,0,2243,3460
48,90,64,571,11,296,0,0,0,942,173,170,23,1484,0,0,0,1850,2792
48,91,41,418,6,233,0,0,0,698,141,120,15,1428,0,0,0,1704,2402
48,92,40,335,9,195,0,0,0,579,127,90,12,1169,0,0,0,1398,1977
48,93,26,190,3,178,0,0,0,397,110,54,8,995,0,0,0,1167,1564
48,94,25,153,2,133,0,0,0,313,90,37,7,755,0,0,0,889,1202
48,95,16,103,2,93,0,0,0,214,71,18,5,565,0,0,0,659,873
48,96,9,62,2,83,0,0,0,156,55,12,3,468,0,0,0,538,694
48,97,5,41,0,59,0,0,0,105,33,5,4,313,0,0,0,355,460
48,98,2,24,0,37,0,0,0,63,32,0,0,217,0,0,0,249,312
48,99,0,13,0,22,0,0,0,35,16,7,0,163,0,0,0,186,221
48,100,5,11,0,29,0,0,0,45,29,0,0,260,0,0,0,289,334
48,999,221645,206448,17719,10731,435,13,4,456995,186573,206926,23785,52389,280,19,3,469975,926970
49,0,2883,0,0,0,0,0,0,2883,2785,0,0,0,0,0,0,2785,5668
49,1,3084,0,0,0,0,0,0,3084,2956,0,0,0,0,0,0,2956,6040
49,2,3160,0,0,0,0,0,0,3160,3100,0,0,0,0,0,0,3100,6260
49,3,3254,0,0,0,0,0,0,3254,2938,0,0,0,0,0,0,2938,6192
49,4,3216,0,0,0,0,0,0,3216,3072,0,0,0,0,0,0,3072,6288
49,5,3442,0,0,0,0,0,0,3442,3166,0,0,0,0,0,0,3166,6608
49,6,3480,0,0,0,0,0,0,3480,3264,0,0,0,0,0,0,3264,6744
49,7,3555,0,0,0,0,0,0,3555,3387,0,0,0,0,0,0,3387,6942
49,8,3632,0,0,0,0,0,0,3632,3565,0,0,0,0,0,0,3565,7197
49,9,3899,0,0,0,0,0,0,3899,3649,0,0,0,0,0,0,3649,7548
49,10,3797,0,0,0,0,0,0,3797,3747,0,0,0,0,0,0,3747,7544
49,11,4008,0,0,0,0,0,0,4008,3945,0,0,0,0,0,0,3945,7953
49,12,4096,0,0,0,0,0,0,4096,3972,0,0,0,0,0,0,3972,8068
49,13,4285,0,0,0,0,0,0,4285,4005,0,0,0,0,0,0,4005,8290
49,14,4384,0,0,0,0,0,0,4384,4170,0,0,0,0,0,0,4170,8554
49,15,4518,0,0,0,0,0,0,4518,4206,0,0,0,0,0,0,4206,8724
49,16,4404,0,0,0,0,0,0,4404,4232,0,0,0,0,0,0,4232,8636
49,17,4507,0,0,0,0,0,0,4507,4221,0,0,0,0,0,0,4221,8728
49,18,4576,0,0,0,0,0,0,4576,4294,4,0,0,0,0,0,4298,8874
49,19,4772,1,0,0,0,0,0,4773,4367,11,0,0,0,0,0,4378,9151
49,20,4493,4,0,1,0,0,0,4498,4242,26,0,0,0,0,0,4268,8766
49,21,4591,10,0,0,0,0,0,4601,4289,71,1,0,0,0,0,4361,8962
49,22,4672,22,2,0,0,0,0,4696,4121,110,2,0,0,0,0,4233,8929
49,23,4811,30,1,0,1,0,0,4843,4227,180,3,0,1,0,0,4411,9254
49,24,4608,63,1,1,1,0,0,4674,4202,232,9,0,2,0,0,4445,9119
49,25,4774,115,8,0,2,0,0,4899,3971,356,6,1,1,0,0,4335,9234
49,26,4850,180,8,0,1,0,0,5039,3902,468,18,0,2,1,0,4391,9430
49,27,4603,222,8,0,1,0,0,4834,3693,597,14,0,0,0,0,4304,9138
49,28,4413,385,9,1,1,1,0,4810,3411,830,13,2,3,0,0,4259,9069
49,29,4169,500,11,0,0,0,0,4680,3158,998,19,2,7,0,0,4184,8864
49,30,4034,643,15,0,2,1,0,4695,3196,1184,33,4,2,0,0,4419,9114
49,31,4030,904,15,0,5,1,0,4955,2818,1527,43,0,11,0,0,4399,9354
49,32,3629,993,22,4,3,0,0,4651,2695,1666,46,3,8,0,0,4418,9069
49,33,3632,1197,45,1,8,0,0,4883,2471,1836,55,5,6,0,0,4373,9256
49,34,3266,1463,41,4,7,0,0,4781,2345,2052,94,5,5,0,0,4501,9282
49,35,3065,1591,45,4,9,0,0,4714,2173,2320,113,11,6,2,0,4625,9339
49,36,2779,1716,64,3,11,0,0,4573,1944,2263,104,11,8,0,0,4330,8903
49,37,2642,1914,58,5,8,2,0,4629,1861,2461,139,19,4,0,0,4484,9113
49,38,2596,2019,78,5,5,0,0,4703,1873,2547,173,21,8,2,0,4624,9327
49,39,2487,2167,112,1,9,2,0,4778,1794,2729,177,15,5,0,0,4720,9498
49,40,2401,2299,114,6,5,0,0,4825,1537,2877,197,34,4,1,0,4650,9475
49,41,2391,2448,132,6,7,0,0,4984,1614,3037,243,27,8,0,0,4929,9913
49,42,2261,2667,162,9,11,0,1,5111,1599,3146,260,54,4,0,0,5063,10174
49,43,2390,2706,183,15,7,0,0,5301,1469,3218,298,42,5,0,0,5032,10333
49,44,2126,2975,213,18,12,2,1,5347,1461,3477,323,52,8,0,0,5321,10668
49,45,2280,3262,239,14,16,0,0,5811,1538,3706,427,52,2,1,0,5726,11537
49,46,2379,3362,300,12,15,1,0,6069,1501,3916,442,75,0,1,0,5935,12004
49,47,2230,3554,326,27,7,0,0,6144,1349,4131,541,89,3,0,0,6113,12257
49,48,2333,3793,359,30,7,2,1,6525,1412,4304,576,88,3,0,0,6383,12908
49,49,2385,4265,402,13,8,0,0,7073,1357,4710,609,113,2,0,0,6791,13864
49,50,2202,4215,438,35,14,0,0,6904,1322,4728,664,131,2,1,0,6848,13752
49,51,2055,4496,534,43,13,1,0,7142,1254,4846,654,163,5,0,0,6922,14064
49,52,2018,4636,537,45,6,0,0,7242,1260,4961,733,166,3,0,1,7124,14366
49,53,1845,4836,584,41,10,0,0,7316,1104,4959,712,185,3,0,0,6963,14279
49,54,1757,4984,616,50,9,0,0,7416,1151,5178,721,201,2,0,0,7253,14669
49,55,1705,4995,587,53,7,0,0,7347,1159,5157,723,241,1,0,0,7281,14628
49,56,1575,5237,623,73,8,0,1,7517,975,5190,729,249,4,1,0,7148,14665
49,57,1489,5326,644,82,11,1,0,7553,904,5364,732,283,2,1,0,7286,14839
49,58,1376,5425,646,67,8,0,0,7522,834,5256,776,357,2,0,0,7225,14747
49,59,1241,5312,680,99,5,0,0,7337,848,5349,740,358,2,0,0,7297,14634
49,60,1056,5012,599,95,3,0,0,6765,740,5019,674,366,2,0,0,6801,13566
49,61,945,4931,566,100,5,0,0,6547,700,4750,624,417,4,0,0,6495,13042
49,62,906,4763,538,113,3,0,0,6323,639,4567,558,481,1,0,0,6246,12569
49,63,768,4598,460,123,9,0,0,5958,580,4408,532,491,1,0,0,6012,11970
49,64,722,4480,434,121,5,0,0,5762,515,4191,480,585,0,0,0,5771,11533
49,65,625,4115,386,135,3,0,0,5264,439,3940,422,594,1,0,0,5396,10660
49,66,572,4068,333,174,2,0,0,5149,436,3738,401,654,2,0,0,5231,10380
49,67,530,3802,314,169,7,0,0,4822,413,3698,341,670,0,0,0,5122,9944
49,68,503,3778,285,186,2,0,1,4755,329,3504,315,768,2,0,0,4918,9673
49,69,486,3727,257,200,3,0,0,4673,310,3313,321,832,0,0,0,4776,9449
49,70,402,3539,234,198,2,0,0,4375,290,3293,262,893,1,0,0,4739,9114
49,71,389,3503,209,216,1,0,0,4318,297,3158,248,932,2,0,0,4637,8955
49,72,399,3545,187,215,4,0,0,4350,260,3082,211,975,0,0,1,4529,8879
49,73,364,3543,201,265,1,0,2,4376,298,3187,217,1147,1,0,0,4850,9226
49,74,310,3466,166,260,1,0,0,4203,264,2963,178,1302,0,0,0,4707,8910
49,75,334,3383,164,284,0,0,0,4165,321,2959,193,1384,1,0,0,4858,9023
49,76,289,3098,114,299,1,0,0,3801,293,2646,176,1479,1,0,0,4595,8396
49,77,301,3471,135,335,2,0,0,4244,286,2824,176,1800,1,0,0,5087,9331
49,78,203,2252,96,246,2,0,0,2799,188,1797,116,1361,0,0,0,3462,6261
49,79,238,2502,80,317,1,0,0,3138,228,1849,112,1721,0,0,0,3910,7048
49,80,198,2456,72,349,1,0,0,3076,246,1852,110,1888,0,0,0,4096,7172
49,81,211,2252,75,395,1,0,0,2934,248,1594,95,1883,0,0,0,3820,6754
49,82,209,2020,67,419,1,0,0,2716,233,1352,76,1981,0,0,0,3642,6358
49,83,177,2061,59,470,0,0,0,2767,245,1269,70,2222,0,0,0,3806,6573
49,84,171,1902,34,479,0,0,0,2586,221,1029,78,2193,0,0,0,3521,6107
49,85,146,1626,27,425,0,0,0,2224,235,843,58,2207,0,0,0,3343,5567
49,86,93,1285,24,356,0,0,0,1758,209,619,51,1909,0,0,0,2788,4546
49,87,93,927,14,349,0,0,0,1383,175,448,26,1798,0,0,0,2447,3830
49,88,75,850,16,329,0,0,0,1270,185,312,22,1748,0,0,0,2267,3537
49,89,61,698,15,292,0,0,0,1066,179,240,21,1626,0,0,0,2066,3132
49,90,46,489,4,261,0,0,0,800,136,148,21,1331,0,0,0,1636,2436
49,91,45,344,3,213,0,0,0,605,127,116,15,1227,0,0,0,1485,2090
49,92,31,285,4,189,0,0,0,509,99,66,10,1086,0,0,0,1261,1770
49,93,23,197,3,159,0,0,0,382,101,48,10,902,0,0,0,1061,1443
49,94,18,125,1,105,0,0,0,249,72,31,6,616,0,0,0,725,974
49,95,12,77,1,98,0,0,0,188,51,26,3,559,0,0,0,639,827
49,96,10,59,0,68,0,0,0,137,51,9,2,409,0,0,0,471,608
49,97,4,28,0,43,0,0,0,75,31,4,2,283,0,0,0,320,395
49,98,0,10,0,27,0,0,0,37,32,2,0,217,0,0,0,251,288
49,99,4,3,0,22,0,0,0,29,23,1,2,125,0,0,0,151,180
49,100,0,13,1,24,0,0,0,38,46,4,1,200,0,0,0,251,289
49,999,207504,190215,15040,9891,320,14,7,422991,171846,190877,19398,48321,164,11,2,430619,853610
50,0,561,0,0,0,0,0,0,561,503,0,0,0,0,0,0,503,1064
50,1,582,0,0,0,0,0,0,582,546,0,0,0,0,0,0,546,1128
50,2,608,0,0,0,0,0,0,608,601,0,0,0,0,0,0,601,1209
50,3,654,0,0,0,0,0,0,654,573,0,0,0,0,0,0,573,1227
50,4,640,0,0,0,0,0,0,640,564,0,0,0,0,0,0,564,1204
50,5,666,0,0,0,0,0,0,666,661,0,0,0,0,0,0,661,1327
50,6,707,0,0,0,0,0,0,707,618,0,0,0,0,0,0,618,1325
50,7,695,0,0,0,0,0,0,695,663,0,0,0,0,0,0,663,1358
50,8,732,0,0,0,0,0,0,732,700,0,0,0,0,0,0,700,1432
50,9,739,0,0,0,0,0,0,739,722,0,0,0,0,0,0,722,1461
50,10,774,0,0,0,0,0,0,774,713,0,0,0,0,0,0,713,1487
50,11,832,0,0,0,0,0,0,832,764,0,0,0,0,0,0,764,1596
50,12,882,0,0,0,0,0,0,882,817,0,0,0,0,0,0,817,1699
50,13,885,0,0,0,0,0,0,885,842,0,0,0,0,0,0,842,1727
50,14,870,0,0,0,0,0,0,870,836,0,0,0,0,0,0,836,1706
50,15,932,0,0,0,0,0,0,932,864,0,0,0,0,0,0,864,1796
50,16,919,0,0,0,0,0,0,919,801,0,0,0,0,0,0,801,1720
50,17,917,0,0,0,0,0,0,917,887,0,0,0,0,0,0,887,1804
50,18,933,0,0,0,0,0,0,933,841,0,0,0,0,0,0,841,1774
50,19,971,0,1,0,0,0,0,972,878,0,0,0,0,0,0,878,1850
50,20,966,2,0,0,0,0,0,968,855,4,0,0,0,0,0,859,1827
50,21,1004,2,0,0,0,0,0,1006,909,5,0,0,0,0,0,914,1920
50,22,939,3,0,0,0,0,0,942,838,18,0,0,0,0,0,856,1798
50,23,1025,13,0,0,0,0,0,1038,943,24,0,0,0,0,0,967,2005
50,24,997,7,0,0,0,0,0,1004,869,42,0,1,0,0,0,912,1916
50,25,1008,24,1,0,0,0,0,1033,870,80,3,0,0,0,0,953,1986
50,26,973,30,1,0,1,0,0,1005,786,83,0,0,0,0,0,869,1874
50,27,969,54,1,0,0,0,0,1024,808,109,4,0,1,0,0,922,1946
50,28,892,70,4,0,0,0,0,966,715,151,6,2,0,0,0,874,1840
50,29,908,101,3,1,1,0,0,1014,712,167,7,0,0,0,0,886,1900
50,30,873,115,5,0,3,0,0,996,690,218,6,0,1,0,0,915,1911
50,31,858,154,3,0,0,0,0,1015,706,241,6,0,0,0,0,953,1968
50,32,831,170,8,2,2,0,0,1013,625,280,7,1,0,0,0,913,1926
50,33,820,221,3,0,0,1,0,1045,599,316,15,1,0,0,0,931,1976
50,34,785,225,6,1,2,0,0,1019,565,359,19,3,1,0,0,947,1966
50,35,711,242,17,0,1,1,0,972,568,334,17,0,0,0,0,919,1891
50,36,681,307,16,1,1,0,0,1006,495,388,35,2,1,0,0,921,1927
50,37,625,329,7,1,1,0,0,963,528,429,31,2,1,0,0,991,1954
50,38,638,352,21,2,1,0,0,1014,470,467,31,3,1,0,0,972,1986
50,39,641,360,12,2,5,0,0,1020,476,488,27,2,0,0,0,993,2013
50,40,684,410,26,1,1,0,0,1122,465,502,37,5,1,0,0,1010,2132
50,41,581,412,36,0,0,0,0,1029,483,533,48,5,3,0,0,1072,2101
50,42,616,466,24,1,2,0,0,1109,478,523,54,8,4,0,0,1067,2176
50,43,600,452,31,0,1,1,0,1085,427,574,74,17,2,0,0,1094,2179
50,44,607,520,32,4,1,0,0,1164,443,550,78,10,2,0,0,1083,2247
50,45,642,548,44,2,1,0,0,1237,423,695,98,11,2,0,0,1229,2466
50,46,605,581,62,4,1,0,0,1253,430,755,110,16,0,0,0,1311,2564
50,47,604,671,78,3,3,0,0,1359,452,793,105,20,0,0,0,1370,2729
50,48,609,724,81,2,2,0,0,1418,438,897,129,19,2,0,0,1485,2903
50,49,645,786,102,8,0,0,0,1541,453,934,122,36,2,0,0,1547,3088
50,50,666,806,112,6,1,1,0,1592,402,1039,138,27,1,0,0,1607,3199
50,51,544,908,116,4,1,0,1,1574,419,1056,154,39,0,0,0,1668,3242
50,52,567,940,138,6,1,0,0,1652,394,1075,170,35,1,0,0,1675,3327
50,53,515,945,139,11,3,0,0,1613,388,1057,229,42,1,0,0,1717,3330
50,54,496,996,143,9,0,0,0,1644,331,1129,197,55,0,0,0,1712,3356
50,55,479,1019,157,11,2,0,0,1668,341,1128,180,73,0,0,0,1722,3390
50,56,424,1046,150,14,3,0,0,1637,328,1185,196,66,0,0,0,1775,3412
50,57,404,1060,153,19,0,0,0,1636,315,1177,196,74,0,0,0,1762,3398
50,58,429,1097,179,19,2,0,0,1726,249,1172,193,81,0,0,0,1695,3421
50,59,391,1106,169,25,1,0,0,1692,286,1204,193,94,0,0,0,1777,3469
50,60,323,1111,164,27,1,0,0,1626,247,1138,177,99,0,0,0,1661,3287
50,61,290,1073,169,26,2,0,0,1560,219,1111,154,109,0,0,0,1593,3153
50,62,301,1080,120,38,2,0,0,1541,218,1086,152,145,0,0,0,1601,3142
50,63,260,1060,125,31,1,0,0,1477,178,1048,132,155,1,0,0,1514,2991
50,64,254,1127,116,41,4,0,0,1542,192,1034,147,161,0,0,0,1534,3076
50,65,242,969,114,34,0,0,0,1359,167,980,101,174,0,0,0,1422,2781
50,66,220,977,100,31,1,0,0,1329,143,960,116,197,1,0,0,1417,2746
50,67,190,965,89,38,0,0,0,1282,129,995,99,183,0,0,0,1406,2688
50,68,179,956,91,57,1,0,0,1284,138,976,73,211,0,0,0,1398,2682
50,69,177,1018,76,53,0,0,0,1324,113,926,96,247,0,0,0,1382,2706
50,70,164,1027,68,60,0,0,0,1319,111,793,73,286,0,0,0,1263,2582
50,71,142,930,54,63,1,0,0,1190,112,841,81,298,0,0,0,1332,2522
50,72,126,950,51,77,0,0,0,1204,94,847,61,299,0,0,0,1301,2505
50,73,134,919,71,78,0,0,0,1202,114,918,77,362,0,0,0,1471,2673
50,74,137,946,62,87,0,0,0,1232,86,758,63,368,0,0,0,1275,2507
50,75,129,934,43,81,0,0,1,1188,109,759,62,452,0,0,0,1382,2570
50,76,105,917,43,123,0,0,0,1188,106,759,55,465,0,0,0,1385,2573
50,77,126,920,38,141,1,0,0,1226,90,719,41,529,0,0,0,1379,2605
50,78,77,599,37,91,0,0,0,804,73,471,24,401,0,0,0,969,1773
50,79,74,656,19,89,0,0,0,838,54,503,33,492,0,0,0,1082,1920
50,80,62,636,22,116,0,0,0,836,66,478,27,478,0,0,0,1049,1885
50,81,73,578,23,100,0,0,0,774,74,416,21,519,0,0,0,1030,1804
50,82,67,565,20,130,0,0,0,782,67,336,24,577,0,0,0,1004,1786
50,83,82,548,20,112,0,0,0,762,71,321,20,590,0,0,0,1002,1764
50,84,53,552,12,129,0,0,0,746,68,252,14,656,0,0,0,990,1736
50,85,49,404,13,117,0,0,0,583,65,213,11,591,0,0,0,880,1463
50,86,41,323,4,123,0,0,0,491,67,155,8,540,0,0,0,770,1261
50,87,29,263,3,88,0,0,0,383,57,113,7,502,0,0,0,679,1062
50,88,20,180,4,92,0,0,0,296,47,76,7,462,0,0,0,592,888
50,89,20,171,3,86,0,0,0,280,39,76,9,446,0,0,0,570,850
50,90,14,124,4,62,0,0,0,204,41,38,8,388,0,0,0,475,679
50,91,9,83,5,56,0,0,0,153,42,32,7,385,0,0,0,466,619
50,92,10,80,2,54,0,0,0,146,26,11,2,301,0,0,0,340,486
50,93,16,53,1,53,0,0,0,123,27,11,2,276,0,0,0,316,439
50,94,9,39,1,29,0,0,0,78,19,5,1,192,0,0,0,217,295
50,95,0,20,1,20,0,0,0,41,15,3,0,163,0,0,0,181,222
50,96,3,12,0,16,0,0,0,31,7,4,0,128,0,0,0,139,170
50,97,0,7,0,9,0,0,0,16,13,2,0,88,0,0,0,103,119
50,98,0,2,0,10,0,0,0,12,7,0,1,63,0,0,0,71,83
50,99,0,3,0,4,0,0,0,7,4,0,0,42,0,0,0,46,53
50,100,0,3,0,6,0,0,0,9,7,1,1,71,0,0,0,80,89
50,999,47958,42054,3869,2837,58,4,2,96782,39888,42346,4902,13841,29,0,0,101006,197788
51,0,2926,0,0,0,0,0,0,2926,2822,0,0,0,0,0,0,2822,5748
51,1,3137,0,0,0,0,0,0,3137,2904,0,0,0,0,0,0,2904,6041
51,2,3192,0,0,0,0,0,0,3192,2961,0,0,0,0,0,0,2961,6153
51,3,3299,0,0,0,0,0,0,3299,3044,0,0,0,0,0,0,3044,6343
51,4,3292,0,0,0,0,0,0,3292,3095,0,0,0,0,0,0,3095,6387
51,5,3513,0,0,0,0,0,0,3513,3242,0,0,0,0,0,0,3242,6755
51,6,3706,0,0,0,0,0,0,3706,3450,0,0,0,0,0,0,3450,7156
51,7,3797,0,0,0,0,0,0,3797,3557,0,0,0,0,0,0,3557,7354
51,8,3907,0,0,0,0,0,0,3907,3654,0,0,0,0,0,0,3654,7561
51,9,3994,0,0,0,0,0,0,3994,3909,0,0,0,0,0,0,3909,7903
51,10,4144,0,0,0,0,0,0,4144,3971,0,0,0,0,0,0,3971,8115
51,11,4342,0,0,0,0,0,0,4342,4123,0,0,0,0,0,0,4123,8465
51,12,4354,0,0,0,0,0,0,4354,4131,0,0,0,0,0,0,4131,8485
51,13,4602,0,0,0,0,0,0,4602,4182,0,0,0,0,0,0,4182,8784
51,14,4601,0,0,0,0,0,0,4601,4303,0,0,0,0,0,0,4303,8904
51,15,4608,0,0,0,0,0,0,4608,4568,0,0,0,0,0,0,4568,9176
51,16,4727,0,0,0,0,0,0,4727,4463,0,0,0,0,0,0,4463,9190
51,17,4769,0,0,0,0,0,0,4769,4501,0,0,0,0,0,0,4501,9270
51,18,4744,0,0,0,0,0,0,4744,4457,4,0,0,0,0,0,4461,9205
51,19,4898,2,0,0,0,0,0,4900,4308,23,0,0,0,0,0,4331,9231
51,20,4747,0,0,0,0,0,0,4747,4393,55,0,0,0,0,0,4448,9195
51,21,4818,10,0,0,0,0,0,4828,4203,97,0,0,1,0,0,4301,9129
51,22,4701,24,2,0,0,0,0,4727,4036,145,2,0,0,0,0,4183,8910
51,23,4937,53,3,0,0,0,0,4993,4280,201,9,0,0,0,0,4490,9483
51,24,4642,76,2,0,0,0,0,4720,4020,315,7,0,0,0,0,4342,9062
51,25,4818,141,4,1,0,0,0,4964,3894,389,7,1,2,0,0,4293,9257
51,26,4541,207,8,1,1,0,0,4758,3784,501,7,1,0,0,0,4293,9051
51,27,4509,295,10,1,1,0,0,4816,3631,622,13,1,2,0,0,4269,9085
51,28,4208,421,14,0,3,0,0,4646,3189,841,12,2,0,1,0,4045,8691
51,29,4170,539,6,0,4,0,0,4719,3237,981,31,2,4,0,0,4255,8974
51,30,3864,713,14,0,1,0,0,4592,2937,1271,28,3,2,0,0,4241,8833
51,31,3818,869,20,1,0,1,0,4709,2886,1496,38,6,1,0,0,4427,9136
51,32,3530,1117,32,6,4,0,0,4689,2727,1718,51,3,1,0,0,4500,9189
51,33,3462,1319,34,4,4,0,0,4823,2469,1887,64,4,3,0,0,4427,9250
51,34,3101,1488,40,1,4,0,0,4634,2326,2128,88,2,10,1,0,4555,9189
51,35,3070,1676,52,3,5,0,0,4806,2246,2308,81,8,1,2,0,4646,9452
51,36,2670,1800,50,10,3,0,0,4533,2056,2359,100,8,3,1,0,4527,9060
51,37,2618,1855,66,4,9,0,0,4552,1899,2512,133,21,3,0,0,4568,9120
51,38,2594,2123,78,7,7,1,0,4810,1890,2767,141,26,6,0,1,4831,9641
51,39,2434,2283,99,2,4,0,0,4822,1794,2764,185,23,5,0,0,4771,9593
51,40,2411,2371,96,7,14,0,0,4899,1706,3011,208,28,3,0,0,4956,9855
51,41,2435,2619,132,7,7,1,0,5201,1706,3188,237,32,3,0,0,5166,10367
51,42,2265,2710,173,11,9,0,0,5168,1639,3187,290,46,2,1,0,5165,10333
51,43,2260,2995,190,10,10,0,0,5465,1567,3345,313,39,4,0,0,5268,10733
51,44,2301,2973,188,24,2,0,0,5488,1519,3585,326,58,3,0,0,5491,10979
51,45,2413,3329,255,20,4,0,0,6021,1740,3819,401,70,2,1,0,6033,12054
51,46,2310,3550,243,13,7,1,0,6124,1636,4009,455,87,2,0,0,6189,12313
51,47,2434,3615,320,21,15,0,0,6405,1608,4238,487,95,3,0,0,6431,12836
51,48,2338,4043,366,26,8,0,0,6781,1628,4476,555,113,11,0,0,6783,13564
51,49,2450,4373,429,34,3,0,0,7289,1747,4849,588,140,5,0,0,7329,14618
51,50,2290,4491,446,33,9,0,0,7269,1509,4897,601,111,6,0,0,7124,14393
51,51,2181,4608,465,33,6,0,0,7293,1578,4774,642,141,4,0,0,7139,14432
51,52,2186,4680,470,30,7,1,0,7374,1409,5221,705,172,4,1,0,7512,14886
51,53,2002,4854,529,46,11,0,0,7442,1294,5212,695,183,5,0,0,7389,14831
51,54,1823,5120,579,50,14,0,0,7586,1256,5324,738,213,5,0,0,7536,15122
51,55,1753,4983,531,63,7,0,1,7338,1175,5251,738,200,3,0,0,7367,14705
51,56,1611,5220,563,70,2,0,1,7467,1132,5362,752,277,1,0,0,7524,14991
51,57,1563,5349,615,92,8,0,0,7627,1044,5358,738,288,5,0,0,7433,15060
51,58,1378,5429,624,106,11,0,0,7548,1025,5407,733,333,1,0,0,7499,15047
51,59,1290,5499,606,106,8,1,0,7510,947,5441,695,315,1,0,0,7399,14909
51,60,1117,5139,562,92,5,0,0,6915,836,5123,642,390,4,0,0,6995,13910
51,61,964,5025,528,105,8,0,0,6630,752,4837,588,435,1,0,0,6613,13243
51,62,939,4894,502,111,4,0,0,6450,688,4850,572,489,2,0,0,6601,13051
51,63,784,4706,485,161,5,0,0,6141,607,4551,505,531,1,1,0,6196,12337
51,64,733,4622,433,145,5,0,0,5938,573,4600,429,566,0,0,0,6168,12106
51,65,668,4327,380,133,7,0,0,5515,456,4410,420,543,3,0,0,5832,11347
51,66,592,4259,350,135,5,0,0,5341,462,4006,393,643,3,0,0,5507,10848
51,67,556,4203,293,168,5,0,0,5225,397,3887,398,743,2,0,0,5427,10652
51,68,463,4114,306,204,2,0,0,5089,376,3871,326,805,0,1,0,5379,10468
51,69,478,3949,264,228,2,0,0,4921,370,3706,325,809,1,0,0,5211,10132
51,70,402,3855,240,211,4,0,0,4712,331,3623,293,856,2,0,0,5105,9817
51,71,394,3615,190,240,3,0,0,4442,319,3372,234,981,1,0,0,4907,9349
51,72,366,3573,217,245,4,0,0,4405,273,3236,244,991,0,0,0,4744,9149
51,73,374,3717,175,276,2,0,0,4544,268,3342,229,1113,2,0,0,4954,9498
51,74,322,3598,160,270,1,0,0,4351,256,3033,208,1199,0,0,0,4696,9047
51,75,323,3595,166,345,4,0,0,4433,242,3069,198,1366,0,0,0,4875,9308
51,76,284,3392,136,346,6,0,0,4164,258,2877,196,1515,0,0,0,4846,9010
51,77,313,3588,135,382,2,0,0,4420,266,3053,149,1801,0,0,0,5269,9689
51,78,196,2409,90,291,0,0,0,2986,175,1981,118,1361,0,0,0,3635,6621
51,79,209,2711,88,366,3,0,0,3377,200,2012,115,1685,0,0,0,4012,7389
51,80,220,2575,77,377,0,0,2,3251,186,1874,115,1862,0,0,0,4037,7288
51,81,179,2297,61,376,1,0,0,2914,195,1662,92,1858,0,0,0,3807,6721
51,82,200,2217,50,385,1,0,0,2853,191,1454,79,1959,0,0,0,3683,6536
51,83,174,2181,39,467,1,0,0,2862,190,1372,84,2202,0,0,0,3848,6710
51,84,144,1990,37,444,0,0,0,2615,192,1142,61,2182,0,0,0,3577,6192
51,85,142,1639,35,447,1,0,0,2264,155,853,52,2160,0,0,0,3220,5484
51,86,93,1300,21,434,0,0,0,1848,159,608,46,2090,0,0,0,2903,4751
51,87,85,1110,21,363,0,0,0,1579,160,473,27,1855,0,0,0,2515,4094
51,88,87,964,15,342,0,0,0,1408,123,341,31,1820,0,0,0,2315,3723
51,89,63,748,19,310,0,0,0,1140,135,267,16,1668,0,0,0,2086,3226
51,90,44,509,9,247,0,0,0,809,119,156,19,1427,0,0,0,1721,2530
51,91,38,391,10,243,0,0,0,682,107,115,11,1259,0,0,0,1492,2174
51,92,23,274,2,237,0,0,0,536,75,91,9,1114,0,0,0,1289,1825
51,93,23,203,6,158,0,0,0,390,90,59,10,1018,0,0,0,1177,1567
51,94,12,143,3,141,0,0,0,299,54,27,9,710,0,0,0,800,1099
51,95,11,85,1,89,0,0,0,186,55,24,2,634,0,0,0,715,901
51,96,5,65,3,74,0,0,0,147,47,13,2,498,0,0,0,560,707
51,97,5,32,3,50,0,0,0,90,24,12,4,353,0,0,0,393,483
51,98,5,19,1,33,0,0,0,58,18,6,0,244,0,0,0,268,326
51,99,2,11,0,30,0,0,0,43,18,4,3,142,0,0,0,167,210
51,100,0,12,1,30,0,0,0,43,25,3,1,244,0,0,0,273,316
51,999,211530,197878,14468,10574,293,6,4,434753,176830,199333,19149,49173,139,10,1,444635,879388
52,0,2527,0,0,0,0,0,0,2527,2393,0,0,0,0,0,0,2393,4920
52,1,2591,0,0,0,0,0,0,2591,2498,0,0,0,0,0,0,2498,5089
52,2,2762,0,0,0,0,0,0,2762,2612,0,0,0,0,0,0,2612,5374
52,3,2766,0,0,0,0,0,0,2766,2602,0,0,0,0,0,0,2602,5368
52,4,2850,0,0,0,0,0,0,2850,2654,0,0,0,0,0,0,2654,5504
52,5,2988,0,0,0,0,0,0,2988,2848,0,0,0,0,0,0,2848,5836
52,6,3141,0,0,0,0,0,0,3141,2949,0,0,0,0,0,0,2949,6090
52,7,3349,0,0,0,0,0,0,3349,3043,0,0,0,0,0,0,3043,6392
52,8,3323,0,0,0,0,0,0,3323,3111,0,0,0,0,0,0,3111,6434
52,9,3374,0,0,0,0,0,0,3374,3152,0,0,0,0,0,0,3152,6526
52,10,3578,0,0,0,0,0,0,3578,3268,0,0,0,0,0,0,3268,6846
52,11,3762,0,0,0,0,0,0,3762,3495,0,0,0,0,0,0,3495,7257
52,12,3853,0,0,0,0,0,0,3853,3690,0,0,0,0,0,0,3690,7543
52,13,3895,0,0,0,0,0,0,3895,3672,0,0,0,0,0,0,3672,7567
52,14,4035,0,0,0,0,0,0,4035,3686,0,0,0,0,0,0,3686,7721
52,15,4147,0,0,0,0,0,0,4147,3830,0,0,0,0,0,0,3830,7977
52,16,4082,0,0,0,0,0,0,4082,3867,0,0,0,0,0,0,3867,7949
52,17,4052,0,0,0,0,0,0,4052,3775,0,0,0,0,0,0,3775,7827
52,18,4079,1,0,0,0,0,0,4080,3661,3,0,0,0,0,0,3664,7744
52,19,4174,4,0,0,0,0,0,4178,3881,13,0,0,0,0,0,3894,8072
52,20,4302,1,0,0,0,0,0,4303,3769,28,0,0,0,0,0,3797,8100
52,21,4066,6,0,0,0,0,0,4072,3635,52,2,0,0,0,0,3689,7761
52,22,4215,15,2,0,0,0,0,4232,3645,94,2,0,0,0,0,3741,7973
52,23,4351,38,4,0,0,0,0,4393,3739,181,1,0,0,0,0,3921,8314
52,24,4282,56,3,0,0,0,0,4341,3640,249,3,1,3,0,0,3896,8237
52,25,4306,112,4,0,4,0,0,4426,3692,331,5,0,3,0,0,4031,8457
52,26,4082,157,8,0,3,0,0,4250,3556,409,7,1,0,1,0,3974,8224
52,27,3999,214,6,0,2,0,0,4221,3315,494,10,0,2,2,0,3823,8044
52,28,3905,338,9,0,5,0,0,4257,3045,671,23,0,5,0,0,3744,8001
52,29,3631,378,9,0,2,0,0,4020,2894,889,18,1,3,0,0,3805,7825
52,30,3482,513,15,0,7,0,0,4017,2874,1089,22,2,4,0,0,3991,8008
52,31,3504,724,16,0,2,0,0,4246,2693,1252,33,3,3,2,1,3987,8233
52,32,3267,894,19,5,2,1,0,4188,2491,1456,36,8,8,0,0,3999,8187
52,33,3199,1080,25,4,13,2,0,4323,2471,1633,46,11,9,1,0,4171,8494
52,34,2870,1186,28,3,8,2,0,4097,2252,1800,69,10,6,2,0,4139,8236
52,35,2818,1456,47,4,5,2,0,4332,2093,1954,75,4,12,1,0,4139,8471
52,36,2689,1544,58,7,6,0,0,4304,1992,1935,107,6,8,1,0,4049,8353
52,37,2480,1611,55,7,14,0,0,4167,1870,2258,115,13,11,0,0,4267,8434
52,38,2501,1808,60,5,8,0,0,4382,1847,2404,143,20,4,0,0,4418,8800
52,39,2373,1960,82,4,9,1,0,4429,1754,2418,152,31,5,0,0,4360,8789
52,40,2267,2159,90,10,9,0,0,4535,1696,2568,179,34,7,1,0,4485,9020
52,41,2235,2298,110,10,5,0,0,4658,1719,2743,212,37,5,0,0,4716,9374
52,42,2163,2485,139,23,7,1,0,4818,1574,2809,258,51,12,1,0,4705,9523
52,43,2110,2577,155,15,10,0,0,4867,1531,2901,264,57,9,0,0,4762,9629
52,44,2233,2851,195,16,9,0,0,5304,1561,3205,346,55,4,2,0,5173,10477
52,45,2430,3013,219,14,16,1,0,5693,1671,3328,366,73,3,0,0,5441,11134
52,46,2247,3123,221,17,13,0,0,5621,1745,3653,382,86,7,0,0,5873,11494
52,47,2447,3406,252,25,9,0,0,6139,1652,3876,473,94,3,0,0,6098,12237
52,48,2383,3655,316,22,16,0,0,6392,1699,4144,509,120,9,0,0,6481,12873
52,49,2430,3977,350,31,15,0,1,6804,1797,4423,539,114,8,0,0,6881,13685
52,50,2321,4131,413,34,5,0,0,6904,1651,4526,601,141,8,0,0,6927,13831
52,51,2318,4251,449,54,8,0,0,7080,1612,4657,612,165,8,0,0,7054,14134
52,52,2209,4340,446,41,8,1,1,7046,1434,4815,645,173,4,0,0,7071,14117
52,53,1937,4471,483,57,11,1,0,6960,1408,4917,654,187,4,1,0,7171,14131
52,54,1871,4824,609,53,11,0,1,7369,1314,5028,646,237,4,0,0,7229,14598
52,55,1754,4722,506,41,7,0,0,7030,1234,5085,696,286,0,0,0,7301,14331
52,56,1652,4854,557,66,12,0,0,7141,1209,5096,739,292,4,0,0,7340,14481
52,57,1504,5045,538,80,11,0,0,7178,1133,5269,688,318,4,0,0,7412,14590
52,58,1455,5069,588,93,8,0,0,7213,1086,5257,716,353,8,0,0,7420,14633
52,59,1269,5286,614,100,3,0,0,7272,947,5598,744,433,2,0,0,7724,14996
52,60,1190,4890,588,74,7,0,0,6749,873,5247,695,408,3,0,0,7226,13975
52,61,1026,4871,543,145,9,0,0,6594,802,5089,619,481,2,0,0,6993,13587
52,62,922,4869,489,137,8,1,0,6426,698,4970,616,532,2,0,0,6818,13244
52,63,795,4678,417,145,11,0,1,6047,598,4627,549,613,1,0,0,6388,12435
52,64,721,4604,427,147,8,0,0,5907,589,4605,527,657,2,0,0,6380,12287
52,65,653,4220,378,161,9,0,0,5421,508,4366,450,675,0,0,0,5999,11420
52,66,614,4148,360,161,9,0,0,5292,502,4213,423,740,3,0,0,5881,11173
52,67,522,4111,303,190,7,0,0,5133,488,4021,366,826,2,0,0,5703,10836
52,68,456,3887,259,182,8,0,0,4792,411,3782,405,820,2,0,0,5420,10212
52,69,418,3836,285,209,2,0,0,4750,370,3776,339,907,1,0,0,5393,10143
52,70,380,3831,247,233,4,0,0,4695,339,3468,315,940,1,0,0,5063,9758
52,71,330,3747,214,266,3,0,0,4560,327,3441,289,1043,0,0,0,5100,9660
52,72,320,3529,181,260,9,0,1,4300,281,3344,257,1076,3,0,0,4961,9261
52,73,339,3600,176,269,5,0,0,4389,282,3293,266,1278,0,0,0,5119,9508
52,74,321,3685,166,358,2,0,0,4532,266,3292,238,1375,1,0,0,5172,9704
52,75,312,3716,161,333,3,0,0,4525,265,3218,204,1592,0,0,0,5279,9804
52,76,270,3663,141,409,2,0,0,4485,257,2991,226,1755,0,0,0,5229,9714
52,77,277,3739,140,469,1,0,1,4627,278,3030,195,2021,2,0,0,5526,10153
52,78,172,2425,73,348,3,0,0,3021,181,1959,148,1489,0,0,0,3777,6798
52,79,230,2799,91,451,0,0,0,3571,210,2160,117,1919,0,0,0,4406,7977
52,80,195,2619,72,479,1,0,0,3366,235,2011,115,1970,0,0,0,4331,7697
52,81,225,2459,75,480,2,0,0,3241,212,1737,126,2132,0,0,0,4207,7448
52,82,177,2306,66,491,1,0,0,3041,206,1458,109,2231,0,0,0,4004,7045
52,83,150,2303,48,549,0,0,0,3050,213,1513,97,2410,0,0,0,4233,7283
52,84,167,2023,42,525,0,0,0,2757,194,1154,92,2371,0,0,0,3811,6568
52,85,118,1611,35,547,1,0,0,2312,182,935,67,2469,0,0,0,3653,5965
52,86,109,1399,34,481,0,0,0,2023,166,684,54,2260,0,0,0,3164,5187
52,87,81,1025,18,413,0,0,0,1537,167,518,41,2123,0,0,0,2849,4386
52,88,58,986,15,405,0,0,0,1464,125,395,50,1938,0,0,0,2508,3972
52,89,66,775,17,379,0,0,0,1237,100,304,25,1797,0,0,0,2226,3463
52,90,43,547,10,279,0,0,0,879,93,180,31,1535,0,0,0,1839,2718
52,91,36,434,6,292,0,0,0,768,85,130,14,1356,0,0,0,1585,2353
52,92,27,330,1,228,0,0,0,586,88,102,14,1138,0,0,0,1342,1928
52,93,20,233,2,157,0,0,0,412,75,68,15,1009,0,0,0,1167,1579
52,94,16,126,2,122,0,0,0,266,46,26,7,744,0,0,0,823,1089
52,95,12,85,3,117,0,0,0,217,39,24,7,571,0,0,0,641,858
52,96,9,50,1,89,0,0,0,149,43,14,4,467,0,0,0,528,677
52,97,3,29,0,62,0,0,0,94,23,5,5,331,0,0,0,364,458
52,98,1,24,0,33,0,0,0,58,25,1,2,212,0,0,0,240,298
52,99,3,10,1,19,0,0,0,33,13,1,2,140,0,0,0,156,189
52,100,0,7,0,23,0,0,0,30,28,2,0,270,0,0,0,300,330
52,999,192669,188862,13787,11958,398,13,6,407693,162510,191665,19259,54038,224,15,1,427712,835405
53,0,2947,0,0,0,0,0,0,2947,2722,0,0,0,0,0,0,2722,5669
53,1,3165,0,0,0,0,0,0,3165,2917,0,0,0,0,0,0,2917,6082
53,2,3227,0,0,0,0,0,0,3227,3095,0,0,0,0,0,0,3095,6322
53,3,3264,0,0,0,0,0,0,3264,2903,0,0,0,0,0,0,2903,6167
53,4,3353,0,0,0,0,0,0,3353,3199,0,0,0,0,0,0,3199,6552
53,5,3491,0,0,0,0,0,0,3491,3410,0,0,0,0,0,0,3410,6901
53,6,3663,0,0,0,0,0,0,3663,3520,0,0,0,0,0,0,3520,7183
53,7,3806,0,0,0,0,0,0,3806,3586,0,0,0,0,0,0,3586,7392
53,8,3901,0,0,0,0,0,0,3901,3721,0,0,0,0,0,0,3721,7622
53,9,4031,0,0,0,0,0,0,4031,3927,0,0,0,0,0,0,3927,7958
53,10,4345,0,0,0,0,0,0,4345,3966,0,0,0,0,0,0,3966,8311
53,11,4377,0,0,0,0,0,0,4377,4147,0,0,0,0,0,0,4147,8524
53,12,4410,0,0,0,0,0,0,4410,4184,0,0,0,0,0,0,4184,8594
53,13,4527,0,0,0,0,0,0,4527,4340,0,0,0,0,0,0,4340,8867
53,14,4631,0,0,0,0,0,0,4631,4441,0,0,0,0,0,0,4441,9072
53,15,4736,0,0,0,0,0,0,4736,4386,0,0,0,0,0,0,4386,9122
53,16,4612,0,0,0,0,0,0,4612,4408,0,0,0,0,0,0,4408,9020
53,17,4644,0,0,0,0,0,0,4644,4418,0,0,0,0,0,0,4418,9062
53,18,4668,0,0,0,0,0,0,4668,4241,2,0,0,0,0,0,4243,8911
53,19,4739,0,0,0,0,0,0,4739,4339,12,0,0,1,0,0,4352,9091
53,20,4734,3,1,1,0,0,0,4739,4260,36,0,0,0,0,0,4296,9035
53,21,4554,2,0,0,1,0,0,4557,4097,45,0,0,0,0,0,4142,8699
53,22,4638,14,4,0,0,0,0,4656,4221,86,2,0,2,0,0,4311,8967
53,23,4860,24,0,0,0,0,0,4884,4338,133,1,0,0,0,0,4472,9356
53,24,4914,52,3,0,2,0,0,4971,4295,219,11,0,0,0,0,4525,9496
53,25,4905,80,2,0,0,0,0,4987,4264,282,7,0,1,0,0,4554,9541
53,26,4902,112,2,0,0,0,0,5016,4165,420,4,1,2,0,0,4592,9608
53,27,4755,185,5,0,0,0,0,4945,4097,506,6,1,2,0,0,4612,9557
53,28,4633,314,6,0,6,0,0,4959,3852,661,15,2,5,1,0,4536,9495
53,29,4537,414,10,0,0,0,0,4961,3641,873,18,2,3,1,0,4538,9499
53,30,4303,606,9,0,8,0,0,4926,3502,1120,29,0,5,0,0,4656,9582
53,31,4397,739,21,0,3,0,0,5160,3441,1411,32,5,6,0,0,4895,10055
53,32,4161,971,19,4,5,0,0,5160,3215,1598,39,7,4,0,0,4863,10023
53,33,3888,1239,28,2,6,2,0,5165,3004,1875,60,13,8,0,0,4960,10125
53,34,3625,1387,27,4,6,0,0,5049,2784,2090,73,3,7,0,0,4957,10006
53,35,3514,1609,47,5,10,0,0,5185,2691,2393,100,10,9,0,0,5203,10388
53,36,3215,1799,40,6,8,1,0,5069,2291,2426,91,7,25,0,0,4840,9909
53,37,2958,1998,74,4,13,0,0,5047,2204,2648,151,22,8,1,0,5034,10081
53,38,3016,2196,73,6,9,0,0,5300,2224,2863,176,17,16,0,0,5296,10596
53,39,2832,2319,84,5,8,0,0,5248,2164,3016,184,21,4,0,0,5389,10637
53,40,2774,2586,121,5,13,0,0,5499,2054,3081,202,28,7,0,0,5372,10871
53,41,2571,2724,115,6,6,0,0,5422,1951,3293,270,41,6,0,0,5561,10983
53,42,2572,2787,153,23,6,1,0,5542,1869,3386,272,42,8,0,0,5577,11119
53,43,2666,3071,210,13,2,2,0,5964,1827,3604,322,61,10,0,1,5825,11789
53,44,2603,3229,244,15,10,1,0,6102,1926,3769,353,52,5,0,0,6105,12207
53,45,2675,3360,246,25,13,0,1,6320,1900,3988,398,51,4,0,0,6341,12661
53,46,2622,3631,278,15,9,0,0,6555,1926,4315,473,84,5,0,0,6803,13358
53,47,2743,3990,337,15,8,0,0,7093,1829,4492,544,93,7,0,0,6965,14058
53,48,2744,4223,393,17,11,1,0,7389,1833,4621,552,123,4,0,0,7133,14522
53,49,2625,4526,426,28,8,0,0,7613,1875,5060,602,135,4,0,0,7676,15289
53,50,2538,4657,467,32,8,0,0,7702,1759,5049,649,134,6,0,0,7597,15299
53,51,2495,4765,463,47,8,0,0,7778,1700,5085,696,129,3,0,0,7613,15391
53,52,2285,4881,528,34,11,1,0,7740,1686,5283,605,180,8,1,0,7763,15503
53,53,2249,5064,529,53,8,0,0,7903,1554,5341,775,185,5,0,0,7860,15763
53,54,2098,5287,587,55,15,1,0,8043,1426,5571,754,230,5,0,0,7986,16029
53,55,1850,5427,576,54,10,0,0,7917,1401,5616,788,265,1,0,0,8071,15988
53,56,1893,5380,600,54,13,0,2,7942,1337,5673,774,238,2,2,0,8026,15968
53,57,1710,5465,637,70,10,0,0,7892,1245,5814,735,285,5,0,0,8084,15976
53,58,1541,5656,660,105,15,0,0,7977,1160,5841,792,349,5,0,0,8147,16124
53,59,1451,5764,626,101,9,0,0,7951,1173,5961,790,403,2,0,0,8329,16280
53,60,1245,5612,647,100,7,0,0,7611,1010,5551,666,374,2,0,0,7603,15214
53,61,1108,5429,535,106,9,0,0,7187,942,5434,625,463,2,0,0,7466,14653
53,62,1044,5177,509,122,13,0,0,6865,859,5211,668,475,3,0,0,7216,14081
53,63,843,4964,417,119,10,0,0,6353,738,4910,577,551,1,0,0,6777,13130
53,64,814,4978,445,145,4,0,0,6386,735,4833,534,571,2,0,0,6675,13061
53,65,730,4750,427,132,7,0,0,6046,660,4474,457,684,1,0,0,6276,12322
53,66,663,4687,360,177,5,0,0,5892,579,4277,452,710,0,1,0,6019,11911
53,67,582,4501,355,172,1,0,1,5612,542,4365,436,795,0,0,0,6138,11750
53,68,509,4208,305,174,2,0,0,5198,527,4008,374,829,0,0,0,5738,10936
53,69,529,4184,280,207,10,0,0,5210,438,3909,346,870,0,0,0,5563,10773
53,70,443,3968,216,218,3,0,0,4848,389,3770,347,918,0,0,0,5424,10272
53,71,431,3873,241,223,9,0,0,4777,360,3764,279,1033,0,0,0,5436,10213
53,72,396,3887,223,256,7,0,1,4770,333,3494,288,1107,1,0,0,5223,9993
53,73,376,3843,184,266,2,0,0,4671,333,3631,251,1233,0,0,0,5448,10119
53,74,330,3931,189,287,6,0,1,4744,333,3339,189,1404,0,0,0,5265,10009
53,75,348,3781,159,331,5,0,0,4624,315,3305,246,1503,0,0,0,5369,9993
53,76,306,3628,142,340,3,0,0,4419,302,2978,194,1588,0,0,0,5062,9481
53,77,318,3734,138,431,2,0,0,4623,300,3059,187,1848,0,0,0,5394,10017
53,78,195,2561,95,342,0,0,0,3193,250,2103,144,1488,1,0,0,3986,7179
53,79,218,2861,84,371,1,0,0,3535,252,2145,123,1752,0,0,0,4272,7807
53,80,225,2761,56,441,0,0,0,3483,253,2036,125,1950,0,0,0,4364,7847
53,81,208,2510,67,440,2,0,1,3228,266,1770,130,1975,0,0,0,4141,7369
53,82,216,2352,43,419,1,0,0,3031,250,1572,87,2159,0,0,0,4068,7099
53,83,201,2273,61,486,1,0,0,3022,243,1445,92,2427,0,0,0,4207,7229
53,84,160,2156,41,464,0,0,1,2822,233,1223,70,2279,0,0,0,3805,6627
53,85,134,1762,25,462,0,0,0,2383,260,961,75,2412,0,0,0,3708,6091
53,86,114,1426,37,416,1,0,0,1994,202,729,49,2130,0,0,0,3110,5104
53,87,112,1101,33,393,1,0,0,1640,191,499,43,2051,0,0,0,2784,4424
53,88,72,1003,6,399,0,0,0,1480,159,430,30,2088,0,0,0,2707,4187
53,89,53,850,8,337,0,0,0,1248,156,284,33,1911,0,0,0,2384,3632
53,90,47,595,8,295,0,0,0,945,146,191,21,1512,0,0,0,1870,2815
53,91,43,431,3,283,0,0,0,760,120,139,21,1378,0,0,0,1658,2418
53,92,24,288,2,213,0,0,0,527,121,101,8,1181,0,0,0,1411,1938
53,93,24,221,3,197,0,0,0,445,99,54,9,1000,0,0,0,1162,1607
53,94,12,160,4,118,0,0,0,294,66,34,9,773,0,0,0,882,1176
53,95,10,99,2,104,0,0,0,215,53,16,1,628,0,0,0,698,913
53,96,5,75,1,71,0,0,0,152,53,10,2,474,0,0,0,539,691
53,97,5,41,2,47,0,0,0,95,32,7,2,337,0,0,0,378,473
53,98,3,14,0,30,0,0,0,47,29,6,2,250,0,0,0,287,334
53,99,1,13,0,19,0,0,0,33,12,0,0,144,0,0,0,156,189
53,100,2,10,0,31,0,0,0,43,28,4,1,199,0,0,0,232,275
53,999,223682,207234,15004,10988,390,10,8,457316,191220,209629,20538,52673,223,7,1,474291,931607
54,0,605,0,0,0,0,0,0,605,582,0,0,0,0,0,0,582,1187
54,1,612,0,0,0,0,0,0,612,587,0,0,0,0,0,0,587,1199
54,2,665,0,0,0,0,0,0,665,567,0,0,0,0,0,0,567,1232
54,3,636,0,0,0,0,0,0,636,589,0,0,0,0,0,0,589,1225
54,4,657,0,0,0,0,0,0,657,635,0,0,0,0,0,0,635,1292
54,5,730,0,0,0,0,0,0,730,677,0,0,0,0,0,0,677,1407
54,6,853,0,0,0,0,0,0,853,743,0,0,0,0,0,0,743,1596
54,7,750,0,0,0,0,0,0,750,807,0,0,0,0,0,0,807,1557
54,8,796,0,0,0,0,0,0,796,832,0,0,0,0,0,0,832,1628
54,9,832,0,0,0,0,0,0,832,817,0,0,0,0,0,0,817,1649
54,10,913,0,0,0,0,0,0,913,835,0,0,0,0,0,0,835,1748
54,11,986,0,0,0,0,0,0,986,873,0,0,0,0,0,0,873,1859
54,12,914,0,0,0,0,0,0,914,929,0,0,0,0,0,0,929,1843
54,13,1033,0,0,0,0,0,0,1033,969,0,0,0,0,0,0,969,2002
54,14,1016,0,0,0,0,0,0,1016,953,0,0,0,0,0,0,953,1969
54,15,1051,0,0,0,0,0,0,1051,924,0,0,0,0,0,0,924,1975
54,16,959,0,1,0,0,0,0,960,946,0,0,0,0,0,0,946,1906
54,17,953,0,0,0,0,0,0,953,854,0,0,0,0,0,0,854,1807
54,18,999,0,0,0,0,0,0,999,909,0,0,0,0,0,0,909,1908
54,19,984,0,0,0,0,0,0,984,934,2,0,0,0,0,0,936,1920
54,20,930,0,0,0,0,0,0,930,896,2,0,0,0,0,0,898,1828
54,21,952,3,0,0,0,0,0,955,856,10,0,0,0,0,0,866,1821
54,22,1027,2,0,0,0,0,0,1029,844,29,0,0,0,0,0,873,1902
54,23,1010,10,1,0,0,0,0,1021,941,26,0,0,0,0,0,967,1988
54,24,995,9,0,0,0,0,0,1004,903,58,1,0,0,0,0,962,1966
54,25,1038,14,1,0,0,0,0,1053,900,76,3,0,0,0,0,979,2032
54,26,1045,24,0,0,1,0,0,1070,871,95,3,0,1,0,0,970,2040
54,27,1003,55,0,0,1,0,0,1059,818,126,5,0,0,0,0,949,2008
54,28,990,56,2,0,1,0,0,1049,776,152,2,0,0,0,0,930,1979
54,29,969,94,1,0,0,0,0,1064,717,208,5,1,0,0,0,931,1995
54,30,896,115,5,0,0,0,0,1016,690,237,13,0,1,0,0,941,1957
54,31,969,153,7,0,3,0,0,1132,707,264,11,0,1,0,0,983,2115
54,32,960,163,5,1,0,0,0,1129,705,373,15,1,1,0,0,1095,2224
54,33,924,234,10,0,2,0,0,1170,685,391,16,4,0,0,0,1096,2266
54,34,846,279,7,0,0,0,0,1132,637,407,16,1,1,0,0,1062,2194
54,35,816,322,13,1,3,0,0,1155,635,464,38,4,1,0,0,1142,2297
54,36,805,363,14,1,3,0,0,1186,570,489,31,1,3,0,0,1094,2280
54,37,769,394,23,1,6,0,0,1193,555,517,38,7,1,0,0,1118,2311
54,38,772,401,23,0,1,0,0,1197,588,614,44,7,2,0,0,1255,2452
54,39,727,492,23,1,3,0,0,1246,502,629,52,5,1,0,0,1189,2435
54,40,755,557,25,1,1,0,0,1339,467,636,54,8,3,0,0,1168,2507
54,41,675,562,44,0,2,0,0,1283,495,751,65,12,0,0,0,1323,2606
54,42,686,622,45,8,1,0,0,1362,524,777,87,28,0,0,0,1416,2778
54,43,732,652,53,7,2,0,0,1446,469,803,91,19,3,0,0,1385,2831
54,44,707,700,63,6,2,0,0,1478,469,875,91,20,1,0,0,1456,2934
54,45,747,803,72,6,2,0,0,1630,578,966,129,23,0,0,0,1696,3326
54,46,762,894,86,8,2,0,0,1752,523,970,132,24,2,0,0,1651,3403
54,47,782,926,104,8,2,1,0,1823,473,1029,138,27,1,0,0,1668,3491
54,48,717,974,121,7,3,0,0,1822,461,1110,158,31,2,0,0,1762,3584
54,49,739,1064,126,3,4,0,0,1936,468,1176,167,29,2,0,0,1842,3778
54,50,700,1024,133,8,2,1,0,1868,442,1229,187,44,1,0,0,1903,3771
54,51,685,1086,143,13,4,0,0,1931,393,1184,165,46,1,0,0,1789,3720
54,52,600,1151,149,6,2,0,0,1908,345,1276,173,42,1,0,0,1837,3745
54,53,586,1119,151,15,3,0,0,1874,301,1281,190,44,0,0,0,1816,3690
54,54,528,1209,174,13,1,0,0,1925,347,1289,186,73,0,0,0,1895,3820
54,55,491,1262,162,12,2,0,0,1929,277,1340,191,64,1,0,0,1873,3802
54,56,448,1297,167,25,2,0,0,1939,294,1381,158,80,1,0,0,1914,3853
54,57,403,1395,166,21,2,0,0,1987,292,1453,199,83,0,0,0,2027,4014
54,58,378,1365,173,30,2,0,0,1948,268,1419,179,95,0,0,0,1961,3909
54,59,366,1419,194,28,1,0,0,2008,257,1514,190,104,0,0,0,2065,4073
54,60,344,1387,153,36,0,0,0,1920,215,1477,161,138,0,0,0,1991,3911
54,61,307,1362,158,42,3,0,0,1872,207,1444,175,138,0,0,0,1964,3836
54,62,301,1388,158,42,1,0,0,1890,189,1465,172,170,0,0,0,1996,3886
54,63,281,1347,122,35,2,1,0,1788,142,1371,138,174,0,0,1,1826,3614
54,64,250,1372,134,58,2,0,0,1816,137,1409,140,197,0,0,0,1883,3699
54,65,191,1362,106,50,0,0,0,1709,127,1280,115,221,0,0,0,1743,3452
54,66,172,1344,105,59,2,0,0,1682,116,1321,117,231,0,0,0,1785,3467
54,67,180,1357,112,47,1,0,0,1697,130,1318,97,282,0,0,0,1827,3524
54,68,158,1293,78,60,0,0,0,1589,124,1273,85,274,0,0,0,1756,3345
54,69,133,1237,83,73,0,0,0,1526,102,1143,92,330,0,0,0,1667,3193
54,70,116,1282,66,77,1,0,0,1542,93,1152,83,362,0,0,0,1690,3232
54,71,111,1227,79,92,0,0,0,1509,95,1100,69,337,0,0,0,1601,3110
54,72,110,1152,55,108,0,0,0,1425,84,954,59,320,0,0,0,1417,2842
54,73,126,1203,62,99,0,0,0,1490,80,1025,54,401,0,0,0,1560,3050
54,74,115,1121,45,119,0,0,1,1401,89,999,45,406,0,0,0,1539,2940
54,75,100,1172,40,130,0,0,0,1442,82,919,55,510,0,0,0,1566,3008
54,76,99,1042,37,140,0,0,0,1318,76,834,51,505,0,0,0,1466,2784
54,77,75,1088,23,133,0,1,0,1320,60,806,40,573,0,0,0,1479,2799
54,78,52,618,23,90,0,0,0,783,29,441,22,411,0,0,0,903,1686
54,79,71,741,29,103,0,0,0,944,53,525,25,570,0,0,0,1173,2117
54,80,60,681,22,121,0,0,0,884,51,456,20,534,0,0,0,1061,1945
54,81,45,598,12,118,0,0,0,773,56,446,18,610,0,0,0,1130,1903
54,82,62,614,20,126,0,0,0,822,52,357,21,638,0,0,0,1068,1890
54,83,57,544,4,112,0,0,0,717,58,339,12,696,0,0,0,1105,1822
54,84,38,492,8,141,0,0,0,679,54,278,15,686,0,0,0,1033,1712
54,85,37,461,7,134,0,0,0,639,44,251,10,685,0,0,0,990,1629
54,86,31,343,0,147,0,0,0,521,44,174,11,645,0,0,0,874,1395
54,87,33,250,4,112,0,0,0,399,40,115,7,618,0,0,0,780,1179
54,88,28,256,7,124,0,0,0,415,28,100,3,606,0,0,0,737,1152
54,89,21,196,2,116,0,0,0,335,36,79,5,554,0,0,0,674,1009
54,90,13,150,3,86,0,0,0,252,39,62,4,475,0,0,0,580,832
54,91,13,103,4,81,0,0,0,201,27,38,4,388,0,0,0,457,658
54,92,4,89,1,59,0,0,0,153,28,26,1,365,0,0,0,420,573
54,93,10,60,0,55,0,0,0,125,23,19,2,314,0,0,0,358,483
54,94,5,30,0,43,0,0,0,78,20,9,2,236,0,0,0,267,345
54,95,1,28,0,32,0,0,0,61,18,6,0,174,0,0,0,198,259
54,96,1,10,1,28,0,0,0,40,11,6,1,127,0,0,0,145,185
54,97,0,6,0,14,0,0,0,20,7,3,0,103,0,0,0,113,133
54,98,1,3,0,11,0,0,0,15,3,2,1,59,0,0,0,65,80
54,99,1,1,0,9,0,0,0,11,3,1,0,43,0,0,0,47,58
54,100,1,1,0,4,0,0,0,6,7,0,2,62,0,0,0,71,77
54,999,51628,52275,4250,3496,78,4,1,111732,41780,52651,5157,16095,32,0,1,115716,227448
55,0,1435,0,0,0,0,0,0,1435,1372,0,0,0,0,0,0,1372,2807
55,1,1539,0,0,0,0,0,0,1539,1446,0,0,0,0,0,0,1446,2985
55,2,1565,0,0,0,0,0,0,1565,1475,0,0,0,0,0,0,1475,3040
55,3,1671,0,0,0,0,0,0,1671,1564,0,0,0,0,0,0,1564,3235
55,4,1649,0,0,0,0,0,0,1649,1573,0,0,0,0,0,0,1573,3222
55,5,1721,0,0,0,0,0,0,1721,1624,0,0,0,0,0,0,1624,3345
55,6,1815,0,0,0,0,0,0,1815,1711,0,0,0,0,0,0,1711,3526
55,7,1907,0,0,0,0,0,0,1907,1824,0,0,0,0,0,0,1824,3731
55,8,1873,0,0,0,0,0,0,1873,1874,0,0,0,0,0,0,1874,3747
55,9,2082,0,0,0,0,0,0,2082,1941,0,0,0,0,0,0,1941,4023
55,10,2115,0,0,0,0,0,0,2115,2016,0,0,0,0,0,0,2016,4131
55,11,2159,0,0,0,0,0,0,2159,2114,0,0,0,0,0,0,2114,4273
55,12,2159,0,0,0,0,0,0,2159,2097,0,0,0,0,0,0,2097,4256
55,13,2353,0,0,0,0,0,0,2353,2164,0,0,0,0,0,0,2164,4517
55,14,2324,0,0,0,0,0,0,2324,2315,0,0,0,0,0,0,2315,4639
55,15,2282,0,0,0,0,0,0,2282,2236,0,0,0,0,0,0,2236,4518
55,16,2331,0,0,0,0,0,0,2331,2270,0,0,0,0,0,0,2270,4601
55,17,2376,0,0,0,0,0,0,2376,2263,0,0,0,0,0,0,2263,4639
55,18,2431,0,0,0,0,0,0,2431,2251,1,0,0,0,0,0,2252,4683
55,19,2401,0,0,0,0,0,0,2401,2282,6,0,0,0,0,0,2288,4689
55,20,2552,2,0,0,0,0,0,2554,2216,13,0,0,0,0,0,2229,4783
55,21,2458,6,0,0,0,0,0,2464,2253,30,0,0,0,0,0,2283,4747
55,22,2465,12,4,0,0,0,0,2481,2183,58,0,0,0,0,0,2241,4722
55,23,2567,13,1,0,0,0,0,2581,2269,76,0,0,2,0,0,2347,4928
55,24,2450,34,3,0,0,0,0,2487,2076,102,0,0,0,0,0,2178,4665
55,25,2488,52,2,0,1,0,0,2543,2124,124,1,0,0,0,0,2249,4792
55,26,2397,80,4,0,1,0,0,2482,2032,205,0,1,0,0,0,2238,4720
55,27,2396,105,2,1,3,1,0,2508,1920,278,3,1,1,0,0,2203,4711
55,28,2336,165,1,0,2,0,0,2504,1916,372,4,0,1,0,0,2293,4797
55,29,2220,211,3,0,3,0,0,2437,1753,464,11,0,1,1,0,2230,4667
55,30,2160,287,7,0,4,0,0,2458,1607,518,17,2,1,0,0,2145,4603
55,31,2166,446,10,0,3,0,0,2625,1685,726,31,2,2,0,0,2446,5071
55,32,1991,528,10,1,1,0,0,2531,1619,785,26,2,4,0,0,2436,4967
55,33,2001,556,13,1,3,1,0,2575,1508,936,26,4,2,1,0,2477,5052
55,34,1849,698,19,2,6,0,0,2574,1435,1051,47,0,5,0,0,2538,5112
55,35,1747,835,39,0,3,0,0,2624,1367,1151,58,4,3,0,0,2583,5207
55,36,1618,834,34,4,2,0,0,2492,1223,1237,53,6,5,0,0,2524,5016
55,37,1664,879,62,2,6,0,0,2613,1210,1266,97,8,5,0,0,2586,5199
55,38,1612,1055,42,1,0,0,0,2710,1179,1450,90,10,2,1,0,2732,5442
55,39,1664,1175,42,2,2,1,0,2886,1209,1424,112,11,6,0,0,2762,5648
55,40,1473,1276,56,2,2,2,0,2811,1116,1544,128,10,6,0,0,2804,5615
55,41,1507,1367,82,4,1,0,0,2961,1050,1704,160,18,4,0,0,2936,5897
55,42,1510,1432,91,4,1,0,0,3038,1048,1662,191,28,4,2,0,2935,5973
55,43,1474,1509,144,3,2,0,1,3133,1036,1769,201,22,1,1,0,3030,6163
55,44,1474,1673,125,11,4,0,0,3287,1062,1842,198,29,3,0,0,3134,6421
55,45,1579,1776,155,4,4,0,1,3519,1140,1931,267,47,6,0,0,3391,6910
55,46,1543,1695,189,8,3,0,0,3438,1092,2145,282,32,2,0,0,3553,6991
55,47,1534,1914,175,9,6,1,0,3639,1130,2197,321,52,2,0,0,3702,7341
55,48,1624,2082,228,22,12,0,0,3968,1059,2414,377,74,3,0,0,3927,7895
55,49,1584,2294,265,13,5,0,0,4161,1114,2659,411,85,2,1,0,4272,8433
55,50,1507,2285,303,26,2,0,0,4123,1124,2614,430,81,6,2,0,4257,8380
55,51,1459,2412,305,15,9,0,0,4200,961,2756,436,109,1,0,0,4263,8463
55,52,1414,2573,298,24,6,0,0,4315,913,2862,486,125,1,0,0,4387,8702
55,53,1334,2582,377,19,6,0,0,4318,922,2952,503,123,6,0,0,4506,8824
55,54,1321,2738,379,26,1,0,0,4465,877,2981,462,133,2,2,0,4457,8922
55,55,1204,2780,385,27,3,0,0,4399,787,2879,513,187,1,0,0,4367,8766
55,56,1128,2804,437,31,3,0,0,4403,763,3057,528,156,3,0,0,4507,8910
55,57,1036,2914,412,49,6,0,0,4417,794,3009,538,206,0,0,0,4547,8964
55,58,1097,2945,432,46,5,0,0,4525,720,3066,493,204,1,0,0,4484,9009
55,59,998,3018,444,58,5,0,0,4523,718,3094,567,223,2,0,0,4604,9127
55,60,862,2834,415,55,7,0,0,4173,555,3128,516,290,2,0,0,4491,8664
55,61,813,2753,418,70,3,0,0,4057,517,2871,477,335,0,0,0,4200,8257
55,62,686,2760,387,68,6,0,0,3907,502,2752,472,343,0,0,0,4069,7976
55,63,637,2761,357,68,3,0,0,3826,469,2698,409,356,1,0,0,3933,7759
55,64,578,2721,369,97,2,0,0,3767,412,2701,417,414,1,0,0,3945,7712
55,65,518,2509,340,91,2,0,0,3460,366,2540,342,454,0,0,0,3702,7162
55,66,471,2372,305,108,2,0,1,3259,291,2477,331,445,1,0,0,3545,6804
55,67,445,2402,301,126,2,0,0,3276,324,2411,317,535,0,0,0,3587,6863
55,68,446,2370,249,136,1,0,0,3202,291,2275,321,551,1,0,0,3439,6641
55,69,352,2385,246,122,4,0,0,3109,259,2290,282,618,0,0,0,3449,6558
55,70,329,2361,223,143,2,0,0,3058,224,2232,229,730,0,0,0,3415,6473
55,71,314,2278,202,150,1,0,0,2945,219,2167,236,733,0,0,0,3355,6300
55,72,326,2172,166,137,1,0,1,2803,210,2098,191,833,0,0,0,3332,6135
55,73,321,2383,162,202,1,0,0,3069,202,2118,189,908,0,0,0,3417,6486
55,74,299,2324,167,218,2,0,0,3010,212,2068,201,995,0,0,0,3476,6486
55,75,307,2401,144,234,0,0,0,3086,213,2018,190,1136,1,0,0,3558,6644
55,76,272,2383,123,269,1,0,0,3048,190,1926,177,1239,0,0,0,3532,6580
55,77,264,2476,108,308,1,0,0,3157,180,1982,159,1458,0,0,0,3779,6936
55,78,185,1586,75,224,0,0,0,2070,152,1246,119,1038,0,0,0,2555,4625
55,79,189,1847,86,295,0,0,0,2417,148,1308,111,1337,0,0,0,2904,5321
55,80,189,1685,83,294,1,0,0,2252,147,1230,109,1363,0,0,0,2849,5101
55,81,175,1585,71,292,1,0,0,2124,153,1175,84,1491,0,0,0,2903,5027
55,82,151,1536,61,349,2,0,0,2099,164,990,67,1543,0,0,0,2764,4863
55,83,155,1478,53,352,0,0,0,2038,164,859,66,1663,1,0,0,2753,4791
55,84,136,1315,44,328,0,0,0,1823,163,774,59,1599,0,0,0,2595,4418
55,85,107,1125,28,337,0,0,0,1597,131,569,58,1618,0,0,0,2376,3973
55,86,91,890,20,303,0,0,0,1304,122,419,54,1417,0,0,0,2012,3316
55,87,55,710,19,264,0,0,0,1048,104,289,24,1401,0,0,0,1818,2866
55,88,53,582,15,229,0,0,0,879,103,265,21,1322,0,0,1,1712,2591
55,89,34,462,15,224,0,0,0,735,106,168,25,1108,0,0,0,1407,2142
55,90,34,354,4,196,0,0,0,588,76,91,13,1033,0,0,0,1213,1801
55,91,26,258,4,160,0,0,0,448,58,71,18,929,0,0,0,1076,1524
55,92,14,206,3,159,0,0,0,382,61,61,10,738,0,0,0,870,1252
55,93,21,138,3,125,0,0,0,287,63,28,10,715,0,0,0,816,1103
55,94,13,87,2,89,0,0,0,191,36,16,8,509,0,0,0,569,760
55,95,7,61,4,68,0,0,0,140,39,13,4,429,0,0,0,485,625
55,96,3,44,0,55,0,0,0,102,29,10,5,351,0,0,0,395,497
55,97,2,22,0,32,0,0,0,56,16,2,2,247,0,0,0,267,323
55,98,1,13,0,20,0,0,0,34,13,3,3,178,0,0,0,197,231
55,99,2,6,0,6,0,0,0,14,18,1,2,116,0,0,0,137,151
55,100,1,6,0,25,0,0,0,32,16,2,0,194,0,0,0,212,244
55,999,120673,112683,10852,7443,171,6,4,251832,100340,113752,14396,36707,104,11,1,265311,517143
56,0,504,0,0,0,0,0,0,504,416,0,0,0,0,0,0,416,920
56,1,459,0,0,0,0,0,0,459,487,0,0,0,0,0,0,487,946
56,2,438,0,0,0,0,0,0,438,404,0,0,0,0,0,0,404,842
56,3,451,0,0,0,0,0,0,451,480,0,0,0,0,0,0,480,931
56,4,457,0,0,0,0,0,0,457,458,0,0,0,0,0,0,458,915
56,5,499,0,0,0,0,0,0,499,475,0,0,0,0,0,0,475,974
56,6,515,0,0,0,0,0,0,515,523,0,0,0,0,0,0,523,1038
56,7,523,0,0,0,0,0,0,523,493,0,0,0,0,0,0,493,1016
56,8,553,0,0,0,0,0,0,553,554,0,0,0,0,0,0,554,1107
56,9,550,0,0,0,0,0,0,550,488,0,0,0,0,0,0,488,1038
56,10,596,0,0,0,0,0,0,596,484,0,0,0,0,0,0,484,1080
56,11,593,0,0,0,0,0,0,593,553,0,0,0,0,0,0,553,1146
56,12,679,0,0,0,0,0,0,679,551,0,0,0,0,0,0,551,1230
56,13,623,0,0,0,0,0,0,623,598,0,0,0,0,0,0,598,1221
56,14,641,0,0,0,0,0,0,641,539,0,0,0,0,0,0,539,1180
56,15,677,0,0,0,0,0,0,677,584,0,0,0,0,0,0,584,1261
56,16,625,0,0,0,0,0,0,625,618,0,0,0,0,0,0,618,1243
56,17,663,0,0,0,0,0,0,663,620,0,0,0,0,0,0,620,1283
56,18,684,0,0,0,0,0,0,684,600,1,0,0,0,0,0,601,1285
56,19,653,1,0,0,0,0,0,654,593,2,0,0,0,0,0,595,1249
56,20,661,1,0,0,0,0,0,662,599,9,0,0,0,0,0,608,1270
56,21,699,1,0,0,0,0,0,700,551,20,0,0,0,0,0,571,1271
56,22,735,4,0,0,0,0,0,739,590,24,1,0,0,0,0,615,1354
56,23,720,3,0,0,1,0,0,724,587,63,1,0,0,0,0,651,1375
56,24,695,17,0,0,0,0,0,712,548,74,1,0,0,0,0,623,1335
56,25,765,36,3,0,0,0,0,804,518,100,3,0,1,0,0,622,1426
56,26,681,39,2,0,0,0,1,723,528,111,0,0,1,0,0,640,1363
56,27,703,59,6,0,0,0,0,768,488,137,1,1,1,0,0,628,1396
56,28,625,73,4,0,0,0,0,702,460,169,3,0,0,0,0,632,1334
56,29,593,88,2,0,0,0,0,683,441,172,4,0,0,0,0,617,1300
56,30,562,112,7,0,1,1,0,683,426,203,8,0,2,0,0,639,1322
56,31,573,140,7,0,1,0,0,721,402,248,10,1,0,0,0,661,1382
56,32,507,171,4,0,2,0,0,684,372,282,8,1,0,0,0,663,1347
56,33,522,211,5,1,0,0,0,739,324,317,8,0,0,0,0,649,1388
56,34,447,261,5,0,0,0,0,713,347,306,12,1,0,0,0,666,1379
56,35,445,248,6,5,2,0,0,706,293,335,11,0,1,0,0,640,1346
56,36,372,277,10,0,0,1,0,660,271,356,11,2,1,0,0,641,1301
56,37,366,308,14,1,2,0,0,691,241,371,19,2,0,0,0,633,1324
56,38,360,321,17,1,1,0,0,700,223,424,27,2,1,0,0,677,1377
56,39,374,354,20,1,1,0,0,750,235,408,40,4,0,0,0,687,1437
56,40,347,386,17,0,0,0,0,750,216,396,31,8,0,0,0,651,1401
56,41,372,426,32,4,0,0,0,834,250,412,49,5,0,0,0,716,1550
56,42,355,412,31,4,1,0,0,803,233,478,38,4,0,0,0,753,1556
56,43,371,445,48,7,2,0,0,873,226,449,56,4,0,0,0,735,1608
56,44,383,495,27,1,0,0,0,906,222,481,55,13,0,0,0,771,1677
56,45,379,519,48,6,0,0,0,952,259,529,71,8,1,0,0,868,1820
56,46,387,566,37,6,2,0,0,998,253,532,66,6,2,0,0,859,1857
56,47,394,535,57,6,0,0,0,992,222,575,94,22,1,0,0,914,1906
56,48,392,616,71,7,0,0,0,1086,253,613,105,13,1,0,0,985,2071
56,49,458,651,86,7,1,0,0,1203,280,697,112,26,1,0,0,1116,2319
56,50,400,605,98,2,1,0,0,1106,277,727,121,22,0,0,0,1147,2253
56,51,446,683,88,9,1,0,0,1227,241,756,124,31,1,0,0,1153,2380
56,52,406,695,79,4,2,0,0,1186,210,785,121,33,3,0,0,1152,2338
56,53,375,698,92,6,2,0,0,1173,242,730,142,44,1,0,0,1159,2332
56,54,358,748,127,15,1,0,0,1249,243,751,132,47,1,0,0,1174,2423
56,55,342,718,127,15,2,0,0,1204,214,744,145,38,0,0,0,1141,2345
56,56,342,749,138,7,0,0,0,1236,211,784,159,50,1,0,0,1205,2441
56,57,342,740,141,17,4,0,0,1244,179,754,173,61,0,0,0,1167,2411
56,58,296,770,126,15,1,0,0,1208,189,820,166,59,0,0,0,1234,2442
56,59,311,802,139,20,0,0,0,1272,181,800,179,83,0,0,0,1243,2515
56,60,239,808,115,16,1,0,0,1179,165,751,139,67,0,0,0,1122,2301
56,61,217,768,110,23,1,0,0,1119,143,703,127,86,1,0,0,1060,2179
56,62,191,721,119,20,2,0,0,1053,122,719,129,103,0,0,0,1073,2126
56,63,218,738,117,20,0,0,0,1093,116,642,115,73,0,0,0,946,2039
56,64,130,663,121,25,1,0,0,940,77,649,113,114,0,0,0,953,1893
56,65,144,621,95,25,1,0,0,886,84,615,101,112,0,0,0,912,1798
56,66,123,585,84,17,1,0,0,810,92,610,97,133,0,0,0,932,1742
56,67,103,616,65,20,1,0,0,805,68,542,94,125,0,0,0,829,1634
56,68,100,600,86,45,0,0,0,831,78,532,89,145,0,0,0,844,1675
56,69,113,558,55,37,1,0,0,764,65,487,81,158,1,0,0,792,1556
56,70,84,567,58,48,0,0,0,757,64,569,82,179,0,0,0,894,1651
56,71,63,483,52,42,0,0,1,641,52,543,73,169,0,0,0,837,1478
56,72,84,570,58,54,0,0,0,766,47,504,68,205,0,0,0,824,1590
56,73,69,515,55,50,0,0,0,689,56,538,63,230,0,0,0,887,1576
56,74,54,588,50,55,0,0,0,747,39,550,58,253,0,0,0,900,1647
56,75,68,600,54,68,1,0,0,791,57,533,78,298,0,0,0,966,1757
56,76,57,592,43,60,0,0,0,752,46,513,56,343,0,0,0,958,1710
56,77,61,588,41,77,0,0,0,767,52,464,44,381,0,0,0,941,1708
56,78,35,411,22,57,1,0,0,526,28,299,28,255,0,0,0,610,1136
56,79,36,440,32,84,0,0,0,592,49,339,37,375,0,0,0,800,1392
56,80,38,422,25,83,0,0,0,568,45,314,41,335,0,0,0,735,1303
56,81,31,416,18,71,0,0,0,536,32,261,32,394,0,0,0,719,1255
56,82,38,383,17,116,0,0,0,554,44,276,21,424,0,0,0,765,1319
56,83,30,384,19,104,0,0,0,537,44,277,18,449,0,0,0,788,1325
56,84,29,338,12,77,0,0,0,456,50,210,20,440,0,0,0,720,1176
56,85,23,287,12,77,0,0,0,399,46,160,22,466,0,0,0,694,1093
56,86,23,238,11,88,0,0,0,360,46,105,12,412,0,0,0,575,935
56,87,18,221,4,76,0,0,0,319,28,96,9,396,0,0,0,529,848
56,88,10,158,3,85,0,0,0,256,29,64,11,363,0,0,0,467,723
56,89,14,115,2,55,0,0,0,186,30,47,9,362,0,0,0,448,634
56,90,6,91,0,65,0,0,0,162,41,37,5,301,0,0,0,384,546
56,91,6,79,1,46,0,0,0,132,27,21,6,235,0,0,0,289,421
56,92,6,47,1,48,0,0,0,102,17,14,5,249,0,0,0,285,387
56,93,4,43,0,45,0,0,0,92,23,15,3,232,0,0,0,273,365
56,94,1,19,1,27,0,0,0,48,16,8,4,145,0,0,0,173,221
56,95,0,21,0,25,0,0,0,46,11,4,1,110,0,0,0,126,172
56,96,2,9,0,14,0,0,0,25,7,4,2,90,0,0,0,103,128
56,97,1,10,0,12,0,0,0,23,10,1,0,78,0,0,0,89,112
56,98,0,3,0,6,0,0,0,9,5,0,0,43,0,0,0,48,57
56,99,0,1,0,7,0,0,0,8,4,0,3,34,0,0,0,41,49
56,100,0,1,0,8,0,0,0,9,10,0,1,60,0,0,0,71,80
56,999,32713,30302,3279,2145,42,2,2,68485,25628,29961,4204,10013,23,0,0,69829,138314
57,0,658,0,0,0,0,0,0,658,619,0,0,0,0,0,0,619,1277
57,1,716,0,0,0,0,0,0,716,666,0,0,0,0,0,0,666,1382
57,2,687,0,0,0,0,0,0,687,693,0,0,0,0,0,0,693,1380
57,3,699,0,0,0,0,0,0,699,690,0,0,0,0,0,0,690,1389
57,4,746,0,0,0,0,0,0,746,649,0,0,0,0,0,0,649,1395
57,5,767,0,0,0,0,0,0,767,739,0,0,0,0,0,0,739,1506
57,6,801,0,0,0,0,0,0,801,765,0,0,0,0,0,0,765,1566
57,7,821,0,0,0,0,0,0,821,763,0,0,0,0,0,0,763,1584
57,8,824,0,0,0,0,0,0,824,729,0,0,0,0,0,0,729,1553
57,9,863,0,0,0,0,0,0,863,817,0,0,0,0,0,0,817,1680
57,10,867,0,0,0,0,0,0,867,794,0,0,0,0,0,0,794,1661
57,11,917,0,0,0,0,0,0,917,897,0,0,0,0,0,0,897,1814
57,12,974,0,0,0,0,0,0,974,850,0,0,0,0,0,0,850,1824
57,13,983,0,0,0,0,0,0,983,931,0,0,0,0,0,0,931,1914
57,14,967,0,0,0,0,0,0,967,916,0,0,0,0,0,0,916,1883
57,15,1028,0,0,0,0,0,0,1028,898,0,0,0,0,0,0,898,1926
57,16,1000,0,0,0,0,0,0,1000,969,0,0,0,0,0,0,969,1969
57,17,963,0,0,0,0,0,0,963,970,0,0,0,0,0,0,970,1933
57,18,1071,0,0,0,0,0,0,1071,876,1,0,0,0,0,0,877,1948
57,19,1113,1,0,0,0,0,0,1114,953,2,0,0,0,0,0,955,2069
57,20,1069,1,0,0,0,0,0,1070,918,8,0,0,0,0,0,926,1996
57,21,1070,1,0,0,0,0,0,1071,901,16,0,0,0,0,0,917,1988
57,22,1090,11,0,0,0,0,0,1101,931,21,0,0,0,0,0,952,2053
57,23,1134,5,1,0,1,0,0,1141,975,27,0,0,0,0,0,1002,2143
57,24,1114,13,0,0,0,0,0,1127,949,42,1,0,0,0,0,992,2119
57,25,1125,28,0,0,0,0,0,1153,928,59,3,0,0,0,0,990,2143
57,26,1215,47,1,0,0,0,0,1263,907,80,0,0,0,0,0,987,2250
57,27,1178,56,2,0,1,0,0,1237,958,138,6,1,2,0,0,1105,2342
57,28,1103,79,4,0,0,0,0,1186,890,135,10,0,1,0,0,1036,2222
57,29,1072,101,4,0,1,0,0,1178,875,209,4,1,0,0,0,1089,2267
57,30,1097,164,2,0,1,0,0,1264,832,248,8,0,1,0,0,1089,2353
57,31,1099,199,7,0,1,0,0,1306,824,328,15,1,0,0,0,1168,2474
57,32,1052,267,10,0,3,0,0,1332,776,371,24,2,3,0,0,1176,2508
57,33,1002,273,12,2,4,0,0,1293,770,416,27,3,1,0,0,1217,2510
57,34,941,346,20,0,1,0,0,1308,666,461,31,1,2,0,0,1161,2469
57,35,913,384,23,0,4,0,0,1324,680,496,33,4,4,0,0,1217,2541
57,36,805,412,28,2,5,0,0,1252,625,504,51,1,1,0,0,1182,2434
57,37,785,454,23,1,1,0,0,1264,536,557,51,3,2,0,0,1149,2413
57,38,698,508,28,4,0,0,0,1238,552,587,55,6,3,0,0,1203,2441
57,39,702,492,43,2,4,0,0,1243,491,656,67,4,1,0,0,1219,2462
57,40,643,531,34,2,4,0,0,1214,458,580,62,7,3,0,0,1110,2324
57,41,624,547,40,1,3,0,0,1215,487,623,64,7,4,0,0,1185,2400
57,42,568,562,52,7,1,0,0,1190,423,620,75,13,3,0,0,1134,2324
57,43,591,594,43,5,6,0,0,1239,470,656,94,16,1,0,0,1237,2476
57,44,572,566,54,4,4,0,0,1200,441,673,102,13,2,0,0,1231,2431
57,45,645,664,71,2,0,0,0,1382,493,735,127,28,2,1,0,1386,2768
57,46,635,730,84,2,3,0,0,1454,466,831,135,24,3,0,0,1459,2913
57,47,639,790,98,11,7,0,0,1545,513,956,167,27,3,0,0,1666,3211
57,48,629,833,112,9,6,0,0,1589,515,1008,180,29,1,0,0,1733,3322
57,49,723,922,139,9,7,0,0,1800,523,1012,193,44,3,0,0,1775,3575
57,50,620,986,138,10,0,0,0,1754,521,1079,229,36,5,0,1,1871,3625
57,51,729,1027,164,9,3,0,0,1932,490,1119,229,37,4,0,0,1879,3811
57,52,679,982,164,10,4,0,0,1839,474,1160,249,57,2,0,0,1942,3781
57,53,628,1018,175,16,4,0,0,1841,474,1120,275,63,4,0,0,1936,3777
57,54,609,998,195,8,6,0,0,1816,370,1118,276,58,6,0,0,1828,3644
57,55,528,1069,198,15,3,0,0,1813,372,1146,290,73,1,0,0,1882,3695
57,56,529,1038,185,25,3,0,0,1780,354,1192,329,60,1,0,0,1936,3716
57,57,517,1157,225,14,2,0,0,1915,348,1230,322,96,0,0,0,1996,3911
57,58,465,1180,257,20,2,0,0,1924,352,1303,340,86,1,0,0,2082,4006
57,59,470,1204,250,34,5,0,0,1963,317,1238,310,117,3,0,0,1985,3948
57,60,401,1173,237,36,9,0,1,1857,305,1179,281,123,2,0,0,1890,3747
57,61,333,1105,230,26,3,0,0,1697,237,1143,293,144,2,0,0,1819,3516
57,62,328,1179,203,32,2,0,0,1744,223,1083,291,139,1,0,0,1737,3481
57,63,269,1091,208,36,4,0,0,1608,205,1041,260,176,2,0,0,1684,3292
57,64,269,1065,190,33,0,0,0,1557,186,1038,259,178,1,0,0,1662,3219
57,65,229,992,167,50,1,0,0,1439,167,1018,257,184,0,0,0,1626,3065
57,66,211,970,156,48,3,0,0,1388,182,972,251,218,0,0,0,1623,3011
57,67,196,1009,197,60,3,0,0,1465,117,933,230,239,0,0,0,1519,2984
57,68,171,965,159,54,1,0,0,1350,134,944,209,252,0,0,0,1539,2889
57,69,163,899,153,65,1,0,0,1281,111,863,202,290,2,0,0,1468,2749
57,70,121,885,130,55,0,0,0,1191,124,902,156,280,0,0,0,1462,2653
57,71,108,910,122,79,2,0,0,1221,101,906,165,294,1,0,0,1467,2688
57,72,117,854,119,72,2,0,0,1164,87,827,171,363,0,0,0,1448,2612
57,73,121,929,110,86,1,0,0,1247,108,918,175,451,0,0,0,1652,2899
57,74,82,938,125,109,0,0,0,1254,83,838,156,454,0,0,0,1531,2785
57,75,106,1032,98,110,0,0,0,1346,100,859,169,510,1,0,0,1639,2985
57,76,88,1001,94,124,0,0,0,1307,92,899,166,590,0,0,0,1747,3054
57,77,106,1010,85,131,0,0,0,1332,91,849,153,608,0,0,0,1701,3033
57,78,63,629,76,99,1,0,0,868,53,538,103,461,0,0,0,1155,2023
57,79,62,713,62,123,0,0,0,960,80,594,103,620,0,0,0,1397,2357
57,80,53,745,55,138,1,0,0,992,59,574,99,617,0,0,0,1349,2341
57,81,63,732,56,133,0,0,1,985,84,545,114,636,0,0,0,1379,2364
57,82,51,699,49,166,1,0,0,966,78,507,99,737,0,0,0,1421,2387
57,83,54,677,46,204,0,0,0,981,78,462,97,821,0,0,0,1458,2439
57,84,39,592,33,167,0,0,0,831,65,406,81,791,0,0,0,1343,2174
57,85,30,562,31,180,1,0,0,804,55,304,66,786,0,0,0,1211,2015
57,86,33,459,25,166,1,0,0,684,41,239,49,753,0,0,0,1082,1766
57,87,20,348,19,131,1,0,0,519,66,167,46,686,0,0,0,965,1484
57,88,27,290,10,135,0,0,0,462,52,142,33,651,0,0,0,878,1340
57,89,14,224,14,104,0,0,0,356,40,79,30,596,0,0,0,745,1101
57,90,13,172,8,103,0,0,0,296,34,73,22,487,0,0,0,616,912
57,91,3,142,6,100,0,0,0,251,40,55,25,457,0,0,0,577,828
57,92,13,101,7,86,0,0,0,207,40,30,17,404,0,0,0,491,698
57,93,8,86,5,55,0,0,0,154,24,23,12,366,0,0,0,425,579
57,94,3,44,1,39,0,0,0,87,25,17,11,295,0,0,0,348,435
57,95,5,31,0,33,0,0,0,69,20,6,5,185,0,0,0,216,285
57,96,2,13,1,26,0,0,0,42,7,6,3,156,0,0,0,172,214
57,97,2,12,0,20,0,0,0,34,8,4,0,143,0,0,0,155,189
57,98,0,7,1,13,0,0,0,21,13,4,1,96,0,0,0,114,135
57,99,1,3,0,4,0,0,0,8,2,1,0,55,0,0,0,58,66
57,100,2,11,4,11,0,0,0,28,7,1,5,122,0,0,0,135,163
57,999,53752,46539,6178,3666,138,0,2,110275,44653,46750,9299,17332,85,1,1,118121,228396
58,0,1053,0,0,0,0,0,0,1053,962,0,0,0,0,0,0,962,2015
58,1,1002,0,0,0,0,0,0,1002,981,0,0,0,0,0,0,981,1983
58,2,959,0,0,0,0,0,0,959,926,0,0,0,0,0,0,926,1885
58,3,1049,0,0,0,0,0,0,1049,978,0,0,0,0,0,0,978,2027
58,4,1090,0,0,0,0,0,0,1090,1095,0,0,0,0,0,0,1095,2185
58,5,1199,0,0,0,0,0,0,1199,1073,0,0,0,0,0,0,1073,2272
58,6,1176,0,0,0,0,0,0,1176,1039,0,0,0,0,0,0,1039,2215
58,7,1235,0,0,0,0,0,0,1235,1128,0,0,0,0,0,0,1128,2363
58,8,1233,0,0,0,0,0,0,1233,1177,0,0,0,0,0,0,1177,2410
58,9,1333,0,0,0,0,0,0,1333,1181,0,0,0,0,0,0,1181,2514
58,10,1250,0,0,0,0,0,0,1250,1252,0,0,0,0,0,0,1252,2502
58,11,1332,0,0,0,0,0,0,1332,1230,0,0,0,0,0,0,1230,2562
58,12,1271,0,0,0,0,0,0,1271,1216,0,0,0,0,0,0,1216,2487
58,13,1368,0,0,0,0,0,0,1368,1232,0,0,0,0,0,0,1232,2600
58,14,1380,0,0,0,0,0,0,1380,1296,0,0,0,0,0,0,1296,2676
58,15,1351,0,0,0,0,0,0,1351,1233,0,0,0,0,0,0,1233,2584
58,16,1374,0,0,0,0,0,0,1374,1262,0,0,0,0,0,0,1262,2636
58,17,1321,0,0,0,0,0,0,1321,1323,0,0,0,0,0,0,1323,2644
58,18,1325,0,0,0,0,0,0,1325,1285,2,0,0,0,0,0,1287,2612
58,19,1362,2,0,0,0,0,0,1364,1264,10,0,0,0,0,0,1274,2638
58,20,1392,0,0,0,0,0,0,1392,1225,23,0,0,0,0,0,1248,2640
58,21,1417,6,0,0,0,0,0,1423,1233,30,0,0,0,0,0,1263,2686
58,22,1404,15,0,0,0,0,0,1419,1190,51,0,0,0,0,0,1241,2660
58,23,1461,21,2,0,0,0,0,1484,1234,102,6,0,0,0,0,1342,2826
58,24,1488,37,2,0,0,0,0,1527,1158,134,1,0,1,0,0,1294,2821
58,25,1533,69,5,0,0,0,0,1607,1172,173,4,0,0,0,0,1349,2956
58,26,1580,90,0,0,0,0,0,1670,1171,234,5,0,0,0,0,1410,3080
58,27,1399,123,8,0,0,0,0,1530,1098,259,9,1,0,0,0,1367,2897
58,28,1393,151,10,0,1,0,0,1555,1021,403,12,0,0,0,0,1436,2991
58,29,1323,213,10,0,0,0,0,1546,992,427,15,0,1,0,0,1435,2981
58,30,1294,266,5,0,1,0,0,1566,931,512,23,1,0,0,0,1467,3033
58,31,1256,364,8,0,1,0,0,1629,954,601,15,1,1,0,0,1572,3201
58,32,1201,448,10,1,3,0,0,1663,823,654,25,3,2,1,0,1508,3171
58,33,1139,534,17,0,0,1,0,1691,780,778,28,0,5,0,0,1591,3282
58,34,1056,568,15,2,6,0,0,1647,700,795,43,2,5,0,0,1545,3192
58,35,1001,612,17,0,3,0,0,1633,640,817,39,7,5,0,0,1508,3141
58,36,898,676,23,0,4,1,0,1602,642,880,56,9,3,0,0,1590,3192
58,37,825,700,30,0,3,0,0,1558,591,906,57,9,2,0,0,1565,3123
58,38,789,739,38,4,0,0,0,1570,539,962,60,15,2,0,0,1578,3148
58,39,810,874,41,5,3,0,0,1733,531,978,63,9,1,0,0,1582,3315
58,40,777,819,46,0,4,0,0,1646,504,951,66,13,6,0,0,1540,3186
58,41,779,908,60,3,3,0,0,1753,505,978,93,11,3,0,0,1590,3343
58,42,706,932,61,3,7,1,0,1710,476,1073,80,18,3,0,0,1650,3360
58,43,698,949,78,7,2,0,0,1734,470,1092,115,24,0,0,0,1701,3435
58,44,741,1013,64,6,3,0,0,1827,479,1113,125,27,3,0,0,1747,3574
58,45,760,1088,59,7,4,0,0,1918,546,1234,123,16,1,1,0,1921,3839
58,46,738,1063,94,15,2,1,0,1913,528,1252,141,18,1,0,0,1940,3853
58,47,749,1287,109,15,2,0,0,2162,515,1259,160,28,0,0,0,1962,4124
58,48,787,1282,129,13,2,0,0,2213,545,1392,172,40,2,0,0,2151,4364
58,49,783,1432,139,12,4,0,0,2370,559,1504,193,53,0,0,0,2309,4679
58,50,739,1344,123,14,2,0,0,2222,538,1546,211,54,1,1,0,2351,4573
58,51,674,1419,155,12,5,0,0,2265,493,1514,185,66,4,0,0,2262,4527
58,52,640,1475,164,7,1,0,0,2287,486,1524,230,73,1,0,0,2314,4601
58,53,664,1429,182,17,4,0,0,2296,438,1584,212,62,0,0,0,2296,4592
58,54,605,1543,192,11,3,0,0,2354,450,1572,215,93,0,0,0,2330,4684
58,55,628,1529,191,19,6,0,0,2373,408,1602,236,105,2,0,0,2353,4726
58,56,585,1637,175,21,2,0,1,2421,382,1537,245,107,1,0,0,2272,4693
58,57,512,1633,176,25,4,0,0,2350,358,1692,237,131,0,0,0,2418,4768
58,58,539,1598,204,23,3,0,1,2368,319,1651,220,143,1,0,0,2334,4702
58,59,451,1644,205,32,5,0,0,2337,351,1588,223,170,0,0,0,2332,4669
58,60,404,1591,163,25,4,0,0,2187,323,1578,224,159,0,0,0,2284,4471
58,61,358,1495,190,23,3,0,1,2070,284,1512,221,144,0,0,0,2161,4231
58,62,355,1526,169,50,2,0,0,2102,239,1515,183,172,2,0,1,2112,4214
58,63,313,1484,147,52,0,0,0,1996,222,1450,202,197,1,0,0,2072,4068
58,64,280,1409,159,53,4,0,1,1906,214,1383,149,213,2,0,0,1961,3867
58,65,262,1442,139,61,0,0,0,1904,190,1302,174,238,0,0,0,1904,3808
58,66,282,1355,139,57,2,0,0,1835,207,1302,149,225,0,0,0,1883,3718
58,67,223,1373,141,63,2,0,0,1802,160,1304,141,270,1,0,0,1876,3678
58,68,210,1271,106,74,3,0,0,1664,163,1267,127,294,1,0,0,1852,3516
58,69,186,1220,121,89,2,0,0,1618,150,1157,110,316,0,0,0,1733,3351
58,70,174,1142,77,68,0,0,0,1461,140,1011,107,336,1,0,0,1595,3056
58,71,155,1127,87,77,1,0,0,1447,127,1023,95,320,0,1,0,1566,3013
58,72,163,1071,66,87,0,0,0,1387,111,904,92,378,0,0,0,1485,2872
58,73,161,1146,70,101,1,0,0,1479,95,1004,96,423,0,0,0,1618,3097
58,74,162,1141,70,98,1,0,1,1473,116,955,73,495,0,0,0,1639,3112
58,75,155,1099,54,119,0,0,0,1427,96,993,86,540,0,0,0,1715,3142
58,76,193,1093,67,125,2,0,0,1480,103,882,83,563,0,0,0,1631,3111
58,77,154,1109,64,144,0,0,0,1471,102,931,54,633,0,0,0,1720,3191
58,78,104,733,44,108,0,0,0,989,73,641,46,544,0,0,0,1304,2293
58,79,104,807,45,128,0,0,0,1084,83,623,47,614,0,0,0,1367,2451
58,80,107,761,34,147,1,1,0,1051,86,575,51,643,0,0,0,1355,2406
58,81,121,794,23,142,2,0,0,1082,101,522,26,718,1,0,0,1368,2450
58,82,118,704,23,150,1,1,0,997,86,503,29,737,0,0,0,1355,2352
58,83,106,711,17,176,0,0,0,1010,97,416,28,815,0,1,0,1357,2367
58,84,95,603,14,191,0,0,0,903,94,378,27,844,0,0,0,1343,2246
58,85,88,537,16,186,0,0,0,827,66,332,26,895,0,0,0,1319,2146
58,86,77,447,12,189,0,0,0,725,67,209,19,791,0,0,0,1086,1811
58,87,69,337,9,119,0,0,0,534,56,157,17,701,0,0,0,931,1465
58,88,56,314,7,146,0,0,0,523,51,120,8,689,0,0,0,868,1391
58,89,37,258,4,130,0,0,0,429,61,104,9,616,0,0,0,790,1219
58,90,31,173,10,114,0,0,0,328,45,78,7,561,0,0,0,691,1019
58,91,35,133,2,86,0,0,0,256,42,51,5,519,0,0,0,617,873
58,92,21,114,3,80,0,0,0,218,38,30,6,420,0,0,0,494,712
58,93,20,98,3,80,0,0,0,201,31,16,4,420,0,0,0,471,672
58,94,13,59,0,59,0,0,0,131,27,11,4,283,0,0,0,325,456
58,95,12,37,0,27,0,0,0,76,18,7,2,219,0,0,0,246,322
58,96,3,13,0,39,0,0,0,55,20,6,0,183,0,0,0,209,264
58,97,2,15,0,23,0,0,0,40,13,4,1,124,0,0,0,142,182
58,98,4,6,0,10,0,0,0,20,15,0,0,84,0,0,0,99,119
58,99,2,3,0,7,0,0,0,12,9,1,4,63,0,0,0,77,89
58,100,3,3,0,16,0,0,0,22,13,1,0,94,0,0,0,108,130
58,999,68295,63286,5142,3993,124,6,5,140851,55342,63647,6675,18802,66,5,1,144538,285389
59,0,1676,0,0,0,0,0,0,1676,1526,0,0,0,0,0,0,1526,3202
59,1,1669,0,0,0,0,0,0,1669,1567,0,0,0,0,0,0,1567,3236
59,2,1782,0,0,0,0,0,0,1782,1633,0,0,0,0,0,0,1633,3415
59,3,1752,0,0,0,0,0,0,1752,1661,0,0,0,0,0,0,1661,3413
59,4,1855,0,0,0,0,0,0,1855,1743,0,0,0,0,0,0,1743,3598
59,5,1899,0,0,0,0,0,0,1899,1724,0,0,0,0,0,0,1724,3623
59,6,1955,0,0,0,0,0,0,1955,1807,0,0,0,0,0,0,1807,3762
59,7,2009,0,0,0,0,0,0,2009,1917,0,0,0,0,0,0,1917,3926
59,8,2072,0,0,0,0,0,0,2072,1917,0,0,0,0,0,0,1917,3989
59,9,2075,0,0,0,0,0,0,2075,1972,0,0,0,0,0,0,1972,4047
59,10,2150,0,0,0,0,0,0,2150,1920,0,0,0,0,0,0,1920,4070
59,11,2126,0,0,0,0,0,0,2126,1990,0,0,0,0,0,0,1990,4116
59,12,2139,0,0,0,0,0,0,2139,2054,0,0,0,0,0,0,2054,4193
59,13,2278,0,0,0,0,0,0,2278,2122,0,0,0,0,0,0,2122,4400
59,14,2258,0,0,0,0,0,0,2258,2183,0,0,0,0,0,0,2183,4441
59,15,2280,0,0,0,0,0,0,2280,2053,0,0,0,0,0,0,2053,4333
59,16,2337,0,0,0,0,0,0,2337,2071,0,0,0,0,0,0,2071,4408
59,17,2190,0,0,0,0,0,0,2190,2021,0,0,0,0,0,0,2021,4211
59,18,2242,0,0,0,0,0,0,2242,2058,1,0,0,0,0,0,2059,4301
59,19,2198,1,0,0,0,0,0,2199,2004,10,0,0,0,0,0,2014,4213
59,20,2226,3,0,0,0,0,0,2229,1904,20,0,0,0,0,0,1924,4153
59,21,2183,4,0,0,0,0,0,2187,1938,33,0,0,0,0,0,1971,4158
59,22,2230,10,1,0,0,0,0,2241,1969,62,3,0,0,0,0,2034,4275
59,23,2391,11,2,0,0,0,0,2404,1967,98,3,0,0,0,0,2068,4472
59,24,2286,34,4,0,0,0,0,2324,2096,153,7,0,0,0,0,2256,4580
59,25,2436,60,7,0,1,0,0,2504,1964,190,6,0,0,0,0,2160,4664
59,26,2501,100,7,0,2,0,0,2610,2023,253,8,1,0,0,0,2285,4895
59,27,2411,137,8,0,1,0,0,2557,1859,341,9,1,1,0,0,2211,4768
59,28,2390,222,12,0,2,0,0,2626,1862,448,11,1,0,1,0,2323,4949
59,29,2268,267,10,0,0,0,0,2545,1763,559,10,0,2,0,0,2334,4879
59,30,2248,392,10,0,2,0,0,2652,1711,686,14,2,4,1,0,2418,5070
59,31,2291,496,27,0,4,0,0,2818,1706,835,23,4,3,0,0,2571,5389
59,32,2168,601,18,2,1,0,0,2790,1603,988,38,2,4,0,0,2635,5425
59,33,2050,660,28,3,2,0,0,2743,1575,1139,38,4,4,0,0,2760,5503
59,34,1915,862,18,1,1,0,0,2797,1392,1181,57,4,3,1,0,2638,5435
59,35,1736,976,40,4,5,1,0,2762,1289,1344,60,9,9,0,0,2711,5473
59,36,1528,1084,35,3,3,0,0,2653,1229,1405,70,3,5,0,0,2712,5365
59,37,1529,1178,41,5,3,0,0,2756,1087,1480,92,23,4,0,0,2686,5442
59,38,1513,1249,39,3,3,0,0,2807,1078,1525,103,9,9,0,0,2724,5531
59,39,1410,1372,71,6,1,0,0,2860,992,1579,123,20,5,0,0,2719,5579
59,40,1386,1375,72,1,7,0,0,2841,1018,1681,132,25,9,0,0,2865,5706
59,41,1324,1552,84,3,3,0,0,2966,1003,1745,140,20,3,0,0,2911,5877
59,42,1177,1590,96,9,5,0,0,2877,948,1701,147,27,7,0,0,2830,5707
59,43,1234,1633,105,11,6,0,0,2989,900,1761,178,27,4,1,0,2871,5860
59,44,1266,1668,135,17,3,0,1,3090,920,1886,205,35,8,0,0,3054,6144
59,45,1345,1719,137,20,7,0,0,3228,964,1973,185,37,4,1,0,3164,6392
59,46,1271,1866,153,11,4,0,0,3305,895,2074,226,48,5,1,0,3249,6554
59,47,1286,1985,184,17,5,0,0,3477,918,2137,254,55,2,2,0,3368,6845
59,48,1262,2200,205,14,4,0,0,3685,929,2327,291,56,5,0,0,3608,7293
59,49,1255,2220,200,16,11,0,0,3702,882,2390,316,75,11,0,0,3674,7376
59,50,1157,2261,223,19,4,0,0,3664,966,2325,332,75,6,0,0,3704,7368
59,51,1186,2277,234,21,4,0,0,3722,790,2445,383,75,1,0,0,3694,7416
59,52,1027,2286,290,26,6,0,0,3635,807,2443,386,100,1,0,0,3737,7372
59,53,1046,2384,259,28,11,0,0,3728,740,2381,399,117,2,0,0,3639,7367
59,54,973,2458,291,22,3,0,0,3747,717,2485,421,108,4,0,0,3735,7482
59,55,1005,2468,288,27,10,0,0,3798,672,2453,442,132,3,0,0,3702,7500
59,56,836,2456,325,35,7,0,0,3659,624,2577,416,150,4,0,0,3771,7430
59,57,811,2484,352,42,3,0,0,3692,636,2468,416,184,4,0,1,3709,7401
59,58,753,2505,331,48,5,0,0,3642,590,2479,392,179,4,0,0,3644,7286
59,59,682,2593,344,37,6,0,0,3662,512,2503,420,212,1,0,0,3648,7310
59,60,589,2397,305,47,7,0,0,3345,467,2375,392,208,2,0,0,3444,6789
59,61,472,2316,298,52,8,0,0,3146,435,2307,373,230,1,0,0,3346,6492
59,62,495,2249,282,80,4,0,0,3110,404,2117,320,289,1,0,0,3131,6241
59,63,422,2198,273,82,3,0,0,2978,407,2027,303,311,0,0,0,3048,6026
59,64,401,2075,242,61,2,0,0,2781,349,2101,243,312,1,0,0,3006,5787
59,65,336,1991,219,81,2,0,0,2629,333,1898,277,341,2,0,0,2851,5480
59,66,348,1921,197,74,3,0,0,2543,271,1926,235,359,0,0,0,2791,5334
59,67,298,1902,171,95,2,0,0,2468,255,1823,261,405,1,0,0,2745,5213
59,68,276,1854,177,95,6,0,0,2408,249,1735,229,406,2,0,0,2621,5029
59,69,213,1808,134,105,0,0,0,2260,218,1719,202,457,0,0,0,2596,4856
59,70,228,1710,139,109,1,0,0,2187,174,1592,192,446,0,0,0,2404,4591
59,71,192,1641,120,140,3,0,0,2096,150,1573,146,482,0,0,0,2351,4447
59,72,201,1578,121,133,2,0,0,2035,159,1505,152,530,1,0,0,2347,4382
59,73,184,1707,112,134,1,0,1,2139,179,1593,150,656,0,0,0,2578,4717
59,74,187,1616,118,142,2,0,1,2066,179,1514,130,651,0,0,0,2474,4540
59,75,192,1892,93,192,1,0,0,2370,158,1521,130,735,0,0,0,2544,4914
59,76,196,1768,94,214,3,0,0,2275,143,1432,128,843,0,0,0,2546,4821
59,77,181,1661,69,206,1,0,0,2118,142,1326,133,911,0,0,0,2512,4630
59,78,138,1136,56,164,0,0,0,1494,82,999,71,735,0,0,0,1887,3381
59,79,135,1269,52,206,0,0,0,1662,125,1002,72,845,0,0,0,2044,3706
59,80,134,1128,40,206,0,0,0,1508,101,870,65,915,0,1,0,1952,3460
59,81,140,1107,35,208,2,0,0,1492,105,817,67,932,0,0,0,1921,3413
59,82,128,1043,52,235,0,0,0,1458,118,783,49,1042,0,0,0,1992,3450
59,83,131,1081,42,236,0,0,0,1490,105,730,46,1222,0,0,0,2103,3593
59,84,142,971,26,251,0,0,0,1390,110,609,53,1185,0,0,0,1957,3347
59,85,96,909,25,263,0,0,0,1293,116,534,48,1193,0,0,0,1891,3184
59,86,98,737,21,286,0,0,0,1142,103,378,38,1019,0,0,0,1538,2680
59,87,77,533,9,198,0,0,0,817,65,292,26,985,0,0,0,1368,2185
59,88,69,491,4,215,0,0,0,779,84,219,18,1016,0,0,0,1337,2116
59,89,54,402,9,180,0,0,0,645,69,167,14,930,0,0,0,1180,1825
59,90,42,279,5,164,0,0,0,490,54,127,13,789,0,0,0,983,1473
59,91,37,240,4,122,0,0,0,403,49,83,11,737,0,0,0,880,1283
59,92,28,169,4,110,0,0,0,311,43,57,8,621,0,0,0,729,1040
59,93,17,123,1,113,0,0,0,254,36,42,7,517,0,0,0,602,856
59,94,9,81,2,81,0,0,0,173,27,18,7,441,0,0,0,493,666
59,95,10,50,0,55,0,0,0,115,20,10,2,314,0,0,0,346,461
59,96,6,32,1,45,0,0,0,84,26,7,1,255,0,0,0,289,373
59,97,11,15,0,20,0,0,0,46,12,8,1,175,0,0,0,196,242
59,98,1,11,0,18,0,0,0,30,12,0,2,139,0,0,0,153,183
59,99,3,4,0,25,0,0,0,32,8,3,0,96,0,0,0,107,139
59,100,2,5,0,23,0,0,0,30,13,3,3,167,0,0,0,186,216
59,999,111853,97799,8238,5917,198,1,3,224009,93536,98406,11374,26662,152,9,1,230140,454149
60,0,1827,0,0,0,0,0,0,1827,1748,0,0,0,0,0,0,1748,3575
60,1,1870,0,0,0,0,0,0,1870,1848,0,0,0,0,0,0,1848,3718
60,2,1977,0,0,0,0,0,0,1977,1888,0,0,0,0,0,0,1888,3865
60,3,2048,0,0,0,0,0,0,2048,1875,0,0,0,0,0,0,1875,3923
60,4,2045,0,0,0,0,0,0,2045,2003,0,0,0,0,0,0,2003,4048
60,5,2095,0,0,0,0,0,0,2095,2005,0,0,0,0,0,0,2005,4100
60,6,2277,0,0,0,0,0,0,2277,2079,0,0,0,0,0,0,2079,4356
60,7,2328,0,0,0,0,0,0,2328,2226,0,0,0,0,0,0,2226,4554
60,8,2500,0,0,0,0,0,0,2500,2334,0,0,0,0,0,0,2334,4834
60,9,2402,0,0,0,0,0,0,2402,2378,0,0,0,0,0,0,2378,4780
60,10,2631,0,0,0,0,0,0,2631,2430,0,0,0,0,0,0,2430,5061
60,11,2749,0,0,0,0,0,0,2749,2444,0,0,0,0,0,0,2444,5193
60,12,2620,0,0,0,0,0,0,2620,2658,0,0,0,0,0,0,2658,5278
60,13,2882,0,0,0,0,0,0,2882,2669,0,0,0,0,0,0,2669,5551
60,14,2862,0,0,0,0,0,0,2862,2656,0,0,0,0,0,0,2656,5518
60,15,2813,0,0,0,0,0,0,2813,2726,0,0,0,0,0,0,2726,5539
60,16,2903,0,0,0,0,0,0,2903,2615,0,0,0,0,0,0,2615,5518
60,17,2827,0,0,0,0,0,0,2827,2660,0,0,0,0,0,0,2660,5487
60,18,2885,0,0,0,0,0,0,2885,2597,1,0,0,0,0,0,2598,5483
60,19,2881,0,0,0,0,0,0,2881,2625,5,0,0,0,0,0,2630,5511
60,20,2827,1,0,0,0,0,0,2828,2478,11,0,0,0,0,0,2489,5317
60,21,2911,6,0,0,0,0,0,2917,2470,30,0,0,0,0,0,2500,5417
60,22,2817,10,4,0,0,0,0,2831,2408,55,0,0,0,0,0,2463,5294
60,23,2900,20,0,1,0,0,0,2921,2411,99,1,0,0,0,0,2511,5432
60,24,2855,41,2,0,0,0,0,2898,2379,137,3,0,2,0,0,2521,5419
60,25,2944,77,2,0,0,0,0,3023,2336,263,4,1,1,0,0,2605,5628
60,26,2730,102,1,0,0,0,0,2833,2314,334,3,0,3,0,0,2654,5487
60,27,2682,205,11,0,0,0,0,2898,2205,411,14,0,1,1,0,2632,5530
60,28,2631,244,2,0,1,0,0,2878,2032,548,16,0,4,0,0,2600,5478
60,29,2498,344,8,0,1,0,1,2852,1963,727,23,1,2,1,0,2717,5569
60,30,2524,446,20,1,0,0,0,2991,1866,847,18,0,4,0,0,2735,5726
60,31,2449,605,11,0,1,0,0,3066,1796,996,31,4,2,1,0,2830,5896
60,32,2222,742,18,4,2,0,0,2988,1651,1062,34,1,6,0,0,2754,5742
60,33,2205,854,25,1,4,1,0,3090,1605,1228,48,12,4,1,0,2898,5988
60,34,2008,933,28,1,5,0,0,2975,1468,1315,53,6,9,0,0,2851,5826
60,35,1959,1131,37,2,3,0,0,3132,1396,1483,55,5,9,0,0,2948,6080
60,36,1767,1227,40,2,4,0,0,3040,1270,1517,70,10,10,0,0,2877,5917
60,37,1758,1279,48,3,4,0,0,3092,1167,1530,106,7,7,0,0,2817,5909
60,38,1726,1397,66,6,3,0,0,3198,1163,1704,112,30,7,1,0,3017,6215
60,39,1628,1425,70,2,7,0,0,3132,1118,1863,141,26,6,1,0,3155,6287
60,40,1561,1544,85,1,8,0,0,3199,1073,1901,166,33,6,1,0,3180,6379
60,41,1501,1688,105,7,2,0,0,3303,1095,2084,150,22,9,1,0,3361,6664
60,42,1464,1751,111,13,2,0,0,3341,1014,2080,185,17,2,1,0,3299,6640
60,43,1533,1955,132,15,5,0,0,3640,1083,2058,175,46,4,0,0,3366,7006
60,44,1534,1880,162,12,8,0,0,3596,1016,2216,253,37,5,0,0,3527,7123
60,45,1559,2132,176,17,4,0,0,3888,1100,2435,289,47,8,2,0,3881,7769
60,46,1531,2287,195,19,13,0,0,4045,1091,2559,313,44,4,4,0,4015,8060
60,47,1526,2451,201,20,5,0,0,4203,1161,2709,341,58,11,0,0,4280,8483
60,48,1560,2514,261,14,9,0,0,4358,1062,2782,384,76,6,0,0,4310,8668
60,49,1543,2722,313,23,8,0,0,4609,1084,2887,369,79,7,1,0,4427,9036
60,50,1462,2797,286,25,5,0,0,4575,1037,2859,429,75,3,0,0,4403,8978
60,51,1397,2912,337,20,6,1,0,4673,935,2987,449,96,7,0,0,4474,9147
60,52,1312,2929,347,24,9,0,0,4621,895,2851,456,109,7,0,0,4318,8939
60,53,1159,2848,325,18,3,0,0,4353,842,2904,488,142,5,0,0,4381,8734
60,54,1147,2869,356,28,8,0,0,4408,807,2977,504,122,3,0,0,4413,8821
60,55,1030,2982,382,30,4,0,0,4428,747,2917,471,150,6,0,0,4291,8719
60,56,992,2843,365,40,5,0,0,4245,692,2851,474,175,2,0,0,4194,8439
60,57,909,2922,378,53,9,0,0,4271,680,2986,465,206,1,0,0,4338,8609
60,58,794,2949,356,46,7,0,0,4152,580,2892,463,221,6,0,0,4162,8314
60,59,705,3007,353,57,4,0,0,4126,570,2916,497,233,2,0,0,4218,8344
60,60,675,2762,375,62,4,0,0,3878,544,2661,432,246,4,0,0,3887,7765
60,61,610,2621,348,77,9,0,0,3665,501,2699,400,258,2,0,0,3860,7525
60,62,501,2583,309,61,1,0,0,3455,454,2559,392,275,4,0,0,3684,7139
60,63,468,2560,305,76,3,0,2,3414,359,2570,443,331,0,0,0,3703,7117
60,64,423,2507,273,71,4,0,0,3278,376,2375,378,368,2,0,0,3499,6777
60,65,354,2316,264,104,5,0,0,3043,341,2254,300,379,1,0,0,3275,6318
60,66,367,2360,244,94,2,1,0,3068,270,2342,278,409,1,0,0,3300,6368
60,67,301,2319,237,119,4,0,0,2980,257,2134,283,476,1,0,0,3151,6131
60,68,294,2249,194,91,6,0,0,2834,241,2068,254,509,0,0,0,3072,5906
60,69,261,2137,197,134,1,0,0,2730,207,2095,237,530,1,0,0,3070,5800
60,70,246,2044,179,112,1,0,0,2582,209,1938,211,528,1,0,0,2887,5469
60,71,217,1872,146,158,3,0,0,2396,187,1814,168,626,0,0,0,2795,5191
60,72,181,1964,126,153,3,0,0,2427,163,1824,164,618,1,0,0,2770,5197
60,73,191,1991,124,157,0,0,0,2463,147,1872,185,738,0,0,0,2942,5405
60,74,176,2051,131,165,0,0,1,2524,137,1755,167,798,0,0,0,2857,5381
60,75,202,2078,112,207,2,0,0,2601,167,1786,144,942,2,0,0,3041,5642
60,76,182,1997,92,211,0,0,0,2482,156,1689,155,889,1,0,0,2890,5372
60,77,138,1954,81,237,0,0,0,2410,128,1591,129,1046,0,0,0,2894,5304
60,78,102,1315,59,174,2,0,0,1652,95,1000,95,808,0,0,0,1998,3650
60,79,107,1413,55,218,0,0,0,1793,82,1046,85,965,0,0,0,2178,3971
60,80,119,1355,45,216,1,0,0,1736,80,959,76,989,0,0,0,2104,3840
60,81,119,1206,46,240,0,0,0,1611,81,914,49,1069,0,0,0,2113,3724
60,82,115,1183,50,252,2,0,0,1602,108,838,54,1098,0,0,0,2098,3700
60,83,111,1193,34,280,0,0,0,1618,111,765,45,1243,0,0,0,2164,3782
60,84,113,1070,22,271,0,0,0,1476,94,647,39,1294,0,0,0,2074,3550
60,85,91,981,24,297,0,0,0,1393,80,510,47,1256,0,0,0,1893,3286
60,86,81,741,19,261,0,0,0,1102,78,372,26,1185,0,0,0,1661,2763
60,87,60,580,10,235,0,0,0,885,58,299,25,1082,0,0,0,1464,2349
60,88,70,605,10,237,0,0,0,922,67,227,23,1092,0,0,0,1409,2331
60,89,61,433,14,218,0,0,0,726,51,136,14,1024,0,0,0,1225,1951
60,90,42,306,2,210,0,0,0,560,50,118,14,836,0,0,0,1018,1578
60,91,27,230,2,154,0,0,0,413,38,67,6,710,0,0,0,821,1234
60,92,39,167,4,152,0,0,0,362,44,44,5,642,0,0,0,735,1097
60,93,18,143,7,102,0,0,0,270,38,32,2,630,0,0,0,702,972
60,94,9,90,1,98,0,0,0,198,25,16,3,432,0,0,0,476,674
60,95,10,61,1,75,0,0,0,147,21,12,2,349,0,0,0,384,531
60,96,6,28,3,53,0,0,0,90,13,9,3,272,0,0,0,297,387
60,97,5,20,0,37,0,0,0,62,10,9,1,197,0,0,0,217,279
60,98,1,9,0,23,0,0,0,33,10,1,2,153,0,0,0,166,199
60,99,1,6,0,19,0,0,0,26,9,1,0,101,0,0,0,111,137
60,100,1,3,0,23,0,0,0,27,14,0,1,122,0,0,0,137,164
60,999,130777,114574,9764,6639,212,3,4,261973,108625,115065,13390,29606,202,16,0,266904,528877
61,0,2452,0,0,0,0,0,0,2452,2309,0,0,0,0,0,0,2309,4761
61,1,2694,0,0,0,0,0,0,2694,2486,0,0,0,0,0,0,2486,5180
61,2,2690,0,0,0,0,0,0,2690,2488,0,0,0,0,0,0,2488,5178
61,3,2708,0,0,0,0,0,0,2708,2398,0,0,0,0,0,0,2398,5106
61,4,2633,0,0,0,0,0,0,2633,2559,0,0,0,0,0,0,2559,5192
61,5,2885,0,0,0,0,0,0,2885,2711,0,0,0,0,0,0,2711,5596
61,6,3013,0,0,0,0,0,0,3013,2816,0,0,0,0,0,0,2816,5829
61,7,3157,0,0,0,0,0,0,3157,2896,0,0,0,0,0,0,2896,6053
61,8,3127,0,0,0,0,0,0,3127,2951,0,0,0,0,0,0,2951,6078
61,9,3177,0,0,0,0,0,0,3177,3022,0,0,0,0,0,0,3022,6199
61,10,3308,0,0,0,0,0,0,3308,3088,0,0,0,0,0,0,3088,6396
61,11,3512,0,0,0,0,0,0,3512,3296,0,0,0,0,0,0,3296,6808
61,12,3597,0,0,0,0,0,0,3597,3273,0,0,0,0,0,0,3273,6870
61,13,3633,0,0,0,0,0,0,3633,3463,0,0,0,0,0,0,3463,7096
61,14,3624,0,0,0,0,0,0,3624,3428,0,0,0,0,0,0,3428,7052
61,15,3753,0,0,0,0,0,0,3753,3426,0,0,0,0,0,0,3426,7179
61,16,3629,0,0,0,0,0,0,3629,3403,0,0,0,0,0,0,3403,7032
61,17,3561,0,0,0,0,0,0,3561,3331,0,0,0,0,0,0,3331,6892
61,18,3579,0,0,0,0,0,0,3579,3350,3,0,0,0,0,0,3353,6932
61,19,3623,5,0,0,0,0,0,3628,3259,9,0,0,0,0,0,3268,6896
61,20,3510,1,0,0,0,0,0,3511,3207,32,0,0,0,0,0,3239,6750
61,21,3616,3,0,0,0,0,0,3619,3177,49,1,0,0,0,0,3227,6846
61,22,3645,19,4,0,0,0,0,3668,3252,88,0,0,0,0,0,3340,7008
61,23,3748,33,2,0,0,0,0,3783,3211,172,5,0,0,0,0,3388,7171
61,24,3706,45,5,0,1,0,0,3757,3135,214,6,0,0,0,0,3355,7112
61,25,3835,102,4,1,1,0,0,3943,2998,294,6,0,0,0,0,3298,7241
61,26,3754,149,2,0,0,0,0,3905,3024,429,3,0,1,0,0,3457,7362
61,27,3685,193,10,0,1,0,0,3889,2870,533,9,2,2,0,0,3416,7305
61,28,3599,340,5,0,1,0,0,3945,2709,690,19,3,3,0,0,3424,7369
61,29,3584,428,8,0,1,0,0,4021,2650,879,17,0,2,0,0,3548,7569
61,30,3459,603,15,0,1,0,0,4078,2533,1084,27,1,1,0,0,3646,7724
61,31,3459,769,15,0,3,0,1,4247,2517,1276,23,3,3,1,0,3823,8070
61,32,3223,877,30,3,8,0,0,4141,2347,1431,47,5,6,0,0,3836,7977
61,33,3148,1108,21,2,10,0,0,4289,2189,1679,38,8,6,0,0,3920,8209
61,34,2905,1196,44,6,5,1,1,4158,2102,1772,77,6,5,0,0,3962,8120
61,35,2784,1386,38,2,5,0,0,4215,1863,1941,63,12,8,1,0,3888,8103
61,36,2481,1528,42,0,6,0,0,4057,1845,2010,95,5,9,0,0,3964,8021
61,37,2312,1598,68,3,8,0,0,3989,1569,2163,109,12,9,0,0,3862,7851
61,38,2252,1745,70,4,3,0,0,4074,1696,2223,119,16,5,3,0,4062,8136
61,39,2214,1915,92,2,2,0,0,4225,1589,2381,167,15,7,2,0,4161,8386
61,40,2130,2101,102,4,2,0,0,4339,1442,2529,174,21,3,1,0,4170,8509
61,41,2166,2147,106,7,5,0,0,4431,1479,2475,207,32,3,0,0,4196,8627
61,42,2020,2219,126,9,2,0,0,4376,1456,2640,202,38,2,0,0,4338,8714
61,43,1953,2475,148,19,6,2,0,4603,1481,2745,262,52,4,0,0,4544,9147
61,44,1929,2528,158,19,4,0,0,4638,1457,2826,289,44,5,0,0,4621,9259
61,45,2038,2706,213,16,8,0,0,4981,1536,2938,310,63,9,0,0,4856,9837
61,46,2071,2865,241,22,4,0,0,5203,1552,3133,392,70,2,0,0,5149,10352
61,47,2093,2912,256,27,5,0,0,5293,1574,3324,385,76,6,0,0,5365,10658
61,48,2056,3335,323,26,4,0,0,5744,1573,3519,443,72,1,0,0,5608,11352
61,49,2295,3433,314,30,2,0,0,6074,1585,3600,518,108,4,3,0,5818,11892
61,50,2056,3571,367,28,6,1,0,6029,1479,3755,508,123,11,1,0,5877,11906
61,51,1879,3636,402,33,9,1,0,5960,1428,3762,550,102,6,2,0,5850,11810
61,52,1794,3667,439,34,8,0,0,5942,1390,3802,615,141,6,0,0,5954,11896
61,53,1622,3559,463,38,13,0,0,5695,1292,3601,588,155,4,0,0,5640,11335
61,54,1603,3688,470,39,8,0,0,5808,1210,3797,566,150,5,0,0,5728,11536
61,55,1452,3735,483,49,5,0,0,5724,1107,3673,648,183,1,0,0,5612,11336
61,56,1341,3725,535,47,9,0,0,5657,1052,3792,624,201,2,0,0,5671,11328
61,57,1271,3729,500,60,7,0,0,5567,1035,3715,649,245,0,0,1,5645,11212
61,58,1121,3834,487,66,4,1,0,5513,979,3687,617,289,2,0,0,5574,11087
61,59,1076,3864,489,78,2,0,0,5509,874,3844,623,273,0,0,0,5614,11123
61,60,914,3741,465,90,7,0,0,5217,880,3707,583,278,5,0,0,5453,10670
61,61,858,3484,442,90,3,0,0,4877,798,3551,535,306,2,0,0,5192,10069
61,62,779,3601,444,88,4,0,0,4916,762,3445,569,431,5,0,0,5212,10128
61,63,705,3380,431,92,5,0,0,4613,677,3322,540,396,3,0,0,4938,9551
61,64,596,3263,386,115,3,0,1,4364,703,3242,487,434,3,0,0,4869,9233
61,65,528,3183,343,107,0,0,0,4161,592,2964,422,470,3,0,0,4451,8612
61,66,497,3134,315,120,5,0,1,4072,548,3011,402,543,1,0,0,4505,8577
61,67,440,3170,312,122,2,0,0,4046,481,3095,380,569,0,0,0,4525,8571
61,68,415,3084,292,158,5,0,0,3954,452,2795,349,589,0,0,0,4185,8139
61,69,367,2990,239,149,2,0,0,3747,423,2784,361,693,1,0,0,4262,8009
61,70,317,2784,220,151,2,0,0,3474,365,2674,312,652,0,0,0,4003,7477
61,71,296,2700,187,192,0,0,0,3375,331,2559,276,758,0,0,0,3924,7299
61,72,305,2607,185,194,3,0,0,3294,290,2482,253,772,0,0,0,3797,7091
61,73,264,2685,187,228,0,0,0,3364,251,2547,262,963,1,0,0,4024,7388
61,74,249,2855,203,264,1,0,0,3572,255,2539,243,1075,1,0,0,4113,7685
61,75,280,2951,165,268,1,0,0,3665,257,2517,259,1069,1,0,0,4103,7768
61,76,216,2827,162,315,2,0,0,3522,221,2418,230,1198,0,0,0,4067,7589
61,77,219,2798,130,333,2,0,0,3482,212,2301,181,1370,0,0,0,4064,7546
61,78,143,1811,78,271,0,0,0,2303,129,1532,118,1103,0,0,0,2882,5185
61,79,131,1996,86,284,0,0,1,2498,141,1624,116,1304,0,0,0,3185,5683
61,80,155,1926,77,338,0,0,0,2496,163,1474,115,1326,0,0,0,3078,5574
61,81,155,1733,67,323,4,0,0,2282,174,1260,97,1356,0,0,0,2887,5169
61,82,139,1680,59,374,0,0,0,2252,137,1134,102,1469,0,0,0,2842,5094
61,83,148,1634,61,367,0,0,0,2210,154,1142,83,1637,0,0,0,3016,5226
61,84,122,1486,50,396,0,0,0,2054,147,1012,71,1723,0,0,0,2953,5007
61,85,141,1397,41,364,0,0,0,1943,122,821,55,1739,0,0,0,2737,4680
61,86,89,1088,24,403,0,0,0,1604,105,594,45,1598,0,0,0,2342,3946
61,87,80,892,24,320,0,0,0,1316,71,440,45,1507,0,0,0,2063,3379
61,88,80,816,22,328,0,0,0,1246,86,374,31,1524,0,0,0,2015,3261
61,89,79,637,13,340,0,0,0,1069,78,282,24,1443,0,0,0,1827,2896
61,90,35,491,4,273,0,0,0,803,80,171,18,1208,0,0,0,1477,2280
61,91,49,378,9,246,0,0,0,682,64,112,10,1068,0,0,0,1254,1936
61,92,36,265,1,200,0,0,0,502,44,85,12,903,0,0,0,1044,1546
61,93,24,190,5,157,0,0,0,376,42,63,16,822,0,0,0,943,1319
61,94,23,133,3,127,0,0,0,286,43,30,4,598,0,0,0,675,961
61,95,12,71,0,91,0,0,0,174,32,14,4,491,0,0,0,541,715
61,96,6,47,0,57,0,0,0,110,24,5,5,392,0,0,0,426,536
61,97,2,29,0,43,0,0,0,74,9,7,2,292,0,0,0,310,384
61,98,0,8,0,33,0,0,0,41,15,7,1,203,0,0,0,226,267
61,99,3,8,0,20,0,0,0,31,6,3,1,129,0,0,0,139,170
61,100,2,7,0,44,0,0,0,53,8,1,2,194,0,0,0,205,258
61,999,175139,151732,12829,9149,220,6,5,349080,147789,152649,17622,39121,169,14,1,357365,706445
62,0,3399,0,0,0,0,0,0,3399,3134,0,0,0,0,0,0,3134,6533
62,1,3572,0,0,0,0,0,0,3572,3336,0,0,0,0,0,0,3336,6908
62,2,3630,0,0,0,0,0,0,3630,3436,0,0,0,0,0,0,3436,7066
62,3,3561,0,0,0,0,0,0,3561,3498,0,0,0,0,0,0,3498,7059
62,4,3678,0,0,0,0,0,0,3678,3616,0,0,0,0,0,0,3616,7294
62,5,3933,0,0,0,0,0,0,3933,3773,0,0,0,0,0,0,3773,7706
62,6,3994,0,0,0,0,0,0,3994,3775,0,0,0,0,0,0,3775,7769
62,7,4205,0,0,0,0,0,0,4205,3896,0,0,0,0,0,0,3896,8101
62,8,4306,0,0,0,0,0,0,4306,4086,0,0,0,0,0,0,4086,8392
62,9,4355,0,0,0,0,0,0,4355,4210,0,0,0,0,0,0,4210,8565
62,10,4349,0,0,0,0,0,0,4349,4267,0,0,0,0,0,0,4267,8616
62,11,4535,0,0,0,0,0,0,4535,4279,0,0,0,0,0,0,4279,8814
62,12,4591,0,0,0,0,0,0,4591,4358,0,0,0,0,0,0,4358,8949
62,13,4726,0,0,0,0,0,0,4726,4288,0,0,0,0,0,0,4288,9014
62,14,4878,0,0,0,0,0,0,4878,4617,0,0,0,0,0,0,4617,9495
62,15,4755,0,0,0,0,0,0,4755,4491,0,0,0,0,0,0,4491,9246
62,16,4782,0,0,0,0,0,0,4782,4533,0,0,0,0,0,0,4533,9315
62,17,4927,0,1,0,0,0,0,4928,4445,0,0,0,0,0,0,4445,9373
62,18,4931,1,0,0,0,0,0,4932,4378,1,0,0,0,0,0,4379,9311
62,19,5034,5,0,0,0,0,0,5039,4449,16,0,0,0,0,0,4465,9504
62,20,4858,8,0,0,0,0,0,4866,4274,41,0,0,0,0,0,4315,9181
62,21,4930,16,0,0,0,1,0,4947,4369,59,0,1,0,0,0,4429,9376
62,22,4967,14,3,0,0,0,0,4984,4382,111,1,0,0,0,0,4494,9478
62,23,5091,31,6,0,0,0,0,5128,4435,204,4,0,0,0,0,4643,9771
62,24,5098,72,5,2,0,0,0,5177,4412,251,7,0,1,0,0,4671,9848
62,25,5098,119,6,0,1,0,0,5224,4289,353,11,0,2,0,0,4655,9879
62,26,5141,195,7,1,1,0,0,5345,4469,473,10,0,3,1,0,4956,10301
62,27,5214,256,12,1,3,0,0,5486,4511,641,12,1,5,1,0,5171,10657
62,28,5180,401,8,0,4,0,0,5593,4401,820,19,0,4,0,0,5244,10837
62,29,5206,512,8,1,7,1,0,5735,4358,1058,32,2,11,0,0,5461,11196
62,30,5198,660,12,0,3,2,0,5875,4195,1286,28,4,5,1,0,5519,11394
62,31,5100,959,25,2,7,0,0,6093,4298,1703,54,7,8,0,0,6070,12163
62,32,4914,1106,29,4,8,0,0,6061,3878,1788,56,8,11,1,1,5743,11804
62,33,4801,1394,41,4,13,0,0,6253,3777,2064,69,9,16,3,0,5938,12191
62,34,4289,1581,35,2,10,0,0,5917,3478,2246,89,4,19,3,0,5839,11756
62,35,4098,1850,42,3,12,0,0,6005,3324,2480,118,8,13,1,1,5945,11950
62,36,3899,2011,63,8,11,1,0,5993,3028,2671,136,17,20,1,0,5873,11866
62,37,3555,2209,72,8,15,3,0,5862,2954,2918,155,25,16,0,0,6068,11930
62,38,3519,2450,114,3,14,0,0,6100,2838,3032,209,27,25,1,0,6132,12232
62,39,3443,2621,109,6,13,1,0,6193,2781,3242,230,18,27,1,0,6299,12492
62,40,3378,2843,144,7,17,2,0,6391,2741,3271,260,39,26,1,0,6338,12729
62,41,3195,2923,167,8,16,1,0,6310,2631,3373,270,49,23,0,0,6346,12656
62,42,3026,3144,179,12,25,0,0,6386,2477,3446,298,47,20,2,0,6290,12676
62,43,3107,3313,180,23,16,2,0,6641,2498,3582,389,58,13,2,0,6542,13183
62,44,3009,3301,226,21,21,1,0,6579,2539,3928,369,72,13,1,0,6922,13501
62,45,3068,3748,275,28,24,0,0,7143,2557,3995,406,77,19,0,0,7054,14197
62,46,3210,3701,274,25,8,3,0,7221,2645,4119,481,93,22,3,0,7363,14584
62,47,3285,4015,320,13,22,0,2,7657,2611,4393,545,111,23,0,0,7683,15340
62,48,3224,4167,376,39,27,1,0,7834,2711,4718,592,101,19,1,0,8142,15976
62,49,3297,4336,384,31,36,1,0,8085,2683,4851,608,143,14,1,1,8301,16386
62,50,3146,4622,480,35,32,0,0,8315,2682,4950,704,135,16,0,0,8487,16802
62,51,3017,4651,488,47,23,0,0,8226,2557,4899,786,159,15,1,0,8417,16643
62,52,2926,4947,561,42,24,0,0,8500,2473,5206,784,152,26,0,0,8641,17141
62,53,2660,4889,603,53,29,4,0,8238,2301,5163,865,204,12,0,0,8545,16783
62,54,2590,4995,603,49,30,0,0,8267,2237,5230,874,226,18,0,0,8585,16852
62,55,2418,4894,624,63,21,0,0,8020,2068,5169,920,289,18,0,1,8465,16485
62,56,2204,4914,692,75,35,0,0,7920,2006,5190,957,277,5,0,0,8435,16355
62,57,2166,5002,664,81,24,1,0,7938,1930,5113,957,303,9,1,0,8313,16251
62,58,1931,5127,748,85,16,0,1,7908,1758,5252,943,369,6,0,0,8328,16236
62,59,1864,5321,729,106,22,0,1,8043,1716,5364,994,402,10,1,0,8487,16530
62,60,1564,4982,686,91,24,0,1,7348,1526,4819,947,378,13,0,0,7683,15031
62,61,1396,4864,665,111,16,0,2,7054,1320,4942,908,462,5,1,0,7638,14692
62,62,1309,4674,593,138,22,0,0,6736,1253,4887,828,487,4,0,1,7460,14196
62,63,1090,4540,608,139,17,0,1,6395,1165,4595,884,548,3,0,0,7195,13590
62,64,1024,4644,620,175,17,0,0,6480,1110,4455,751,655,5,0,1,6977,13457
62,65,949,4413,554,171,16,1,2,6106,950,4455,755,632,4,0,0,6796,12902
62,66,848,4426,550,165,13,0,0,6002,904,4262,727,675,8,0,0,6576,12578
62,67,714,4320,504,192,10,1,0,5741,861,4148,656,760,5,0,0,6430,12171
62,68,668,3998,478,222,8,0,0,5374,727,3964,643,814,3,0,0,6151,11525
62,69,612,4086,372,213,9,0,0,5292,666,3929,614,909,6,0,0,6124,11416
62,70,532,3908,354,255,6,0,0,5055,552,3720,547,948,3,0,0,5770,10825
62,71,478,3690,361,244,13,0,0,4786,543,3651,516,1016,3,0,0,5729,10515
62,72,464,3628,354,270,4,0,0,4720,503,3516,476,1086,2,0,0,5583,10303
62,73,417,3794,305,314,4,0,0,4834,472,3600,463,1218,3,0,0,5756,10590
62,74,360,3902,280,336,2,0,0,4880,427,3534,459,1402,1,0,0,5823,10703
62,75,393,4125,289,412,6,1,0,5226,392,3761,470,1684,1,0,0,6308,11534
62,76,364,4120,282,434,0,0,0,5200,357,3639,393,1835,0,0,0,6224,11424
62,77,341,4135,250,509,1,0,0,5236,341,3505,437,2094,0,0,0,6377,11613
62,78,203,2609,160,387,0,0,0,3359,216,2202,255,1511,3,0,0,4187,7546
62,79,268,2960,135,460,1,0,0,3824,280,2417,253,1794,1,0,0,4745,8569
62,80,219,2814,152,508,1,0,0,3694,246,2208,223,1996,0,0,0,4673,8367
62,81,195,2632,109,505,1,0,0,3442,279,2086,223,2063,1,0,0,4652,8094
62,82,226,2521,111,534,1,0,0,3393,257,1884,206,2316,0,0,0,4663,8056
62,83,236,2602,96,634,1,0,0,3569,255,1882,202,2665,0,0,0,5004,8573
62,84,212,2425,86,676,3,0,0,3402,238,1601,170,2780,0,0,0,4789,8191
62,85,152,2127,67,651,1,0,0,2998,215,1352,150,2705,0,0,0,4422,7420
62,86,141,1746,60,559,0,0,0,2506,171,1017,110,2464,1,0,0,3763,6269
62,87,102,1398,35,601,1,0,0,2137,176,754,79,2275,0,0,0,3284,5421
62,88,98,1246,26,552,1,0,0,1923,160,615,79,2368,0,0,0,3222,5145
62,89,85,962,32,516,0,0,0,1595,131,457,57,2157,0,0,0,2802,4397
62,90,65,809,25,478,0,0,0,1377,133,320,47,1965,0,0,0,2465,3842
62,91,64,609,15,403,0,0,0,1091,101,209,27,1724,0,0,0,2061,3152
62,92,45,463,11,360,0,0,0,879,112,124,35,1478,0,0,0,1749,2628
62,93,38,325,7,294,0,0,0,664,84,107,24,1383,0,0,0,1598,2262
62,94,18,215,1,241,0,0,0,475,65,61,15,1122,0,0,0,1263,1738
62,95,17,115,4,173,0,0,0,309,55,35,7,797,0,0,0,894,1203
62,96,10,105,3,145,0,0,0,263,40,25,9,646,0,0,0,720,983
62,97,9,46,0,103,0,0,0,158,35,9,2,455,0,0,0,501,659
62,98,7,30,1,50,0,0,0,88,33,4,9,352,0,0,0,398,486
62,99,1,19,1,49,0,0,0,70,19,7,2,239,0,0,0,267,337
62,100,3,15,1,55,0,0,0,74,35,3,3,380,0,0,0,421,495
62,999,252398,208366,18558,14213,789,28,10,494362,224542,211431,27903,58675,588,29,6,523174,1017536
63,0,933,0,0,0,0,0,0,933,886,0,0,0,0,0,0,886,1819
63,1,959,0,0,0,0,0,0,959,935,0,0,0,0,0,0,935,1894
63,2,1052,0,0,0,0,0,0,1052,919,0,0,0,0,0,0,919,1971
63,3,956,0,0,0,0,0,0,956,940,0,0,0,0,0,0,940,1896
63,4,1068,0,0,0,0,0,0,1068,1052,0,0,0,0,0,0,1052,2120
63,5,1108,0,0,0,0,0,0,1108,1045,0,0,0,0,0,0,1045,2153
63,6,1161,0,0,0,0,0,0,1161,1061,0,0,0,0,0,0,1061,2222
63,7,1143,0,0,0,0,0,0,1143,1181,0,0,0,0,0,0,1181,2324
63,8,1189,0,0,0,0,0,0,1189,1119,0,0,0,0,0,0,1119,2308
63,9,1254,0,0,0,0,0,0,1254,1215,0,0,0,0,0,0,1215,2469
63,10,1305,0,0,0,0,0,0,1305,1279,0,0,0,0,0,0,1279,2584
63,11,1354,0,0,0,0,0,0,1354,1299,0,0,0,0,0,0,1299,2653
63,12,1414,0,0,0,0,0,0,1414,1348,0,0,0,0,0,0,1348,2762
63,13,1461,0,0,0,0,0,0,1461,1431,0,0,0,0,0,0,1431,2892
63,14,1518,0,0,0,0,0,0,1518,1462,0,0,0,0,0,0,1462,2980
63,15,1526,0,0,0,0,0,0,1526,1407,0,0,0,0,0,0,1407,2933
63,16,1490,0,0,0,0,0,0,1490,1368,0,0,0,0,0,0,1368,2858
63,17,1528,0,0,0,0,0,0,1528,1343,0,0,0,0,0,0,1343,2871
63,18,1528,0,0,0,0,0,0,1528,1339,1,0,0,0,0,0,1340,2868
63,19,1474,0,0,0,0,0,0,1474,1344,3,0,0,0,0,0,1347,2821
63,20,1440,1,0,0,0,0,0,1441,1347,8,0,0,1,0,0,1356,2797
63,21,1474,2,0,0,0,0,0,1476,1384,17,0,0,0,0,0,1401,2877
63,22,1465,8,1,0,0,0,0,1474,1317,46,0,0,0,0,0,1363,2837
63,23,1501,16,1,0,0,0,0,1518,1338,51,2,0,0,0,0,1391,2909
63,24,1569,16,4,0,0,0,0,1589,1292,63,2,0,1,0,0,1358,2947
63,25,1681,43,3,0,0,0,0,1727,1244,128,4,0,0,0,0,1376,3103
63,26,1560,40,6,0,1,0,0,1607,1241,154,3,0,2,0,0,1400,3007
63,27,1548,68,0,0,0,0,0,1616,1243,196,4,1,1,0,0,1445,3061
63,28,1457,121,0,0,1,0,0,1579,1181,249,7,0,1,0,0,1438,3017
63,29,1434,145,2,0,1,0,0,1582,1163,304,8,0,0,0,0,1475,3057
63,30,1412,186,3,0,2,0,0,1603,1073,358,9,2,2,0,0,1444,3047
63,31,1436,260,3,0,1,0,0,1700,1054,418,10,2,1,0,0,1485,3185
63,32,1397,284,11,1,6,0,0,1699,1038,484,24,1,3,0,0,1550,3249
63,33,1307,356,14,1,3,0,0,1681,1001,565,36,3,1,0,0,1606,3287
63,34,1248,410,19,2,2,0,0,1681,899,634,32,4,2,0,0,1571,3252
63,35,1157,482,16,1,4,0,0,1660,940,696,45,7,3,0,0,1691,3351
63,36,1115,515,18,4,4,0,0,1656,828,713,45,4,0,1,0,1591,3247
63,37,1099,552,28,6,3,0,0,1688,773,759,67,14,3,0,0,1616,3304
63,38,1116,680,32,0,1,1,0,1830,741,803,58,9,3,0,0,1614,3444
63,39,1018,718,37,3,4,0,0,1780,764,873,66,15,2,0,0,1720,3500
63,40,1041,766,46,0,4,0,0,1857,781,953,104,16,2,1,0,1857,3714
63,41,947,844,49,3,2,0,0,1845,756,960,110,14,2,0,0,1842,3687
63,42,982,845,67,9,1,1,0,1905,765,991,105,16,4,0,0,1881,3786
63,43,998,884,63,8,5,0,0,1958,749,1085,110,23,4,0,0,1971,3929
63,44,1051,964,94,6,2,0,0,2117,792,1158,140,23,0,1,0,2114,4231
63,45,1151,1040,89,10,3,2,0,2295,842,1266,161,24,2,0,0,2295,4590
63,46,1151,1157,110,12,5,0,0,2435,902,1292,208,39,0,0,0,2441,4876
63,47,1188,1249,167,10,2,0,0,2616,866,1443,223,36,3,0,0,2571,5187
63,48,1146,1319,153,12,4,0,0,2634,887,1503,247,35,1,0,0,2673,5307
63,49,1194,1490,154,20,1,0,0,2859,903,1622,286,45,0,0,0,2856,5715
63,50,1130,1505,215,10,5,0,0,2865,841,1613,283,51,5,0,0,2793,5658
63,51,1158,1549,207,9,6,0,0,2929,818,1719,305,66,6,0,0,2914,5843
63,52,1054,1566,223,12,7,0,0,2862,783,1707,264,95,3,0,0,2852,5714
63,53,958,1580,250,17,6,0,0,2811,712,1792,334,74,6,0,0,2918,5729
63,54,1010,1652,240,21,5,0,0,2928,728,1780,371,116,1,0,0,2996,5924
63,55,886,1721,244,24,2,0,0,2877,631,1897,339,100,1,0,0,2968,5845
63,56,802,1678,282,28,4,0,0,2794,558,1798,342,145,3,0,1,2847,5641
63,57,808,1822,300,29,4,0,0,2963,525,1856,368,130,1,0,0,2880,5843
63,58,716,1818,281,38,6,0,0,2859,460,1925,361,155,2,0,0,2903,5762
63,59,617,1830,304,42,7,0,0,2800,476,1953,375,180,4,0,0,2988,5788
63,60,558,1865,297,29,4,0,0,2753,458,2017,305,165,0,0,0,2945,5698
63,61,504,1821,263,53,3,0,1,2645,388,1893,317,198,2,0,0,2798,5443
63,62,416,1755,276,65,6,0,0,2518,342,1920,342,219,1,0,0,2824,5342
63,63,407,1853,244,54,1,0,0,2559,268,1872,310,286,1,0,0,2737,5296
63,64,340,1837,247,73,1,0,0,2498,315,1888,277,259,2,0,0,2741,5239
63,65,316,1774,226,73,3,0,0,2392,243,1677,265,318,0,0,0,2503,4895
63,66,314,1778,210,84,2,0,0,2388,249,1816,269,321,0,0,0,2655,5043
63,67,241,1760,207,92,1,0,0,2301,218,1798,258,352,0,0,0,2626,4927
63,68,240,1663,185,92,2,0,0,2182,195,1640,221,367,1,0,0,2424,4606
63,69,213,1601,177,116,2,0,0,2109,178,1601,204,437,0,0,0,2420,4529
63,70,166,1652,138,102,0,0,0,2058,160,1538,196,433,0,0,0,2327,4385
63,71,153,1593,126,105,1,0,0,1978,136,1526,182,499,0,0,0,2343,4321
63,72,162,1547,101,139,1,0,0,1950,122,1429,155,521,1,0,0,2228,4178
63,73,143,1608,138,155,0,0,0,2044,114,1494,152,608,0,0,0,2368,4412
63,74,122,1553,106,166,0,0,0,1947,101,1434,154,646,0,0,0,2335,4282
63,75,117,1640,118,173,0,0,0,2048,107,1509,145,726,0,0,0,2487,4535
63,76,140,1751,88,197,0,1,0,2177,101,1397,112,847,0,0,0,2457,4634
63,77,124,1637,78,245,2,0,0,2086,108,1372,103,940,0,0,0,2523,4609
63,78,61,997,47,157,0,0,0,1262,65,798,70,595,0,0,0,1528,2790
63,79,84,1200,54,213,0,0,0,1551,73,896,66,803,0,0,0,1838,3389
63,80,78,1085,37,212,0,0,0,1412,82,827,59,868,0,0,0,1836,3248
63,81,65,954,47,211,0,0,0,1277,95,765,48,861,0,0,0,1769,3046
63,82,67,942,28,214,0,0,0,1251,81,615,50,949,0,0,0,1695,2946
63,83,67,974,23,254,0,0,0,1318,83,650,61,1153,0,0,0,1947,3265
63,84,49,848,31,281,1,0,0,1210,77,540,49,1092,0,0,0,1758,2968
63,85,45,781,15,251,0,0,0,1092,69,478,43,1122,0,0,0,1712,2804
63,86,46,639,10,222,0,0,0,917,57,350,32,1051,0,0,0,1490,2407
63,87,45,464,17,232,0,0,0,758,48,259,33,917,0,0,0,1257,2015
63,88,36,429,12,225,1,0,0,703,57,189,18,948,0,0,0,1212,1915
63,89,32,389,7,207,0,0,0,635,48,166,19,873,0,0,0,1106,1741
63,90,17,283,4,183,0,0,0,487,33,108,12,780,0,0,0,933,1420
63,91,18,187,2,120,0,0,0,327,20,66,10,672,0,0,0,768,1095
63,92,17,149,1,145,0,0,0,312,18,53,10,587,0,0,0,668,980
63,93,9,114,4,122,0,0,0,249,19,31,3,490,0,0,0,543,792
63,94,7,54,0,88,0,0,0,149,22,11,4,344,0,0,0,381,530
63,95,3,39,2,50,0,0,0,94,18,11,0,265,0,0,0,294,388
63,96,4,26,1,32,0,0,0,63,12,7,3,193,0,0,0,215,278
63,97,1,16,0,25,0,0,0,42,10,1,2,145,0,0,0,158,200
63,98,1,14,0,30,0,0,0,45,8,2,1,107,0,0,0,118,163
63,99,1,2,0,15,0,0,0,18,3,1,1,88,0,0,0,93,111
63,100,0,3,0,20,0,0,0,23,4,0,0,127,0,0,0,131,154
63,999,78272,73459,7303,5860,145,5,1,165045,65414,74481,10019,24617,84,3,1,174619,339664
64,0,1139,0,0,0,0,0,0,1139,1161,0,0,0,0,0,0,1161,2300
64,1,1157,0,0,0,0,0,0,1157,1174,0,0,0,0,0,0,1174,2331
64,2,1314,0,0,0,0,0,0,1314,1208,0,0,0,0,0,0,1208,2522
64,3,1318,0,0,0,0,0,0,1318,1271,0,0,0,0,0,0,1271,2589
64,4,1378,0,0,0,0,0,0,1378,1248,0,0,0,0,0,0,1248,2626
64,5,1514,0,0,0,0,0,0,1514,1360,0,0,0,0,0,0,1360,2874
64,6,1537,0,0,0,0,0,0,1537,1388,0,0,0,0,0,0,1388,2925
64,7,1528,0,0,0,0,0,0,1528,1423,0,0,0,0,0,0,1423,2951
64,8,1601,0,0,0,0,0,0,1601,1498,0,0,0,0,0,0,1498,3099
64,9,1627,0,0,0,0,0,0,1627,1566,0,0,0,0,0,0,1566,3193
64,10,1647,0,0,0,0,0,0,1647,1622,0,0,0,0,0,0,1622,3269
64,11,1751,0,0,0,0,0,0,1751,1594,0,0,0,0,0,0,1594,3345
64,12,1854,0,0,0,0,0,0,1854,1665,0,0,0,0,0,0,1665,3519
64,13,1857,0,0,0,0,0,0,1857,1770,0,0,0,0,0,0,1770,3627
64,14,1945,0,0,0,0,0,0,1945,1776,0,0,0,0,0,0,1776,3721
64,15,1932,0,0,0,0,0,0,1932,1805,0,0,0,0,0,0,1805,3737
64,16,1888,0,0,0,0,0,0,1888,1780,0,0,0,0,0,0,1780,3668
64,17,1987,0,0,0,0,0,0,1987,1817,0,0,0,0,0,0,1817,3804
64,18,1934,0,0,0,0,0,0,1934,1670,1,0,0,0,0,0,1671,3605
64,19,1945,0,0,0,0,0,0,1945,1706,6,0,0,0,0,0,1712,3657
64,20,1981,1,0,0,0,0,0,1982,1647,14,0,0,0,0,0,1661,3643
64,21,1872,4,0,0,0,0,0,1876,1691,30,0,0,0,0,0,1721,3597
64,22,1940,9,0,0,0,0,0,1949,1664,47,3,0,0,0,0,1714,3663
64,23,2001,13,2,0,0,0,0,2016,1654,77,5,0,2,0,0,1738,3754
64,24,1921,31,0,0,0,0,0,1952,1505,109,1,0,1,0,0,1616,3568
64,25,1928,42,1,0,0,0,0,1971,1498,173,6,1,0,0,0,1678,3649
64,26,1892,74,4,0,1,0,0,1971,1490,242,5,0,2,0,0,1739,3710
64,27,1855,104,2,1,2,0,0,1964,1469,310,5,0,0,1,0,1785,3749
64,28,1757,158,4,0,3,0,0,1922,1359,348,16,0,1,1,0,1725,3647
64,29,1697,210,3,0,1,0,0,1911,1385,431,9,1,4,2,0,1832,3743
64,30,1603,282,11,0,2,0,0,1898,1254,531,11,1,5,0,0,1802,3700
64,31,1588,377,9,0,2,0,0,1976,1268,600,16,1,3,0,0,1888,3864
64,32,1544,458,17,6,2,0,0,2027,1158,689,30,0,5,0,0,1882,3909
64,33,1396,522,16,1,4,0,0,1939,1065,723,35,3,1,0,0,1827,3766
64,34,1343,592,18,0,2,0,0,1955,1080,813,42,3,5,0,0,1943,3898
64,35,1328,690,25,0,2,0,0,2045,966,840,50,7,4,0,0,1867,3912
64,36,1200,716,31,2,3,1,0,1953,958,939,62,5,4,0,0,1968,3921
64,37,1238,795,44,1,5,0,0,2083,980,1022,62,9,4,0,0,2077,4160
64,38,1150,826,45,2,4,0,0,2027,900,1062,104,12,1,1,0,2080,4107
64,39,1111,857,45,3,2,0,0,2018,833,1092,104,13,4,0,0,2046,4064
64,40,1078,976,69,6,3,0,0,2132,888,1144,114,11,6,0,0,2163,4295
64,41,1124,1033,71,4,6,0,0,2238,913,1240,149,22,7,1,0,2332,4570
64,42,1026,1057,84,2,5,0,0,2174,823,1307,135,9,2,1,0,2277,4451
64,43,1117,1167,98,8,4,0,0,2394,800,1411,152,23,4,0,0,2390,4784
64,44,1152,1232,101,6,4,0,0,2495,879,1412,169,29,3,0,0,2492,4987
64,45,1163,1335,131,5,5,1,0,2640,933,1499,205,28,4,0,0,2669,5309
64,46,1206,1432,149,3,4,0,0,2794,981,1689,233,26,4,0,0,2933,5727
64,47,1216,1557,149,10,5,0,0,2937,1010,1603,233,31,4,0,0,2881,5818
64,48,1286,1673,209,15,3,0,0,3186,1015,1793,277,37,5,0,0,3127,6313
64,49,1318,1714,209,8,4,0,0,3253,1005,1879,320,58,2,0,0,3264,6517
64,50,1223,1726,209,8,5,1,0,3172,991,1897,353,56,4,0,0,3301,6473
64,51,1211,1830,223,18,7,0,0,3289,943,1963,331,76,2,1,0,3316,6605
64,52,1152,1847,260,18,6,0,0,3283,871,1940,363,77,1,0,0,3252,6535
64,53,1067,1841,266,19,5,0,0,3198,901,1976,399,94,2,0,0,3372,6570
64,54,1025,1888,290,20,6,0,0,3229,781,2086,407,107,3,0,0,3384,6613
64,55,1028,1997,309,20,7,0,1,3362,779,1980,374,100,1,1,0,3235,6597
64,56,928,1994,327,25,6,0,1,3281,711,1943,411,120,1,0,0,3186,6467
64,57,863,2046,324,32,6,0,0,3271,735,2014,417,123,3,0,0,3292,6563
64,58,793,1982,322,27,4,0,0,3128,595,2022,434,178,2,0,0,3231,6359
64,59,791,2163,350,42,9,0,0,3355,617,2164,417,172,2,0,0,3372,6727
64,60,676,1983,334,53,4,0,0,3050,503,1950,380,188,1,0,0,3022,6072
64,61,536,2012,292,35,4,0,0,2879,477,1960,372,193,1,0,0,3003,5882
64,62,535,1918,305,62,3,0,0,2823,434,2000,358,200,3,0,0,2995,5818
64,63,461,1921,289,65,5,0,1,2742,394,1836,369,226,1,0,0,2826,5568
64,64,431,1890,280,69,3,0,0,2673,375,1770,319,269,1,0,0,2734,5407
64,65,362,1806,239,77,4,0,0,2488,343,1727,299,240,0,0,0,2609,5097
64,66,335,1743,213,75,4,0,0,2370,301,1746,325,301,1,0,0,2674,5044
64,67,316,1779,234,93,5,0,0,2427,281,1708,285,331,1,0,0,2606,5033
64,68,239,1752,196,89,1,0,0,2277,238,1619,263,304,0,0,0,2424,4701
64,69,223,1591,179,100,1,0,0,2094,199,1580,231,346,0,0,0,2356,4450
64,70,193,1561,186,94,0,0,1,2035,213,1402,214,362,1,0,0,2192,4227
64,71,212,1572,163,94,1,0,0,2042,196,1477,204,422,0,1,0,2300,4342
64,72,175,1558,152,98,3,0,1,1987,178,1400,185,442,0,0,0,2205,4192
64,73,170,1568,163,126,2,0,0,2029,148,1474,209,518,1,0,0,2350,4379
64,74,149,1565,144,134,2,0,0,1994,153,1476,164,590,2,0,0,2385,4379
64,75,139,1647,120,146,0,0,0,2052,151,1527,153,657,0,0,0,2488,4540
64,76,139,1641,113,176,0,0,0,2069,125,1320,120,704,0,0,0,2269,4338
64,77,145,1567,93,180,0,0,0,1985,121,1413,129,764,0,0,0,2427,4412
64,78,73,1046,76,157,0,0,0,1352,95,902,103,625,0,0,0,1725,3077
64,79,106,1178,78,168,0,0,0,1530,86,940,99,761,0,0,0,1886,3416
64,80,96,1076,51,174,0,0,0,1397,105,832,75,834,0,0,0,1846,3243
64,81,84,1017,54,186,1,0,0,1342,84,765,80,749,0,0,0,1678,3020
64,82,83,1003,48,206,1,0,0,1341,86,714,87,820,0,0,0,1707,3048
64,83,93,1019,34,215,0,0,0,1361,94,743,58,1024,0,0,0,1919,3280
64,84,85,996,35,253,0,0,0,1369,94,681,54,1051,0,0,0,1880,3249
64,85,84,902,42,253,0,0,0,1281,98,522,39,1082,0,0,0,1741,3022
64,86,74,738,21,236,1,0,0,1070,86,399,38,1046,0,0,0,1569,2639
64,87,48,567,15,211,0,0,0,841,80,303,29,973,0,0,0,1385,2226
64,88,56,532,13,219,0,0,0,820,49,260,36,1005,0,0,0,1350,2170
64,89,34,465,15,206,0,0,0,720,61,205,26,979,0,0,0,1271,1991
64,90,32,347,9,205,0,0,0,593,61,118,23,802,0,0,0,1004,1597
64,91,27,255,4,161,0,0,0,447,57,80,9,729,0,0,0,875,1322
64,92,18,190,3,147,0,0,0,358,45,59,7,588,0,0,0,699,1057
64,93,26,135,2,136,0,0,0,299,44,36,7,571,0,0,0,658,957
64,94,15,86,3,82,0,0,0,186,27,24,3,406,0,0,0,460,646
64,95,14,61,3,76,0,0,0,154,25,16,6,341,0,0,0,388,542
64,96,3,36,1,56,0,0,0,96,9,13,4,253,0,0,0,279,375
64,97,2,19,0,33,0,0,0,54,16,9,1,200,0,0,0,226,280
64,98,3,18,0,31,0,0,0,52,13,3,1,134,0,0,0,151,203
64,99,2,11,0,21,0,0,0,34,6,0,0,83,0,0,0,89,123
64,100,1,8,0,24,0,0,0,33,10,4,0,152,0,0,0,166,199
64,999,93460,82030,8629,5534,184,3,5,189845,79658,82074,11823,23698,121,10,0,197384,387229
65,0,1287,0,0,0,0,0,0,1287,1226,0,0,0,0,0,0,1226,2513
65,1,1363,0,0,0,0,0,0,1363,1314,0,0,0,0,0,0,1314,2677
65,2,1311,0,0,0,0,0,0,1311,1272,0,0,0,0,0,0,1272,2583
65,3,1370,0,0,0,0,0,0,1370,1281,0,0,0,0,0,0,1281,2651
65,4,1392,0,0,0,0,0,0,1392,1328,0,0,0,0,0,0,1328,2720
65,5,1529,0,0,0,0,0,0,1529,1382,0,0,0,0,0,0,1382,2911
65,6,1620,0,0,0,0,0,0,1620,1432,0,0,0,0,0,0,1432,3052
65,7,1649,0,0,0,0,0,0,1649,1556,0,0,0,0,0,0,1556,3205
65,8,1691,0,0,0,0,0,0,1691,1565,0,0,0,0,0,0,1565,3256
65,9,1753,0,0,0,0,0,0,1753,1631,0,0,0,0,0,0,1631,3384
65,10,1775,0,0,0,0,0,0,1775,1769,0,0,0,0,0,0,1769,3544
65,11,1831,0,0,0,0,0,0,1831,1763,0,0,0,0,0,0,1763,3594
65,12,1988,0,0,0,0,0,0,1988,1782,0,0,0,0,0,0,1782,3770
65,13,2011,0,0,0,0,0,0,2011,1778,0,0,0,0,0,0,1778,3789
65,14,1977,0,0,0,0,0,0,1977,1813,0,0,0,0,0,0,1813,3790
65,15,1994,0,0,0,0,0,0,1994,1850,0,0,0,0,0,0,1850,3844
65,16,1997,0,0,0,0,0,0,1997,1865,0,0,0,0,0,0,1865,3862
65,17,1949,0,0,0,0,0,0,1949,1912,0,0,0,0,0,0,1912,3861
65,18,1965,0,0,0,0,0,0,1965,1771,0,0,0,0,0,0,1771,3736
65,19,1990,0,0,0,0,0,0,1990,1832,5,0,0,0,0,0,1837,3827
65,20,1945,3,0,0,0,0,0,1948,1760,16,0,0,0,0,0,1776,3724
65,21,1982,3,0,0,0,0,0,1985,1754,30,0,0,0,0,0,1784,3769
65,22,1965,7,3,0,0,0,0,1975,1698,53,0,0,0,0,0,1751,3726
65,23,2066,17,3,0,0,0,0,2086,1682,100,4,0,0,0,0,1786,3872
65,24,1944,26,3,1,1,0,0,1975,1614,127,7,0,0,0,0,1748,3723
65,25,1998,70,6,0,0,0,0,2074,1606,175,2,0,2,0,0,1785,3859
65,26,1918,67,7,0,0,0,0,1992,1565,230,4,0,0,1,0,1800,3792
65,27,1867,126,4,0,0,0,0,1997,1540,311,1,1,1,0,0,1854,3851
65,28,1783,165,1,0,3,1,0,1953,1438,373,11,0,0,0,0,1822,3775
65,29,1799,237,5,0,2,0,0,2043,1421,427,13,0,1,0,0,1862,3905
65,30,1708,278,10,0,0,0,0,1996,1246,505,16,0,1,0,0,1768,3764
65,31,1659,394,9,1,0,0,0,2063,1352,605,19,3,2,0,0,1981,4044
65,32,1612,484,14,2,2,0,0,2114,1243,736,20,7,2,0,0,2008,4122
65,33,1525,561,14,1,1,0,0,2102,1236,771,43,5,0,0,0,2055,4157
65,34,1452,628,21,5,2,0,0,2108,1164,874,31,7,2,0,0,2078,4186
65,35,1407,680,22,0,2,0,0,2111,1005,938,41,4,2,0,0,1990,4101
65,36,1300,723,29,0,4,0,0,2056,1029,1010,66,4,2,1,0,2112,4168
65,37,1282,835,49,4,4,0,0,2174,899,1079,73,12,2,0,0,2065,4239
65,38,1282,905,28,1,6,0,0,2222,1026,1141,93,14,2,1,0,2277,4499
65,39,1138,971,48,4,2,0,0,2163,920,1186,102,10,2,0,0,2220,4383
65,40,1171,983,51,5,3,0,0,2213,903,1216,101,15,3,0,0,2238,4451
65,41,1115,1125,58,1,6,0,0,2305,943,1326,115,10,6,0,0,2400,4705
65,42,1186,1187,74,4,4,0,0,2455,927,1362,139,20,0,1,0,2449,4904
65,43,1120,1199,75,7,3,0,0,2404,912,1457,126,20,1,0,0,2516,4920
65,44,1147,1358,93,5,1,0,0,2604,955,1495,164,27,3,0,0,2644,5248
65,45,1231,1423,100,13,5,0,0,2772,1018,1571,185,37,3,0,0,2814,5586
65,46,1255,1537,114,10,3,0,0,2919,946,1691,189,40,1,0,0,2867,5786
65,47,1220,1594,129,13,5,0,0,2961,960,1793,234,45,2,1,0,3035,5996
65,48,1255,1729,145,13,4,0,0,3146,985,1922,282,44,0,1,0,3234,6380
65,49,1329,1820,223,11,4,0,0,3387,974,2039,295,62,4,0,0,3374,6761
65,50,1164,1887,193,13,4,0,0,3261,849,2080,306,61,2,0,0,3298,6559
65,51,1062,1957,222,15,8,0,0,3264,837,2042,334,73,2,0,0,3288,6552
65,52,1060,1895,251,20,4,0,0,3230,759,2107,353,94,2,0,0,3315,6545
65,53,1021,2018,259,19,7,0,0,3324,665,2078,349,84,2,0,0,3178,6502
65,54,910,1993,249,20,4,0,0,3176,683,2125,392,97,0,0,0,3297,6473
65,55,821,2074,227,21,9,0,0,3152,644,2170,383,102,5,0,0,3304,6456
65,56,770,2066,269,33,3,0,0,3141,584,2113,341,114,1,0,0,3153,6294
65,57,770,2117,283,24,3,0,0,3197,527,2132,370,142,2,0,0,3173,6370
65,58,669,2156,272,36,6,0,0,3139,518,2176,366,156,1,0,0,3217,6356
65,59,669,2175,286,26,4,0,0,3160,508,2200,342,154,1,0,0,3205,6365
65,60,518,2090,262,39,1,0,0,2910,458,2148,326,181,0,0,0,3113,6023
65,61,478,2055,231,50,4,0,0,2818,385,2064,308,168,2,0,0,2927,5745
65,62,431,2026,272,50,6,0,0,2785,352,2035,305,245,2,0,0,2939,5724
65,63,382,1957,219,74,3,0,0,2635,323,2023,287,243,0,0,0,2876,5511
65,64,346,1911,225,72,4,0,1,2559,300,1927,292,265,0,0,0,2784,5343
65,65,313,1818,192,73,2,0,0,2398,268,1829,269,315,0,0,0,2681,5079
65,66,279,1824,204,69,5,0,0,2381,254,1790,237,288,0,0,0,2569,4950
65,67,236,1860,187,81,5,0,0,2369,229,1748,218,355,0,0,0,2550,4919
65,68,234,1759,161,81,1,0,0,2236,227,1707,219,362,0,0,0,2515,4751
65,69,204,1668,150,84,2,0,0,2108,183,1569,168,384,0,0,0,2304,4412
65,70,183,1644,118,105,2,0,0,2052,181,1553,186,414,1,0,0,2335,4387
65,71,208,1572,95,115,1,0,2,1993,152,1582,150,480,1,0,0,2365,4358
65,72,146,1598,112,138,1,0,1,1996,151,1527,161,461,0,0,0,2300,4296
65,73,174,1631,116,115,0,0,0,2036,139,1481,130,538,0,0,0,2288,4324
65,74,177,1645,102,156,0,1,0,2081,125,1440,141,590,1,0,0,2297,4378
65,75,156,1640,86,154,0,0,0,2036,117,1490,114,661,0,0,0,2382,4418
65,76,141,1633,90,168,0,0,0,2032,138,1340,112,709,0,0,0,2299,4331
65,77,126,1566,99,201,1,0,0,1993,113,1321,89,776,2,0,0,2301,4294
65,78,107,1208,61,163,0,0,0,1539,88,1000,72,653,0,0,0,1813,3352
65,79,97,1234,43,166,0,0,0,1540,87,1020,70,738,0,0,0,1915,3455
65,80,120,1128,46,195,1,0,0,1490,82,842,71,789,0,0,0,1784,3274
65,81,90,1065,40,202,0,0,0,1397,68,756,58,856,0,0,0,1738,3135
65,82,102,1035,42,219,0,0,0,1398,92,727,35,893,0,0,0,1747,3145
65,83,105,990,35,227,0,0,0,1357,103,702,44,1022,0,0,0,1871,3228
65,84,83,917,28,219,0,0,0,1247,83,649,51,1045,0,0,0,1828,3075
65,85,97,894,17,263,0,0,0,1271,81,489,46,1097,0,0,0,1713,2984
65,86,76,712,15,223,0,0,0,1026,78,337,23,998,0,0,0,1436,2462
65,87,60,553,18,197,0,0,0,828,63,248,22,896,0,0,0,1229,2057
65,88,59,500,11,244,0,0,0,814,53,187,17,951,0,0,0,1208,2022
65,89,40,387,9,202,0,0,0,638,46,141,14,812,0,0,0,1013,1651
65,90,23,313,7,168,0,0,0,511,49,116,7,763,0,0,0,935,1446
65,91,14,215,4,156,0,0,0,389,31,59,10,619,0,0,0,719,1108
65,92,14,158,3,105,0,0,0,280,41,41,10,527,0,0,0,619,899
65,93,12,110,1,95,0,0,0,218,28,42,8,476,0,0,0,554,772
65,94,12,72,2,81,0,0,0,167,24,17,3,413,0,0,0,457,624
65,95,6,43,1,58,0,0,0,108,25,10,5,304,0,0,0,344,452
65,96,0,39,0,56,0,0,0,95,14,3,1,229,0,0,0,247,342
65,97,2,15,0,28,0,0,0,45,17,6,1,154,0,0,0,178,223
65,98,0,9,1,15,0,0,0,25,10,2,1,132,0,0,0,145,170
65,99,0,7,1,17,0,0,0,25,6,2,0,80,0,0,0,88,113
65,100,0,3,0,13,0,0,0,16,5,1,0,121,0,0,0,127,143
65,999,94870,84977,7155,5465,158,2,4,192631,80686,85758,10193,23467,71,6,0,200181,392812
66,0,1040,0,0,0,0,0,0,1040,991,0,0,0,0,0,0,991,2031
66,1,1113,0,0,0,0,0,0,1113,1046,0,0,0,0,0,0,1046,2159
66,2,1151,0,0,0,0,0,0,1151,1130,0,0,0,0,0,0,1130,2281
66,3,1177,0,0,0,0,0,0,1177,1088,0,0,0,0,0,0,1088,2265
66,4,1250,0,0,0,0,0,0,1250,1136,0,0,0,0,0,0,1136,2386
66,5,1230,0,0,0,0,0,0,1230,1233,0,0,0,0,0,0,1233,2463
66,6,1359,0,0,0,0,0,0,1359,1276,0,0,0,0,0,0,1276,2635
66,7,1470,0,0,0,0,0,0,1470,1314,0,0,0,0,0,0,1314,2784
66,8,1452,0,0,0,0,0,0,1452,1453,0,0,0,0,0,0,1453,2905
66,9,1539,0,0,0,0,0,0,1539,1418,0,0,0,0,0,0,1418,2957
66,10,1625,0,0,0,0,0,0,1625,1513,0,0,0,0,0,0,1513,3138
66,11,1624,0,0,0,0,0,0,1624,1503,0,0,0,0,0,0,1503,3127
66,12,1729,0,0,0,0,0,0,1729,1669,0,0,0,0,0,0,1669,3398
66,13,1674,0,0,0,0,0,0,1674,1608,0,0,0,0,0,0,1608,3282
66,14,1688,0,0,0,0,0,0,1688,1681,0,0,0,0,0,0,1681,3369
66,15,1790,0,0,0,0,0,0,1790,1671,0,0,0,0,0,0,1671,3461
66,16,1776,0,0,0,0,0,0,1776,1602,0,0,0,0,0,0,1602,3378
66,17,1807,0,0,0,0,0,0,1807,1631,0,0,0,0,0,0,1631,3438
66,18,1892,0,0,0,0,0,0,1892,1671,0,0,0,0,0,0,1671,3563
66,19,1864,0,0,0,0,0,0,1864,1598,5,0,0,0,0,0,1603,3467
66,20,1772,0,0,0,0,0,0,1772,1686,15,0,0,0,0,0,1701,3473
66,21,1825,4,0,0,0,0,0,1829,1610,23,1,0,0,0,0,1634,3463
66,22,1790,6,0,0,0,0,0,1796,1616,28,1,0,0,0,0,1645,3441
66,23,1950,8,0,0,0,0,0,1958,1616,53,0,0,0,0,0,1669,3627
66,24,1820,32,1,0,0,0,0,1853,1513,61,2,1,0,0,0,1577,3430
66,25,1853,32,0,0,0,0,0,1885,1493,109,2,0,0,0,0,1604,3489
66,26,1759,50,2,0,0,0,0,1811,1409,142,5,0,1,0,0,1557,3368
66,27,1738,66,5,0,1,0,0,1810,1378,190,5,0,1,0,0,1574,3384
66,28,1687,117,6,0,0,0,0,1810,1349,236,4,0,2,0,0,1591,3401
66,29,1603,149,2,0,0,0,0,1754,1271,287,7,0,1,0,0,1566,3320
66,30,1508,193,4,0,0,0,0,1705,1263,347,6,1,2,0,0,1619,3324
66,31,1610,233,7,1,0,0,0,1851,1189,468,16,1,1,1,0,1676,3527
66,32,1517,313,9,0,2,0,0,1841,1103,567,19,1,1,0,0,1691,3532
66,33,1405,382,8,1,1,0,0,1797,1093,637,27,1,1,0,0,1759,3556
66,34,1355,482,10,2,1,0,0,1850,1018,747,38,5,2,0,0,1810,3660
66,35,1350,548,22,0,3,0,0,1923,984,830,45,3,3,0,0,1865,3788
66,36,1297,596,17,2,1,0,0,1913,895,867,50,5,8,1,0,1826,3739
66,37,1158,698,27,3,0,0,0,1886,847,928,60,10,1,0,0,1846,3732
66,38,1117,716,34,1,3,0,0,1871,887,931,69,13,2,0,0,1902,3773
66,39,1057,793,32,1,2,0,0,1885,797,1041,71,8,5,0,0,1922,3807
66,40,1157,947,55,0,4,0,0,2163,791,1134,85,13,4,1,0,2028,4191
66,41,1053,988,60,0,2,0,0,2103,831,1209,104,13,1,1,0,2159,4262
66,42,1036,1033,55,3,2,0,0,2129,740,1276,120,18,1,1,0,2156,4285
66,43,1002,1126,60,2,0,0,0,2190,729,1368,135,15,3,0,0,2250,4440
66,44,1004,1131,92,8,0,0,0,2235,702,1406,157,31,2,0,0,2298,4533
66,45,1107,1345,113,4,2,0,0,2571,733,1552,182,29,2,0,0,2498,5069
66,46,1007,1358,124,6,1,1,0,2497,769,1662,202,38,2,0,0,2673,5170
66,47,1035,1529,136,11,3,1,0,2715,724,1750,206,44,2,1,0,2727,5442
66,48,1000,1556,139,15,4,0,0,2714,684,1849,208,40,1,0,0,2782,5496
66,49,961,1735,160,12,4,0,0,2872,712,1876,245,48,2,0,0,2883,5755
66,50,916,1694,177,12,1,1,0,2801,673,1908,248,71,2,0,0,2902,5703
66,51,853,1753,202,12,5,1,0,2826,536,1918,266,54,0,0,1,2775,5601
66,52,817,1824,209,19,1,0,0,2870,574,2018,278,71,2,0,0,2943,5813
66,53,740,1838,228,18,6,0,0,2830,484,1919,302,77,1,0,0,2783,5613
66,54,748,1843,243,22,3,1,1,2861,549,2067,308,70,1,0,0,2995,5856
66,55,629,1991,203,27,1,0,0,2851,485,2010,275,108,1,0,0,2879,5730
66,56,634,1982,262,27,4,0,0,2909,466,2025,335,111,1,0,0,2938,5847
66,57,600,1999,251,32,2,1,0,2885,361,2156,280,127,0,0,0,2924,5809
66,58,527,2058,218,40,4,0,0,2847,382,2016,302,140,1,0,0,2841,5688
66,59,520,2112,253,33,4,0,0,2922,350,2159,259,177,0,0,0,2945,5867
66,60,445,2064,236,42,3,0,0,2790,317,2024,233,145,1,0,0,2720,5510
66,61,340,2011,199,36,1,0,0,2587,306,1953,255,165,0,0,0,2679,5266
66,62,342,1944,224,41,5,0,0,2556,304,1950,227,212,0,0,0,2693,5249
66,63,353,1868,188,52,4,0,0,2465,237,1926,199,242,0,0,0,2604,5069
66,64,301,1836,173,60,2,0,0,2372,262,1828,195,226,1,0,0,2512,4884
66,65,267,1759,170,61,3,0,0,2260,194,1735,210,247,0,1,0,2387,4647
66,66,260,1704,150,54,0,0,0,2168,186,1634,190,273,0,0,0,2283,4451
66,67,222,1667,133,65,3,0,0,2090,183,1647,166,304,0,0,0,2300,4390
66,68,194,1578,108,93,2,0,0,1975,159,1568,156,304,1,0,0,2188,4163
66,69,197,1560,120,69,0,0,0,1946,142,1469,139,343,0,0,0,2093,4039
66,70,164,1533,100,85,0,0,0,1882,138,1454,105,345,0,0,0,2042,3924
66,71,141,1483,107,100,1,0,0,1832,119,1370,109,378,1,0,0,1977,3809
66,72,140,1573,82,85,0,0,0,1880,118,1379,102,428,0,0,0,2027,3907
66,73,148,1547,68,119,1,0,0,1883,112,1477,95,485,0,0,0,2169,4052
66,74,159,1515,84,119,0,0,0,1877,95,1388,94,572,1,0,0,2150,4027
66,75,123,1525,75,146,0,0,0,1869,100,1331,81,627,0,0,0,2139,4008
66,76,131,1443,72,153,0,0,0,1799,75,1194,70,662,0,0,0,2001,3800
66,77,133,1439,68,168,1,0,0,1809,90,1223,90,709,0,0,1,2113,3922
66,78,80,1073,50,154,0,0,0,1357,73,875,69,620,0,0,0,1637,2994
66,79,88,1086,26,140,0,0,0,1340,58,843,64,713,0,0,0,1678,3018
66,80,80,1086,31,157,0,0,0,1354,79,781,39,749,0,0,0,1648,3002
66,81,85,935,29,155,0,0,0,1204,71,634,35,737,0,0,0,1477,2681
66,82,83,866,24,149,1,0,0,1123,62,595,39,816,0,0,0,1512,2635
66,83,63,949,23,168,0,0,0,1203,78,587,34,952,0,0,0,1651,2854
66,84,70,886,20,192,0,0,0,1168,68,468,21,970,0,0,0,1527,2695
66,85,80,743,20,194,0,0,0,1037,62,414,24,1076,0,0,0,1576,2613
66,86,53,582,10,171,0,0,0,816,63,280,16,890,0,0,0,1249,2065
66,87,30,530,7,156,0,0,0,723,48,227,15,832,0,0,0,1122,1845
66,88,44,390,6,176,0,0,0,616,51,176,11,871,0,0,0,1109,1725
66,89,28,339,6,155,0,0,0,528,29,149,11,789,0,0,0,978,1506
66,90,27,255,8,142,0,0,0,432,35,86,13,685,0,0,0,819,1251
66,91,23,202,1,121,0,0,0,347,41,49,5,590,0,0,0,685,1032
66,92,11,161,2,121,0,0,0,295,32,43,3,551,0,0,0,629,924
66,93,9,119,3,79,0,0,0,210,19,28,5,424,0,0,0,476,686
66,94,3,79,1,54,0,0,0,137,12,23,3,294,0,0,0,332,469
66,95,8,49,0,42,0,0,0,99,10,7,2,272,0,0,0,291,390
66,96,2,26,1,45,0,0,0,74,11,9,1,210,0,0,0,231,305
66,97,3,14,0,22,0,0,0,39,9,6,1,158,0,0,0,174,213
66,98,1,13,0,13,0,0,0,27,10,3,1,106,0,0,0,120,147
66,99,1,3,0,13,0,0,0,17,6,1,1,72,0,0,0,80,97
66,100,0,8,1,13,0,0,0,22,6,1,0,98,0,0,0,105,127
66,999,83699,77703,6052,4494,94,6,1,172049,69594,78625,8054,21486,65,7,2,177833,349882
67,0,1397,0,0,0,0,0,0,1397,1333,0,0,0,0,0,0,1333,2730
67,1,1361,0,0,0,0,0,0,1361,1323,0,0,0,0,0,0,1323,2684
67,2,1445,0,0,0,0,0,0,1445,1456,0,0,0,0,0,0,1456,2901
67,3,1534,0,0,0,0,0,0,1534,1475,0,0,0,0,0,0,1475,3009
67,4,1650,0,0,0,0,0,0,1650,1459,0,0,0,0,0,0,1459,3109
67,5,1680,0,0,0,0,0,0,1680,1554,0,0,0,0,0,0,1554,3234
67,6,1730,0,0,0,0,0,0,1730,1624,0,0,0,0,0,0,1624,3354
67,7,1864,0,0,0,0,0,0,1864,1729,0,0,0,0,0,0,1729,3593
67,8,1949,0,0,0,0,0,0,1949,1827,0,0,0,0,0,0,1827,3776
67,9,1955,0,0,0,0,0,0,1955,1873,0,0,0,0,0,0,1873,3828
67,10,2079,0,0,0,0,0,0,2079,1892,0,0,0,0,0,0,1892,3971
67,11,2115,0,0,0,0,0,0,2115,2000,0,0,0,0,0,0,2000,4115
67,12,2150,0,0,0,0,0,0,2150,2088,0,0,0,0,0,0,2088,4238
67,13,2225,0,0,0,0,0,0,2225,2175,0,0,0,0,0,0,2175,4400
67,14,2397,0,0,0,0,0,0,2397,2178,0,0,0,0,0,0,2178,4575
67,15,2367,0,0,0,0,0,0,2367,2257,0,0,0,0,0,0,2257,4624
67,16,2317,0,0,0,0,0,0,2317,2176,0,0,0,0,0,0,2176,4493
67,17,2249,0,0,0,0,0,0,2249,2116,1,0,0,0,0,0,2117,4366
67,18,2283,0,0,0,0,0,0,2283,2086,0,0,0,0,0,0,2086,4369
67,19,2418,0,0,0,0,0,0,2418,2102,5,0,0,0,0,0,2107,4525
67,20,2268,1,0,0,0,0,0,2269,2061,21,0,0,0,0,0,2082,4351
67,21,2423,1,0,0,0,0,0,2424,2085,30,0,0,0,0,0,2115,4539
67,22,2328,2,0,0,0,0,0,2330,2025,54,3,0,0,0,0,2082,4412
67,23,2398,25,3,0,1,0,0,2427,2001,86,3,0,1,0,0,2091,4518
67,24,2403,44,1,0,0,0,0,2448,2041,104,5,0,0,0,0,2150,4598
67,25,2475,46,2,0,2,0,0,2525,1948,171,5,0,1,0,0,2125,4650
67,26,2386,77,0,0,1,0,0,2464,1972,190,7,1,0,0,0,2170,4634
67,27,2317,118,4,0,1,0,0,2440,1790,280,7,0,1,0,0,2078,4518
67,28,2278,156,4,0,2,0,0,2440,1793,328,6,0,2,0,0,2129,4569
67,29,2165,192,2,0,1,0,0,2360,1697,385,9,0,3,0,0,2094,4454
67,30,2128,231,6,0,2,0,0,2367,1655,516,12,0,3,0,0,2186,4553
67,31,2122,332,9,0,1,0,0,2464,1578,642,18,3,2,0,0,2243,4707
67,32,2018,453,8,1,6,0,0,2486,1439,665,25,5,3,0,0,2137,4623
67,33,1982,550,12,2,1,0,0,2547,1445,802,35,2,3,0,0,2287,4834
67,34,1711,620,14,0,2,0,0,2347,1357,942,37,3,1,0,0,2340,4687
67,35,1648,697,23,2,4,0,0,2374,1213,1020,48,5,5,0,0,2291,4665
67,36,1609,760,29,1,0,0,0,2399,1126,1125,51,9,3,0,0,2314,4713
67,37,1544,919,36,2,2,0,0,2503,1108,1256,79,10,4,0,0,2457,4960
67,38,1506,952,48,1,2,1,0,2510,1111,1294,98,15,2,0,1,2521,5031
67,39,1440,1175,47,4,4,0,0,2670,1101,1417,96,12,3,0,0,2629,5299
67,40,1332,1226,56,0,5,0,0,2619,1084,1500,96,10,4,0,0,2694,5313
67,41,1482,1296,78,1,2,0,1,2860,998,1611,145,11,8,0,0,2773,5633
67,42,1357,1363,94,8,4,0,0,2826,972,1612,150,21,4,0,0,2759,5585
67,43,1415,1544,101,9,3,0,0,3072,1024,1790,159,29,2,0,0,3004,6076
67,44,1308,1638,137,17,5,0,0,3105,934,1873,222,42,3,1,0,3075,6180
67,45,1335,1786,150,11,10,0,0,3292,963,2013,224,48,4,0,0,3252,6544
67,46,1417,1828,162,16,1,0,0,3424,986,2094,224,30,3,0,0,3337,6761
67,47,1293,1888,190,14,7,1,0,3393,935,2256,247,61,3,0,0,3502,6895
67,48,1344,2218,171,17,6,0,0,3756,944,2467,308,46,7,0,0,3772,7528
67,49,1386,2217,219,20,5,0,0,3847,864,2440,328,53,4,0,0,3689,7536
67,50,1222,2229,213,14,2,0,0,3680,820,2480,320,73,5,0,0,3698,7378
67,51,1148,2275,231,21,7,0,0,3682,798,2544,338,78,2,0,0,3760,7442
67,52,1122,2431,266,19,5,0,0,3843,757,2598,379,79,2,0,0,3815,7658
67,53,971,2404,276,20,5,0,0,3676,654,2586,363,130,1,0,0,3734,7410
67,54,923,2420,265,23,8,0,0,3639,678,2676,388,127,4,0,0,3873,7512
67,55,835,2449,270,33,4,0,0,3591,614,2684,422,134,1,0,0,3855,7446
67,56,789,2434,267,35,6,0,0,3531,585,2624,375,150,0,0,0,3734,7265
67,57,732,2598,315,43,4,0,0,3692,547,2755,354,154,0,0,0,3810,7502
67,58,662,2604,289,56,4,0,0,3615,527,2602,377,171,3,0,0,3680,7295
67,59,644,2640,324,46,4,0,0,3658,472,2853,372,210,2,0,0,3909,7567
67,60,566,2517,278,51,3,0,0,3415,436,2658,378,229,1,0,0,3702,7117
67,61,501,2479,306,64,4,0,0,3354,383,2447,321,217,1,0,0,3369,6723
67,62,428,2525,250,68,5,0,0,3276,354,2466,332,281,2,0,0,3435,6711
67,63,406,2326,254,70,1,0,0,3057,354,2357,263,277,0,0,0,3251,6308
67,64,377,2286,211,70,4,0,0,2948,289,2397,232,333,0,0,0,3251,6199
67,65,360,2244,233,87,1,0,0,2925,283,2259,217,341,1,0,0,3101,6026
67,66,315,2230,176,98,4,0,0,2823,239,2291,231,378,1,0,0,3140,5963
67,67,295,2296,175,106,2,0,1,2875,236,2274,250,470,0,0,0,3230,6105
67,68,253,2164,182,105,1,0,0,2705,195,2171,214,472,0,0,0,3052,5757
67,69,242,2148,128,111,1,0,0,2630,196,2017,183,461,0,0,0,2857,5487
67,70,198,1987,125,130,4,0,0,2444,171,2060,162,511,1,0,0,2905,5349
67,71,201,2057,131,140,2,0,0,2531,149,1922,179,562,0,0,0,2812,5343
67,72,198,2072,123,133,4,0,0,2530,167,1893,121,605,0,0,0,2786,5316
67,73,183,2108,122,172,2,0,0,2587,155,1870,145,693,1,0,0,2864,5451
67,74,149,1970,85,159,0,0,0,2363,141,1723,129,764,0,0,0,2757,5120
67,75,179,2070,58,192,1,0,0,2500,135,1756,101,768,0,0,0,2760,5260
67,76,153,1935,72,198,1,0,0,2359,126,1599,102,905,0,0,0,2732,5091
67,77,158,1843,75,249,0,0,0,2325,133,1573,88,1031,0,0,0,2825,5150
67,78,114,1548,55,203,1,0,0,1921,85,1160,67,868,0,0,0,2180,4101
67,79,99,1398,46,187,0,0,0,1730,90,1098,60,931,1,0,0,2180,3910
67,80,101,1422,39,211,0,0,0,1773,99,1074,38,1079,0,0,0,2290,4063
67,81,114,1221,28,235,2,0,0,1600,104,904,46,1092,0,0,0,2146,3746
67,82,95,1220,28,217,1,0,0,1561,102,773,37,1171,0,0,0,2083,3644
67,83,79,1236,19,237,0,0,0,1571,101,823,44,1380,0,0,0,2348,3919
67,84,80,1213,26,250,1,0,0,1570,101,675,30,1470,0,0,0,2276,3846
67,85,88,1011,17,259,0,0,0,1375,116,545,30,1459,0,0,0,2150,3525
67,86,66,953,18,228,0,0,0,1265,72,407,19,1374,0,0,0,1872,3137
67,87,38,699,9,224,0,0,0,970,73,304,14,1309,0,0,0,1700,2670
67,88,48,639,5,229,0,0,0,921,82,239,22,1258,0,0,0,1601,2522
67,89,45,508,6,187,0,0,0,746,56,173,10,1141,0,0,0,1380,2126
67,90,19,402,10,180,0,0,0,611,58,108,13,982,0,0,0,1161,1772
67,91,18,290,4,157,0,0,0,469,61,72,6,812,0,0,0,951,1420
67,92,12,224,2,130,0,0,0,368,53,64,10,820,0,0,0,947,1315
67,93,6,178,4,110,0,0,0,298,43,33,3,663,0,0,0,742,1040
67,94,7,106,1,94,0,0,0,208,41,18,3,514,0,0,0,576,784
67,95,5,78,0,61,0,0,0,144,40,10,1,394,0,0,0,445,589
67,96,2,47,0,65,0,0,0,114,25,4,1,288,0,0,0,318,432
67,97,0,11,0,40,0,0,0,51,18,3,1,213,0,0,0,235,286
67,98,2,16,0,22,0,0,0,40,9,5,1,159,0,0,0,174,214
67,99,1,7,1,21,0,0,0,30,6,2,1,115,0,0,0,124,154
67,100,0,5,0,13,0,0,0,18,17,2,3,163,0,0,0,185,203
67,999,109232,102528,7624,6199,174,2,2,225761,91019,103621,10443,30675,108,1,1,235868,461629
68,0,981,0,0,0,0,0,0,981,915,0,0,0,0,0,0,915,1896
68,1,977,0,0,0,0,0,0,977,892,0,0,0,0,0,0,892,1869
68,2,1054,0,0,0,0,0,0,1054,1002,0,0,0,0,0,0,1002,2056
68,3,1090,0,0,0,0,0,0,1090,998,0,0,0,0,0,0,998,2088
68,4,1094,0,0,0,0,0,0,1094,1036,0,0,0,0,0,0,1036,2130
68,5,1148,0,0,0,0,0,0,1148,1060,0,0,0,0,0,0,1060,2208
68,6,1214,0,0,0,0,0,0,1214,1167,0,0,0,0,0,0,1167,2381
68,7,1226,0,0,0,0,0,0,1226,1238,0,0,0,0,0,0,1238,2464
68,8,1244,0,0,0,0,0,0,1244,1217,0,0,0,0,0,0,1217,2461
68,9,1299,0,0,0,0,0,0,1299,1285,0,0,0,0,0,0,1285,2584
68,10,1337,0,0,0,0,0,0,1337,1190,0,0,0,0,0,0,1190,2527
68,11,1354,0,0,0,0,0,0,1354,1292,0,0,0,0,0,0,1292,2646
68,12,1385,0,0,0,0,0,0,1385,1384,0,0,0,0,0,0,1384,2769
68,13,1524,0,0,0,0,0,0,1524,1328,0,0,0,0,0,0,1328,2852
68,14,1484,0,0,0,0,0,0,1484,1431,0,0,0,0,0,0,1431,2915
68,15,1472,0,0,0,0,0,0,1472,1369,0,0,0,0,0,0,1369,2841
68,16,1479,0,0,0,0,0,0,1479,1433,0,0,0,0,0,0,1433,2912
68,17,1413,0,0,0,0,0,0,1413,1384,1,0,0,0,0,0,1385,2798
68,18,1408,1,0,0,0,0,0,1409,1383,4,0,0,0,0,0,1387,2796
68,19,1500,0,0,0,0,0,0,1500,1307,2,0,0,0,0,0,1309,2809
68,20,1551,0,0,0,0,0,0,1551,1355,11,0,0,0,0,0,1366,2917
68,21,1511,5,0,0,0,0,0,1516,1343,13,0,0,0,0,0,1356,2872
68,22,1445,5,2,0,0,0,0,1452,1333,27,1,0,0,0,0,1361,2813
68,23,1540,15,0,0,0,0,0,1555,1364,52,2,0,0,0,0,1418,2973
68,24,1536,15,0,0,1,0,0,1552,1332,69,2,0,0,0,0,1403,2955
68,25,1530,29,2,1,0,0,0,1562,1259,102,0,0,0,1,0,1362,2924
68,26,1596,48,3,0,0,0,0,1647,1209,165,4,0,1,0,0,1379,3026
68,27,1434,81,3,0,0,0,0,1518,1249,187,4,1,0,0,0,1441,2959
68,28,1415,115,3,0,1,0,0,1534,1139,241,8,0,2,0,0,1390,2924
68,29,1440,146,1,1,0,0,0,1588,1119,301,10,0,0,0,0,1430,3018
68,30,1428,190,4,0,0,0,0,1622,1054,395,6,0,1,0,0,1456,3078
68,31,1353,270,9,0,2,0,0,1634,995,488,18,0,1,0,0,1502,3136
68,32,1242,316,5,1,1,0,0,1565,983,567,22,0,1,0,0,1573,3138
68,33,1305,386,8,1,2,0,0,1702,937,663,20,3,3,0,0,1626,3328
68,34,1199,465,8,0,1,0,0,1673,813,660,32,3,1,0,0,1509,3182
68,35,1108,540,14,1,1,0,0,1664,827,814,33,3,1,0,0,1678,3342
68,36,978,638,15,0,0,0,0,1631,699,831,33,5,2,0,1,1571,3202
68,37,1012,678,21,2,1,0,0,1714,753,831,49,10,1,0,0,1644,3358
68,38,971,729,21,8,2,0,0,1731,699,975,52,4,1,1,0,1732,3463
68,39,945,736,40,3,4,0,0,1728,641,992,70,6,0,0,0,1709,3437
68,40,867,827,48,2,0,0,0,1744,593,1069,80,9,3,0,0,1754,3498
68,41,878,962,37,1,1,0,0,1879,651,1124,65,11,0,0,0,1851,3730
68,42,869,958,57,1,3,0,0,1888,584,1176,79,17,4,0,0,1860,3748
68,43,840,987,61,6,1,0,0,1895,543,1228,112,17,3,0,0,1903,3798
68,44,819,1062,56,8,2,0,0,1947,556,1335,111,25,1,0,0,2028,3975
68,45,824,1169,85,5,4,0,0,2087,583,1291,146,24,0,0,0,2044,4131
68,46,796,1232,105,5,2,0,0,2140,538,1463,149,17,1,0,0,2168,4308
68,47,785,1297,117,8,0,0,0,2207,508,1493,155,36,1,0,0,2193,4400
68,48,806,1347,101,11,1,0,0,2266,536,1574,182,32,1,0,0,2325,4591
68,49,741,1458,125,7,4,0,0,2335,515,1615,204,43,0,0,0,2377,4712
68,50,702,1442,121,9,2,0,0,2276,488,1589,178,53,0,0,0,2308,4584
68,51,690,1479,168,16,0,0,0,2353,404,1611,207,52,0,0,0,2274,4627
68,52,679,1519,136,14,0,0,0,2348,431,1765,206,63,0,0,0,2465,4813
68,53,581,1546,138,10,1,0,0,2276,382,1610,189,72,0,0,0,2253,4529
68,54,583,1601,201,23,0,0,0,2408,376,1780,193,82,0,0,0,2431,4839
68,55,529,1697,158,14,0,0,0,2398,332,1705,210,99,0,0,0,2346,4744
68,56,489,1629,163,24,0,0,0,2305,347,1787,189,106,0,0,0,2429,4734
68,57,483,1664,182,22,1,0,0,2352,342,1756,214,104,0,0,0,2416,4768
68,58,427,1702,192,20,1,0,0,2342,293,1833,228,124,1,0,1,2480,4822
68,59,449,1779,211,21,0,0,0,2460,273,1862,195,135,1,0,0,2466,4926
68,60,346,1685,171,33,1,0,0,2236,256,1773,203,142,2,0,0,2376,4612
68,61,340,1692,170,42,0,0,0,2244,220,1634,185,147,1,0,0,2187,4431
68,62,331,1698,149,45,2,0,0,2225,241,1679,200,180,0,0,0,2300,4525
68,63,275,1630,151,56,0,0,0,2112,210,1683,157,222,0,0,0,2272,4384
68,64,277,1623,136,39,0,0,0,2075,172,1667,148,237,0,0,0,2224,4299
68,65,235,1578,115,57,1,0,0,1986,172,1539,163,216,1,0,0,2091,4077
68,66,197,1504,123,67,1,0,0,1892,167,1547,163,290,0,0,0,2167,4059
68,67,193,1550,95,83,1,0,0,1922,167,1452,125,271,0,0,0,2015,3937
68,68,190,1443,104,85,2,0,0,1824,141,1408,120,368,0,0,0,2037,3861
68,69,179,1467,83,90,1,0,0,1820,120,1378,109,333,0,0,0,1940,3760
68,70,177,1445,85,79,0,0,0,1786,96,1291,107,367,0,0,0,1861,3647
68,71,164,1470,90,96,1,0,0,1821,113,1279,86,426,0,0,0,1904,3725
68,72,163,1383,70,99,0,0,0,1715,112,1341,95,443,0,0,0,1991,3706
68,73,133,1412,65,93,0,0,0,1703,95,1244,92,498,0,0,0,1929,3632
68,74,146,1329,59,102,0,0,0,1636,83,1077,68,514,0,0,0,1742,3378
68,75,112,1298,57,121,1,0,0,1589,102,1155,48,616,0,0,0,1921,3510
68,76,130,1277,48,103,2,0,0,1560,62,1006,59,642,0,0,0,1769,3329
68,77,101,1116,36,147,1,0,0,1401,61,974,45,640,0,0,0,1720,3121
68,78,79,928,30,114,0,0,0,1151,66,721,45,641,0,0,0,1473,2624
68,79,93,898,29,116,0,0,0,1136,67,627,33,673,0,0,0,1400,2536
68,80,73,881,26,122,1,0,0,1103,64,607,34,720,0,0,0,1425,2528
68,81,74,830,18,125,1,0,0,1048,45,530,26,802,0,0,0,1403,2451
68,82,72,716,15,121,0,0,0,924,67,519,19,779,0,0,0,1384,2308
68,83,81,830,15,157,0,0,0,1083,53,497,30,895,0,0,0,1475,2558
68,84,87,826,13,159,0,0,0,1085,69,457,24,975,0,0,0,1525,2610
68,85,61,756,14,225,0,0,0,1056,60,335,15,1104,0,0,0,1514,2570
68,86,67,612,11,161,0,0,0,851,55,279,8,919,0,0,0,1261,2112
68,87,38,457,9,136,0,0,0,640,53,169,12,883,0,0,0,1117,1757
68,88,42,465,6,134,0,0,0,647,47,143,7,872,0,0,0,1069,1716
68,89,32,359,6,161,0,0,0,558,39,86,9,787,0,0,0,921,1479
68,90,24,263,1,120,0,0,0,408,35,58,5,695,0,0,0,793,1201
68,91,24,188,1,90,0,0,0,303,35,47,5,603,0,0,0,690,993
68,92,18,152,4,82,0,0,0,256,22,28,2,494,0,0,0,546,802
68,93,8,101,0,75,0,0,0,184,26,21,3,470,0,0,0,520,704
68,94,13,60,1,65,0,0,0,139,17,3,3,319,0,0,0,342,481
68,95,7,55,1,42,0,0,0,105,17,9,2,230,0,0,0,258,363
68,96,0,29,0,38,0,0,0,67,15,4,2,222,0,0,0,243,310
68,97,2,13,0,17,0,0,0,32,15,5,1,161,0,0,0,182,214
68,98,3,5,0,15,0,0,0,23,11,1,1,87,0,0,0,100,123
68,99,1,10,0,11,0,0,0,22,4,1,0,62,0,0,0,67,89
68,100,0,8,0,16,0,0,0,24,12,1,0,110,0,0,0,123,147
68,999,70647,68807,4628,3984,55,0,0,148121,58173,69332,6117,21211,35,2,2,154872,302993
69,0,627,0,0,0,0,0,0,627,565,0,0,0,0,0,0,565,1192
69,1,622,0,0,0,0,0,0,622,564,0,0,0,0,0,0,564,1186
69,2,620,0,0,0,0,0,0,620,619,0,0,0,0,0,0,619,1239
69,3,659,0,0,0,0,0,0,659,627,0,0,0,0,0,0,627,1286
69,4,633,0,0,0,0,0,0,633,638,0,0,0,0,0,0,638,1271
69,5,672,0,0,0,0,0,0,672,666,0,0,0,0,0,0,666,1338
69,6,696,0,0,0,0,0,0,696,724,0,0,0,0,0,0,724,1420
69,7,813,0,0,0,0,0,0,813,719,0,0,0,0,0,0,719,1532
69,8,774,0,0,0,0,0,0,774,787,0,0,0,0,0,0,787,1561
69,9,889,0,0,0,0,0,0,889,780,0,0,0,0,0,0,780,1669
69,10,854,0,0,0,0,0,0,854,834,0,0,0,0,0,0,834,1688
69,11,837,0,0,0,0,0,0,837,827,0,0,0,0,0,0,827,1664
69,12,875,0,0,0,0,0,0,875,823,0,0,0,0,0,0,823,1698
69,13,889,0,0,0,0,0,0,889,879,0,0,0,0,0,0,879,1768
69,14,913,0,0,0,0,0,0,913,868,0,0,0,0,0,0,868,1781
69,15,977,0,0,0,0,0,0,977,894,0,0,0,0,0,0,894,1871
69,16,940,0,0,0,0,0,0,940,840,0,0,0,0,0,0,840,1780
69,17,952,0,0,0,0,0,0,952,855,0,0,0,0,0,0,855,1807
69,18,924,0,0,0,0,0,0,924,894,0,0,0,0,0,0,894,1818
69,19,1014,0,0,0,0,0,0,1014,927,1,0,0,0,0,0,928,1942
69,20,975,2,0,0,0,0,0,977,833,4,0,0,0,0,0,837,1814
69,21,978,0,0,0,0,0,0,978,801,9,0,0,0,0,0,810,1788
69,22,983,2,0,0,0,0,0,985,844,19,0,0,0,0,0,863,1848
69,23,1064,4,1,0,0,0,0,1069,910,22,0,0,0,0,0,932,2001
69,24,1046,10,0,0,0,0,0,1056,902,31,0,0,0,0,0,933,1989
69,25,1107,13,1,0,0,0,0,1121,941,41,0,0,0,0,0,982,2103
69,26,961,21,0,0,0,0,0,982,873,71,1,0,0,0,0,945,1927
69,27,1038,32,0,0,0,0,0,1070,783,99,4,0,0,0,0,886,1956
69,28,1009,53,1,0,0,0,0,1063,797,118,3,0,1,0,0,919,1982
69,29,961,79,0,0,0,0,0,1040,772,166,2,2,0,0,0,942,1982
69,30,989,97,0,0,0,0,0,1086,774,207,6,0,0,0,0,987,2073
69,31,959,148,3,0,0,0,0,1110,708,260,10,2,0,0,0,980,2090
69,32,884,202,5,1,1,0,0,1093,653,346,11,0,1,0,0,1011,2104
69,33,884,247,8,0,0,0,0,1139,613,339,14,1,1,0,0,968,2107
69,34,785,304,8,2,1,0,0,1100,587,437,18,2,2,0,0,1046,2146
69,35,772,329,12,0,0,0,0,1113,585,489,23,2,0,0,0,1099,2212
69,36,744,355,17,0,1,0,0,1117,499,541,20,3,0,0,0,1063,2180
69,37,689,381,21,0,0,0,0,1091,493,556,27,3,1,0,0,1080,2171
69,38,676,426,22,0,1,0,0,1125,474,615,36,6,1,0,0,1132,2257
69,39,635,516,24,0,1,0,0,1176,409,657,34,5,0,0,0,1105,2281
69,40,613,533,26,1,2,0,0,1175,407,721,48,4,0,0,0,1180,2355
69,41,580,588,32,1,0,0,0,1201,407,661,61,8,0,0,0,1137,2338
69,42,570,596,29,7,1,0,0,1203,394,702,64,4,0,0,0,1164,2367
69,43,573,669,32,2,2,0,0,1278,353,764,68,16,0,0,0,1201,2479
69,44,517,700,46,13,0,0,0,1276,364,825,79,9,1,0,0,1278,2554
69,45,539,686,63,3,1,0,0,1292,377,895,108,11,0,0,0,1391,2683
69,46,498,734,45,4,2,0,0,1283,360,989,88,16,0,0,0,1453,2736
69,47,486,799,72,5,3,0,0,1365,310,950,105,24,1,0,0,1390,2755
69,48,472,916,77,1,0,0,0,1466,335,1008,112,14,1,0,0,1470,2936
69,49,506,944,69,7,2,0,0,1528,358,1024,121,29,0,0,0,1532,3060
69,50,492,938,91,4,2,0,0,1527,287,1071,121,26,1,0,0,1506,3033
69,51,504,976,93,6,0,0,0,1579,330,1165,132,30,1,0,0,1658,3237
69,52,419,1029,102,7,1,0,0,1558,275,1155,133,43,0,0,0,1606,3164
69,53,423,987,94,10,0,0,0,1514,242,1209,159,54,0,0,0,1664,3178
69,54,394,1054,108,8,2,0,0,1566,257,1210,174,45,0,0,0,1686,3252
69,55,364,1144,117,17,3,0,0,1645,245,1236,156,67,0,0,0,1704,3349
69,56,336,1123,127,11,3,0,0,1600,194,1266,155,67,0,0,0,1682,3282
69,57,300,1094,107,22,3,0,0,1526,199,1238,145,87,1,0,0,1670,3196
69,58,274,1236,131,16,2,0,0,1659,205,1284,143,85,0,0,0,1717,3376
69,59,257,1286,125,19,0,0,0,1687,210,1358,154,97,0,0,0,1819,3506
69,60,241,1164,132,19,2,0,0,1558,161,1309,140,113,0,0,0,1723,3281
69,61,205,1162,107,22,0,0,0,1496,147,1168,135,125,0,0,0,1575,3071
69,62,177,1147,116,31,1,0,0,1472,160,1123,130,130,1,0,0,1544,3016
69,63,177,1157,104,31,4,0,0,1473,147,1170,108,133,0,0,0,1558,3031
69,64,163,1100,92,20,2,0,0,1377,138,1112,96,158,1,0,0,1505,2882
69,65,157,1055,78,35,1,0,0,1326,131,1138,109,178,0,0,0,1556,2882
69,66,126,1040,72,33,0,0,0,1271,116,1103,95,165,0,0,0,1479,2750
69,67,137,1044,75,37,0,0,0,1293,96,1056,69,236,0,0,0,1457,2750
69,68,112,1028,54,39,0,0,0,1233,104,992,70,246,0,0,0,1412,2645
69,69,113,946,62,54,1,0,0,1176,94,995,59,211,0,0,0,1359,2535
69,70,88,990,47,44,0,0,0,1169,89,899,64,268,1,0,0,1321,2490
69,71,99,932,35,56,0,0,0,1122,72,883,51,281,1,0,0,1288,2410
69,72,74,921,52,53,0,0,0,1100,56,812,34,331,0,0,0,1233,2333
69,73,67,970,40,73,0,0,0,1150,58,854,41,324,0,0,0,1277,2427
69,74,75,924,37,62,0,0,0,1098,61,828,41,327,0,0,0,1257,2355
69,75,56,949,20,68,0,0,0,1093,66,781,26,450,0,0,0,1323,2416
69,76,58,873,38,80,0,0,0,1049,65,691,42,459,0,0,0,1257,2306
69,77,53,809,21,83,0,0,0,966,71,619,42,455,0,0,0,1187,2153
69,78,49,663,21,72,1,0,0,806,38,497,27,454,0,0,0,1016,1822
69,79,44,584,15,74,0,0,0,717,40,401,20,414,0,0,0,875,1592
69,80,44,673,19,92,0,0,0,828,41,395,18,517,0,0,0,971,1799
69,81,33,609,14,75,0,0,0,731,32,346,14,529,0,0,0,921,1652
69,82,38,555,13,81,0,0,0,687,63,324,10,553,0,0,0,950,1637
69,83,37,601,17,115,0,0,0,770,58,335,18,631,0,0,0,1042,1812
69,84,40,538,7,117,0,0,0,702,41,302,11,640,0,0,0,994,1696
69,85,28,501,6,114,0,0,0,649,47,258,17,653,0,0,0,975,1624
69,86,27,438,4,103,0,0,0,572,33,185,6,599,0,0,0,823,1395
69,87,26,342,3,91,0,0,0,462,39,142,8,550,0,0,0,739,1201
69,88,17,313,4,100,0,0,0,434,26,100,7,528,0,0,0,661,1095
69,89,14,253,0,93,0,0,0,360,28,61,4,481,0,0,0,574,934
69,90,10,196,3,95,0,0,0,304,33,46,3,464,0,0,0,546,850
69,91,14,119,2,74,0,0,0,209,23,32,2,347,0,0,0,404,613
69,92,5,89,3,63,0,0,0,160,23,19,4,346,0,0,0,392,552
69,93,5,67,1,39,0,0,0,112,13,20,0,289,0,0,0,322,434
69,94,9,44,0,43,0,0,0,96,10,8,2,210,0,0,0,230,326
69,95,2,40,0,33,0,0,0,75,15,4,0,142,0,0,0,161,236
69,96,2,18,0,27,0,0,0,47,12,7,2,117,0,0,0,138,185
69,97,1,13,1,16,0,0,0,31,9,5,0,83,0,0,0,97,128
69,98,0,7,0,12,0,0,0,19,8,2,0,63,0,0,0,73,92
69,99,0,2,0,2,0,0,0,4,3,1,0,34,0,0,0,38,42
69,100,1,2,0,10,0,0,0,13,5,1,0,70,0,0,0,76,89
69,999,46060,46131,3024,2548,46,0,0,97809,38162,46783,4060,14066,17,0,0,103088,200897
70,0,461,0,0,0,0,0,0,461,457,0,0,0,0,0,0,457,918
70,1,483,0,0,0,0,0,0,483,514,0,0,0,0,0,0,514,997
70,2,530,0,0,0,0,0,0,530,479,0,0,0,0,0,0,479,1009
70,3,527,0,0,0,0,0,0,527,469,0,0,0,0,0,0,469,996
70,4,518,0,0,0,0,0,0,518,529,0,0,0,0,0,0,529,1047
70,5,594,0,0,0,0,0,0,594,564,0,0,0,0,0,0,564,1158
70,6,648,0,0,0,0,0,0,648,613,0,0,0,0,0,0,613,1261
70,7,646,0,0,0,0,0,0,646,615,0,0,0,0,0,0,615,1261
70,8,661,0,0,0,0,0,0,661,573,0,0,0,0,0,0,573,1234
70,9,687,0,0,0,0,0,0,687,658,0,0,0,0,0,0,658,1345
70,10,733,0,0,0,0,0,0,733,710,0,0,0,0,0,0,710,1443
70,11,791,0,0,0,0,0,0,791,753,0,0,0,0,0,0,753,1544
70,12,769,0,0,0,0,0,0,769,795,0,0,0,0,0,0,795,1564
70,13,777,0,0,0,0,0,0,777,784,0,0,0,0,0,0,784,1561
70,14,768,0,0,0,0,0,0,768,736,0,0,0,0,0,0,736,1504
70,15,895,0,0,0,0,0,0,895,812,0,0,0,0,0,0,812,1707
70,16,830,0,0,0,0,0,0,830,777,0,0,0,0,0,0,777,1607
70,17,877,0,0,0,0,0,0,877,767,0,0,0,0,0,0,767,1644
70,18,887,0,0,0,0,0,0,887,764,1,0,0,0,0,0,765,1652
70,19,808,0,0,0,0,0,0,808,791,2,0,0,0,0,0,793,1601
70,20,837,2,0,0,0,0,0,839,758,7,0,0,0,0,0,765,1604
70,21,906,0,0,0,0,0,0,906,768,11,0,0,0,0,0,779,1685
70,22,849,3,0,0,0,0,0,852,744,13,0,0,0,0,0,757,1609
70,23,885,7,0,0,0,0,0,892,753,18,1,0,0,0,0,772,1664
70,24,831,9,0,0,0,0,0,840,770,29,0,0,1,0,0,800,1640
70,25,882,12,1,0,1,0,0,896,771,43,3,1,0,0,0,818,1714
70,26,847,16,0,0,0,0,0,863,689,60,1,0,0,0,0,750,1613
70,27,857,30,0,0,0,0,0,887,714,72,0,0,0,0,0,786,1673
70,28,877,44,0,0,0,0,0,921,709,100,6,1,0,0,0,816,1737
70,29,775,56,0,0,0,0,0,831,654,152,5,0,1,0,0,812,1643
70,30,813,91,1,0,0,0,0,905,606,191,7,1,0,0,0,805,1710
70,31,809,115,4,0,0,0,0,928,601,242,10,1,1,0,0,855,1783
70,32,749,130,3,1,1,0,0,884,581,279,9,2,1,0,0,872,1756
70,33,729,183,5,0,3,0,0,920,559,306,21,3,2,0,0,891,1811
70,34,696,196,7,0,1,0,0,900,512,312,16,0,0,0,0,840,1740
70,35,682,256,13,0,3,0,0,954,496,390,28,2,1,0,0,917,1871
70,36,623,271,13,0,1,0,0,908,472,430,29,2,0,0,0,933,1841
70,37,603,311,28,3,2,0,0,947,411,447,27,3,1,0,0,889,1836
70,38,619,334,22,1,0,0,0,976,461,498,29,4,2,0,0,994,1970
70,39,632,422,19,1,0,0,0,1074,433,529,44,1,0,0,0,1007,2081
70,40,615,447,31,2,1,0,0,1096,424,574,38,8,1,0,0,1045,2141
70,41,540,475,21,2,1,0,0,1039,397,626,46,5,1,0,0,1075,2114
70,42,511,532,32,3,3,0,0,1081,372,622,66,11,1,0,0,1072,2153
70,43,577,572,52,6,2,0,0,1209,373,630,70,10,0,0,0,1083,2292
70,44,549,544,50,3,4,0,0,1150,404,663,83,12,3,0,0,1165,2315
70,45,542,631,59,3,1,0,0,1236,366,704,96,11,1,0,0,1178,2414
70,46,559,694,67,4,1,0,0,1325,409,800,130,15,0,0,0,1354,2679
70,47,593,738,81,3,1,0,0,1416,368,824,123,18,2,0,0,1335,2751
70,48,542,816,78,10,1,0,0,1447,395,930,136,23,1,0,0,1485,2932
70,49,552,787,81,8,5,0,0,1433,371,974,156,26,0,0,0,1527,2960
70,50,508,872,122,3,1,0,0,1506,328,989,155,36,1,0,0,1509,3015
70,51,514,924,110,11,1,0,0,1560,301,1041,146,29,1,0,0,1518,3078
70,52,478,912,111,9,2,0,0,1512,349,949,169,41,1,0,0,1509,3021
70,53,423,958,133,6,5,0,0,1525,282,1042,198,51,2,0,0,1575,3100
70,54,441,981,150,16,1,0,0,1589,320,1105,194,49,2,0,0,1670,3259
70,55,357,969,144,12,4,0,0,1486,259,1065,157,58,2,0,0,1541,3027
70,56,367,995,141,8,0,0,0,1511,252,1070,177,51,2,0,0,1552,3063
70,57,351,1038,142,21,3,0,1,1556,203,1130,201,70,0,0,0,1604,3160
70,58,330,1133,156,20,0,0,0,1639,221,1141,191,63,0,0,0,1616,3255
70,59,291,1196,174,24,4,0,0,1689,207,1210,200,93,2,0,0,1712,3401
70,60,231,1160,173,19,2,0,0,1585,179,1224,208,92,1,0,0,1704,3289
70,61,231,1130,160,30,1,0,0,1552,165,1123,168,98,1,0,0,1555,3107
70,62,237,1050,145,36,0,0,0,1468,145,1135,137,133,0,0,0,1550,3018
70,63,183,1015,125,26,0,0,0,1349,143,1006,154,125,0,0,0,1428,2777
70,64,167,1071,126,37,1,0,0,1402,126,1027,141,149,2,0,0,1445,2847
70,65,165,1047,106,51,2,1,0,1372,138,1086,124,183,0,0,0,1531,2903
70,66,160,1025,97,28,1,0,0,1311,111,1030,121,216,0,0,0,1478,2789
70,67,141,1057,97,47,3,0,0,1345,88,963,101,234,0,0,0,1386,2731
70,68,124,950,95,67,1,0,0,1237,105,1003,83,224,0,0,0,1415,2652
70,69,132,994,75,52,3,0,0,1256,88,876,85,228,0,0,0,1277,2533
70,70,101,912,58,62,1,0,0,1134,90,839,68,291,0,0,0,1288,2422
70,71,84,904,47,58,0,0,0,1093,75,756,66,275,0,0,0,1172,2265
70,72,89,856,55,66,1,0,0,1067,63,742,60,276,1,0,0,1142,2209
70,73,93,905,54,71,0,0,0,1123,72,731,73,340,0,0,0,1216,2339
70,74,82,885,47,95,1,0,0,1110,62,753,76,358,0,0,0,1249,2359
70,75,89,899,58,95,0,0,0,1141,63,743,62,432,0,0,0,1300,2441
70,76,77,896,48,104,1,0,0,1126,52,789,49,473,0,0,0,1363,2489
70,77,87,885,42,106,0,0,0,1120,49,675,54,520,0,0,0,1298,2418
70,78,40,519,28,71,0,0,0,658,38,432,29,363,0,0,0,862,1520
70,79,45,626,15,96,0,0,0,782,42,493,49,483,1,0,0,1068,1850
70,80,45,569,21,90,0,0,0,725,41,417,28,444,0,0,0,930,1655
70,81,37,577,15,91,0,0,0,720,35,401,19,471,0,0,0,926,1646
70,82,46,585,16,111,0,0,0,758,37,424,32,544,0,0,0,1037,1795
70,83,43,569,22,137,0,0,0,771,45,394,30,686,0,0,0,1155,1926
70,84,31,494,11,135,0,0,0,671,40,301,18,596,0,0,0,955,1626
70,85,36,461,13,136,0,0,0,646,46,213,9,631,0,0,0,899,1545
70,86,38,347,6,117,0,0,0,508,35,177,13,609,0,0,0,834,1342
70,87,21,272,5,101,0,0,0,399,34,138,13,536,0,0,0,721,1120
70,88,20,228,4,78,0,0,0,330,32,110,9,516,0,0,0,667,997
70,89,15,170,2,87,0,0,0,274,27,77,12,442,0,0,0,558,832
70,90,11,145,1,67,0,0,0,224,21,53,9,404,0,0,0,487,711
70,91,13,107,0,76,0,0,0,196,25,35,5,368,0,0,0,433,629
70,92,7,72,0,52,0,0,0,131,13,24,7,306,0,0,0,350,481
70,93,9,51,2,50,0,0,0,112,20,12,8,283,0,0,0,323,435
70,94,2,38,0,51,0,0,0,91,19,7,3,221,0,0,0,250,341
70,95,2,17,0,27,0,0,0,46,10,12,4,184,0,0,0,210,256
70,96,0,24,0,16,0,0,0,40,5,4,2,104,0,0,0,115,155
70,97,0,11,1,13,0,0,0,25,6,3,1,94,0,0,0,104,129
70,98,1,4,0,14,0,0,0,19,5,2,0,66,0,0,0,73,92
70,99,2,2,0,5,0,0,0,9,2,2,0,44,0,0,0,48,57
70,100,2,2,0,7,0,0,0,11,3,2,0,74,0,0,0,79,90
70,999,41970,42233,3821,2858,71,1,1,90955,34618,42455,5098,13817,39,0,0,96027,186982
71,0,1066,0,0,0,0,0,0,1066,960,0,0,0,0,0,0,960,2026
71,1,1088,0,0,0,0,0,0,1088,1012,0,0,0,0,0,0,1012,2100
71,2,1167,0,0,0,0,0,0,1167,1146,0,0,0,0,0,0,1146,2313
71,3,1114,0,0,0,0,0,0,1114,1118,0,0,0,0,0,0,1118,2232
71,4,1257,0,0,0,0,0,0,1257,1233,0,0,0,0,0,0,1233,2490
71,5,1258,0,0,0,0,0,0,1258,1260,0,0,0,0,0,0,1260,2518
71,6,1404,0,0,0,0,0,0,1404,1275,0,0,0,0,0,0,1275,2679
71,7,1447,0,0,0,0,0,0,1447,1364,0,0,0,0,0,0,1364,2811
71,8,1482,0,0,0,0,0,0,1482,1364,0,0,0,0,0,0,1364,2846
71,9,1517,0,0,0,0,0,0,1517,1459,0,0,0,0,0,0,1459,2976
71,10,1595,0,0,0,0,0,0,1595,1534,0,0,0,0,0,0,1534,3129
71,11,1732,0,0,0,0,0,0,1732,1652,0,0,0,0,0,0,1652,3384
71,12,1646,0,0,0,0,0,0,1646,1637,0,0,0,0,0,0,1637,3283
71,13,1758,0,0,0,0,0,0,1758,1656,0,0,0,0,0,0,1656,3414
71,14,1778,0,0,0,0,0,0,1778,1577,0,0,0,0,0,0,1577,3355
71,15,1878,0,0,0,0,0,0,1878,1798,0,0,0,0,0,0,1798,3676
71,16,1853,0,0,0,0,0,0,1853,1715,0,0,0,0,0,0,1715,3568
71,17,1839,0,0,0,0,0,0,1839,1742,0,0,0,0,0,0,1742,3581
71,18,1898,0,0,0,0,0,0,1898,1718,0,0,0,0,0,0,1718,3616
71,19,1808,0,0,0,0,0,0,1808,1672,4,0,0,0,0,0,1676,3484
71,20,1829,4,0,0,0,0,0,1833,1620,9,1,0,1,0,0,1631,3464
71,21,1797,2,0,0,1,0,0,1800,1630,16,0,0,0,0,0,1646,3446
71,22,1825,3,1,0,0,0,0,1829,1665,38,1,0,0,0,0,1704,3533
71,23,1781,11,2,0,1,0,0,1795,1586,41,1,0,0,0,0,1628,3423
71,24,1824,27,3,0,0,0,0,1854,1530,63,5,0,0,0,0,1598,3452
71,25,1838,28,1,0,1,0,0,1868,1583,78,2,0,0,0,0,1663,3531
71,26,1812,43,2,0,0,0,0,1857,1503,127,2,0,2,0,0,1634,3491
71,27,1755,61,2,0,0,0,0,1818,1582,165,4,1,0,0,0,1752,3570
71,28,1712,82,5,0,2,0,1,1802,1409,245,6,0,2,0,0,1662,3464
71,29,1660,142,1,0,0,0,0,1803,1400,286,11,0,2,0,0,1699,3502
71,30,1699,175,10,0,0,0,0,1884,1321,400,11,0,2,0,0,1734,3618
71,31,1608,252,8,0,4,0,0,1872,1286,509,14,1,3,0,0,1813,3685
71,32,1580,334,7,1,3,0,0,1925,1220,598,24,0,2,1,0,1845,3770
71,33,1515,410,16,0,2,1,0,1944,1195,664,28,4,8,0,0,1899,3843
71,34,1378,479,15,2,4,0,0,1878,1044,714,39,3,8,0,0,1808,3686
71,35,1348,582,24,0,5,1,0,1960,1065,893,37,6,7,0,1,2009,3969
71,36,1238,612,23,1,3,0,0,1877,904,924,56,0,11,0,0,1895,3772
71,37,1201,715,32,1,3,2,0,1954,842,913,69,7,12,0,0,1843,3797
71,38,1144,816,47,0,3,1,0,2011,919,1064,76,9,5,0,0,2073,4084
71,39,1124,894,60,0,6,0,0,2084,822,1137,93,7,11,0,0,2070,4154
71,40,1047,941,58,4,4,0,1,2055,823,1159,109,10,7,0,0,2108,4163
71,41,1121,1017,64,1,10,0,0,2213,827,1288,114,12,6,0,0,2247,4460
71,42,1059,1119,80,6,4,0,0,2268,771,1319,142,16,5,1,0,2254,4522
71,43,1027,1165,109,6,0,1,0,2308,802,1448,148,25,6,3,0,2432,4740
71,44,1033,1265,93,9,8,0,0,2408,766,1517,166,20,4,0,0,2473,4881
71,45,1019,1387,101,4,9,0,1,2521,822,1642,198,25,6,1,0,2694,5215
71,46,1109,1475,138,11,7,0,0,2740,760,1696,240,30,8,0,1,2735,5475
71,47,1063,1608,161,8,8,0,0,2848,767,1812,240,38,6,1,0,2864,5712
71,48,1122,1667,182,9,11,2,1,2994,829,1949,281,44,10,1,0,3114,6108
71,49,1055,1775,198,16,6,0,0,3050,738,2055,298,55,6,0,0,3152,6202
71,50,1033,1837,220,17,6,1,0,3114,691,2115,344,53,4,1,0,3208,6322
71,51,927,1927,262,15,9,0,0,3140,651,2212,374,57,12,0,0,3306,6446
71,52,882,1978,282,16,5,0,0,3163,655,2220,380,95,6,0,0,3356,6519
71,53,903,1983,282,26,3,1,0,3198,563,2170,404,85,10,0,0,3232,6430
71,54,791,2066,328,13,6,0,0,3204,557,2252,402,113,3,0,0,3327,6531
71,55,722,2169,318,22,12,0,0,3243,540,2287,395,115,5,0,0,3342,6585
71,56,701,2151,320,36,5,0,0,3213,484,2293,409,135,6,0,0,3327,6540
71,57,684,2192,335,39,10,0,0,3260,485,2312,407,132,4,0,0,3340,6600
71,58,623,2324,329,36,10,0,0,3322,483,2458,419,165,5,0,0,3530,6852
71,59,567,2281,368,40,8,0,1,3265,430,2415,467,190,3,0,0,3505,6770
71,60,508,2253,347,49,12,0,0,3169,319,2236,417,208,1,0,0,3181,6350
71,61,481,2099,276,48,9,0,0,2913,327,2119,368,242,3,0,0,3059,5972
71,62,422,2117,269,50,7,0,0,2865,309,2121,399,260,2,0,0,3091,5956
71,63,389,2138,295,60,8,0,0,2890,275,2027,332,280,5,0,0,2919,5809
71,64,343,1996,234,54,5,0,0,2632,230,2016,321,307,1,0,0,2875,5507
71,65,293,1894,251,64,2,0,0,2504,229,1943,258,280,0,0,0,2710,5214
71,66,269,1808,208,65,4,0,0,2354,209,1858,275,337,2,0,0,2681,5035
71,67,258,1849,207,105,5,0,0,2424,173,1786,224,356,1,0,0,2540,4964
71,68,239,1750,190,90,6,0,0,2275,152,1753,201,390,1,0,0,2497,4772
71,69,213,1817,177,79,4,0,0,2290,163,1706,225,419,0,0,0,2513,4803
71,70,185,1745,157,104,1,0,0,2192,160,1544,183,474,1,0,0,2362,4554
71,71,190,1699,124,127,4,0,0,2144,142,1620,166,541,1,0,0,2470,4614
71,72,156,1641,141,133,4,0,0,2075,106,1570,184,515,0,0,0,2375,4450
71,73,154,1741,113,136,5,0,1,2150,123,1504,158,568,0,0,0,2353,4503
71,74,156,1704,106,150,1,0,1,2118,117,1447,132,663,0,0,0,2359,4477
71,75,182,1764,112,159,0,0,0,2217,147,1530,132,763,0,0,0,2572,4789
71,76,177,1682,97,193,2,0,0,2151,123,1473,114,853,0,0,0,2563,4714
71,77,156,1738,85,227,1,0,0,2207,104,1401,104,972,1,0,0,2582,4789
71,78,108,1205,60,188,2,0,0,1563,84,978,85,728,0,0,0,1875,3438
71,79,125,1253,58,157,0,0,0,1593,99,939,74,903,1,0,0,2016,3609
71,80,91,1164,47,214,0,0,0,1516,85,838,67,894,2,0,0,1886,3402
71,81,101,1037,37,211,4,0,0,1390,94,795,69,954,0,0,0,1912,3302
71,82,90,1092,29,229,2,0,0,1442,86,698,57,1057,1,0,0,1899,3341
71,83,104,979,30,246,1,0,0,1360,89,655,52,1166,0,0,0,1962,3322
71,84,89,905,28,198,0,0,0,1220,91,580,36,1128,1,0,0,1836,3056
71,85,66,845,19,286,0,0,0,1216,76,492,34,1144,2,0,0,1748,2964
71,86,75,646,21,221,0,0,0,963,70,356,31,1036,1,0,0,1494,2457
71,87,58,509,19,231,1,0,0,818,71,258,32,910,0,0,0,1271,2089
71,88,38,458,10,240,0,0,0,746,69,202,31,934,0,0,0,1236,1982
71,89,29,341,16,171,0,0,0,557,57,154,14,817,0,0,0,1042,1599
71,90,30,268,4,154,0,0,0,456,60,107,8,725,0,0,0,900,1356
71,91,18,204,4,145,0,0,0,371,59,86,10,641,0,0,0,796,1167
71,92,13,153,0,105,0,0,0,271,59,56,10,558,0,0,0,683,954
71,93,18,113,4,103,0,0,0,238,36,33,6,489,0,0,0,564,802
71,94,9,40,4,74,0,0,0,127,29,23,5,376,0,0,0,433,560
71,95,6,35,2,48,0,0,0,91,24,11,3,294,0,0,0,332,423
71,96,3,18,1,39,0,0,0,61,25,11,4,202,0,0,0,242,303
71,97,3,13,1,24,0,0,0,41,15,2,1,143,0,0,0,161,202
71,98,5,12,0,10,0,0,0,27,14,2,2,111,0,0,0,129,156
71,99,1,8,0,12,0,0,0,21,10,1,1,80,0,0,0,92,113
71,100,3,8,1,21,0,0,0,33,11,6,2,97,0,0,0,116,149
71,999,86595,84740,8271,5559,269,10,7,185451,73183,86444,11244,25268,225,9,2,196375,381826
72,0,835,0,0,0,0,0,0,835,848,0,0,0,0,0,0,848,1683
72,1,917,0,0,0,0,0,0,917,851,0,0,0,0,0,0,851,1768
72,2,938,0,0,0,0,0,0,938,885,0,0,0,0,0,0,885,1823
72,3,947,0,0,0,0,0,0,947,903,0,0,0,0,0,0,903,1850
72,4,1006,0,0,0,0,0,0,1006,948,0,0,0,0,0,0,948,1954
72,5,1106,0,0,0,0,0,0,1106,1034,0,0,0,0,0,0,1034,2140
72,6,1136,0,0,0,0,0,0,1136,1050,0,0,0,0,0,0,1050,2186
72,7,1134,0,0,0,0,0,0,1134,1054,0,0,0,0,0,0,1054,2188
72,8,1227,0,0,0,0,0,0,1227,1135,0,0,0,0,0,0,1135,2362
72,9,1246,0,0,0,0,0,0,1246,1205,0,0,0,0,0,0,1205,2451
72,10,1221,0,0,0,0,0,0,1221,1177,0,0,0,0,0,0,1177,2398
72,11,1371,0,0,0,0,0,0,1371,1218,0,0,0,0,0,0,1218,2589
72,12,1397,0,0,0,0,0,0,1397,1262,0,0,0,0,0,0,1262,2659
72,13,1336,0,0,0,0,0,0,1336,1305,0,0,0,0,0,0,1305,2641
72,14,1398,0,0,0,0,0,0,1398,1286,0,0,0,0,0,0,1286,2684
72,15,1483,0,0,0,0,0,0,1483,1332,0,0,0,0,0,0,1332,2815
72,16,1444,0,0,0,0,0,0,1444,1292,0,0,0,0,0,0,1292,2736
72,17,1384,0,0,0,0,0,0,1384,1346,0,0,0,0,0,0,1346,2730
72,18,1396,0,0,0,0,0,0,1396,1276,2,0,0,0,0,0,1278,2674
72,19,1428,0,0,0,0,0,0,1428,1309,4,0,0,0,0,0,1313,2741
72,20,1379,4,0,0,0,0,0,1383,1248,11,0,0,0,0,0,1259,2642
72,21,1490,4,0,0,0,0,0,1494,1210,19,0,0,0,0,0,1229,2723
72,22,1376,6,0,0,0,0,0,1382,1292,39,1,0,0,0,0,1332,2714
72,23,1453,12,0,0,0,0,0,1465,1294,55,1,0,0,0,0,1350,2815
72,24,1370,8,0,0,1,0,0,1379,1157,74,1,0,0,0,0,1232,2611
72,25,1456,22,1,0,0,0,0,1479,1212,107,0,0,0,0,0,1319,2798
72,26,1335,44,6,0,0,0,0,1385,1182,139,3,0,0,0,0,1324,2709
72,27,1347,49,3,0,0,0,0,1399,1126,190,1,0,0,0,0,1317,2716
72,28,1296,83,1,0,0,0,0,1380,1016,240,10,0,2,0,0,1268,2648
72,29,1257,120,4,1,1,0,0,1383,1032,242,9,0,2,0,0,1285,2668
72,30,1229,167,2,0,2,0,0,1400,1006,322,8,0,0,1,0,1337,2737
72,31,1198,236,7,3,1,0,0,1445,937,480,16,0,2,1,0,1436,2881
72,32,1214,271,9,2,5,0,0,1501,859,494,21,2,5,0,0,1381,2882
72,33,1112,383,4,1,1,0,0,1501,864,572,18,3,3,0,1,1461,2962
72,34,1078,425,10,2,2,0,0,1517,861,598,22,4,7,0,0,1492,3009
72,35,1057,474,17,4,1,0,0,1553,777,735,27,5,3,0,0,1547,3100
72,36,936,568,18,0,4,0,0,1526,768,740,42,7,2,0,0,1559,3085
72,37,874,606,32,4,2,0,0,1518,704,841,66,4,2,0,0,1617,3135
72,38,900,635,33,2,3,0,0,1573,696,885,59,4,5,0,0,1649,3222
72,39,906,688,43,1,5,0,0,1643,634,841,72,7,2,1,0,1557,3200
72,40,827,818,42,1,2,0,0,1690,634,918,74,7,2,0,0,1635,3325
72,41,807,810,54,6,5,1,0,1683,640,1018,94,11,3,0,0,1766,3449
72,42,722,899,54,3,1,0,0,1679,600,1058,135,19,2,0,0,1814,3493
72,43,720,996,66,8,2,0,0,1792,587,1165,112,16,5,1,0,1886,3678
72,44,778,1042,86,5,1,0,0,1912,611,1184,143,21,3,0,0,1962,3874
72,45,783,1123,96,8,3,0,0,2013,588,1244,159,23,2,0,0,2016,4029
72,46,754,1172,118,7,4,0,0,2055,646,1353,156,31,1,0,0,2187,4242
72,47,782,1146,119,9,4,0,0,2060,626,1359,181,31,2,0,0,2199,4259
72,48,792,1327,146,8,3,0,0,2276,592,1514,227,35,4,1,0,2373,4649
72,49,755,1429,146,11,9,0,0,2350,564,1568,218,47,5,0,0,2402,4752
72,50,728,1460,164,7,5,0,0,2364,518,1597,265,53,3,0,0,2436,4800
72,51,723,1465,181,19,3,0,0,2391,484,1515,264,52,4,0,0,2319,4710
72,52,649,1523,196,22,2,0,0,2392,452,1718,284,54,3,0,0,2511,4903
72,53,612,1565,195,21,1,0,1,2395,422,1621,284,59,2,0,1,2389,4784
72,54,574,1651,208,21,2,0,0,2456,406,1718,251,68,3,0,0,2446,4902
72,55,523,1528,208,13,3,0,0,2275,397,1714,266,94,3,0,0,2474,4749
72,56,478,1591,188,17,5,0,0,2279,376,1703,285,85,3,0,0,2452,4731
72,57,441,1621,219,27,3,0,0,2311,337,1693,292,102,6,0,0,2430,4741
72,58,407,1672,221,31,4,0,0,2335,304,1661,281,109,2,0,0,2357,4692
72,59,391,1719,237,41,0,0,0,2388,267,1805,290,131,2,0,0,2495,4883
72,60,295,1656,205,23,6,0,0,2185,274,1684,260,137,2,0,0,2357,4542
72,61,283,1642,216,42,4,1,0,2188,236,1589,258,149,0,0,0,2232,4420
72,62,274,1622,151,45,1,0,1,2094,181,1639,241,191,1,0,0,2253,4347
72,63,214,1564,206,45,0,0,0,2029,174,1620,186,195,0,0,0,2175,4204
72,64,228,1535,159,42,1,0,0,1965,174,1501,207,203,1,0,0,2086,4051
72,65,195,1458,149,59,1,0,0,1862,159,1420,183,229,1,0,0,1992,3854
72,66,146,1427,138,55,1,0,0,1767,151,1435,166,273,0,0,0,2025,3792
72,67,133,1382,135,59,0,0,0,1709,113,1330,161,264,1,0,0,1869,3578
72,68,163,1385,118,72,1,0,0,1739,135,1281,154,303,1,0,0,1874,3613
72,69,126,1322,97,81,1,0,0,1627,112,1256,126,307,1,0,0,1802,3429
72,70,129,1254,97,80,0,0,0,1560,110,1137,127,344,0,0,0,1718,3278
72,71,99,1251,89,91,2,0,0,1532,98,1219,142,312,0,0,0,1771,3303
72,72,116,1290,98,89,0,0,0,1593,96,1150,108,384,1,0,0,1739,3332
72,73,89,1258,92,109,0,0,0,1548,83,1065,113,430,1,0,0,1692,3240
72,74,100,1219,75,115,1,0,0,1510,95,1135,81,455,1,0,0,1767,3277
72,75,109,1311,69,134,0,0,0,1623,95,1187,99,513,0,0,0,1894,3517
72,76,84,1370,56,131,1,0,0,1642,82,1138,113,591,0,0,0,1924,3566
72,77,94,1264,43,166,0,0,0,1567,89,1102,83,646,0,0,0,1920,3487
72,78,63,988,40,131,1,0,0,1223,65,785,58,594,0,0,0,1502,2725
72,79,59,911,41,129,0,0,0,1140,52,724,58,635,0,0,0,1469,2609
72,80,58,943,21,136,1,0,0,1159,58,710,51,641,0,0,0,1460,2619
72,81,59,770,31,137,1,0,0,998,53,609,42,654,0,0,0,1358,2356
72,82,50,754,22,162,1,0,0,989,54,579,47,702,0,0,0,1382,2371
72,83,47,744,24,193,0,0,0,1008,60,526,47,842,0,0,0,1475,2483
72,84,56,739,18,188,0,0,0,1001,52,436,31,819,0,0,0,1338,2339
72,85,41,614,16,187,0,0,0,858,47,375,24,822,0,0,0,1268,2126
72,86,39,548,15,191,0,0,0,793,63,286,28,839,0,0,0,1216,2009
72,87,36,415,8,174,0,0,0,633,59,219,24,764,0,0,0,1066,1699
72,88,26,399,8,142,0,0,0,575,45,175,16,724,0,0,0,960,1535
72,89,21,296,5,149,1,0,0,472,37,114,9,653,0,0,0,813,1285
72,90,14,215,4,117,0,0,0,350,31,77,10,572,0,0,0,690,1040
72,91,25,169,1,92,0,0,0,287,28,62,8,546,0,0,0,644,931
72,92,9,131,2,95,0,0,0,237,25,35,4,404,0,0,0,468,705
72,93,1,104,3,80,0,0,0,188,19,33,6,396,0,0,0,454,642
72,94,6,62,1,66,0,0,0,135,9,20,4,313,0,0,0,346,481
72,95,6,46,0,45,0,0,0,97,14,14,1,251,0,0,0,280,377
72,96,1,20,0,33,0,0,0,54,7,2,1,163,0,0,0,173,227
72,97,2,16,0,24,0,0,0,42,8,6,0,129,0,0,0,143,185
72,98,0,6,0,12,0,0,0,18,5,3,1,101,0,0,0,110,128
72,99,1,5,0,11,0,0,0,17,3,3,1,65,0,0,0,72,89
72,100,0,5,0,16,0,0,0,21,5,0,1,97,0,0,0,103,124
72,999,65356,65472,5587,4253,115,2,2,140787,55898,66437,7918,18736,106,5,2,149102,289889
73,0,2976,0,0,0,0,0,0,2976,2936,0,0,0,0,0,0,2936,5912
73,1,3273,0,0,0,0,0,0,3273,3022,0,0,0,0,0,0,3022,6295
73,2,3297,0,0,0,0,0,0,3297,3189,0,0,0,0,0,0,3189,6486
73,3,3370,0,0,0,0,0,0,3370,3073,0,0,0,0,0,0,3073,6443
73,4,3392,0,0,0,0,0,0,3392,3223,0,0,0,0,0,0,3223,6615
73,5,3565,0,0,0,0,0,0,3565,3484,0,0,0,0,0,0,3484,7049
73,6,3788,0,0,0,0,0,0,3788,3598,0,0,0,0,0,0,3598,7386
73,7,3874,0,0,0,0,0,0,3874,3713,0,0,0,0,0,0,3713,7587
73,8,4009,0,0,0,0,0,0,4009,3663,0,0,0,0,0,0,3663,7672
73,9,4221,0,0,0,0,0,0,4221,4029,0,0,0,0,0,0,4029,8250
73,10,4260,0,0,0,0,0,0,4260,3991,0,0,0,0,0,0,3991,8251
73,11,4479,0,0,0,0,0,0,4479,4267,0,0,0,0,0,0,4267,8746
73,12,4495,0,0,0,0,0,0,4495,4206,0,0,0,0,0,0,4206,8701
73,13,4706,0,0,0,0,0,0,4706,4358,0,0,0,0,0,0,4358,9064
73,14,4679,0,0,0,0,0,0,4679,4504,0,0,0,0,0,0,4504,9183
73,15,5015,0,0,0,0,0,0,5015,4413,0,0,0,0,0,0,4413,9428
73,16,4893,0,0,0,0,0,0,4893,4424,0,0,0,0,0,0,4424,9317
73,17,4875,0,0,0,0,0,0,4875,4507,0,1,0,0,0,0,4508,9383
73,18,4946,0,0,0,0,0,0,4946,4632,2,0,0,0,0,0,4634,9580
73,19,5181,0,0,0,0,0,0,5181,4526,9,0,0,0,0,0,4535,9716
73,20,5039,0,0,0,0,0,0,5039,4446,23,0,0,0,0,0,4469,9508
73,21,4939,5,0,0,1,0,0,4945,4544,51,0,0,0,0,0,4595,9540
73,22,4886,10,2,0,0,0,0,4898,4453,66,2,0,0,0,0,4521,9419
73,23,5139,19,2,0,1,0,0,5161,4433,118,4,0,0,0,0,4555,9716
73,24,4941,40,4,0,1,0,0,4986,4251,173,4,0,0,0,0,4428,9414
73,25,5065,87,8,0,0,0,0,5160,4293,254,7,0,0,0,0,4554,9714
73,26,5005,123,7,0,1,0,0,5136,4294,324,7,0,1,0,0,4626,9762
73,27,4750,169,9,1,1,0,0,4930,4155,438,6,1,2,1,0,4603,9533
73,28,4636,266,8,0,5,0,0,4915,4138,628,13,1,4,0,0,4784,9699
73,29,4554,366,17,0,1,1,0,4939,3959,801,23,0,2,0,0,4785,9724
73,30,4506,466,20,0,9,0,0,5001,3777,940,34,2,14,2,0,4769,9770
73,31,4484,682,12,0,4,1,0,5183,3884,1272,30,3,8,1,0,5198,10381
73,32,4262,813,24,1,11,0,0,5111,3695,1417,65,3,10,1,0,5191,10302
73,33,4324,1075,36,2,9,0,0,5446,3493,1678,57,4,11,0,0,5243,10689
73,34,4003,1229,32,4,9,0,0,5277,3426,1958,80,8,7,0,0,5479,10756
73,35,3860,1613,55,3,9,0,0,5540,3234,2199,86,8,12,1,0,5540,11080
73,36,3618,1738,56,4,10,1,0,5427,2955,2224,110,17,17,0,0,5323,10750
73,37,3299,1786,63,5,14,0,0,5167,2822,2440,166,26,15,2,0,5471,10638
73,38,3367,2035,90,2,16,1,0,5511,2739,2664,174,33,11,2,0,5623,11134
73,39,3124,2247,100,8,13,0,0,5492,2740,2801,215,22,9,1,0,5788,11280
73,40,3152,2411,133,7,14,1,0,5718,2667,3014,222,29,17,0,0,5949,11667
73,41,3081,2642,126,11,15,0,0,5875,2525,3040,241,28,13,0,0,5847,11722
73,42,2995,2775,171,14,14,2,0,5971,2461,3241,263,45,14,1,0,6025,11996
73,43,2831,2835,197,18,16,1,0,5898,2450,3298,297,49,6,0,0,6100,11998
73,44,2805,3099,212,23,18,0,0,6157,2476,3476,332,83,11,0,0,6378,12535
73,45,2914,3315,226,21,12,1,0,6489,2560,3764,426,89,13,1,0,6853,13342
73,46,2858,3609,269,27,9,0,1,6773,2473,3972,455,77,11,0,0,6988,13761
73,47,3003,3644,313,32,12,0,0,7004,2493,4312,500,94,12,2,0,7413,14417
73,48,3120,3897,374,24,17,0,0,7432,2491,4536,573,105,14,0,0,7719,15151
73,49,3105,4332,420,33,20,1,0,7911,2533,5077,631,108,11,0,0,8360,16271
73,50,2913,4426,442,29,13,1,0,7824,2597,5038,663,152,11,0,1,8462,16286
73,51,2654,4774,474,42,21,1,0,7966,2307,5146,759,149,13,0,0,8374,16340
73,52,2580,4882,527,43,7,1,0,8040,2229,5352,785,197,7,2,0,8572,16612
73,53,2476,4903,540,56,18,1,0,7994,2005,5219,793,198,3,0,0,8218,16212
73,54,2331,5079,605,61,21,1,1,8099,2006,5383,832,191,8,0,0,8420,16519
73,55,2145,5142,609,58,18,1,0,7973,1900,5350,841,236,8,0,0,8335,16308
73,56,2020,5221,649,74,14,1,0,7979,1730,5631,865,292,3,1,1,8523,16502
73,57,1968,5428,664,88,19,0,0,8167,1636,5615,881,308,7,0,0,8447,16614
73,58,1741,5483,653,93,14,0,0,7984,1549,5717,904,300,4,0,0,8474,16458
73,59,1625,5508,648,103,18,0,0,7902,1453,5588,907,350,2,1,1,8302,16204
73,60,1384,5167,589,102,13,2,0,7257,1292,5210,845,367,4,0,0,7718,14975
73,61,1203,5023,659,99,25,0,0,7009,1118,5096,772,430,2,0,0,7418,14427
73,62,1144,4855,590,132,13,0,0,6734,1064,4795,734,484,10,0,0,7087,13821
73,63,962,4891,571,137,12,0,0,6573,969,4877,749,475,6,0,0,7076,13649
73,64,863,4773,558,145,12,0,2,6353,913,4745,714,539,4,0,0,6915,13268
73,65,756,4582,454,161,12,0,1,5966,826,4483,649,597,4,0,1,6560,12526
73,66,679,4455,449,171,9,0,0,5763,757,4354,624,636,4,0,0,6375,12138
73,67,645,4200,394,199,14,0,1,5453,692,4287,589,715,2,0,1,6286,11739
73,68,608,4207,374,217,11,0,0,5417,649,4120,556,819,2,0,0,6146,11563
73,69,518,4199,392,212,8,0,1,5330,594,4207,511,854,1,0,1,6168,11498
73,70,502,3995,312,234,7,0,0,5050,530,3817,459,871,1,0,0,5678,10728
73,71,443,3910,293,232,10,0,0,4888,457,3882,416,970,3,0,0,5728,10616
73,72,406,3969,279,276,3,0,0,4933,400,3819,427,1072,2,0,0,5720,10653
73,73,390,4003,276,297,2,0,0,4968,410,3844,405,1216,3,0,0,5878,10846
73,74,373,4171,253,347,8,0,0,5152,404,3959,381,1452,0,0,0,6196,11348
73,75,352,4420,258,381,4,0,0,5415,391,4022,389,1697,1,1,0,6501,11916
73,76,330,4286,229,449,4,0,0,5298,364,3916,371,1866,1,0,0,6518,11816
73,77,311,4223,192,523,7,0,1,5257,368,3683,355,2003,0,0,0,6409,11666
73,78,236,3178,157,429,2,0,0,4002,273,2810,256,1741,0,0,0,5080,9082
73,79,207,3141,129,478,4,0,0,3959,288,2538,218,1841,0,0,0,4885,8844
73,80,207,3032,97,484,3,0,0,3823,262,2487,214,2048,0,0,0,5011,8834
73,81,199,2674,108,470,4,0,0,3455,283,2060,188,2098,0,0,0,4629,8084
73,82,227,2607,102,501,2,0,0,3439,254,2139,179,2282,0,0,0,4854,8293
73,83,200,2817,87,626,1,0,1,3732,288,2032,168,2720,0,0,0,5208,8940
73,84,202,2576,74,675,1,0,0,3528,241,1807,165,2797,0,0,0,5010,8538
73,85,159,2314,66,673,1,0,0,3213,265,1487,119,2827,0,0,0,4698,7911
73,86,136,1802,68,615,0,0,0,2621,241,1100,104,2637,0,0,0,4082,6703
73,87,101,1416,31,538,0,0,0,2086,207,823,81,2418,0,0,0,3529,5615
73,88,101,1383,34,502,0,0,0,2020,194,706,71,2317,0,0,0,3288,5308
73,89,62,1034,32,452,0,0,0,1580,172,514,53,2154,0,0,0,2893,4473
73,90,70,861,13,427,1,0,0,1372,124,366,26,1962,0,0,0,2478,3850
73,91,56,612,8,388,0,0,0,1064,148,237,41,1739,0,0,0,2165,3229
73,92,43,509,12,308,1,0,0,873,111,173,29,1543,0,0,0,1856,2729
73,93,39,349,7,264,1,0,0,660,102,125,32,1332,0,0,0,1591,2251
73,94,24,251,7,218,0,0,0,500,88,76,16,1092,0,0,0,1272,1772
73,95,15,167,3,179,0,0,0,364,72,50,15,848,0,0,0,985,1349
73,96,13,114,1,127,0,0,0,255,63,29,9,661,1,0,0,763,1018
73,97,6,50,0,91,0,0,0,147,41,13,6,456,0,0,0,516,663
73,98,7,23,1,61,0,0,0,92,31,10,5,324,0,0,0,370,462
73,99,4,16,1,42,0,0,0,63,25,6,3,226,0,0,0,260,323
73,100,4,23,1,67,0,0,0,95,31,7,3,397,0,0,0,438,533
73,999,237599,208452,16958,13816,620,19,9,477473,214032,212960,25201,58731,362,20,6,511312,988785
74,0,881,0,0,0,0,0,0,881,840,0,0,0,0,0,0,840,1721
74,1,925,0,0,0,0,0,0,925,925,0,0,0,0,0,0,925,1850
74,2,984,0,0,0,0,0,0,984,906,0,0,0,0,0,0,906,1890
74,3,952,0,0,0,0,0,0,952,908,0,0,0,0,0,0,908,1860
74,4,984,0,0,0,0,0,0,984,1018,0,0,0,0,0,0,1018,2002
74,5,1100,0,0,0,0,0,0,1100,1081,0,0,0,0,0,0,1081,2181
74,6,1140,0,0,0,0,0,0,1140,1154,0,0,0,0,0,0,1154,2294
74,7,1196,0,0,0,0,0,0,1196,1124,0,0,0,0,0,0,1124,2320
74,8,1239,0,0,0,0,0,0,1239,1186,0,0,0,0,0,0,1186,2425
74,9,1293,0,0,0,0,0,0,1293,1240,0,0,0,0,0,0,1240,2533
74,10,1305,0,0,0,0,0,0,1305,1254,0,0,0,0,0,0,1254,2559
74,11,1373,0,0,0,0,0,0,1373,1394,0,0,0,0,0,0,1394,2767
74,12,1417,0,0,0,0,0,0,1417,1365,0,0,0,0,0,0,1365,2782
74,13,1503,0,0,0,0,0,0,1503,1399,0,0,0,0,0,0,1399,2902
74,14,1518,0,0,0,0,0,0,1518,1449,0,0,0,0,0,0,1449,2967
74,15,1543,0,0,0,0,0,0,1543,1428,0,0,0,0,0,0,1428,2971
74,16,1596,0,0,0,0,0,0,1596,1462,0,0,0,0,0,0,1462,3058
74,17,1571,0,0,0,0,0,0,1571,1476,0,0,0,0,0,0,1476,3047
74,18,1539,0,0,0,0,0,0,1539,1396,3,0,0,0,0,0,1399,2938
74,19,1638,0,0,0,0,0,0,1638,1437,2,0,0,0,0,0,1439,3077
74,20,1485,2,0,0,0,0,0,1487,1388,8,0,0,0,0,0,1396,2883
74,21,1471,0,0,0,0,0,0,1471,1355,14,0,0,0,0,0,1369,2840
74,22,1490,5,0,0,0,0,0,1495,1407,23,1,0,0,0,0,1431,2926
74,23,1516,10,0,0,0,0,0,1526,1309,34,0,0,1,0,0,1344,2870
74,24,1542,18,0,0,0,0,0,1560,1245,66,0,0,1,0,0,1312,2872
74,25,1487,28,2,0,2,0,0,1519,1285,81,2,0,1,0,0,1369,2888
74,26,1559,28,1,0,1,0,0,1589,1250,117,0,0,2,0,0,1369,2958
74,27,1409,56,0,0,0,0,0,1465,1157,166,2,1,0,0,0,1326,2791
74,28,1410,86,4,0,1,0,0,1501,1174,214,7,0,1,0,0,1396,2897
74,29,1418,118,1,0,0,0,0,1537,1122,271,6,0,1,0,0,1400,2937
74,30,1352,163,5,0,2,0,0,1522,1027,335,9,0,2,0,0,1373,2895
74,31,1332,252,7,0,1,1,0,1593,1014,425,14,0,4,1,0,1458,3051
74,32,1274,315,4,1,1,0,0,1595,958,493,24,1,2,1,0,1479,3074
74,33,1285,383,11,3,3,0,0,1685,956,561,38,1,0,0,0,1556,3241
74,34,1195,421,17,0,3,1,0,1637,867,618,25,3,5,0,0,1518,3155
74,35,1140,502,15,0,3,0,0,1660,827,730,40,4,3,0,0,1604,3264
74,36,973,536,16,1,6,0,0,1532,832,750,39,13,11,0,0,1645,3177
74,37,921,604,23,1,3,0,0,1552,743,774,41,6,5,0,0,1569,3121
74,38,974,676,48,1,2,0,0,1701,789,803,69,13,2,0,0,1676,3377
74,39,899,690,41,4,5,0,0,1639,722,867,77,7,5,0,0,1678,3317
74,40,873,832,41,3,3,0,0,1752,683,955,97,14,3,0,0,1752,3504
74,41,992,857,62,2,1,0,0,1914,748,965,100,12,8,0,0,1833,3747
74,42,867,846,62,4,3,0,0,1782,719,1027,123,14,2,0,0,1885,3667
74,43,916,951,84,9,6,0,0,1966,708,1127,106,18,3,0,0,1962,3928
74,44,902,1043,73,2,4,1,0,2025,703,1238,140,15,2,0,0,2098,4123
74,45,1009,1153,91,6,7,0,0,2266,733,1309,160,14,2,0,0,2218,4484
74,46,908,1217,119,8,3,0,0,2255,715,1394,193,22,3,0,0,2327,4582
74,47,930,1259,150,11,3,0,0,2353,723,1477,214,24,0,0,0,2438,4791
74,48,926,1396,161,9,1,0,0,2493,725,1582,244,31,5,1,0,2588,5081
74,49,967,1536,201,11,4,0,0,2719,711,1709,274,52,3,0,0,2749,5468
74,50,899,1586,230,17,3,0,0,2735,666,1793,295,41,3,0,0,2798,5533
74,51,845,1608,219,18,2,0,0,2692,640,1893,329,45,2,0,0,2909,5601
74,52,794,1710,237,18,2,0,0,2761,563,1792,340,59,3,1,0,2758,5519
74,53,768,1712,268,14,3,0,0,2765,529,1784,371,67,1,0,0,2752,5517
74,54,656,1790,280,18,4,1,0,2749,430,1920,356,87,2,0,0,2795,5544
74,55,654,1703,255,26,7,0,0,2645,455,1919,365,96,3,0,1,2839,5484
74,56,600,1792,287,23,4,0,0,2706,414,1915,389,111,4,0,0,2833,5539
74,57,509,1834,311,24,4,0,0,2682,413,1968,406,117,1,0,0,2905,5587
74,58,506,1833,316,41,7,0,0,2703,389,1957,423,106,4,0,0,2879,5582
74,59,442,2030,330,52,6,0,0,2860,388,1981,421,141,4,0,0,2935,5795
74,60,372,1915,329,54,3,0,0,2673,310,1929,416,160,4,0,0,2819,5492
74,61,371,1852,290,41,2,0,0,2556,275,1862,321,174,1,0,0,2633,5189
74,62,292,1804,274,52,4,0,0,2426,284,1824,331,217,5,0,0,2661,5087
74,63,252,1690,247,48,8,1,0,2246,233,1706,294,223,4,0,0,2460,4706
74,64,233,1653,211,65,3,0,0,2165,221,1617,299,246,0,0,0,2383,4548
74,65,252,1567,193,48,2,0,0,2062,180,1596,312,256,4,0,0,2348,4410
74,66,187,1684,210,62,1,0,0,2144,178,1596,246,286,3,0,0,2309,4453
74,67,184,1644,165,74,1,0,0,2068,166,1588,209,365,1,0,1,2330,4398
74,68,170,1610,182,70,1,0,0,2033,139,1552,219,361,0,0,1,2272,4305
74,69,144,1473,129,95,1,0,0,1842,136,1556,199,364,1,0,0,2256,4098
74,70,118,1472,147,94,0,0,0,1831,107,1388,195,366,1,0,0,2057,3888
74,71,128,1491,130,84,1,0,0,1834,104,1396,130,388,2,0,0,2020,3854
74,72,110,1431,101,86,1,0,0,1729,100,1306,117,448,0,0,0,1971,3700
74,73,108,1450,108,118,1,0,0,1785,98,1316,138,480,1,0,0,2033,3818
74,74,100,1579,101,143,1,0,0,1924,108,1346,129,559,0,0,0,2142,4066
74,75,83,1635,87,165,3,0,0,1973,81,1416,157,658,0,0,0,2312,4285
74,76,90,1595,108,195,2,1,0,1991,80,1378,144,758,0,0,0,2360,4351
74,77,78,1667,73,197,0,0,0,2015,96,1456,139,865,1,0,0,2557,4572
74,78,70,1279,60,161,1,0,0,1571,61,1060,103,719,0,0,0,1943,3514
74,79,49,1198,64,186,0,0,0,1497,66,951,74,793,0,0,0,1884,3381
74,80,38,1060,42,203,1,0,0,1344,66,844,66,745,0,0,0,1721,3065
74,81,54,1038,38,195,0,0,0,1325,54,766,69,827,0,0,0,1716,3041
74,82,51,931,32,196,2,0,1,1213,73,693,53,884,0,0,0,1703,2916
74,83,51,955,30,219,1,0,0,1256,73,628,57,975,1,0,0,1734,2990
74,84,45,901,18,209,0,0,0,1173,59,534,49,1029,0,0,0,1671,2844
74,85,34,855,25,248,0,0,0,1162,55,482,36,1035,0,0,0,1608,2770
74,86,29,688,21,198,0,0,0,936,46,360,30,930,0,0,0,1366,2302
74,87,26,495,6,169,0,0,0,696,53,256,18,845,0,0,0,1172,1868
74,88,28,430,16,199,0,0,0,673,46,168,22,833,0,0,0,1069,1742
74,89,23,315,10,157,0,0,0,505,43,133,10,700,0,0,0,886,1391
74,90,18,267,4,139,0,0,0,428,31,90,13,632,0,0,0,766,1194
74,91,7,227,2,107,0,0,0,343,37,58,8,599,0,0,0,702,1045
74,92,7,137,3,128,0,0,0,275,33,42,10,484,0,0,0,569,844
74,93,6,98,2,94,0,0,0,200,25,27,2,447,0,0,0,501,701
74,94,9,69,1,79,0,0,0,158,25,12,2,339,0,0,0,378,536
74,95,3,38,1,70,0,0,0,112,21,10,3,263,0,0,0,297,409
74,96,2,35,1,37,0,0,0,75,17,4,0,163,0,0,0,184,259
74,97,1,8,0,25,0,0,0,34,9,5,1,124,0,0,0,139,173
74,98,0,10,0,21,0,0,0,31,6,1,0,78,0,0,0,85,116
74,99,0,8,1,17,0,0,0,26,6,5,0,70,0,0,0,81,107
74,100,3,5,0,16,0,0,0,24,6,4,1,98,0,0,0,109,133
74,999,71618,73840,7434,5091,150,6,1,158140,61731,74021,10362,21921,133,4,3,168175,326315
75,0,1390,0,0,0,0,0,0,1390,1255,0,0,0,0,0,0,1255,2645
75,1,1348,0,0,0,0,0,0,1348,1265,0,0,0,0,0,0,1265,2613
75,2,1441,0,0,0,0,0,0,1441,1328,0,0,0,0,0,0,1328,2769
75,3,1477,0,0,0,0,0,0,1477,1358,0,0,0,0,0,0,1358,2835
75,4,1437,0,0,0,0,0,0,1437,1438,0,0,0,0,0,0,1438,2875
75,5,1560,0,0,0,0,0,0,1560,1516,0,0,0,0,0,0,1516,3076
75,6,1657,0,0,0,0,0,0,1657,1553,0,0,0,0,0,0,1553,3210
75,7,1726,0,0,0,0,0,0,1726,1647,0,0,0,0,0,0,1647,3373
75,8,1825,0,0,0,0,0,0,1825,1663,0,0,0,0,0,0,1663,3488
75,9,1833,0,0,0,0,0,0,1833,1831,0,0,0,0,0,0,1831,3664
75,10,1853,0,0,0,0,0,0,1853,1816,0,0,0,0,0,0,1816,3669
75,11,1936,0,0,0,0,0,0,1936,1798,0,0,0,0,0,0,1798,3734
75,12,1954,0,0,0,0,0,0,1954,1882,0,0,0,0,0,0,1882,3836
75,13,2039,0,0,0,0,0,0,2039,1967,0,0,0,0,0,0,1967,4006
75,14,2030,0,0,0,0,0,0,2030,1931,0,0,0,0,0,0,1931,3961
75,15,2080,0,0,0,0,0,0,2080,1949,0,0,0,0,0,0,1949,4029
75,16,2065,1,0,0,0,0,0,2066,1925,0,0,0,0,0,0,1925,3991
75,17,2000,0,0,0,0,0,0,2000,1846,0,0,0,0,0,0,1846,3846
75,18,2063,0,0,0,0,0,0,2063,1815,2,0,0,0,0,0,1817,3880
75,19,2065,0,0,0,0,0,0,2065,1851,6,0,0,0,0,0,1857,3922
75,20,1988,2,0,0,0,0,0,1990,1796,18,0,0,0,0,0,1814,3804
75,21,2044,2,0,0,2,0,0,2048,1768,34,0,0,0,0,0,1802,3850
75,22,2014,9,0,0,0,0,0,2023,1748,37,3,0,0,0,0,1788,3811
75,23,2079,18,0,0,0,0,0,2097,1823,62,0,0,1,0,0,1886,3983
75,24,2047,30,3,0,1,0,0,2081,1729,99,4,1,0,0,0,1833,3914
75,25,2049,51,3,0,0,0,0,2103,1658,122,3,0,1,0,0,1784,3887
75,26,2080,52,3,1,0,0,0,2136,1734,185,9,0,1,0,0,1929,4065
75,27,2028,68,4,0,1,0,0,2101,1689,214,5,0,3,1,0,1912,4013
75,28,2006,132,1,0,2,0,0,2141,1693,325,4,0,2,0,0,2024,4165
75,29,2000,140,5,0,3,0,0,2148,1584,415,3,3,2,1,0,2008,4156
75,30,1931,270,5,1,4,0,0,2211,1560,532,4,2,5,0,0,2103,4314
75,31,1996,365,8,1,1,0,0,2371,1573,638,14,1,2,0,0,2228,4599
75,32,1863,440,5,0,4,0,0,2312,1402,731,20,3,6,0,0,2162,4474
75,33,1868,554,15,3,8,0,0,2448,1429,861,36,3,7,0,0,2336,4784
75,34,1647,650,21,0,5,0,0,2323,1302,928,37,1,3,1,0,2272,4595
75,35,1595,736,23,1,3,0,0,2358,1145,1056,40,8,6,0,0,2255,4613
75,36,1458,782,25,2,6,0,0,2273,1125,1011,44,2,4,0,0,2186,4459
75,37,1325,831,37,2,7,1,0,2203,1039,1156,82,13,4,0,0,2294,4497
75,38,1338,972,41,3,3,2,0,2359,1063,1246,91,6,13,2,0,2421,4780
75,39,1283,1105,46,4,3,0,0,2441,1023,1322,79,10,2,0,0,2436,4877
75,40,1191,1163,60,1,7,0,0,2422,968,1446,91,13,5,0,0,2523,4945
75,41,1269,1336,63,3,7,0,0,2678,921,1393,116,14,5,1,0,2450,5128
75,42,1242,1381,82,9,9,0,0,2723,889,1541,139,28,7,0,0,2604,5327
75,43,1200,1395,91,16,9,0,0,2711,909,1609,156,21,11,1,0,2707,5418
75,44,1222,1536,112,7,7,0,0,2884,884,1739,158,30,5,2,0,2818,5702
75,45,1215,1636,120,9,3,1,0,2984,890,1889,215,33,7,0,0,3034,6018
75,46,1222,1740,153,9,14,0,0,3138,922,1830,228,34,3,0,0,3017,6155
75,47,1213,1819,169,19,9,0,0,3229,883,2147,230,58,7,0,0,3325,6554
75,48,1144,1976,162,17,9,0,1,3309,855,2152,269,51,1,0,0,3328,6637
75,49,1254,2098,187,13,2,0,0,3554,882,2441,302,55,5,0,0,3685,7239
75,50,1047,2159,229,25,5,0,0,3465,807,2344,300,58,5,0,0,3514,6979
75,51,1028,2346,231,16,5,1,0,3627,739,2286,369,64,3,0,0,3461,7088
75,52,933,2311,209,15,6,0,0,3474,706,2419,366,82,6,1,0,3580,7054
75,53,877,2135,278,14,6,0,1,3311,640,2263,324,83,0,0,0,3310,6621
75,54,802,2302,294,25,4,0,0,3427,560,2371,376,103,4,0,0,3414,6841
75,55,744,2245,254,23,3,0,0,3269,532,2326,359,124,5,0,0,3346,6615
75,56,677,2311,287,33,6,0,0,3314,507,2387,369,147,4,0,1,3415,6729
75,57,612,2334,321,37,4,0,0,3308,456,2401,371,153,3,0,0,3384,6692
75,58,649,2300,304,40,5,0,0,3298,428,2369,369,147,1,0,0,3314,6612
75,59,510,2392,315,42,4,0,0,3263,402,2548,360,162,3,0,0,3475,6738
75,60,466,2244,248,52,3,0,0,3013,380,2372,352,165,4,0,0,3273,6286
75,61,392,2175,238,53,4,0,0,2862,311,2353,325,207,2,0,0,3198,6060
75,62,352,2196,263,52,8,0,0,2871,295,2263,317,259,1,0,0,3135,6006
75,63,335,2168,243,77,3,0,0,2826,283,2144,308,256,1,0,0,2992,5818
75,64,294,2196,231,98,3,0,0,2822,230,2089,223,291,2,0,0,2835,5657
75,65,268,2065,222,68,10,1,0,2634,215,1998,244,315,0,0,0,2772,5406
75,66,239,1996,150,86,3,0,0,2474,230,1923,224,353,0,0,0,2730,5204
75,67,205,1956,168,103,7,0,0,2439,190,1921,188,417,1,0,0,2717,5156
75,68,203,1876,153,103,3,0,0,2338,164,1855,179,362,1,0,0,2561,4899
75,69,175,1890,125,101,1,0,0,2292,147,1867,181,440,2,0,0,2637,4929
75,70,179,1754,138,123,2,0,0,2196,154,1700,155,445,1,0,0,2455,4651
75,71,154,1738,108,111,2,0,0,2113,123,1665,150,475,0,0,0,2413,4526
75,72,125,1738,88,143,2,0,0,2096,109,1595,134,461,2,0,1,2302,4398
75,73,122,1763,109,145,1,0,0,2140,129,1691,132,602,3,0,0,2557,4697
75,74,124,1829,101,161,3,0,0,2218,122,1643,156,665,1,0,0,2587,4805
75,75,135,1884,87,210,2,0,0,2318,105,1693,131,752,0,0,0,2681,4999
75,76,104,1832,78,202,0,0,0,2216,118,1684,122,783,0,0,0,2707,4923
75,77,106,1829,75,222,0,0,0,2232,107,1576,119,965,1,0,0,2768,5000
75,78,85,1405,50,207,0,0,0,1747,89,1124,74,798,0,0,0,2085,3832
75,79,65,1304,41,182,0,0,0,1592,86,977,70,906,1,0,0,2040,3632
75,80,61,1251,36,192,0,0,0,1540,75,956,71,943,0,0,0,2045,3585
75,81,66,1125,36,206,1,0,0,1434,68,889,45,922,0,0,0,1924,3358
75,82,63,1005,30,209,1,0,0,1308,64,726,46,972,0,0,0,1808,3116
75,83,67,1121,23,247,0,0,0,1458,74,731,46,1173,0,0,0,2024,3482
75,84,63,1006,23,235,1,0,0,1328,68,630,41,1127,0,0,0,1866,3194
75,85,49,913,19,280,0,0,0,1261,67,528,26,1241,0,0,0,1862,3123
75,86,42,737,19,258,0,0,0,1056,54,373,23,1143,0,0,0,1593,2649
75,87,38,576,11,228,0,0,0,853,54,287,16,994,0,0,0,1351,2204
75,88,29,541,8,238,0,0,0,816,49,217,8,925,0,0,0,1199,2015
75,89,33,408,9,167,1,0,0,618,50,148,19,861,0,0,0,1078,1696
75,90,14,301,5,173,0,0,0,493,31,88,17,772,0,0,0,908,1401
75,91,18,205,2,140,0,0,0,365,30,74,7,661,0,0,0,772,1137
75,92,7,165,4,130,0,0,0,306,41,33,5,586,0,0,0,665,971
75,93,11,111,3,113,0,0,0,238,31,40,4,476,0,0,0,551,789
75,94,3,61,2,80,0,0,0,146,21,21,3,393,0,0,0,438,584
75,95,4,50,1,61,0,0,0,116,13,12,3,298,0,0,0,326,442
75,96,2,34,0,46,0,0,0,82,11,7,2,185,0,0,0,205,287
75,97,3,18,0,33,0,0,0,54,9,10,3,144,0,0,0,166,220
75,98,1,6,0,15,0,0,0,22,4,1,0,108,0,0,0,113,135
75,99,0,2,0,14,0,0,0,16,5,0,0,80,0,0,0,85,101
75,100,1,4,0,22,0,0,0,27,8,4,1,107,0,0,0,120,147
75,999,97172,93603,7313,5977,238,6,2,204311,82711,94809,10115,25541,175,10,2,213363,417674
76,0,1026,0,0,0,0,0,0,1026,920,0,0,0,0,0,0,920,1946
76,1,1038,0,0,0,0,0,0,1038,985,0,0,0,0,0,0,985,2023
76,2,1110,0,0,0,0,0,0,1110,1121,0,0,0,0,0,0,1121,2231
76,3,1150,0,0,0,0,0,0,1150,1059,0,0,0,0,0,0,1059,2209
76,4,1174,0,0,0,0,0,0,1174,1071,0,0,0,0,0,0,1071,2245
76,5,1149,0,0,0,0,0,0,1149,1126,0,0,0,0,0,0,1126,2275
76,6,1272,0,0,0,0,0,0,1272,1177,0,0,0,0,0,0,1177,2449
76,7,1323,0,0,0,0,0,0,1323,1279,0,0,0,0,0,0,1279,2602
76,8,1323,0,0,0,0,0,0,1323,1233,0,0,0,0,0,0,1233,2556
76,9,1413,0,0,0,0,0,0,1413,1314,0,0,0,0,0,0,1314,2727
76,10,1471,0,0,0,0,0,0,1471,1221,0,0,0,0,0,0,1221,2692
76,11,1465,0,0,0,0,0,0,1465,1429,0,0,0,0,0,0,1429,2894
76,12,1508,0,0,0,0,0,0,1508,1463,0,0,0,0,0,0,1463,2971
76,13,1539,0,0,0,0,0,0,1539,1430,0,0,0,0,0,0,1430,2969
76,14,1571,0,0,0,0,0,0,1571,1435,0,0,0,0,0,0,1435,3006
76,15,1580,0,0,0,0,0,0,1580,1510,0,0,0,0,0,0,1510,3090
76,16,1628,0,0,0,0,0,0,1628,1510,0,0,0,0,0,0,1510,3138
76,17,1568,0,0,0,0,0,0,1568,1515,0,0,0,0,0,0,1515,3083
76,18,1580,0,0,0,0,0,0,1580,1507,0,1,0,0,0,0,1508,3088
76,19,1665,0,0,0,0,0,0,1665,1545,2,0,0,0,0,0,1547,3212
76,20,1559,2,0,0,0,0,0,1561,1433,8,1,0,0,0,0,1442,3003
76,21,1612,3,0,0,0,0,0,1615,1486,27,0,0,0,0,0,1513,3128
76,22,1635,3,2,0,0,0,0,1640,1454,35,0,0,0,0,0,1489,3129
76,23,1621,10,3,0,0,0,0,1634,1416,62,4,0,0,0,0,1482,3116
76,24,1649,24,3,0,0,0,0,1676,1358,89,1,0,0,0,0,1448,3124
76,25,1790,32,3,0,0,0,0,1825,1314,123,2,0,0,0,0,1439,3264
76,26,1668,58,0,0,0,0,0,1726,1323,150,3,0,1,0,0,1477,3203
76,27,1685,86,4,0,0,0,0,1775,1349,192,9,0,0,0,0,1550,3325
76,28,1542,117,2,0,0,1,0,1662,1240,258,2,0,0,0,0,1500,3162
76,29,1561,157,1,0,0,0,0,1719,1216,329,9,0,2,0,0,1556,3275
76,30,1488,197,5,0,3,0,0,1693,1107,400,7,0,0,0,0,1514,3207
76,31,1532,276,4,0,0,0,0,1812,1144,484,8,2,2,0,0,1640,3452
76,32,1447,355,4,3,1,0,0,1810,1061,538,21,1,3,0,0,1624,3434
76,33,1403,417,15,1,1,1,0,1838,978,726,27,5,2,0,0,1738,3576
76,34,1267,494,18,1,3,0,0,1783,1005,662,34,1,5,0,0,1707,3490
76,35,1311,588,14,1,1,1,0,1916,991,742,33,6,3,0,0,1775,3691
76,36,1227,679,20,1,0,0,0,1927,876,865,34,6,4,0,0,1785,3712
76,37,1087,678,33,3,1,0,0,1802,831,894,61,10,3,0,0,1799,3601
76,38,1091,752,31,2,1,1,1,1879,877,974,79,11,1,0,0,1942,3821
76,39,1070,818,37,3,2,0,0,1930,807,982,85,8,3,0,0,1885,3815
76,40,993,927,47,2,0,0,0,1969,731,1041,82,6,0,0,0,1860,3829
76,41,980,962,49,1,0,0,0,1992,730,1119,87,13,3,0,0,1952,3944
76,42,904,975,68,10,5,0,1,1963,685,1181,111,22,2,0,0,2001,3964
76,43,840,1124,90,5,1,0,0,2060,632,1268,133,26,0,0,0,2059,4119
76,44,891,1151,90,10,3,0,0,2145,623,1378,141,33,3,0,0,2178,4323
76,45,940,1211,92,8,3,0,0,2254,677,1375,194,31,1,0,0,2278,4532
76,46,845,1254,132,9,0,0,0,2240,650,1523,213,33,4,0,0,2423,4663
76,47,892,1428,158,4,1,1,0,2484,597,1648,230,40,2,0,0,2517,5001
76,48,844,1458,181,10,4,0,0,2497,629,1739,270,39,3,0,0,2680,5177
76,49,806,1614,169,17,0,0,0,2606,585,1737,275,57,0,0,0,2654,5260
76,50,752,1707,163,13,2,0,0,2637,515,1878,285,57,2,0,0,2737,5374
76,51,716,1781,204,17,2,0,0,2720,519,1865,247,71,4,0,0,2706,5426
76,52,698,1754,195,12,4,0,0,2663,507,1899,286,66,0,0,0,2758,5421
76,53,647,1766,225,20,0,0,0,2658,423,1894,273,70,1,0,0,2661,5319
76,54,558,1874,220,19,6,0,0,2677,423,2017,279,98,1,0,0,2818,5495
76,55,563,1794,219,33,0,0,0,2609,446,1999,313,101,0,0,0,2859,5468
76,56,545,1916,209,23,1,0,0,2694,397,1973,315,127,1,0,0,2813,5507
76,57,540,1921,243,33,7,1,0,2745,380,2000,286,150,0,0,0,2816,5561
76,58,472,1930,259,40,4,0,0,2705,351,2038,304,157,0,0,0,2850,5555
76,59,442,1997,244,46,1,0,0,2730,314,1978,276,145,3,0,0,2716,5446
76,60,380,1799,202,36,1,0,0,2418,249,1918,263,168,1,0,0,2599,5017
76,61,335,1838,204,39,3,0,0,2419,222,1924,262,185,0,0,0,2593,5012
76,62,286,1872,185,56,2,0,0,2401,205,1835,256,224,1,0,0,2521,4922
76,63,260,1799,176,58,1,0,1,2295,192,1892,219,219,0,0,0,2522,4817
76,64,252,1797,174,61,1,0,0,2285,175,1735,203,237,0,0,0,2350,4635
76,65,222,1675,163,60,1,0,0,2121,166,1716,170,265,0,0,0,2317,4438
76,66,199,1718,166,73,2,0,0,2158,135,1661,164,266,0,0,0,2226,4384
76,67,194,1607,142,81,0,0,0,2024,131,1632,152,328,0,0,0,2243,4267
76,68,168,1594,106,90,3,0,0,1961,127,1519,137,338,0,0,0,2121,4082
76,69,153,1586,125,104,4,0,0,1972,112,1580,155,380,0,0,0,2227,4199
76,70,146,1496,110,95,3,0,0,1850,113,1429,119,405,0,0,0,2066,3916
76,71,145,1509,101,91,2,0,0,1848,97,1347,103,347,0,0,0,1894,3742
76,72,161,1554,89,113,2,0,0,1919,100,1459,93,469,0,0,0,2121,4040
76,73,139,1508,87,132,1,0,0,1867,91,1353,108,510,0,0,0,2062,3929
76,74,123,1589,59,139,1,0,0,1911,83,1479,103,549,0,0,0,2214,4125
76,75,138,1714,70,154,0,0,0,2076,100,1534,77,674,0,0,0,2385,4461
76,76,115,1597,60,169,0,0,0,1941,88,1348,81,699,0,0,0,2216,4157
76,77,103,1508,42,176,1,0,0,1830,101,1189,82,694,0,0,0,2066,3896
76,78,76,1168,49,179,1,0,0,1473,61,914,50,614,0,0,0,1639,3112
76,79,62,1054,25,144,0,0,0,1285,65,750,45,643,0,0,0,1503,2788
76,80,84,1025,27,179,0,0,0,1315,63,772,40,741,0,0,0,1616,2931
76,81,70,917,30,144,0,0,0,1161,65,648,36,699,1,0,0,1449,2610
76,82,70,889,22,182,0,0,0,1163,64,630,28,747,0,0,0,1469,2632
76,83,77,903,20,218,0,0,0,1218,71,583,26,997,0,0,0,1677,2895
76,84,70,804,23,190,0,0,0,1087,71,495,30,908,0,0,0,1504,2591
76,85,60,776,16,220,0,0,0,1072,49,434,26,1004,0,0,0,1513,2585
76,86,63,576,10,178,0,0,0,827,64,345,12,909,0,0,0,1330,2157
76,87,53,502,7,197,0,0,0,759,49,229,14,780,0,0,0,1072,1831
76,88,39,441,9,192,0,0,0,681,39,209,15,804,0,0,0,1067,1748
76,89,32,340,6,167,0,0,0,545,38,158,11,710,0,0,0,917,1462
76,90,32,286,1,177,0,0,0,496,41,92,8,642,0,0,0,783,1279
76,91,23,183,4,95,0,0,0,305,25,63,2,577,0,0,0,667,972
76,92,25,148,1,133,0,0,0,307,26,39,3,546,0,0,0,614,921
76,93,17,120,1,85,0,0,0,223,24,25,2,445,0,0,0,496,719
76,94,12,70,0,80,0,0,0,162,9,19,0,295,0,0,0,323,485
76,95,6,53,2,50,0,0,0,111,16,10,2,254,0,0,0,282,393
76,96,2,30,0,44,0,0,0,76,11,10,2,224,0,0,0,247,323
76,97,3,16,0,19,0,0,0,38,5,3,1,151,0,0,0,160,198
76,98,3,7,0,19,0,0,0,29,6,1,0,93,0,0,0,100,129
76,99,0,3,2,10,0,0,0,15,3,4,0,71,0,0,0,78,93
76,100,2,1,0,18,0,0,0,21,8,3,0,101,0,0,0,112,133
76,999,76066,76362,5972,4994,86,6,3,163489,63290,77078,8121,21304,62,0,0,169855,333344
77,0,787,0,0,0,0,0,0,787,728,0,0,0,0,0,0,728,1515
77,1,791,0,0,0,0,0,0,791,804,0,0,0,0,0,0,804,1595
77,2,875,0,0,0,0,0,0,875,827,0,0,0,0,0,0,827,1702
77,3,835,0,0,0,0,0,0,835,781,0,0,0,0,0,0,781,1616
77,4,879,0,0,0,0,0,0,879,898,0,0,0,0,0,0,898,1777
77,5,900,0,0,0,0,0,0,900,914,0,0,0,0,0,0,914,1814
77,6,961,0,0,0,0,0,0,961,955,0,0,0,0,0,0,955,1916
77,7,998,0,0,0,0,0,0,998,979,0,0,0,0,0,0,979,1977
77,8,1050,0,0,0,0,0,0,1050,1017,0,0,0,0,0,0,1017,2067
77,9,1147,0,0,0,0,0,0,1147,1010,0,0,0,0,0,0,1010,2157
77,10,1121,0,0,0,0,0,0,1121,1083,0,0,0,0,0,0,1083,2204
77,11,1142,0,0,0,0,0,0,1142,1164,0,0,0,0,0,0,1164,2306
77,12,1217,0,0,0,0,0,0,1217,1118,0,0,0,0,0,0,1118,2335
77,13,1237,0,0,0,0,0,0,1237,1193,0,0,0,0,0,0,1193,2430
77,14,1220,0,0,0,0,0,0,1220,1230,0,0,0,0,0,0,1230,2450
77,15,1231,0,0,0,0,0,0,1231,1143,0,0,0,0,0,0,1143,2374
77,16,1230,0,0,0,0,0,0,1230,1214,0,0,0,0,0,0,1214,2444
77,17,1248,0,0,0,0,0,0,1248,1118,0,0,0,0,0,0,1118,2366
77,18,1318,0,0,0,0,0,0,1318,1083,2,0,0,0,0,0,1085,2403
77,19,1306,1,0,0,0,0,0,1307,1114,9,0,0,0,0,0,1123,2430
77,20,1298,4,0,0,0,0,0,1302,1093,12,0,0,0,0,0,1105,2407
77,21,1240,10,0,0,0,0,0,1250,1076,31,0,0,0,0,0,1107,2357
77,22,1296,13,0,0,0,0,0,1309,1118,49,0,0,0,0,0,1167,2476
77,23,1346,28,0,0,0,0,0,1374,1134,54,0,0,0,0,0,1188,2562
77,24,1328,22,4,0,0,0,0,1354,1062,66,0,0,0,0,0,1128,2482
77,25,1365,28,0,0,0,0,0,1393,1019,113,1,0,0,0,0,1133,2526
77,26,1304,56,1,0,0,0,0,1361,1057,141,3,0,0,0,0,1201,2562
77,27,1363,90,4,0,0,0,0,1457,1039,125,5,0,0,0,0,1169,2626
77,28,1251,106,2,0,0,0,0,1359,954,235,3,0,0,0,0,1192,2551
77,29,1182,133,3,0,0,0,0,1318,984,232,2,0,0,0,0,1218,2536
77,30,1180,194,2,0,1,0,0,1377,925,305,4,0,1,0,0,1235,2612
77,31,1201,218,9,0,1,0,0,1429,938,415,9,2,0,0,0,1364,2793
77,32,1067,281,3,4,1,0,0,1356,787,415,10,2,0,0,0,1214,2570
77,33,1103,364,5,0,0,0,0,1472,826,499,16,2,1,0,0,1344,2816
77,34,1048,387,13,1,1,0,0,1450,732,553,20,5,1,0,0,1311,2761
77,35,958,431,10,0,1,0,0,1400,752,601,28,3,0,0,0,1384,2784
77,36,867,461,18,1,0,1,0,1348,714,603,21,2,2,0,0,1342,2690
77,37,869,521,21,0,3,1,0,1415,608,680,45,5,0,0,0,1338,2753
77,38,789,601,18,0,2,0,0,1410,645,702,52,10,3,0,0,1412,2822
77,39,781,641,27,0,2,0,0,1451,633,817,44,7,0,0,0,1501,2952
77,40,749,659,18,0,2,0,0,1428,646,865,49,7,4,0,0,1571,2999
77,41,772,716,34,4,3,0,0,1529,611,898,74,12,2,0,0,1597,3126
77,42,689,720,44,5,3,0,0,1461,622,865,66,13,2,0,0,1568,3029
77,43,721,836,37,7,1,0,0,1602,545,899,78,11,1,0,0,1534,3136
77,44,691,840,57,1,6,0,0,1595,575,1014,100,17,4,0,0,1710,3305
77,45,702,954,50,9,4,0,0,1719,614,1101,101,16,3,0,0,1835,3554
77,46,748,1042,76,5,4,0,0,1875,550,1224,127,22,2,0,0,1925,3800
77,47,673,1055,73,9,1,0,0,1811,570,1206,138,36,0,1,0,1951,3762
77,48,722,1088,93,9,3,0,0,1915,567,1255,161,34,1,0,0,2018,3933
77,49,712,1181,102,3,2,0,0,2000,541,1344,170,31,3,0,0,2089,4089
77,50,659,1186,100,11,2,0,0,1958,496,1364,143,36,6,0,0,2045,4003
77,51,708,1245,107,9,1,0,0,2070,499,1406,171,45,2,0,0,2123,4193
77,52,608,1299,119,11,2,0,0,2039,470,1350,177,58,1,0,0,2056,4095
77,53,579,1259,116,15,0,0,0,1969,446,1404,207,57,3,0,0,2117,4086
77,54,538,1373,140,14,1,0,0,2066,386,1549,222,57,2,0,0,2216,4282
77,55,472,1419,173,14,3,1,0,2082,391,1477,209,66,0,0,0,2143,4225
77,56,462,1447,176,21,2,0,0,2108,396,1566,192,72,1,0,0,2227,4335
77,57,450,1538,139,26,1,0,0,2154,339,1574,228,100,1,0,0,2242,4396
77,58,402,1463,175,18,2,0,0,2060,308,1521,199,100,2,0,0,2130,4190
77,59,329,1544,180,23,5,0,0,2081,290,1575,252,130,3,0,0,2250,4331
77,60,320,1446,166,30,1,0,0,1963,236,1442,203,101,1,0,0,1983,3946
77,61,277,1347,150,27,2,0,0,1803,256,1409,176,162,1,0,0,2004,3807
77,62,246,1372,153,34,2,0,0,1807,212,1445,169,156,0,0,0,1982,3789
77,63,243,1315,123,44,2,0,0,1727,171,1296,179,178,2,0,0,1826,3553
77,64,208,1432,115,46,5,0,0,1806,158,1362,163,195,1,0,0,1879,3685
77,65,195,1244,103,55,3,0,0,1600,158,1358,147,232,1,0,0,1896,3496
77,66,161,1226,123,44,2,0,0,1556,144,1243,134,186,0,0,0,1707,3263
77,67,154,1251,93,58,2,0,0,1558,141,1186,120,250,1,0,0,1698,3256
77,68,147,1134,109,60,4,0,0,1454,132,1226,123,269,0,0,0,1750,3204
77,69,128,1240,81,68,0,0,0,1517,106,1168,124,283,0,0,0,1681,3198
77,70,121,1166,75,66,0,0,0,1428,88,1125,106,308,0,0,0,1627,3055
77,71,96,1116,50,83,1,0,0,1346,84,1096,101,309,0,0,0,1590,2936
77,72,127,1117,57,83,0,0,0,1384,75,1028,93,315,0,0,0,1511,2895
77,73,102,1174,67,76,0,0,1,1420,65,1022,80,354,0,0,0,1521,2941
77,74,117,1196,50,85,0,0,0,1448,81,1123,72,414,0,0,0,1690,3138
77,75,93,1259,58,133,0,0,0,1543,79,1139,73,503,0,0,0,1794,3337
77,76,113,1231,49,124,1,0,0,1518,74,1046,63,527,0,0,0,1710,3228
77,77,86,1135,51,120,1,0,0,1393,66,928,48,570,0,0,0,1612,3005
77,78,66,801,24,108,1,0,0,1000,56,732,35,491,0,0,0,1314,2314
77,79,78,811,35,109,0,0,0,1033,49,626,29,518,0,0,0,1222,2255
77,80,56,810,23,123,1,0,0,1013,51,597,42,578,0,0,0,1268,2281
77,81,69,678,22,144,1,0,0,914,64,474,22,591,0,0,0,1151,2065
77,82,62,700,18,119,0,0,0,899,46,517,29,639,0,0,0,1231,2130
77,83,69,775,25,165,2,0,0,1036,47,528,22,819,0,0,0,1416,2452
77,84,63,628,14,188,0,0,0,893,38,398,14,817,0,0,0,1267,2160
77,85,51,634,13,143,0,0,0,841,47,346,22,846,0,0,0,1261,2102
77,86,43,529,7,134,0,0,0,713,38,258,17,786,0,0,0,1099,1812
77,87,31,403,5,149,0,0,0,588,28,160,16,665,0,0,0,869,1457
77,88,40,381,4,126,0,0,0,551,33,176,14,720,0,0,0,943,1494
77,89,32,323,5,131,0,0,0,491,33,112,8,631,0,0,0,784,1275
77,90,35,236,5,114,0,0,0,390,30,84,4,574,0,0,0,692,1082
77,91,17,164,2,124,0,0,0,307,26,60,1,470,0,0,0,557,864
77,92,15,152,1,108,0,0,0,276,23,38,5,471,0,0,0,537,813
77,93,9,88,2,68,0,0,0,167,16,29,3,401,0,0,0,449,616
77,94,11,73,4,58,0,0,0,146,16,21,1,287,0,0,0,325,471
77,95,5,43,1,49,0,0,0,98,13,9,1,243,0,0,0,266,364
77,96,3,18,0,44,0,0,0,65,9,8,2,187,0,0,0,206,271
77,97,3,20,0,39,0,0,0,62,4,4,2,148,0,0,0,158,220
77,98,0,7,1,11,0,0,0,19,5,4,2,107,0,0,0,118,137
77,99,0,5,0,11,0,0,0,16,4,0,0,65,0,0,0,69,85
77,100,0,9,0,21,0,0,0,30,6,4,0,115,0,0,0,125,155
77,999,60407,58143,4033,3742,91,3,1,126420,51339,58943,5792,17439,58,1,0,133572,259992
78,0,536,0,0,0,0,0,0,536,557,0,0,0,0,0,0,557,1093
78,1,617,0,0,0,0,0,0,617,572,0,0,0,0,0,0,572,1189
78,2,613,0,0,0,0,0,0,613,612,0,0,0,0,0,0,612,1225
78,3,642,0,0,0,0,0,0,642,595,0,0,0,0,0,0,595,1237
78,4,628,0,0,0,0,0,0,628,613,0,0,0,0,0,0,613,1241
78,5,776,0,0,0,0,0,0,776,672,0,0,0,0,0,0,672,1448
78,6,723,0,0,0,0,0,0,723,664,0,0,0,0,0,0,664,1387
78,7,798,0,0,0,0,0,0,798,719,0,0,0,0,0,0,719,1517
78,8,795,0,0,0,0,0,0,795,760,0,0,0,0,0,0,760,1555
78,9,773,0,0,0,0,0,0,773,731,0,0,0,0,0,0,731,1504
78,10,807,0,0,0,0,0,0,807,793,0,0,0,0,0,0,793,1600
78,11,888,0,0,0,0,0,0,888,805,0,0,0,0,0,0,805,1693
78,12,979,0,0,0,0,0,0,979,850,0,0,0,0,0,0,850,1829
78,13,905,0,0,0,0,0,0,905,903,0,0,0,0,0,0,903,1808
78,14,982,0,0,0,0,0,0,982,899,0,0,0,0,0,0,899,1881
78,15,1008,0,0,0,0,0,0,1008,941,0,0,0,0,0,0,941,1949
78,16,990,1,0,0,0,0,0,991,902,0,0,0,0,0,0,902,1893
78,17,1016,0,0,0,0,0,0,1016,896,1,0,0,0,0,0,897,1913
78,18,1003,0,0,0,0,0,0,1003,935,1,0,0,0,0,0,936,1939
78,19,1001,0,0,0,0,0,0,1001,886,7,0,0,0,0,0,893,1894
78,20,1015,1,0,0,0,0,0,1016,877,13,0,0,0,0,0,890,1906
78,21,962,4,0,0,0,0,0,966,902,12,0,0,0,0,0,914,1880
78,22,966,10,0,0,0,0,0,976,865,24,0,0,0,0,0,889,1865
78,23,979,11,1,0,0,0,0,991,840,40,0,0,0,0,0,880,1871
78,24,985,13,3,0,0,0,0,1001,848,59,1,1,0,0,0,909,1910
78,25,999,24,2,0,0,0,0,1025,840,67,1,0,0,0,0,908,1933
78,26,965,37,0,0,0,0,0,1002,799,93,1,0,0,0,0,893,1895
78,27,1012,46,0,0,2,0,0,1060,759,129,3,0,0,0,0,891,1951
78,28,940,69,4,0,1,0,0,1014,669,135,3,1,0,0,0,808,1822
78,29,971,82,3,0,2,0,0,1058,762,170,5,0,0,1,0,938,1996
78,30,926,111,7,1,1,0,0,1046,702,208,6,0,0,0,0,916,1962
78,31,872,167,4,0,1,0,0,1044,653,277,7,1,1,0,0,939,1983
78,32,871,155,3,1,1,0,0,1031,697,311,13,1,0,0,0,1022,2053
78,33,847,232,8,1,0,0,0,1088,633,326,12,2,2,0,0,975,2063
78,34,818,239,6,0,0,0,0,1063,624,395,17,2,0,1,0,1039,2102
78,35,848,299,29,2,0,0,0,1178,579,461,23,2,3,0,0,1068,2246
78,36,735,362,11,0,1,0,0,1109,536,468,25,1,3,0,0,1033,2142
78,37,664,367,15,0,1,0,0,1047,510,516,38,2,3,0,0,1069,2116
78,38,689,422,14,2,1,0,0,1128,499,516,35,2,1,0,0,1053,2181
78,39,677,479,26,1,0,0,0,1183,487,560,51,4,2,1,0,1105,2288
78,40,707,450,26,1,0,0,0,1184,499,609,48,5,2,0,0,1163,2347
78,41,629,535,27,3,0,0,0,1194,523,671,69,7,0,0,0,1270,2464
78,42,637,562,38,2,2,0,0,1241,480,658,72,9,4,0,0,1223,2464
78,43,686,614,46,3,0,0,0,1349,425,703,85,3,0,0,0,1216,2565
78,44,644,669,49,1,2,0,0,1365,471,760,88,12,1,0,0,1332,2697
78,45,627,751,63,3,1,0,0,1445,501,795,117,13,2,1,0,1429,2874
78,46,639,752,69,6,3,1,0,1470,511,889,120,21,1,1,0,1543,3013
78,47,639,801,90,7,2,0,0,1539,521,953,148,22,0,0,0,1644,3183
78,48,664,897,108,8,1,0,0,1678,457,1030,156,23,0,0,0,1666,3344
78,49,607,951,101,8,1,0,1,1669,497,1050,164,25,2,0,0,1738,3407
78,50,580,986,118,13,0,0,0,1697,460,1120,176,28,0,0,0,1784,3481
78,51,587,989,110,12,1,0,0,1699,458,1204,190,53,2,0,0,1907,3606
78,52,498,1072,128,7,1,0,0,1706,387,1170,208,61,1,0,0,1827,3533
78,53,520,1078,151,11,1,0,0,1761,370,1137,199,53,1,0,0,1760,3521
78,54,493,1173,154,9,1,0,0,1830,385,1255,216,51,1,0,0,1908,3738
78,55,457,1131,179,17,1,0,0,1785,352,1215,214,61,1,0,0,1843,3628
78,56,410,1152,164,18,1,0,0,1745,339,1188,206,63,2,0,0,1798,3543
78,57,357,1203,189,16,2,0,0,1767,306,1252,218,105,1,0,0,1882,3649
78,58,331,1239,214,28,1,1,0,1814,311,1274,220,97,1,0,0,1903,3717
78,59,326,1240,178,29,3,0,0,1776,282,1367,235,105,0,0,0,1989,3765
78,60,315,1210,189,34,1,0,0,1749,259,1281,236,122,0,0,0,1898,3647
78,61,241,1183,166,25,3,0,0,1618,215,1177,192,124,1,0,0,1709,3327
78,62,238,1148,167,31,1,0,0,1585,206,1238,177,110,1,0,0,1732,3317
78,63,192,1209,148,35,3,0,0,1587,189,1190,165,155,1,0,0,1700,3287
78,64,188,1109,158,24,1,0,0,1480,173,1079,163,177,1,0,0,1593,3073
78,65,178,1080,129,38,0,0,0,1425,171,1141,172,175,0,0,0,1659,3084
78,66,176,1100,128,43,1,0,0,1448,163,1118,174,199,0,0,0,1654,3102
78,67,141,1155,131,53,3,0,0,1483,156,1074,157,227,0,0,0,1614,3097
78,68,156,1115,113,51,0,0,0,1435,134,1124,143,227,1,0,0,1629,3064
78,69,133,1101,111,63,2,0,0,1410,125,1021,151,273,0,0,0,1570,2980
78,70,135,1070,93,46,1,0,0,1345,88,1007,119,260,0,0,0,1474,2819
78,71,88,1061,96,74,0,0,0,1319,86,900,90,271,0,0,0,1347,2666
78,72,121,1002,77,78,0,0,0,1278,115,873,104,282,0,0,0,1374,2652
78,73,106,1088,73,83,0,0,0,1350,101,946,100,317,0,0,0,1464,2814
78,74,83,1115,73,91,0,0,0,1362,105,928,74,432,0,0,0,1539,2901
78,75,77,1122,72,119,0,0,1,1391,89,953,85,447,1,0,0,1575,2966
78,76,71,1047,77,109,0,0,0,1304,89,904,71,517,0,0,0,1581,2885
78,77,77,1068,47,129,1,0,0,1322,76,834,47,531,0,0,0,1488,2810
78,78,45,764,35,143,0,0,0,987,59,626,56,497,0,0,0,1238,2225
78,79,56,739,51,110,1,0,0,957,44,554,33,492,0,0,0,1123,2080
78,80,45,662,34,111,0,0,0,852,51,515,35,515,0,0,0,1116,1968
78,81,42,606,20,111,1,0,0,780,43,474,31,530,0,0,0,1078,1858
78,82,40,657,25,121,0,0,0,843,51,431,35,578,0,0,0,1095,1938
78,83,47,640,28,127,0,0,0,842,44,445,31,736,0,0,0,1256,2098
78,84,48,554,17,163,0,0,0,782,43,329,26,733,0,0,0,1131,1913
78,85,52,514,13,147,0,0,0,726,52,293,23,692,0,0,0,1060,1786
78,86,30,413,8,126,1,0,0,578,51,231,19,642,0,0,0,943,1521
78,87,19,366,10,126,0,0,0,521,39,170,9,565,0,0,0,783,1304
78,88,22,315,3,120,0,0,0,460,37,122,15,582,0,0,0,756,1216
78,89,23,247,6,109,0,0,0,385,22,75,11,550,0,0,0,658,1043
78,90,25,164,3,116,0,0,0,308,21,62,10,494,0,0,0,587,895
78,91,12,142,3,73,0,0,0,230,15,44,7,350,0,0,0,416,646
78,92,12,113,3,57,0,0,0,185,15,29,6,354,0,0,0,404,589
78,93,9,68,0,53,0,0,0,130,10,19,7,319,0,0,0,355,485
78,94,3,46,0,37,0,0,0,86,7,9,2,246,0,0,0,264,350
78,95,1,37,0,39,0,0,0,77,5,9,2,193,0,0,0,209,286
78,96,2,17,0,35,0,0,0,54,6,5,1,148,0,0,0,160,214
78,97,4,14,0,19,0,0,0,37,4,4,1,115,0,0,0,124,161
78,98,1,6,0,13,0,0,0,20,3,1,0,64,0,0,0,68,88
78,99,0,3,0,6,0,0,0,9,3,0,0,49,0,0,0,52,61
78,100,1,3,0,16,0,0,0,20,2,0,1,64,0,0,0,67,87
78,999,48514,48449,4645,3314,55,2,2,104981,41088,48324,6171,15190,43,5,0,110821,215802
79,0,1886,0,0,0,0,0,0,1886,1771,0,0,0,0,0,0,1771,3657
79,1,1973,0,0,0,0,0,0,1973,1855,0,0,0,0,0,0,1855,3828
79,2,2067,0,0,0,0,0,0,2067,2016,0,0,0,0,0,0,2016,4083
79,3,2120,0,0,0,0,0,0,2120,1979,0,0,0,0,0,0,1979,4099
79,4,2221,0,0,0,0,0,0,2221,2185,0,0,0,0,0,0,2185,4406
79,5,2397,0,0,0,0,0,0,2397,2149,0,0,0,0,0,0,2149,4546
79,6,2466,0,0,0,0,0,0,2466,2316,0,0,0,0,0,0,2316,4782
79,7,2601,0,0,0,0,0,0,2601,2463,0,0,0,0,0,0,2463,5064
79,8,2638,0,0,0,0,0,0,2638,2477,0,0,0,0,0,0,2477,5115
79,9,2734,0,0,0,0,0,0,2734,2656,0,0,0,0,0,0,2656,5390
79,10,2867,0,0,0,0,0,0,2867,2689,0,0,0,0,0,0,2689,5556
79,11,2912,0,0,0,0,0,0,2912,2918,0,0,0,0,0,0,2918,5830
79,12,3005,0,0,0,0,0,0,3005,2881,0,0,0,0,0,0,2881,5886
79,13,3078,0,0,0,0,0,0,3078,2859,0,0,0,0,0,0,2859,5937
79,14,3143,0,0,0,0,0,0,3143,2870,0,0,0,0,0,0,2870,6013
79,15,3160,0,0,0,0,0,0,3160,3149,0,0,0,0,0,0,3149,6309
79,16,3210,0,0,0,0,0,0,3210,2958,0,0,0,0,0,0,2958,6168
79,17,3198,0,0,0,0,0,0,3198,2959,0,0,0,0,0,0,2959,6157
79,18,3194,0,0,0,0,0,0,3194,2985,1,0,0,0,0,0,2986,6180
79,19,3111,1,0,0,0,0,0,3112,2928,5,0,0,0,0,0,2933,6045
79,20,3211,2,1,0,0,0,0,3214,2799,20,0,0,0,0,0,2819,6033
79,21,3044,7,0,0,0,0,0,3051,2847,39,1,0,0,0,0,2887,5938
79,22,3170,10,0,0,0,0,0,3180,2817,57,0,0,0,0,0,2874,6054
79,23,3105,20,1,0,0,0,0,3126,2840,88,0,0,0,0,0,2928,6054
79,24,3247,37,4,0,1,0,0,3289,2604,131,2,0,0,0,0,2737,6026
79,25,3171,68,3,0,0,0,0,3242,2657,187,4,0,0,0,0,2848,6090
79,26,3073,92,3,0,3,0,0,3171,2624,262,1,0,0,0,0,2887,6058
79,27,3061,127,1,0,1,0,0,3190,2516,342,11,0,2,0,0,2871,6061
79,28,2955,212,4,0,3,0,0,3174,2482,417,7,0,1,0,0,2907,6081
79,29,2819,235,1,1,1,0,0,3057,2300,560,7,0,1,0,0,2868,5925
79,30,2932,364,6,1,1,0,0,3304,2266,703,11,2,2,0,0,2984,6288
79,31,2886,487,8,0,3,0,0,3384,2202,909,25,1,6,1,0,3144,6528
79,32,2690,598,13,0,6,0,0,3307,2034,1032,30,7,1,0,0,3104,6411
79,33,2625,694,16,1,3,1,0,3340,2034,1189,37,5,5,0,1,3271,6611
79,34,2493,940,20,2,4,0,0,3459,1906,1345,57,7,1,0,0,3316,6775
79,35,2388,1084,33,1,7,0,0,3513,1938,1562,68,8,7,0,0,3583,7096
79,36,2201,1107,47,1,5,0,0,3361,1646,1662,71,11,3,0,0,3393,6754
79,37,2039,1294,60,2,6,0,0,3401,1638,1744,112,11,2,0,0,3507,6908
79,38,2064,1371,65,1,6,0,1,3508,1587,1927,124,15,2,0,0,3655,7163
79,39,1930,1583,69,1,6,0,1,3590,1546,2048,136,19,4,0,0,3753,7343
79,40,2007,1857,75,8,6,1,0,3954,1482,2316,182,18,5,0,0,4003,7957
79,41,1879,1859,97,5,5,0,0,3845,1419,2193,170,27,6,0,0,3815,7660
79,42,1756,1985,123,7,7,0,0,3878,1364,2454,211,28,11,0,0,4068,7946
79,43,1710,2142,121,8,5,0,0,3986,1290,2515,242,40,3,0,0,4090,8076
79,44,1712,2279,161,7,7,0,0,4166,1200,2682,261,51,5,0,0,4199,8365
79,45,1690,2412,181,12,6,0,0,4301,1312,2797,287,47,4,0,0,4447,8748
79,46,1607,2682,183,10,5,0,0,4487,1254,2976,331,53,4,0,0,4618,9105
79,47,1648,2665,225,14,4,0,0,4556,1219,3219,331,69,6,0,0,4844,9400
79,48,1616,2849,263,16,5,0,0,4749,1231,3313,384,82,3,1,0,5014,9763
79,49,1599,3158,274,12,8,0,0,5051,1172,3522,376,99,3,0,0,5172,10223
79,50,1489,3169,268,25,5,1,0,4957,1026,3518,407,108,2,0,0,5061,10018
79,51,1346,3154,323,28,8,0,0,4859,1041,3528,432,103,3,0,0,5107,9966
79,52,1285,3286,308,25,9,0,0,4913,967,3623,437,135,3,0,0,5165,10078
79,53,1169,3373,345,26,6,0,0,4919,866,3556,448,165,2,0,0,5037,9956
79,54,1104,3398,337,35,2,0,0,4876,852,3749,468,147,1,0,0,5217,10093
79,55,1026,3386,351,40,5,0,0,4808,842,3720,515,234,0,0,0,5311,10119
79,56,957,3428,378,41,5,0,0,4809,811,3749,466,197,3,0,0,5226,10035
79,57,968,3537,360,47,11,0,0,4923,729,3712,454,221,2,0,0,5118,10041
79,58,910,3731,342,75,6,0,0,5064,706,3858,462,283,4,0,0,5313,10377
79,59,831,3816,421,70,3,0,0,5141,649,3879,521,308,2,1,0,5360,10501
79,60,712,3371,358,75,13,0,0,4529,624,3784,448,307,0,0,0,5163,9692
79,61,674,3447,341,63,5,0,1,4531,507,3718,423,338,1,0,0,4987,9518
79,62,610,3581,334,97,1,0,0,4623,500,3597,389,404,0,0,0,4890,9513
79,63,570,3529,319,97,3,0,0,4518,478,3586,403,414,0,0,0,4881,9399
79,64,504,3425,297,104,5,0,0,4335,471,3359,344,456,1,0,0,4631,8966
79,65,481,3169,215,96,7,0,0,3968,402,3146,317,455,1,0,0,4321,8289
79,66,446,3107,230,115,1,0,0,3899,375,3066,274,564,1,0,0,4280,8179
79,67,375,3210,223,138,4,0,0,3950,359,3047,265,564,0,0,0,4235,8185
79,68,382,3070,198,148,1,0,0,3799,298,3012,261,569,0,0,0,4140,7939
79,69,317,3016,208,130,0,0,0,3671,302,2920,225,687,1,0,0,4135,7806
79,70,338,2988,149,167,3,0,0,3645,280,2751,214,753,1,0,0,3999,7644
79,71,268,2782,128,149,3,0,0,3330,257,2518,186,754,0,0,0,3715,7045
79,72,278,2868,143,175,2,0,1,3467,233,2654,190,837,0,0,0,3914,7381
79,73,250,2938,142,220,4,0,0,3554,251,2576,167,925,0,0,0,3919,7473
79,74,223,2975,129,240,2,0,0,3569,228,2593,187,1048,0,0,0,4056,7625
79,75,242,3108,106,262,2,0,0,3720,227,2626,145,1219,1,0,0,4218,7938
79,76,252,2761,85,258,1,0,0,3357,215,2284,132,1240,0,0,0,3871,7228
79,77,214,2529,90,286,1,0,0,3120,176,2120,117,1318,0,0,0,3731,6851
79,78,170,2035,52,223,0,0,0,2480,152,1559,87,1146,0,0,0,2944,5424
79,79,178,2025,59,269,1,0,0,2532,165,1572,75,1374,0,0,0,3186,5718
79,80,169,2073,45,313,1,0,0,2601,151,1466,75,1515,0,0,0,3207,5808
79,81,156,1741,53,283,0,0,0,2233,128,1246,63,1432,1,0,0,2870,5103
79,82,151,1735,43,331,0,0,0,2260,140,1105,60,1556,0,0,0,2861,5121
79,83,150,1809,50,350,0,0,0,2359,148,1095,68,1832,0,0,0,3143,5502
79,84,126,1586,28,357,0,0,0,2097,155,1023,56,1886,0,0,0,3120,5217
79,85,130,1519,40,402,1,0,0,2092,124,860,42,1937,0,0,0,2963,5055
79,86,90,1157,18,335,1,0,0,1601,98,592,47,1827,0,0,0,2564,4165
79,87,79,966,13,322,0,0,0,1380,107,458,29,1725,0,0,0,2319,3699
79,88,70,852,15,308,0,0,0,1245,97,354,20,1616,0,0,0,2087,3332
79,89,74,718,14,292,0,0,0,1098,97,248,9,1616,0,0,0,1970,3068
79,90,50,569,7,276,0,0,0,902,74,176,17,1351,0,0,0,1618,2520
79,91,34,397,4,224,0,0,0,659,64,129,12,1208,0,0,0,1413,2072
79,92,28,309,5,228,0,0,0,570,57,79,9,1092,0,0,0,1237,1807
79,93,24,246,1,189,1,0,0,461,36,63,8,944,0,0,0,1051,1512
79,94,15,148,1,130,0,0,0,294,36,27,8,711,0,0,0,782,1076
79,95,11,99,0,90,0,0,0,200,29,19,7,543,0,0,0,598,798
79,96,11,63,1,73,0,0,0,148,27,22,2,455,0,0,0,506,654
79,97,1,34,1,53,0,0,0,89,17,6,7,316,0,0,0,346,435
79,98,4,20,1,28,0,0,0,53,16,4,2,240,0,0,0,262,315
79,99,5,15,0,33,0,0,0,53,10,1,1,151,0,0,0,163,216
79,100,2,13,0,26,0,0,0,41,18,5,1,194,0,0,0,218,259
79,999,146258,144502,9637,8477,237,3,4,309118,125907,146575,13481,42020,117,3,1,328104,637222
80,0,556,0,0,0,0,0,0,556,543,0,0,0,0,0,0,543,1099
80,1,564,0,0,0,0,0,0,564,585,0,0,0,0,0,0,585,1149
80,2,632,0,0,0,0,0,0,632,617,0,0,0,0,0,0,617,1249
80,3,665,0,0,0,0,0,0,665,626,0,0,0,0,0,0,626,1291
80,4,682,0,0,0,0,0,0,682,655,0,0,0,0,0,0,655,1337
80,5,677,0,0,0,0,0,0,677,694,0,0,0,0,0,0,694,1371
80,6,733,0,0,0,0,0,0,733,680,0,0,0,0,0,0,680,1413
80,7,761,0,0,0,0,0,0,761,749,0,0,0,0,0,0,749,1510
80,8,742,0,0,0,0,0,0,742,727,0,0,0,0,0,0,727,1469
80,9,869,0,0,0,0,0,0,869,791,0,0,0,0,0,0,791,1660
80,10,879,0,0,0,0,0,0,879,837,0,0,0,0,0,0,837,1716
80,11,932,0,0,0,0,0,0,932,877,0,0,0,0,0,0,877,1809
80,12,902,0,0,0,0,0,0,902,873,0,0,0,0,0,0,873,1775
80,13,980,0,0,0,0,0,0,980,955,0,0,0,0,0,0,955,1935
80,14,937,0,0,0,0,0,0,937,885,0,0,0,0,0,0,885,1822
80,15,1007,0,0,0,0,0,0,1007,929,0,0,0,0,0,0,929,1936
80,16,1071,0,0,0,0,0,0,1071,1011,0,0,0,0,0,0,1011,2082
80,17,1027,0,0,0,0,0,0,1027,960,0,0,0,0,0,0,960,1987
80,18,1044,0,0,0,0,0,0,1044,913,1,0,0,0,0,0,914,1958
80,19,1039,1,0,0,0,0,0,1040,940,2,0,0,0,0,0,942,1982
80,20,1007,0,0,0,0,0,0,1007,882,5,0,0,0,0,0,887,1894
80,21,1032,0,0,0,0,0,0,1032,943,9,0,0,0,0,0,952,1984
80,22,993,0,1,0,0,0,0,994,903,12,1,0,0,0,0,916,1910
80,23,1049,6,0,0,0,0,0,1055,923,27,0,0,1,0,0,951,2006
80,24,1055,13,2,0,0,0,0,1070,925,39,0,0,1,0,0,965,2035
80,25,1069,21,1,0,0,0,0,1091,855,57,0,0,1,0,0,913,2004
80,26,1024,27,0,0,0,0,0,1051,833,71,0,1,0,0,0,905,1956
80,27,988,44,1,0,0,0,0,1033,789,83,2,0,0,0,0,874,1907
80,28,945,56,1,0,0,0,0,1002,747,114,3,1,0,0,0,865,1867
80,29,928,77,5,0,0,0,0,1010,762,184,5,1,1,0,0,953,1963
80,30,851,108,4,0,2,0,0,965,737,201,3,0,0,0,0,941,1906
80,31,892,144,4,0,1,0,0,1041,692,280,6,0,0,0,0,978,2019
80,32,881,154,0,1,1,0,0,1037,666,300,10,2,1,0,0,979,2016
80,33,848,210,7,1,3,1,0,1070,660,342,19,0,1,1,0,1023,2093
80,34,777,241,5,0,0,0,0,1023,609,404,12,6,0,0,0,1031,2054
80,35,797,319,10,1,0,0,0,1127,570,443,20,2,2,0,0,1037,2164
80,36,728,387,17,0,1,0,0,1133,559,470,27,4,2,1,0,1063,2196
80,37,704,356,13,4,1,0,0,1078,547,552,38,3,3,0,0,1143,2221
80,38,702,436,26,1,0,1,0,1166,524,585,46,6,1,0,0,1162,2328
80,39,645,461,22,1,1,0,0,1130,447,584,50,6,3,0,0,1090,2220
80,40,666,500,22,0,3,0,0,1191,516,663,42,4,2,0,0,1227,2418
80,41,632,583,23,4,2,1,0,1245,496,718,57,8,0,0,0,1279,2524
80,42,579,637,33,2,0,0,0,1251,459,732,75,13,2,0,0,1281,2532
80,43,566,685,38,6,2,0,0,1297,408,719,86,21,2,0,0,1236,2533
80,44,562,694,50,4,1,0,0,1311,412,849,83,22,1,0,0,1367,2678
80,45,557,729,53,7,5,0,0,1351,432,931,114,16,1,0,0,1494,2845
80,46,591,807,67,9,1,0,0,1475,391,985,125,23,1,0,0,1525,3000
80,47,600,909,82,8,0,0,0,1599,382,969,128,33,0,0,0,1512,3111
80,48,553,949,78,5,2,0,0,1587,369,1125,152,34,0,0,0,1680,3267
80,49,499,1014,99,6,5,0,0,1623,381,1263,151,35,2,0,0,1832,3455
80,50,518,1061,102,10,2,1,0,1694,370,1233,159,31,2,1,0,1796,3490
80,51,467,1029,123,10,1,0,0,1630,350,1229,176,44,2,0,0,1801,3431
80,52,451,1083,127,11,1,1,0,1674,341,1291,188,58,1,0,0,1879,3553
80,53,437,1099,135,16,3,0,0,1690,300,1208,183,57,0,0,0,1748,3438
80,54,384,1247,139,16,1,0,0,1787,301,1301,199,63,1,0,0,1865,3652
80,55,386,1236,135,15,2,0,0,1774,267,1351,196,80,0,0,0,1894,3668
80,56,357,1183,155,20,2,0,0,1717,251,1297,196,77,0,0,0,1821,3538
80,57,331,1180,151,30,2,0,0,1694,238,1371,186,86,0,0,0,1881,3575
80,58,317,1303,163,32,2,0,0,1817,236,1357,204,113,0,0,0,1910,3727
80,59,273,1296,163,25,2,0,0,1759,215,1378,198,121,0,0,0,1912,3671
80,60,216,1316,131,26,4,0,0,1693,182,1306,173,124,0,0,0,1785,3478
80,61,230,1209,145,27,1,0,0,1612,171,1258,181,118,0,0,1,1729,3341
80,62,213,1171,141,33,2,0,0,1560,141,1237,147,138,0,0,0,1663,3223
80,63,163,1194,103,37,3,0,0,1500,141,1223,153,161,1,0,0,1679,3179
80,64,166,1115,113,37,1,0,0,1432,134,1156,133,156,0,0,0,1579,3011
80,65,181,1110,117,37,3,0,0,1448,125,1091,135,179,0,0,0,1530,2978
80,66,136,1082,99,43,2,0,0,1362,124,1001,121,187,2,0,0,1435,2797
80,67,137,1094,102,51,0,0,0,1384,127,1122,124,233,1,0,0,1607,2991
80,68,137,1086,83,55,2,0,0,1363,94,1061,131,265,0,0,0,1551,2914
80,69,98,1026,82,54,3,0,0,1263,91,1081,102,230,0,0,0,1504,2767
80,70,93,989,78,67,1,0,0,1228,103,953,97,290,0,0,0,1443,2671
80,71,81,1001,78,74,0,0,0,1234,92,991,88,282,0,0,0,1453,2687
80,72,97,1046,67,69,0,0,0,1279,75,950,84,316,1,0,0,1426,2705
80,73,97,983,68,82,0,0,0,1230,75,932,77,370,0,0,0,1454,2684
80,74,100,1062,71,99,0,0,0,1332,81,919,72,391,2,0,0,1465,2797
80,75,84,1206,56,97,1,0,0,1444,76,981,60,452,0,0,0,1569,3013
80,76,92,1099,51,98,0,0,0,1340,65,885,57,496,1,0,0,1504,2844
80,77,75,992,38,123,0,0,0,1228,53,847,60,515,0,0,0,1475,2703
80,78,56,771,33,87,0,0,0,947,41,653,55,442,0,0,0,1191,2138
80,79,53,732,21,105,0,0,0,911,68,600,37,483,0,0,0,1188,2099
80,80,45,798,22,113,2,0,0,980,48,577,30,598,0,0,0,1253,2233
80,81,49,726,24,113,0,0,0,912,37,503,48,570,0,0,0,1158,2070
80,82,47,692,13,127,0,0,0,879,49,449,24,616,0,0,0,1138,2017
80,83,46,711,15,141,0,0,0,913,55,415,20,699,0,0,0,1189,2102
80,84,40,589,11,168,0,0,0,808,58,360,24,671,0,0,0,1113,1921
80,85,34,562,10,158,0,0,0,764,40,276,28,735,0,0,0,1079,1843
80,86,25,408,13,157,0,0,0,603,41,227,13,692,0,0,0,973,1576
80,87,22,334,10,117,0,0,0,483,15,149,14,593,0,0,0,771,1254
80,88,18,296,6,143,0,0,0,463,38,121,9,598,0,0,0,766,1229
80,89,29,224,4,123,0,0,0,380,26,93,7,536,0,0,0,662,1042
80,90,18,206,6,112,0,0,0,342,26,68,5,508,0,0,0,607,949
80,91,8,151,3,73,0,0,0,235,20,54,4,384,0,0,0,462,697
80,92,11,113,1,69,0,0,0,194,18,23,7,384,0,0,0,432,626
80,93,4,79,3,65,0,0,0,151,14,25,3,336,0,0,0,378,529
80,94,3,56,0,44,0,0,0,103,14,13,4,279,0,0,0,310,413
80,95,3,24,1,41,0,0,0,69,7,9,0,196,0,0,0,212,281
80,96,2,18,3,35,0,0,0,58,9,5,1,136,0,0,0,151,209
80,97,0,18,0,26,0,0,0,44,10,0,2,113,0,0,0,125,169
80,98,0,11,0,10,0,0,0,21,1,1,1,89,0,0,0,92,113
80,99,0,7,0,13,0,0,0,20,0,1,0,45,0,0,0,46,66
80,100,0,1,0,6,0,0,0,7,6,1,1,73,0,0,0,81,88
80,999,47249,49593,3879,3400,74,5,0,104200,40126,50352,5472,15650,42,3,1,111646,215846
81,0,877,0,0,0,0,0,0,877,812,0,0,0,0,0,0,812,1689
81,1,907,0,0,0,0,0,0,907,900,0,0,0,0,0,0,900,1807
81,2,933,0,0,0,0,0,0,933,915,0,0,0,0,0,0,915,1848
81,3,948,0,0,0,0,0,0,948,920,0,0,0,0,0,0,920,1868
81,4,1019,0,0,0,0,0,0,1019,946,0,0,0,0,0,0,946,1965
81,5,1150,0,0,0,0,0,0,1150,1048,0,0,0,0,0,0,1048,2198
81,6,1159,0,0,0,0,0,0,1159,1064,0,0,0,0,0,0,1064,2223
81,7,1189,0,0,0,0,0,0,1189,1146,0,0,0,0,0,0,1146,2335
81,8,1190,0,0,0,0,0,0,1190,1223,0,0,0,0,0,0,1223,2413
81,9,1284,0,0,0,0,0,0,1284,1229,0,0,0,0,0,0,1229,2513
81,10,1291,0,0,0,0,0,0,1291,1209,0,0,0,0,0,0,1209,2500
81,11,1340,0,0,0,0,0,0,1340,1275,0,0,0,0,0,0,1275,2615
81,12,1393,0,0,0,0,0,0,1393,1280,0,0,0,0,0,0,1280,2673
81,13,1383,0,0,0,0,0,0,1383,1342,0,0,0,0,0,0,1342,2725
81,14,1444,0,0,0,0,0,0,1444,1348,0,0,0,0,0,0,1348,2792
81,15,1482,0,0,0,0,0,0,1482,1429,0,0,0,0,0,0,1429,2911
81,16,1445,0,0,0,0,0,0,1445,1314,0,0,0,0,0,0,1314,2759
81,17,1437,0,0,0,0,0,0,1437,1440,0,0,0,0,0,0,1440,2877
81,18,1410,0,0,0,0,0,0,1410,1318,1,0,0,1,0,0,1320,2730
81,19,1465,1,0,0,0,0,0,1466,1292,3,0,0,0,0,0,1295,2761
81,20,1448,0,0,0,0,0,0,1448,1256,8,0,0,0,0,0,1264,2712
81,21,1437,3,0,0,0,0,0,1440,1311,14,0,0,0,0,0,1325,2765
81,22,1458,5,2,0,1,0,0,1466,1348,21,0,0,0,0,0,1369,2835
81,23,1468,9,0,0,0,0,0,1477,1315,32,1,0,0,0,0,1348,2825
81,24,1470,12,0,0,0,0,0,1482,1276,50,0,0,1,0,0,1327,2809
81,25,1571,17,2,0,0,0,0,1590,1253,75,0,0,0,0,0,1328,2918
81,26,1460,43,1,0,1,0,0,1505,1281,107,2,0,0,0,0,1390,2895
81,27,1485,55,1,0,0,0,0,1541,1213,134,1,0,1,0,0,1349,2890
81,28,1478,88,3,0,0,0,0,1569,1200,168,2,0,0,0,0,1370,2939
81,29,1402,106,1,0,0,0,0,1509,1151,238,6,0,0,0,0,1395,2904
81,30,1458,123,2,1,1,0,0,1585,1078,282,3,0,1,0,0,1364,2949
81,31,1455,218,5,0,0,0,0,1678,1069,367,13,1,1,0,0,1451,3129
81,32,1351,253,8,2,2,0,0,1616,988,429,14,1,3,1,0,1436,3052
81,33,1380,337,4,0,1,0,0,1722,1057,535,15,4,1,0,0,1612,3334
81,34,1281,373,9,1,3,0,0,1667,951,593,23,0,0,0,0,1567,3234
81,35,1257,460,18,2,1,0,0,1738,953,709,42,3,3,2,0,1712,3450
81,36,1219,555,11,1,2,0,0,1788,883,740,33,0,0,0,0,1656,3444
81,37,1116,568,26,0,2,0,0,1712,800,804,55,10,1,0,0,1670,3382
81,38,1138,654,22,1,3,0,0,1818,786,913,48,11,4,0,0,1762,3580
81,39,1107,732,38,2,5,0,0,1884,776,930,64,8,0,0,0,1778,3662
81,40,1013,773,27,2,4,0,0,1819,781,1037,67,15,3,0,0,1903,3722
81,41,975,954,35,2,2,0,0,1968,773,1146,88,20,3,0,0,2030,3998
81,42,953,1021,59,4,0,0,0,2037,707,1199,101,19,0,0,0,2026,4063
81,43,938,990,60,4,2,0,0,1994,661,1194,95,15,2,0,0,1967,3961
81,44,921,1145,78,5,2,0,0,2151,651,1276,135,18,1,0,0,2081,4232
81,45,887,1248,90,4,2,0,0,2231,631,1437,147,30,1,0,0,2246,4477
81,46,887,1325,106,3,6,0,0,2327,568,1437,172,32,5,0,0,2214,4541
81,47,866,1371,110,7,3,0,0,2357,547,1541,188,32,1,0,0,2309,4666
81,48,872,1523,135,6,5,1,0,2542,566,1657,217,46,2,0,0,2488,5030
81,49,819,1547,149,6,4,0,0,2525,545,1705,230,49,1,0,0,2530,5055
81,50,749,1534,161,8,4,0,0,2456,502,1731,257,47,1,0,0,2538,4994
81,51,667,1619,157,12,1,0,0,2456,462,1780,265,56,0,0,0,2563,5019
81,52,656,1578,194,14,5,0,1,2448,421,1800,234,77,2,0,0,2534,4982
81,53,590,1654,206,24,5,0,0,2479,403,1764,243,78,3,0,0,2491,4970
81,54,530,1717,202,18,2,0,0,2469,403,1829,271,94,1,0,0,2598,5067
81,55,509,1768,196,31,5,0,0,2509,360,1836,265,107,3,0,0,2571,5080
81,56,483,1803,228,21,4,1,0,2540,339,1882,271,132,1,0,0,2625,5165
81,57,468,1912,244,35,6,0,0,2665,342,1852,256,125,0,0,0,2575,5240
81,58,452,1886,242,34,4,0,0,2618,336,1886,258,167,2,0,0,2649,5267
81,59,432,1922,230,33,6,0,0,2623,288,1880,267,173,0,0,0,2608,5231
81,60,351,1834,208,48,0,0,0,2441,257,1821,227,177,0,0,0,2482,4923
81,61,324,1776,218,47,4,0,0,2369,226,1756,221,208,1,0,0,2412,4781
81,62,267,1761,193,53,7,0,0,2281,215,1767,190,217,1,0,0,2390,4671
81,63,256,1713,158,66,3,0,0,2196,198,1707,191,253,1,0,0,2350,4546
81,64,251,1697,170,57,1,0,0,2176,187,1602,192,252,1,0,0,2234,4410
81,65,225,1674,151,68,2,0,0,2120,159,1577,159,291,0,0,0,2186,4306
81,66,201,1587,169,68,1,0,0,2026,176,1572,155,333,0,0,0,2236,4262
81,67,190,1592,119,78,2,0,0,1981,150,1519,160,342,1,0,0,2172,4153
81,68,196,1589,132,103,2,0,0,2022,152,1449,144,369,0,0,0,2114,4136
81,69,177,1622,110,89,1,0,0,1999,120,1490,141,393,1,0,0,2145,4144
81,70,155,1534,109,90,2,0,0,1890,124,1339,102,425,0,0,0,1990,3880
81,71,117,1491,82,89,1,0,0,1780,134,1265,115,409,2,0,0,1925,3705
81,72,127,1356,122,83,2,0,0,1690,102,1187,110,467,2,0,0,1868,3558
81,73,126,1459,104,126,2,0,0,1817,81,1138,99,512,0,0,0,1830,3647
81,74,138,1368,99,129,0,0,0,1734,107,1186,80,600,0,0,0,1973,3707
81,75,122,1457,69,142,1,0,0,1791,93,1161,75,636,1,0,0,1966,3757
81,76,120,1441,74,153,2,0,0,1790,90,1144,69,687,0,0,0,1990,3780
81,77,112,1264,59,156,2,0,0,1593,80,980,71,748,0,0,0,1879,3472
81,78,61,1003,40,137,0,0,0,1241,77,701,46,682,0,0,0,1506,2747
81,79,70,956,49,152,0,0,1,1228,67,691,42,675,0,0,0,1475,2703
81,80,50,890,35,145,1,0,0,1121,77,569,45,703,0,0,0,1394,2515
81,81,51,774,33,140,0,0,0,998,50,529,36,690,0,0,0,1305,2303
81,82,52,767,33,137,0,0,0,989,60,464,25,728,0,0,0,1277,2266
81,83,52,719,17,190,0,0,0,978,73,418,31,908,0,0,0,1430,2408
81,84,45,690,15,187,0,0,0,937,58,336,22,893,0,0,0,1309,2246
81,85,35,593,18,176,0,0,0,822,57,311,21,821,0,0,0,1210,2032
81,86,32,465,12,175,0,0,0,684,51,232,21,808,0,0,0,1112,1796
81,87,30,382,9,133,0,0,0,554,47,170,11,717,0,0,0,945,1499
81,88,29,313,5,145,0,0,0,492,31,133,13,659,0,0,0,836,1328
81,89,13,256,1,122,0,0,0,392,24,94,8,631,0,0,0,757,1149
81,90,12,206,3,118,0,0,0,339,25,66,4,555,0,0,0,650,989
81,91,11,148,4,97,0,0,0,260,32,50,11,435,0,0,0,528,788
81,92,11,81,3,77,0,0,0,172,17,27,2,381,0,0,0,427,599
81,93,5,85,2,55,0,0,0,147,14,19,1,369,0,0,0,403,550
81,94,4,39,0,55,0,0,0,98,17,20,3,244,0,0,0,284,382
81,95,3,30,0,32,0,0,0,65,7,6,2,189,0,0,0,204,269
81,96,6,15,0,34,0,0,0,55,6,5,0,157,0,0,0,168,223
81,97,1,13,0,13,0,0,0,27,5,4,0,97,0,0,0,106,133
81,98,1,3,0,9,0,0,0,13,5,2,1,71,0,0,0,79,92
81,99,0,5,0,7,0,0,0,12,4,2,0,37,0,0,0,43,55
81,100,0,5,0,3,0,0,0,8,6,2,0,90,0,0,0,98,106
81,999,70881,70555,5687,4267,130,2,2,151524,59142,69533,7195,20229,60,3,0,156162,307686
82,0,444,0,0,0,0,0,0,444,375,0,0,0,0,0,0,375,819
82,1,430,0,0,0,0,0,0,430,432,0,0,0,0,0,0,432,862
82,2,466,0,0,0,0,0,0,466,405,0,0,0,0,0,0,405,871
82,3,461,0,0,0,0,0,0,461,454,0,0,0,0,0,0,454,915
82,4,514,0,0,0,0,0,0,514,426,0,0,0,0,0,0,426,940
82,5,508,0,0,0,0,0,0,508,425,0,0,0,0,0,0,425,933
82,6,523,0,0,0,0,0,0,523,498,0,0,0,0,0,0,498,1021
82,7,517,0,0,0,0,0,0,517,502,0,0,0,0,0,0,502,1019
82,8,550,0,0,0,0,0,0,550,534,0,0,0,0,0,0,534,1084
82,9,569,0,0,0,0,0,0,569,563,0,0,0,0,0,0,563,1132
82,10,622,0,0,0,0,0,0,622,513,0,0,0,0,0,0,513,1135
82,11,622,0,0,0,0,0,0,622,581,0,0,0,0,0,0,581,1203
82,12,642,0,0,0,0,0,0,642,601,0,0,0,0,0,0,601,1243
82,13,604,0,0,0,0,0,0,604,604,0,0,0,0,0,0,604,1208
82,14,699,0,0,0,0,0,0,699,600,0,0,0,0,0,0,600,1299
82,15,672,0,0,0,0,0,0,672,641,0,0,0,0,0,0,641,1313
82,16,653,0,0,0,0,0,0,653,627,0,0,0,0,0,0,627,1280
82,17,737,0,0,0,0,0,0,737,607,0,0,0,0,0,0,607,1344
82,18,709,0,0,0,0,0,0,709,604,0,0,0,0,0,0,604,1313
82,19,734,0,0,0,0,0,0,734,627,2,0,0,0,0,0,629,1363
82,20,775,0,0,0,0,0,0,775,574,4,1,0,0,0,0,579,1354
82,21,688,2,0,0,0,0,0,690,664,5,0,0,0,0,0,669,1359
82,22,699,3,0,0,0,0,0,702,628,5,1,0,1,0,0,635,1337
82,23,740,2,0,0,0,0,0,742,699,18,1,0,0,0,0,718,1460
82,24,748,6,0,0,0,0,0,754,669,22,0,0,1,0,0,692,1446
82,25,789,13,0,0,0,0,0,802,614,33,2,0,0,0,0,649,1451
82,26,816,25,1,0,0,0,0,842,607,47,0,0,0,0,0,654,1496
82,27,824,32,0,0,0,0,0,856,631,66,3,0,0,0,0,700,1556
82,28,860,49,3,0,2,0,0,914,612,90,1,0,0,0,0,703,1617
82,29,792,61,1,0,1,0,0,855,611,118,4,0,0,0,0,733,1588
82,30,754,85,0,0,0,0,0,839,579,119,5,0,0,0,0,703,1542
82,31,816,106,3,2,1,0,0,928,577,169,7,0,0,0,0,753,1681
82,32,748,137,3,1,0,0,0,889,511,184,6,2,0,0,0,703,1592
82,33,693,140,5,0,0,0,0,838,518,206,10,1,0,0,0,735,1573
82,34,647,180,4,0,1,0,0,832,486,272,9,1,1,0,0,769,1601
82,35,631,226,4,0,0,0,0,861,488,250,15,1,0,0,0,754,1615
82,36,627,217,8,1,0,0,0,853,429,321,21,2,1,0,0,774,1627
82,37,559,241,6,1,0,0,0,807,416,377,15,3,2,1,0,814,1621
82,38,558,295,12,1,0,0,0,866,381,418,23,1,0,0,0,823,1689
82,39,514,347,14,2,2,0,0,879,361,409,18,3,0,0,0,791,1670
82,40,511,393,18,1,1,0,0,924,341,420,28,3,1,0,0,793,1717
82,41,490,407,18,0,4,0,0,919,315,459,28,4,1,0,0,807,1726
82,42,445,401,29,0,1,0,0,876,348,535,40,8,2,0,0,933,1809
82,43,460,435,23,2,0,0,0,920,329,516,39,8,0,0,0,892,1812
82,44,467,483,32,0,1,0,0,983,305,537,60,7,0,0,0,909,1892
82,45,483,539,46,5,0,0,0,1073,314,648,54,13,0,1,0,1030,2103
82,46,442,576,37,0,0,0,0,1055,301,662,66,16,0,0,0,1045,2100
82,47,407,622,42,2,1,0,0,1074,316,673,67,17,1,0,0,1074,2148
82,48,411,653,51,5,2,0,0,1122,289,746,78,18,0,0,0,1131,2253
82,49,438,726,50,4,2,0,0,1220,256,812,80,25,2,0,0,1175,2395
82,50,385,718,48,9,0,0,0,1160,294,788,75,24,1,0,0,1182,2342
82,51,341,750,55,11,0,0,0,1157,240,807,95,32,0,0,0,1174,2331
82,52,324,702,62,9,1,0,0,1098,214,861,93,34,0,0,0,1202,2300
82,53,308,769,73,7,0,0,0,1157,196,920,101,34,2,0,0,1253,2410
82,54,329,851,80,11,0,0,0,1271,184,870,100,46,0,0,0,1200,2471
82,55,281,827,83,8,4,0,0,1203,208,909,107,53,0,0,0,1277,2480
82,56,265,894,70,8,0,0,0,1237,185,929,87,50,0,0,0,1251,2488
82,57,256,862,109,19,3,0,0,1249,157,927,100,76,0,0,0,1260,2509
82,58,233,967,84,16,2,0,0,1302,176,964,88,78,0,0,0,1306,2608
82,59,215,951,78,23,2,0,0,1269,166,920,113,84,0,0,0,1283,2552
82,60,198,930,94,26,2,0,0,1250,124,909,99,89,0,0,0,1221,2471
82,61,172,893,106,18,1,0,0,1190,149,872,94,119,1,0,0,1235,2425
82,62,149,890,94,30,2,0,0,1165,134,854,77,106,0,0,0,1171,2336
82,63,149,907,74,21,2,0,0,1153,113,853,71,125,0,0,0,1162,2315
82,64,131,822,57,26,1,0,0,1037,109,808,73,128,0,0,0,1118,2155
82,65,131,817,60,15,0,0,0,1023,100,781,75,134,0,0,0,1090,2113
82,66,107,743,62,38,1,0,0,951,80,743,66,163,0,0,0,1052,2003
82,67,121,796,56,37,1,0,0,1011,80,756,75,149,0,0,0,1060,2071
82,68,107,789,61,36,1,0,0,994,77,718,56,165,0,0,0,1016,2010
82,69,90,812,49,37,1,0,0,989,64,702,58,184,0,0,0,1008,1997
82,70,81,763,53,43,1,0,0,941,78,700,40,200,1,0,0,1019,1960
82,71,87,733,64,46,1,0,0,931,60,657,42,191,0,0,0,950,1881
82,72,51,756,49,48,0,0,0,904,60,677,56,206,0,0,0,999,1903
82,73,73,804,45,80,0,0,0,1002,57,619,52,236,0,0,0,964,1966
82,74,56,759,40,71,0,0,0,926,59,604,38,242,1,0,0,944,1870
82,75,63,782,31,79,0,0,0,955,60,646,35,338,0,0,0,1079,2034
82,76,52,703,35,72,0,0,0,862,56,528,31,311,0,0,0,926,1788
82,77,51,661,19,74,0,0,0,805,41,447,21,354,0,0,0,863,1668
82,78,34,509,23,62,0,0,0,628,34,394,29,263,0,0,0,720,1348
82,79,35,492,21,81,0,0,0,629,44,308,22,289,0,0,1,664,1293
82,80,38,472,17,84,0,0,0,611,34,318,24,323,0,0,0,699,1310
82,81,35,408,14,72,1,0,0,530,24,274,10,340,0,0,0,648,1178
82,82,39,381,20,72,0,0,0,512,28,248,12,372,0,0,0,660,1172
82,83,26,399,10,98,0,0,0,533,37,295,18,425,0,0,0,775,1308
82,84,32,347,8,87,1,0,0,475,34,195,7,433,0,0,0,669,1144
82,85,22,355,10,102,0,0,0,489,24,173,13,455,0,0,0,665,1154
82,86,15,273,4,86,0,0,0,378,22,118,11,404,0,0,0,555,933
82,87,7,220,4,73,0,0,0,304,14,99,4,285,0,0,0,402,706
82,88,20,189,1,88,0,0,0,298,29,78,4,382,0,0,0,493,791
82,89,14,136,3,77,0,0,0,230,20,75,3,303,0,0,0,401,631
82,90,4,121,2,58,0,0,0,185,15,48,3,287,0,0,0,353,538
82,91,12,76,2,51,0,0,0,141,11,32,3,201,0,0,0,247,388
82,92,7,69,0,41,0,0,0,117,14,33,1,209,0,0,0,257,374
82,93,5,59,1,46,0,0,0,111,13,17,2,188,0,0,0,220,331
82,94,3,35,0,41,0,0,0,79,6,13,0,139,0,0,0,158,237
82,95,3,18,0,21,0,0,0,42,9,6,0,97,0,0,0,112,154
82,96,1,20,0,18,0,0,0,39,8,11,0,84,0,0,0,103,142
82,97,0,8,0,13,0,0,0,21,0,2,2,71,0,0,0,75,96
82,98,0,5,0,7,0,0,0,12,2,3,1,48,0,0,0,54,66
82,99,0,4,0,6,0,0,0,10,2,0,1,34,0,0,0,37,47
82,100,1,6,0,4,0,0,0,11,3,0,0,49,0,0,0,52,63
82,999,35667,34655,2341,2233,47,0,0,74943,28736,33652,2870,9765,19,2,1,75045,149988
83,0,13180,0,0,0,0,0,0,13180,12341,0,0,0,0,0,0,12341,25521
83,1,14108,0,0,0,0,0,0,14108,13345,0,0,0,0,0,0,13345,27453
83,2,14748,0,0,0,0,0,0,14748,14073,0,0,0,0,0,0,14073,28821
83,3,15023,0,0,0,0,0,0,15023,14216,0,0,0,0,0,0,14216,29239
83,4,15827,0,0,0,0,0,0,15827,14914,0,0,0,0,0,0,14914,30741
83,5,16710,0,0,0,0,0,0,16710,15958,0,0,0,0,0,0,15958,32668
83,6,17457,0,0,0,0,0,0,17457,16453,0,0,0,0,0,0,16453,33910
83,7,18237,0,0,0,0,0,0,18237,17372,0,0,0,0,0,0,17372,35609
83,8,18812,0,0,0,0,0,0,18812,17963,0,0,0,0,0,0,17963,36775
83,9,19806,0,0,0,0,0,0,19806,18331,0,0,0,0,0,0,18331,38137
83,10,19787,0,0,0,0,0,0,19787,18679,0,0,0,0,0,0,18679,38466
83,11,21028,0,0,0,0,0,0,21028,19923,0,0,0,0,0,0,19923,40951
83,12,21084,0,0,0,0,0,0,21084,19931,0,0,0,0,0,0,19931,41015
83,13,21553,0,0,0,0,0,0,21553,20203,0,0,0,0,0,0,20203,41756
83,14,21713,0,0,0,0,0,0,21713,20234,0,0,0,0,0,0,20234,41947
83,15,21699,0,0,0,0,0,0,21699,20700,0,0,0,0,0,0,20700,42399
83,16,22026,0,0,0,0,0,0,22026,20622,2,0,0,0,0,0,20624,42650
83,17,21875,0,0,0,0,0,0,21875,20485,0,0,0,0,0,0,20485,42360
83,18,21412,1,1,0,0,0,0,21414,19757,3,0,0,0,0,0,19760,41174
83,19,21495,0,0,0,0,0,0,21495,19978,22,0,0,0,0,0,20000,41495
83,20,20780,5,1,0,0,0,0,20786,19435,61,0,0,0,0,0,19496,40282
83,21,20494,17,0,0,0,0,0,20511,18904,87,0,1,0,0,0,18992,39503
83,22,20586,30,7,0,0,0,0,20623,18844,207,4,0,0,0,0,19055,39678
83,23,20932,65,7,0,3,0,0,21007,18890,305,8,0,1,0,0,19204,40211
83,24,20467,127,11,0,4,0,0,20609,18406,463,11,1,5,0,0,18886,39495
83,25,21029,236,14,0,5,0,0,21284,18653,772,19,1,6,0,0,19451,40735
83,26,20444,390,11,0,8,0,0,20853,18165,1106,14,1,6,0,0,19292,40145
83,27,20704,578,13,0,8,0,0,21303,18038,1598,17,2,9,1,0,19665,40968
83,28,20690,919,14,0,10,2,0,21635,17626,2152,45,4,15,3,0,19845,41480
83,29,20225,1423,32,1,29,0,0,21710,17305,2988,58,9,28,1,0,20389,42099
83,30,19884,1872,45,2,17,3,0,21823,17213,3883,95,6,30,3,0,21230,43053
83,31,20264,2688,38,5,29,1,0,23025,16981,5064,130,14,30,4,0,22223,45248
83,32,19056,3584,74,6,40,2,0,22762,16100,5983,155,16,30,2,0,22286,45048
83,33,19278,4382,97,10,43,6,0,23816,15609,7217,211,32,37,4,0,23110,46926
83,34,17903,5457,131,7,47,0,0,23545,14490,8261,267,31,44,2,0,23095,46640
83,35,17485,6701,153,20,66,1,0,24426,14041,9598,366,45,65,5,1,24121,48547
83,36,16367,7364,205,11,71,0,0,24018,13275,10537,400,49,60,7,0,24328,48346
83,37,15313,8395,227,26,58,3,0,24022,12324,11098,581,83,49,5,0,24140,48162
83,38,15113,9635,330,28,78,3,0,25187,12155,12408,631,104,58,4,0,25360,50547
83,39,14662,10939,361,29,63,1,1,26056,11891,13267,820,125,64,5,0,26172,52228
83,40,14092,11963,485,40,77,5,0,26662,11471,14142,879,127,55,1,0,26675,53337
83,41,13697,13080,583,38,93,5,0,27496,11489,15281,986,135,77,2,0,27970,55466
83,42,13120,13535,618,74,75,2,0,27424,10847,15920,1159,221,61,0,0,28208,55632
83,43,12589,14486,699,68,73,2,0,27917,10679,16505,1309,258,41,4,0,28796,56713
83,44,12348,15329,892,89,104,3,0,28765,10558,17433,1562,311,61,4,0,29929,58694
83,45,12642,16401,996,88,76,3,0,30206,10591,18767,1731,331,48,0,0,31468,61674
83,46,12420,16929,1127,92,83,0,0,30651,10198,19539,1979,376,54,1,0,32147,62798
83,47,12075,18077,1267,111,83,3,1,31617,10447,20630,2095,473,53,2,0,33700,65317
83,48,12329,19332,1458,146,96,1,0,33362,10529,22020,2466,509,50,1,0,35575,68937
83,49,12400,20278,1687,139,97,4,3,34608,10443,23537,2787,597,64,2,0,37430,72038
83,50,11462,21073,1868,160,107,1,1,34672,9912,23683,2922,678,46,1,0,37242,71914
83,51,11073,21928,1966,194,102,1,1,35265,9315,24512,3137,749,44,2,2,37761,73026
83,52,10234,22422,2090,190,94,1,1,35032,8689,24781,3393,897,46,2,0,37808,72840
83,53,9660,22693,2156,236,102,0,1,34848,8121,24707,3601,1043,41,2,0,37515,72363
83,54,9087,23375,2418,267,89,1,2,35239,7923,25234,3768,1141,41,0,0,38107,73346
83,55,8439,23225,2523,308,98,3,2,34598,7346,25034,3842,1278,35,4,0,37539,72137
83,56,7718,23528,2587,322,106,2,1,34264,7035,25151,4070,1381,28,1,0,37666,71930
83,57,7420,24118,2753,404,108,0,0,34803,6518,25224,4041,1579,24,2,0,37388,72191
83,58,6737,24387,2817,406,104,0,1,34452,6180,25135,4095,1703,40,1,1,37155,71607
83,59,6382,25041,2839,489,100,0,2,34853,5763,25757,4214,2026,40,2,3,37805,72658
83,60,5314,23679,2666,551,93,4,1,32308,5128,24283,3952,2181,32,3,1,35580,67888
83,61,4683,22675,2620,536,62,2,1,30579,4727,22887,3697,2244,29,1,1,33586,64165
83,62,4180,22220,2435,612,69,0,2,29518,4259,22159,3419,2589,27,1,0,32454,61972
83,63,3749,21026,2172,670,68,1,1,27687,3947,20868,3353,2786,26,1,1,30982,58669
83,64,3356,20271,2070,657,64,1,1,26420,3652,20151,3134,2903,15,1,0,29856,56276
83,65,2879,19274,1972,732,71,1,3,24932,3319,18973,2975,3113,19,0,0,28399,53331
83,66,2751,18914,1818,696,55,0,1,24235,3143,18653,2717,3386,23,0,0,27922,52157
83,67,2482,18538,1748,833,38,1,1,23641,2659,17819,2625,3718,18,0,1,26840,50481
83,68,2151,18174,1521,843,28,0,0,22717,2691,17225,2351,3909,8,0,0,26184,48901
83,69,1873,17280,1502,1001,36,0,1,21693,2547,16504,2303,4315,6,0,0,25675,47368
83,70,1769,16219,1282,987,27,0,0,20284,2288,15435,2013,4341,9,0,0,24086,44370
83,71,1496,15705,1190,1061,27,0,1,19480,2067,14616,2003,4699,10,0,0,23395,42875
83,72,1493,15181,1077,1084,31,1,1,18868,1967,13977,1859,5081,13,0,0,22897,41765
83,73,1363,15547,1001,1201,30,2,0,19144,1931,14012,1809,5639,7,0,0,23398,42542
83,74,1163,15092,962,1364,24,0,2,18607,1838,13380,1643,6125,6,0,0,22992,41599
83,75,1171,15433,906,1558,21,0,1,19090,1892,13734,1608,6958,8,0,0,24200,43290
83,76,1059,15173,865,1769,21,0,0,18887,1735,13041,1511,7577,7,0,0,23871,42758
83,77,1003,14423,758,1739,13,0,0,17936,1684,12160,1500,8013,6,0,0,23363,41299
83,78,756,11040,549,1567,11,0,0,13923,1428,9121,1113,6976,4,0,1,18643,32566
83,79,698,10658,517,1656,13,0,1,13543,1368,8303,1031,7378,3,0,1,18084,31627
83,80,689,10673,491,1750,11,0,0,13614,1395,8311,1014,8245,2,0,0,18967,32581
83,81,626,9769,445,1927,14,0,1,12782,1339,7261,912,8519,3,0,1,18035,30817
83,82,566,9501,359,2032,12,0,0,12470,1289,6645,834,8988,4,0,1,17761,30231
83,83,564,9428,350,2290,15,0,0,12647,1458,6440,783,10327,1,0,0,19009,31656
83,84,469,8591,271,2228,4,0,0,11563,1260,5381,642,10136,1,0,0,17420,28983
83,85,412,7478,245,2048,6,0,0,10189,1154,4428,596,9826,1,0,0,16005,26194
83,86,341,6056,207,2054,4,0,0,8662,1051,3333,433,9184,1,0,0,14002,22664
83,87,270,4912,166,1855,6,0,0,7209,937,2582,407,8393,0,0,0,12319,19528
83,88,234,4385,141,1851,1,0,1,6613,861,2035,309,8126,0,0,0,11331,17944
83,89,211,3412,108,1609,4,0,0,5344,777,1467,242,7436,0,0,0,9922,15266
83,90,155,2610,69,1371,1,0,1,4207,635,1061,194,6489,0,0,0,8379,12586
83,91,101,2040,52,1173,1,1,0,3368,567,765,146,5529,0,0,0,7007,10375
83,92,91,1471,34,1098,0,0,0,2694,489,513,132,4798,0,0,0,5932,8626
83,93,80,1136,17,936,0,0,0,2169,445,415,95,4259,0,0,0,5214,7383
83,94,62,691,13,677,0,0,0,1443,292,221,91,3098,0,0,0,3702,5145
83,95,42,447,10,444,0,0,0,943,275,145,45,2367,0,0,0,2832,3775
83,96,30,274,4,346,1,0,0,655,169,84,29,1892,0,0,0,2174,2829
83,97,21,186,7,249,0,0,0,463,145,51,25,1290,0,0,0,1511,1974
83,98,9,90,1,161,0,0,0,261,114,51,27,929,0,0,0,1121,1382
83,99,8,65,3,132,0,0,0,208,100,33,12,647,0,0,0,792,1000
83,100,37,67,4,182,0,0,0,290,154,52,27,1002,0,0,0,1235,1525
83,999,1025587,885812,68229,51536,3328,73,38,2034603,937053,908649,111479,231748,1775,87,15,2190806,4225409
84,0,1881,0,0,0,0,0,0,1881,1825,0,0,0,0,0,0,1825,3706
84,1,1961,0,0,0,0,0,0,1961,1876,0,0,0,0,0,0,1876,3837
84,2,2102,0,0,0,0,0,0,2102,1955,0,0,0,0,0,0,1955,4057
84,3,2035,0,0,0,0,0,0,2035,1987,0,0,0,0,0,0,1987,4022
84,4,2206,0,0,0,0,0,0,2206,2086,0,0,0,0,0,0,2086,4292
84,5,2379,0,0,0,0,0,0,2379,2230,0,0,0,0,0,0,2230,4609
84,6,2519,0,0,0,0,0,0,2519,2293,0,0,0,0,0,0,2293,4812
84,7,2544,0,0,0,0,0,0,2544,2364,0,0,0,0,0,0,2364,4908
84,8,2460,0,0,0,0,0,0,2460,2412,0,0,0,0,0,0,2412,4872
84,9,2640,0,0,0,0,0,0,2640,2493,0,0,0,0,0,0,2493,5133
84,10,2726,0,0,0,0,0,0,2726,2598,0,0,0,0,0,0,2598,5324
84,11,2808,0,0,0,0,0,0,2808,2615,0,0,0,0,0,0,2615,5423
84,12,2828,0,0,0,0,0,0,2828,2700,0,0,0,0,0,0,2700,5528
84,13,2936,0,0,0,0,0,0,2936,2735,0,0,0,0,0,0,2735,5671
84,14,2875,0,0,0,0,0,0,2875,2767,0,0,0,0,0,0,2767,5642
84,15,2848,0,0,0,0,0,0,2848,2750,0,0,0,0,0,0,2750,5598
84,16,2866,0,0,0,0,0,0,2866,2698,0,0,0,0,0,0,2698,5564
84,17,2871,0,0,0,0,0,0,2871,2748,0,0,0,0,0,0,2748,5619
84,18,2759,0,0,0,0,0,0,2759,2686,1,0,0,0,0,0,2687,5446
84,19,2854,0,0,0,0,0,0,2854,2679,4,0,0,0,0,0,2683,5537
84,20,2907,3,0,0,0,0,0,2910,2699,16,0,0,0,0,0,2715,5625
84,21,2853,3,0,0,0,0,0,2856,2587,26,0,0,0,0,0,2613,5469
84,22,2904,8,0,0,0,0,0,2912,2649,37,0,0,0,0,0,2686,5598
84,23,3086,12,0,0,0,0,0,3098,2631,52,2,1,0,0,0,2686,5784
84,24,3056,27,0,0,0,0,0,3083,2608,96,0,0,0,0,0,2704,5787
84,25,2989,45,0,0,0,0,0,3034,2422,126,4,0,0,0,0,2552,5586
84,26,3085,84,0,1,0,0,0,3170,2480,245,1,1,1,0,0,2728,5898
84,27,2959,124,4,0,1,0,0,3088,2465,279,4,1,0,0,0,2749,5837
84,28,2935,170,1,0,0,0,0,3106,2301,430,7,0,2,1,0,2741,5847
84,29,2985,237,6,1,0,0,0,3229,2228,576,12,2,2,0,0,2820,6049
84,30,2818,363,5,0,0,0,0,3186,2159,711,11,4,0,1,0,2886,6072
84,31,2791,471,10,0,0,0,0,3272,2086,972,14,2,3,0,0,3077,6349
84,32,2498,633,9,1,1,0,0,3142,1934,1078,32,5,5,0,0,3054,6196
84,33,2550,767,20,2,2,0,0,3341,1787,1299,37,3,4,0,0,3130,6471
84,34,2371,958,21,3,2,0,0,3355,1748,1441,45,4,1,0,0,3239,6594
84,35,2353,1105,31,4,4,0,0,3497,1624,1594,70,8,5,0,0,3301,6798
84,36,2151,1173,32,2,6,0,0,3364,1486,1721,62,8,3,0,0,3280,6644
84,37,2172,1431,49,1,1,0,0,3654,1378,1701,71,9,1,0,0,3160,6814
84,38,1977,1527,48,2,3,0,0,3557,1336,1916,98,10,2,0,0,3362,6919
84,39,1913,1724,65,4,4,0,0,3710,1229,1987,104,13,4,0,0,3337,7047
84,40,1815,1762,58,5,3,0,0,3643,1149,2123,124,14,3,0,0,3413,7056
84,41,1764,1974,88,5,0,0,0,3831,1149,2350,141,37,3,0,0,3680,7511
84,42,1685,2099,88,7,2,1,0,3882,1135,2379,165,27,5,1,0,3712,7594
84,43,1590,2227,106,12,4,0,0,3939,993,2517,174,33,0,0,0,3717,7656
84,44,1538,2291,125,11,3,0,0,3968,971,2574,244,38,3,0,0,3830,7798
84,45,1542,2427,135,13,2,0,0,4119,966,2815,218,55,3,0,0,4057,8176
84,46,1498,2601,148,18,3,0,0,4268,945,2871,251,45,4,1,0,4117,8385
84,47,1448,2897,184,17,5,0,0,4551,929,3092,284,57,0,0,0,4362,8913
84,48,1443,2992,191,31,3,0,0,4660,917,3315,293,87,4,0,0,4616,9276
84,49,1314,3094,219,21,2,0,0,4650,912,3392,293,95,2,0,0,4694,9344
84,50,1290,3152,280,22,2,0,0,4746,872,3414,352,107,0,0,0,4745,9491
84,51,1216,3192,260,24,7,1,0,4700,797,3465,328,125,1,0,0,4716,9416
84,52,1139,3162,301,30,10,0,0,4642,744,3452,412,122,1,0,0,4731,9373
84,53,1003,3321,274,38,4,0,1,4641,628,3492,381,150,3,0,0,4654,9295
84,54,912,3290,301,36,5,0,0,4544,564,3551,400,183,1,0,0,4699,9243
84,55,862,3346,261,54,3,0,0,4526,546,3581,398,176,2,0,0,4703,9229
84,56,767,3431,312,51,5,1,0,4567,563,3487,407,216,2,0,0,4675,9242
84,57,656,3522,321,56,3,0,0,4558,515,3572,383,246,1,0,0,4717,9275
84,58,651,3528,322,59,4,0,0,4564,490,3479,391,231,1,0,0,4592,9156
84,59,593,3536,306,79,7,0,0,4521,452,3607,370,310,2,0,0,4741,9262
84,60,510,3292,319,64,2,0,0,4187,413,3272,349,318,4,0,0,4356,8543
84,61,429,3191,269,61,2,0,0,3952,358,3175,300,330,1,0,0,4164,8116
84,62,393,3156,236,79,2,0,0,3866,324,3159,310,376,0,0,1,4170,8036
84,63,336,3007,246,101,9,0,0,3699,303,2948,274,449,3,0,0,3977,7676
84,64,302,2976,226,108,1,0,0,3613,276,2820,277,468,2,0,0,3843,7456
84,65,263,2768,217,103,1,0,0,3352,277,2687,244,449,1,0,0,3658,7010
84,66,273,2728,195,111,2,0,0,3309,194,2655,197,534,0,0,0,3580,6889
84,67,224,2682,166,116,1,0,0,3189,220,2553,191,527,2,0,0,3493,6682
84,68,181,2691,163,130,2,0,0,3167,213,2578,182,559,0,0,0,3532,6699
84,69,172,2790,172,138,1,0,0,3273,198,2471,163,693,0,0,0,3525,6798
84,70,165,2524,111,167,0,0,0,2967,165,2222,135,625,0,0,0,3147,6114
84,71,147,2425,126,166,0,0,0,2864,160,2115,128,707,0,0,0,3110,5974
84,72,147,2421,112,156,1,0,0,2837,153,2142,136,808,1,0,0,3240,6077
84,73,112,2451,126,171,1,0,0,2861,151,2147,169,906,0,0,0,3373,6234
84,74,130,2496,133,220,1,0,0,2980,166,2063,152,1002,0,0,0,3383,6363
84,75,135,2594,109,252,1,0,0,3091,164,2055,130,1165,0,0,0,3514,6605
84,76,126,2540,83,248,1,0,0,2998,143,1771,126,1204,0,0,0,3244,6242
84,77,96,2275,72,268,1,0,0,2712,144,1671,107,1285,0,0,0,3207,5919
84,78,64,1508,54,193,0,0,0,1819,74,1093,63,883,0,0,0,2113,3932
84,79,64,1401,53,216,0,0,0,1734,93,983,62,988,0,0,0,2126,3860
84,80,58,1436,39,221,1,0,0,1755,76,962,47,1109,0,0,0,2194,3949
84,81,62,1389,40,225,1,0,0,1717,87,899,46,1183,0,0,0,2215,3932
84,82,51,1290,26,245,0,0,0,1612,113,763,42,1216,0,0,0,2134,3746
84,83,51,1287,36,310,1,0,0,1685,80,722,53,1359,0,0,0,2214,3899
84,84,45,1167,30,298,0,0,0,1540,87,635,43,1272,0,0,0,2037,3577
84,85,27,991,16,288,0,0,0,1322,64,504,24,1325,0,0,0,1917,3239
84,86,34,836,7,265,0,0,0,1142,81,375,24,1230,0,0,0,1710,2852
84,87,21,660,14,261,0,0,0,956,65,301,21,1066,0,0,0,1453,2409
84,88,31,591,10,235,2,0,0,869,49,232,12,1024,0,0,0,1317,2186
84,89,19,413,7,226,0,0,0,665,58,162,23,856,0,0,0,1099,1764
84,90,10,299,5,158,0,0,0,472,38,121,12,743,0,0,0,914,1386
84,91,8,261,0,151,0,0,0,420,29,96,6,660,0,0,0,791,1211
84,92,8,209,3,136,0,0,0,356,31,53,8,564,0,0,0,656,1012
84,93,5,133,2,115,0,0,0,255,43,45,11,486,0,0,0,585,840
84,94,5,90,2,93,0,0,0,190,20,21,3,350,0,0,0,394,584
84,95,4,62,0,60,0,0,0,126,18,20,2,282,0,0,0,322,448
84,96,4,35,0,39,0,0,0,78,11,8,1,196,0,0,0,216,294
84,97,2,23,1,33,0,0,0,59,7,6,0,137,0,0,0,150,209
84,98,0,14,0,17,0,0,0,31,4,6,2,106,0,0,0,118,149
84,99,0,8,0,13,0,0,0,21,9,7,0,83,0,0,0,99,120
84,100,2,12,2,23,0,0,0,39,6,10,2,110,0,0,0,128,167
84,999,133893,131831,8009,7090,135,3,1,280962,111736,131364,10660,32058,88,4,1,285911,566873
85,0,1403,0,0,0,0,0,0,1403,1432,0,0,0,0,0,0,1432,2835
85,1,1567,0,0,0,0,0,0,1567,1411,0,0,0,0,0,0,1411,2978
85,2,1543,0,0,0,0,0,0,1543,1488,0,0,0,0,0,0,1488,3031
85,3,1570,0,0,0,0,0,0,1570,1612,0,0,0,0,0,0,1612,3182
85,4,1670,0,0,0,0,0,0,1670,1579,0,0,0,0,0,0,1579,3249
85,5,1740,0,0,0,0,0,0,1740,1651,0,0,0,0,0,0,1651,3391
85,6,1853,0,0,0,0,0,0,1853,1803,0,0,0,0,0,0,1803,3656
85,7,2053,0,0,0,0,0,0,2053,1899,0,0,0,0,0,0,1899,3952
85,8,1921,0,0,0,0,0,0,1921,1934,0,0,0,0,0,0,1934,3855
85,9,1956,0,0,0,0,0,0,1956,1902,0,0,0,0,0,0,1902,3858
85,10,2025,0,0,0,0,0,0,2025,1962,0,0,0,0,0,0,1962,3987
85,11,2097,0,0,0,0,0,0,2097,2093,0,0,0,0,0,0,2093,4190
85,12,2107,0,0,0,0,0,0,2107,2006,0,0,0,0,0,0,2006,4113
85,13,2270,0,0,0,0,0,0,2270,2128,0,0,0,0,0,0,2128,4398
85,14,2202,0,0,0,0,0,0,2202,2033,0,0,0,0,0,0,2033,4235
85,15,2188,0,0,0,0,0,0,2188,2149,0,0,0,0,0,0,2149,4337
85,16,2278,0,0,0,0,0,0,2278,2068,0,0,0,0,0,0,2068,4346
85,17,2144,1,1,0,0,0,0,2146,2077,0,0,0,0,0,0,2077,4223
85,18,2189,0,0,0,0,0,0,2189,2054,1,0,0,0,0,0,2055,4244
85,19,2310,1,0,1,0,0,0,2312,2074,3,0,0,0,0,0,2077,4389
85,20,2215,1,0,0,0,0,0,2216,2049,11,0,0,0,0,0,2060,4276
85,21,2195,0,0,0,0,0,0,2195,2034,18,0,0,0,0,0,2052,4247
85,22,2259,3,0,0,0,0,0,2262,1937,42,0,0,0,0,0,1979,4241
85,23,2349,12,0,0,0,0,0,2361,2014,66,1,0,1,0,0,2082,4443
85,24,2372,27,0,0,0,0,0,2399,2042,70,0,1,0,0,0,2113,4512
85,25,2354,29,0,0,1,0,0,2384,2019,103,0,0,2,0,0,2124,4508
85,26,2441,56,1,0,0,0,0,2498,1938,180,3,0,0,0,0,2121,4619
85,27,2271,90,2,0,0,0,0,2363,1941,240,3,1,0,1,0,2186,4549
85,28,2335,143,4,0,2,0,0,2484,1870,315,7,0,0,0,0,2192,4676
85,29,2342,189,2,1,0,0,0,2534,1816,461,10,1,1,0,0,2289,4823
85,30,2221,271,3,1,0,0,0,2496,1708,593,14,1,1,1,0,2318,4814
85,31,2297,371,4,0,2,0,0,2674,1774,729,18,2,1,0,0,2524,5198
85,32,2160,521,7,0,3,0,0,2691,1607,863,14,2,0,0,0,2486,5177
85,33,2027,655,9,2,0,0,0,2693,1475,983,31,2,1,0,0,2492,5185
85,34,2014,751,23,0,0,0,0,2788,1407,1169,38,5,0,0,0,2619,5407
85,35,1851,886,26,1,3,0,0,2767,1307,1259,42,6,2,0,0,2616,5383
85,36,1724,1039,20,2,2,0,0,2787,1242,1268,50,8,0,1,0,2569,5356
85,37,1589,1098,22,2,2,0,0,2713,1170,1438,78,11,2,0,0,2699,5412
85,38,1641,1166,34,0,1,1,0,2843,1040,1541,71,9,1,0,0,2662,5505
85,39,1523,1304,49,4,0,0,0,2880,1037,1688,84,12,0,0,0,2821,5701
85,40,1497,1483,67,1,3,0,0,3051,933,1820,89,18,0,0,0,2860,5911
85,41,1437,1585,63,6,5,0,0,3096,873,1904,106,17,2,0,0,2902,5998
85,42,1292,1660,69,5,1,0,0,3027,938,1942,123,27,0,0,0,3030,6057
85,43,1273,1744,74,8,1,0,0,3100,804,2092,138,23,1,0,0,3058,6158
85,44,1200,1769,112,3,2,0,0,3086,814,2133,157,47,0,0,0,3151,6237
85,45,1170,1968,110,9,3,0,0,3260,805,2223,189,44,1,0,0,3262,6522
85,46,1177,1982,112,8,2,0,0,3281,755,2262,192,53,0,0,0,3262,6543
85,47,1087,2154,150,7,0,0,0,3398,718,2491,209,56,0,0,0,3474,6872
85,48,1050,2273,170,17,3,0,0,3513,660,2557,216,48,0,0,0,3481,6994
85,49,1100,2400,156,18,2,0,0,3676,647,2670,233,78,0,0,0,3628,7304
85,50,920,2379,173,19,0,0,0,3491,641,2646,208,78,0,0,0,3573,7064
85,51,858,2320,183,14,0,0,0,3375,526,2789,224,104,2,0,0,3645,7020
85,52,830,2564,189,29,3,0,0,3615,541,2782,232,97,1,0,0,3653,7268
85,53,743,2591,179,25,1,0,0,3539,489,2725,253,113,0,0,0,3580,7119
85,54,718,2651,173,34,0,0,0,3576,458,2971,256,127,0,0,0,3812,7388
85,55,645,2673,163,29,0,0,0,3510,424,2831,209,173,0,0,0,3637,7147
85,56,617,2759,212,55,1,0,0,3644,414,2995,272,168,1,0,0,3850,7494
85,57,532,2761,213,46,1,0,0,3553,371,2971,237,182,1,0,0,3762,7315
85,58,460,2866,230,47,1,0,0,3604,341,2983,234,241,2,0,0,3801,7405
85,59,434,2940,225,64,0,0,0,3663,348,3161,220,279,0,0,0,4008,7671
85,60,403,2766,182,67,1,0,0,3419,284,2909,201,257,0,0,0,3651,7070
85,61,373,2818,199,59,2,0,0,3451,297,2833,204,346,0,0,0,3680,7131
85,62,350,2698,167,64,2,0,0,3281,313,2726,166,359,0,0,0,3564,6845
85,63,332,2752,168,92,0,0,0,3344,229,2702,156,440,0,0,0,3527,6871
85,64,294,2645,165,105,0,0,0,3209,217,2661,144,433,0,0,0,3455,6664
85,65,273,2660,111,90,0,0,0,3134,208,2531,161,489,0,0,0,3389,6523
85,66,269,2637,122,120,0,0,0,3148,209,2385,127,533,0,0,0,3254,6402
85,67,230,2541,122,129,2,0,0,3024,168,2326,113,569,0,0,0,3176,6200
85,68,221,2613,124,141,1,0,0,3100,164,2386,136,624,0,0,0,3310,6410
85,69,193,2545,103,127,0,0,0,2968,168,2238,111,685,0,0,0,3202,6170
85,70,190,2376,91,137,0,0,0,2794,177,2106,95,666,0,0,0,3044,5838
85,71,168,2375,74,121,0,0,0,2738,179,1989,82,727,0,0,0,2977,5715
85,72,151,2413,74,152,0,0,0,2790,143,1915,80,838,0,0,0,2976,5766
85,73,118,2313,71,181,0,0,0,2683,143,1861,76,879,0,0,0,2959,5642
85,74,135,2380,86,229,0,0,0,2830,127,1875,81,934,0,0,0,3017,5847
85,75,129,2445,57,224,0,0,0,2855,139,1836,75,1100,0,0,0,3150,6005
85,76,110,2301,55,220,0,0,0,2686,127,1624,60,1159,0,0,0,2970,5656
85,77,87,1928,51,232,0,0,0,2298,117,1395,42,1148,0,0,0,2702,5000
85,78,65,1282,31,152,0,0,0,1530,68,869,34,805,0,0,0,1776,3306
85,79,64,1300,36,200,0,0,0,1600,89,878,31,991,0,0,0,1989,3589
85,80,65,1287,21,185,0,0,0,1558,92,824,36,999,0,0,0,1951,3509
85,81,59,1142,12,174,0,0,0,1387,71,667,27,969,0,0,0,1734,3121
85,82,40,1040,18,204,0,0,0,1302,81,633,22,1016,0,0,0,1752,3054
85,83,65,1212,22,255,0,0,0,1554,79,605,23,1140,0,0,0,1847,3401
85,84,46,1014,16,256,0,0,0,1332,82,543,20,1254,0,0,0,1899,3231
85,85,34,862,10,246,0,0,0,1152,74,428,13,1231,0,0,0,1746,2898
85,86,33,743,9,244,0,0,0,1029,74,361,15,1080,0,0,0,1530,2559
85,87,28,600,7,208,0,0,0,843,50,281,9,1007,0,0,0,1347,2190
85,88,18,506,7,205,0,0,0,736,54,208,10,945,0,0,0,1217,1953
85,89,20,420,1,204,0,0,0,645,51,165,8,940,0,0,0,1164,1809
85,90,13,343,5,186,0,0,0,547,37,118,5,777,0,0,0,937,1484
85,91,10,217,2,156,0,0,0,385,38,109,3,625,0,0,0,775,1160
85,92,10,190,2,146,0,0,0,348,37,61,2,554,0,0,0,654,1002
85,93,1,124,1,120,0,0,0,246,26,45,0,490,0,0,0,561,807
85,94,4,74,0,81,0,0,0,159,20,33,3,366,0,0,0,422,581
85,95,3,48,0,74,0,0,0,125,26,14,3,257,0,0,0,300,425
85,96,4,28,0,51,0,0,0,83,19,13,3,189,0,0,0,224,307
85,97,0,21,0,31,0,0,0,52,11,7,2,180,0,0,0,200,252
85,98,3,10,0,17,0,0,0,30,9,4,2,94,0,0,0,109,139
85,99,1,7,0,15,0,0,0,23,11,6,0,83,0,0,0,100,123
85,100,1,6,0,29,0,0,0,36,10,9,0,111,0,0,0,130,166
85,999,104919,111818,5452,6387,53,1,0,228630,87800,111168,6842,30323,23,3,0,236159,464789
86,0,3800,0,0,0,0,0,0,3800,3640,0,0,0,0,0,0,3640,7440
86,1,3953,0,0,0,0,0,0,3953,3745,0,0,0,0,0,0,3745,7698
86,2,3662,0,0,0,0,0,0,3662,3590,0,0,0,0,0,0,3590,7252
86,3,4019,0,0,0,0,0,0,4019,3731,0,0,0,0,0,0,3731,7750
86,4,3958,0,0,0,0,0,0,3958,3753,0,0,0,0,0,0,3753,7711
86,5,4163,0,0,0,0,0,0,4163,4025,0,0,0,0,0,0,4025,8188
86,6,4222,0,0,0,0,0,0,4222,4098,0,0,0,0,0,0,4098,8320
86,7,4362,0,0,0,0,0,0,4362,4127,0,0,0,0,0,0,4127,8489
86,8,4396,0,0,0,0,0,0,4396,4212,0,0,0,0,0,0,4212,8608
86,9,4447,0,0,0,0,0,0,4447,4140,0,0,0,0,0,0,4140,8587
86,10,4473,0,0,0,0,0,0,4473,4337,0,0,0,0,0,0,4337,8810
86,11,4680,0,0,0,0,0,0,4680,4345,0,0,0,0,0,0,4345,9025
86,12,4889,0,0,0,0,0,0,4889,4500,0,0,0,0,0,0,4500,9389
86,13,4998,0,0,0,0,0,0,4998,4946,0,0,0,0,0,0,4946,9944
86,14,5117,0,0,0,0,0,0,5117,4846,0,0,0,0,0,0,4846,9963
86,15,5129,0,0,0,0,0,0,5129,4934,0,0,0,0,0,0,4934,10063
86,16,5265,0,0,0,0,0,0,5265,4931,0,0,0,0,0,0,4931,10196
86,17,5293,0,0,1,0,0,0,5294,5042,0,0,0,0,0,0,5042,10336
86,18,5447,0,0,0,0,0,0,5447,4971,3,0,0,0,0,0,4974,10421
86,19,5667,3,0,0,0,0,0,5670,5250,10,0,0,0,0,0,5260,10930
86,20,5546,1,0,1,0,0,0,5548,5170,27,0,0,0,0,0,5197,10745
86,21,5356,7,0,0,0,0,0,5363,5091,44,0,0,1,0,0,5136,10499
86,22,5430,14,1,0,0,0,0,5445,5124,76,0,0,0,0,0,5200,10645
86,23,5236,33,0,0,0,0,0,5269,4978,143,3,1,0,0,0,5125,10394
86,24,5293,51,0,0,1,0,0,5345,4852,213,0,0,0,0,0,5065,10410
86,25,5316,111,1,0,0,0,0,5428,4591,358,3,0,1,0,0,4953,10381
86,26,5154,191,0,0,1,0,0,5346,4503,518,5,0,0,0,0,5026,10372
86,27,5017,261,1,0,0,0,0,5279,4163,757,3,5,1,0,0,4929,10208
86,28,4679,442,4,1,1,0,0,5127,3934,1168,11,1,2,0,0,5116,10243
86,29,4680,680,5,1,0,0,0,5366,3740,1490,12,2,1,0,0,5245,10611
86,30,4306,965,5,1,1,0,0,5278,3273,1950,17,4,2,0,0,5246,10524
86,31,4143,1327,3,1,2,0,0,5476,3125,2422,19,6,1,0,0,5573,11049
86,32,3890,1707,15,3,3,0,0,5618,2881,2787,34,9,3,0,0,5714,11332
86,33,3643,1983,14,3,2,1,0,5646,2543,2995,40,4,3,0,0,5585,11231
86,34,3391,2199,13,4,4,0,0,5611,2175,3478,57,12,0,0,0,5722,11333
86,35,3158,2564,29,1,2,0,0,5754,2070,3563,62,16,2,0,0,5713,11467
86,36,2815,2810,38,4,6,0,0,5673,1796,3749,90,24,2,0,0,5661,11334
86,37,2588,3076,48,4,3,0,0,5719,1663,3956,116,22,7,1,0,5765,11484
86,38,2459,3239,59,6,9,1,0,5773,1515,4207,103,22,4,0,0,5851,11624
86,39,2329,3545,60,8,4,0,0,5946,1468,4387,125,43,6,0,0,6029,11975
86,40,2273,3848,86,8,3,0,0,6218,1283,4683,123,31,4,0,0,6124,12342
86,41,2055,4099,72,9,4,0,0,6239,1217,4799,148,38,0,0,0,6202,12441
86,42,1950,4198,99,13,6,0,0,6266,1171,4700,160,61,1,0,0,6093,12359
86,43,1879,4277,109,13,2,0,0,6280,1089,4883,194,72,4,0,0,6242,12522
86,44,1864,4435,124,21,6,0,0,6450,1095,5057,211,70,0,0,0,6433,12883
86,45,1764,4710,138,18,2,0,0,6632,1039,5221,246,83,1,0,0,6590,13222
86,46,1647,4737,151,22,6,0,0,6563,998,5199,244,112,1,0,0,6554,13117
86,47,1674,5000,145,22,5,0,0,6846,965,5545,257,136,1,0,0,6904,13750
86,48,1591,5206,178,31,3,0,0,7009,958,5573,259,146,1,0,0,6937,13946
86,49,1517,5378,201,41,3,0,0,7140,988,5849,263,159,0,0,0,7259,14399
86,50,1350,5346,191,42,5,0,0,6934,949,5806,270,195,1,0,0,7221,14155
86,51,1227,5224,183,62,4,0,0,6700,933,5718,307,228,0,0,0,7186,13886
86,52,1232,5392,205,53,5,0,1,6888,872,5773,296,278,2,0,0,7221,14109
86,53,1126,5461,193,64,5,0,0,6849,887,5609,301,256,1,0,0,7054,13903
86,54,1012,5697,192,67,3,0,0,6971,822,5706,291,343,0,0,0,7162,14133
86,55,980,5750,209,66,1,0,0,7006,858,5786,288,380,0,0,0,7312,14318
86,56,912,5816,199,99,1,0,0,7027,797,5784,279,372,1,0,0,7233,14260
86,57,801,5765,222,116,0,0,0,6904,828,5692,299,458,1,0,0,7278,14182
86,58,794,5881,206,125,5,0,0,7011,778,5656,278,506,0,0,0,7218,14229
86,59,697,6019,213,132,1,0,0,7062,772,5730,283,579,1,0,0,7365,14427
86,60,625,5481,205,120,5,0,0,6436,703,5282,247,586,0,0,0,6818,13254
86,61,521,5301,170,142,1,0,1,6136,676,4893,245,686,2,0,0,6502,12638
86,62,502,5095,155,171,2,0,0,5925,620,4970,204,738,0,0,0,6532,12457
86,63,459,4958,139,156,3,0,0,5715,583,4518,194,778,0,0,0,6073,11788
86,64,366,4909,133,170,1,0,0,5579,584,4336,179,835,1,0,0,5935,11514
86,65,383,4557,129,180,1,0,0,5250,558,4029,175,866,0,0,0,5628,10878
86,66,339,4434,119,203,1,0,0,5096,438,3809,151,878,0,0,0,5276,10372
86,67,273,4182,121,222,0,0,0,4798,409,3726,152,982,0,0,0,5269,10067
86,68,288,4259,103,231,0,0,0,4881,428,3622,154,1082,1,0,0,5287,10168
86,69,232,4190,94,232,3,0,0,4751,437,3605,141,1262,0,0,0,5445,10196
86,70,209,3700,69,219,1,0,0,4198,352,3032,131,1114,0,0,0,4629,8827
86,71,188,3528,67,279,0,0,0,4062,355,2766,113,1183,0,0,0,4417,8479
86,72,165,3536,68,274,0,0,0,4043,313,2679,117,1331,0,0,0,4440,8483
86,73,134,3526,75,286,1,0,0,4022,319,2731,97,1512,0,0,0,4659,8681
86,74,158,3327,58,329,1,0,0,3873,311,2641,82,1601,0,0,0,4635,8508
86,75,120,3246,56,395,0,0,0,3817,307,2518,93,1626,1,0,0,4545,8362
86,76,128,3067,44,396,0,0,0,3635,274,2160,84,1788,0,0,0,4306,7941
86,77,108,2947,47,386,0,0,0,3488,250,2055,72,1959,0,0,0,4336,7824
86,78,77,2242,34,350,2,0,0,2705,207,1518,44,1586,0,0,0,3355,6060
86,79,93,1858,24,321,0,0,0,2296,199,1155,30,1445,0,0,0,2829,5125
86,80,76,1791,24,345,0,0,1,2237,216,1243,31,1640,0,0,0,3130,5367
86,81,57,1658,14,345,0,0,0,2074,177,1010,29,1568,0,0,0,2784,4858
86,82,52,1402,24,366,0,0,0,1844,198,871,30,1669,0,0,0,2768,4612
86,83,63,1440,12,435,0,0,0,1950,198,833,31,1828,0,0,0,2890,4840
86,84,39,1253,11,434,0,0,0,1737,194,670,25,1713,0,0,0,2602,4339
86,85,26,989,11,412,0,0,0,1438,164,541,20,1557,0,0,0,2282,3720
86,86,31,833,5,358,0,0,0,1227,121,406,17,1393,0,0,0,1937,3164
86,87,26,645,7,337,0,0,0,1015,124,331,10,1374,0,0,0,1839,2854
86,88,21,559,4,304,1,0,0,889,125,228,10,1243,0,0,0,1606,2495
86,89,15,380,3,238,0,0,0,636,90,159,13,1086,0,0,0,1348,1984
86,90,18,289,1,244,0,0,0,552,85,129,12,836,0,0,0,1062,1614
86,91,11,244,1,201,0,0,0,457,55,108,2,775,0,0,0,940,1397
86,92,8,158,2,177,0,0,0,345,63,66,2,652,0,0,0,783,1128
86,93,11,129,0,141,0,0,0,281,51,44,4,535,0,0,0,634,915
86,94,6,64,0,104,0,0,0,174,31,17,3,387,0,0,0,438,612
86,95,5,48,1,66,0,0,0,120,29,20,1,294,0,0,0,344,464
86,96,4,23,0,43,0,0,0,70,23,7,1,206,0,0,0,237,307
86,97,1,15,0,37,0,0,0,53,16,8,0,148,0,0,0,172,225
86,98,0,10,0,22,0,0,0,32,10,9,1,112,0,0,0,132,164
86,99,0,3,0,11,0,0,0,14,6,3,1,83,0,0,0,93,107
86,100,3,12,0,18,0,0,0,33,16,5,1,115,0,0,0,137,170
86,999,210555,217736,5642,10763,132,2,3,444833,185432,219823,8646,47726,61,1,0,461689,906522
87,0,850,0,0,0,0,0,0,850,820,0,0,0,0,0,0,820,1670
87,1,919,0,0,0,0,0,0,919,874,0,0,0,0,0,0,874,1793
87,2,865,0,0,0,0,0,0,865,780,0,0,0,0,0,0,780,1645
87,3,943,0,0,0,0,0,0,943,866,0,0,0,0,0,0,866,1809
87,4,989,0,0,0,0,0,0,989,990,0,0,0,0,0,0,990,1979
87,5,962,0,0,0,0,0,0,962,942,0,0,0,0,0,0,942,1904
87,6,1023,0,0,0,0,0,0,1023,1013,0,0,0,0,0,0,1013,2036
87,7,1046,0,0,0,0,0,0,1046,1019,0,0,0,0,0,0,1019,2065
87,8,1059,0,0,0,0,0,0,1059,969,0,0,0,0,0,0,969,2028
87,9,1046,0,0,0,0,0,0,1046,970,0,0,0,0,0,0,970,2016
87,10,1119,0,0,0,0,0,0,1119,1047,0,0,0,0,0,0,1047,2166
87,11,1118,0,0,0,0,0,0,1118,1024,0,0,0,0,0,0,1024,2142
87,12,1216,0,0,0,0,0,0,1216,1063,0,0,0,0,0,0,1063,2279
87,13,1157,0,0,0,0,0,0,1157,1163,0,0,0,0,0,0,1163,2320
87,14,1224,0,0,0,0,0,0,1224,1171,0,0,0,0,0,0,1171,2395
87,15,1231,0,0,0,0,0,0,1231,1151,0,0,0,0,0,0,1151,2382
87,16,1258,0,0,0,0,0,0,1258,1254,0,0,0,0,0,0,1254,2512
87,17,1314,0,0,0,0,0,0,1314,1184,0,0,0,0,0,0,1184,2498
87,18,1376,0,0,0,0,0,0,1376,1200,0,0,0,0,0,0,1200,2576
87,19,1466,0,0,0,0,0,0,1466,1214,2,0,0,0,0,0,1216,2682
87,20,1431,0,0,0,0,0,0,1431,1233,7,0,0,0,0,0,1240,2671
87,21,1433,3,0,0,0,0,0,1436,1302,13,0,0,0,0,0,1315,2751
87,22,1406,8,0,0,0,0,0,1414,1273,18,0,0,0,0,0,1291,2705
87,23,1546,6,0,0,0,0,0,1552,1313,22,0,0,0,0,0,1335,2887
87,24,1411,17,1,1,0,0,0,1430,1286,54,0,0,0,0,0,1340,2770
87,25,1429,15,0,0,0,0,0,1444,1275,76,0,0,0,0,0,1351,2795
87,26,1444,36,0,0,1,0,0,1481,1272,101,0,0,0,0,0,1373,2854
87,27,1460,51,0,0,0,0,0,1511,1184,150,2,0,0,0,0,1336,2847
87,28,1393,83,1,0,1,0,0,1478,1113,211,4,0,0,0,0,1328,2806
87,29,1405,134,2,0,0,0,0,1541,1059,292,0,1,1,0,0,1353,2894
87,30,1272,205,2,1,1,0,0,1481,1067,367,5,1,0,0,0,1440,2921
87,31,1329,270,6,0,0,0,0,1605,946,494,3,2,0,0,0,1445,3050
87,32,1231,353,2,1,0,0,0,1587,897,533,5,1,1,0,0,1437,3024
87,33,1178,396,8,0,0,0,0,1582,822,673,21,2,2,0,0,1520,3102
87,34,1054,491,11,0,0,0,0,1556,716,721,13,3,1,0,0,1454,3010
87,35,1047,580,4,0,0,0,0,1631,666,813,28,5,1,0,0,1513,3144
87,36,924,585,6,0,0,0,0,1515,561,846,26,3,0,0,0,1436,2951
87,37,843,646,15,1,0,0,0,1505,495,869,36,5,0,0,0,1405,2910
87,38,779,746,17,0,0,0,0,1542,512,923,35,6,2,0,0,1478,3020
87,39,757,823,15,1,0,0,0,1596,486,992,47,8,1,0,0,1534,3130
87,40,684,832,22,2,0,0,0,1540,431,1047,62,12,1,0,0,1553,3093
87,41,680,891,23,1,0,0,0,1595,398,1061,49,13,0,0,0,1521,3116
87,42,646,935,25,5,0,0,0,1611,403,1140,42,12,0,0,0,1597,3208
87,43,608,942,26,4,0,0,0,1580,365,1167,47,8,0,0,0,1587,3167
87,44,553,1040,31,3,0,0,0,1627,323,1239,65,25,0,0,0,1652,3279
87,45,580,1042,27,4,0,0,0,1653,336,1278,70,14,0,0,0,1698,3351
87,46,528,1076,48,5,0,0,0,1657,357,1345,68,22,1,0,0,1793,3450
87,47,527,1295,44,4,0,0,0,1870,330,1373,77,40,0,0,0,1820,3690
87,48,515,1233,65,7,1,0,0,1821,285,1490,92,39,0,0,0,1906,3727
87,49,493,1303,70,4,0,0,0,1870,307,1522,91,43,0,0,0,1963,3833
87,50,502,1365,75,12,0,0,0,1954,290,1509,97,49,0,0,0,1945,3899
87,51,450,1355,67,10,2,0,0,1884,272,1586,104,49,1,0,0,2012,3896
87,52,421,1420,80,20,0,0,0,1941,256,1617,103,67,0,0,0,2043,3984
87,53,395,1495,91,18,1,0,0,2000,252,1681,96,81,0,0,0,2110,4110
87,54,398,1552,80,17,0,0,0,2047,292,1711,114,98,0,0,0,2215,4262
87,55,354,1627,76,22,0,1,0,2080,265,1682,104,98,1,0,0,2150,4230
87,56,354,1609,90,19,0,0,0,2072,251,1761,99,122,0,0,0,2233,4305
87,57,320,1700,89,22,0,0,0,2131,241,1747,115,136,0,0,0,2239,4370
87,58,275,1759,81,34,0,0,0,2149,218,1743,91,155,0,0,0,2207,4356
87,59,308,1757,83,39,2,0,0,2189,251,1818,99,202,0,0,0,2370,4559
87,60,249,1715,95,43,0,0,0,2102,217,1689,89,171,2,0,0,2168,4270
87,61,218,1666,66,44,0,0,0,1994,177,1587,80,188,0,0,0,2032,4026
87,62,200,1685,68,35,1,0,0,1989,185,1621,70,209,0,0,0,2085,4074
87,63,189,1615,73,40,0,0,0,1917,155,1562,54,215,0,0,0,1986,3903
87,64,189,1571,37,66,0,0,0,1863,158,1483,60,265,1,0,0,1967,3830
87,65,163,1440,53,36,0,0,0,1692,151,1314,60,288,0,0,0,1813,3505
87,66,140,1423,55,46,0,0,0,1664,135,1279,61,294,0,0,0,1769,3433
87,67,119,1336,51,74,0,0,0,1580,120,1235,40,292,0,0,0,1687,3267
87,68,138,1399,52,75,0,0,0,1664,118,1174,47,308,1,0,0,1648,3312
87,69,115,1320,45,70,0,0,0,1550,116,1177,45,349,0,0,0,1687,3237
87,70,93,1238,34,70,0,0,0,1435,98,1073,25,361,0,0,0,1557,2992
87,71,77,1205,27,71,1,0,0,1381,94,1055,36,367,0,0,0,1552,2933
87,72,85,1216,20,83,0,0,0,1404,88,953,26,398,0,0,0,1465,2869
87,73,78,1203,39,91,0,0,0,1411,95,908,33,494,1,0,0,1531,2942
87,74,72,1217,25,94,0,0,0,1408,69,936,36,547,0,0,0,1588,2996
87,75,67,1166,32,113,0,0,0,1378,91,954,28,583,0,0,0,1656,3034
87,76,73,1154,20,124,0,0,0,1371,94,810,19,604,0,0,0,1527,2898
87,77,56,1038,16,121,0,0,0,1231,75,726,19,577,0,0,0,1397,2628
87,78,44,740,12,94,0,0,0,890,56,536,10,474,0,0,0,1076,1966
87,79,26,683,9,100,0,0,0,818,57,489,14,532,0,0,0,1092,1910
87,80,34,752,6,106,0,0,0,898,71,443,10,581,0,0,0,1105,2003
87,81,35,597,10,98,0,0,0,740,52,385,13,497,0,0,0,947,1687
87,82,29,553,9,102,0,0,0,693,48,363,7,577,0,0,0,995,1688
87,83,42,634,7,171,0,0,0,854,69,381,11,700,0,0,0,1161,2015
87,84,22,565,11,154,0,0,0,752,71,331,11,750,0,0,0,1163,1915
87,85,14,501,4,148,0,0,0,667,57,275,6,620,0,0,0,958,1625
87,86,31,443,5,167,0,0,0,646,56,213,7,663,0,0,0,939,1585
87,87,18,347,3,146,0,0,0,514,52,160,5,601,0,0,0,818,1332
87,88,10,273,2,144,0,0,0,429,47,138,6,589,0,0,0,780,1209
87,89,14,214,3,135,0,0,0,366,41,92,4,527,0,0,0,664,1030
87,90,8,172,0,108,0,0,0,288,38,80,7,517,0,0,0,642,930
87,91,4,147,1,119,0,0,0,271,32,61,2,405,0,0,0,500,771
87,92,10,99,0,80,0,0,0,189,36,56,2,404,0,0,0,498,687
87,93,4,80,0,90,0,0,0,174,28,31,1,344,0,0,0,404,578
87,94,3,49,0,56,0,0,0,108,17,23,1,229,0,0,0,270,378
87,95,1,31,0,38,0,0,0,70,15,14,1,191,0,0,0,221,291
87,96,2,16,0,28,0,0,0,46,18,9,1,143,0,0,0,171,217
87,97,1,17,0,20,0,0,0,38,4,4,1,85,0,0,0,94,132
87,98,1,9,0,12,0,0,0,22,7,2,1,84,0,0,0,94,116
87,99,0,2,0,8,0,0,0,10,2,0,0,52,0,0,0,54,64
87,100,1,1,0,19,0,0,0,21,14,5,0,77,0,0,0,96,117
87,999,59219,63208,2173,3696,11,1,0,128308,49439,63321,2859,17474,18,0,0,133111,261419
88,0,12046,0,0,0,0,0,0,12046,11441,0,0,0,0,0,0,11441,23487
88,1,12600,0,0,0,0,0,0,12600,11966,0,0,0,0,0,0,11966,24566
88,2,12396,0,0,0,0,0,0,12396,11738,0,0,0,0,0,0,11738,24134
88,3,12875,0,0,0,0,0,0,12875,12160,0,0,0,0,0,0,12160,25035
88,4,13325,0,0,0,0,0,0,13325,12741,0,0,0,0,0,0,12741,26066
88,5,13820,0,0,0,0,0,0,13820,12760,0,0,0,0,0,0,12760,26580
88,6,14144,0,0,0,0,0,0,14144,13620,0,0,0,0,0,0,13620,27764
88,7,14293,0,0,0,0,0,0,14293,13484,0,0,0,0,0,0,13484,27777
88,8,14551,0,0,0,0,0,0,14551,13852,0,0,0,0,0,0,13852,28403
88,9,14792,0,0,0,0,0,0,14792,13954,0,0,0,0,0,0,13954,28746
88,10,15124,0,0,0,0,0,0,15124,14287,0,0,0,0,0,0,14287,29411
88,11,15963,0,0,0,0,0,0,15963,14968,0,0,0,0,0,0,14968,30931
88,12,16262,0,0,0,0,0,0,16262,15361,0,0,0,0,0,0,15361,31623
88,13,16995,0,0,0,0,0,0,16995,15409,0,0,0,0,0,0,15409,32404
88,14,17054,0,0,0,0,0,0,17054,16350,0,0,0,0,0,0,16350,33404
88,15,17328,0,0,0,0,0,0,17328,16464,0,0,0,0,0,0,16464,33792
88,16,17803,3,1,0,0,0,0,17807,17047,1,0,0,0,0,0,17048,34855
88,17,18218,1,1,0,0,0,0,18220,16838,1,0,0,0,0,0,16839,35059
88,18,18177,2,1,0,0,0,0,18180,17169,12,0,0,0,0,0,17181,35361
88,19,18751,4,0,0,0,0,0,18755,17524,27,0,0,0,0,0,17551,36306
88,20,18381,20,2,1,0,0,0,18404,17467,63,1,0,0,0,0,17531,35935
88,21,17980,29,1,0,0,0,0,18010,16948,118,3,0,1,0,0,17070,35080
88,22,18242,67,0,0,0,0,0,18309,16692,280,1,0,1,0,0,16974,35283
88,23,18218,134,0,1,1,0,0,18354,16755,430,1,0,1,0,0,17187,35541
88,24,17895,281,3,0,1,0,0,18180,16238,721,3,1,1,0,0,16964,35144
88,25,17698,403,5,1,0,0,0,18107,15701,1151,12,2,0,0,0,16866,34973
88,26,16932,619,5,1,2,0,0,17559,14966,1732,11,2,1,0,0,16712,34271
88,27,16413,1071,12,0,4,0,0,17500,14200,2471,19,4,3,0,0,16697,34197
88,28,15480,1581,9,0,7,0,0,17077,13591,3438,20,2,4,1,0,17056,34133
88,29,15082,2204,11,1,11,0,0,17309,12446,4444,47,6,5,1,0,16949,34258
88,30,14056,3063,23,0,8,1,0,17151,11540,5624,64,7,6,0,0,17241,34392
88,31,13776,4161,38,3,8,0,0,17986,10902,7238,82,13,8,2,0,18245,36231
88,32,12808,5054,41,3,8,0,0,17914,9705,8258,123,22,6,1,0,18115,36029
88,33,11587,6145,70,8,10,0,0,17820,8555,9039,148,24,13,1,0,17780,35600
88,34,10622,7034,76,10,10,1,0,17753,7701,9970,209,40,11,0,0,17931,35684
88,35,10158,7734,114,15,13,0,0,18034,7032,11056,246,45,26,2,0,18407,36441
88,36,9047,8653,142,9,19,0,0,17870,6157,11176,266,70,12,2,0,17683,35553
88,37,8089,9206,162,17,17,0,0,17491,5506,11714,310,61,14,0,0,17605,35096
88,38,7816,10288,194,26,20,0,0,18344,5104,12545,379,71,6,0,0,18105,36449
88,39,7264,10630,225,25,10,0,0,18154,4856,13370,429,105,18,0,0,18778,36932
88,40,6734,11474,260,25,10,1,0,18504,4558,13848,468,109,10,2,0,18995,37499
88,41,6729,12354,287,36,9,1,0,19416,4294,14539,531,168,7,0,0,19539,38955
88,42,5909,12130,332,57,13,1,0,18442,4080,14609,593,145,4,1,0,19432,37874
88,43,5775,13071,358,46,11,0,0,19261,3737,15047,647,210,4,1,0,19646,38907
88,44,5520,13419,436,60,13,2,0,19450,3667,15598,727,241,14,3,0,20250,39700
88,45,5332,14113,398,66,12,0,0,19921,3562,16197,770,304,9,0,0,20842,40763
88,46,5279,14685,492,80,19,2,0,20557,3542,16650,850,358,7,1,0,21408,41965
88,47,5085,15236,548,92,13,0,0,20974,3677,17063,896,402,2,0,0,22040,43014
88,48,5205,16304,621,98,24,0,1,22253,3536,17769,979,507,6,0,0,22797,45050
88,49,4959,17041,656,137,10,0,0,22803,3631,18724,1085,605,8,0,0,24053,46856
88,50,4566,16794,681,130,15,0,0,22186,3395,18543,1083,639,16,0,0,23676,45862
88,51,4373,17290,712,158,15,1,0,22549,3263,18516,1121,736,2,1,0,23639,46188
88,52,4036,16966,775,183,19,0,0,21979,3190,18593,1182,842,9,1,0,23817,45796
88,53,3691,16999,762,195,21,1,0,21669,3012,18227,1188,868,6,0,0,23301,44970
88,54,3524,17619,775,220,13,0,0,22151,2919,18396,1136,1094,4,1,0,23550,45701
88,55,3182,17557,773,264,11,1,0,21788,2780,18413,1123,1104,5,0,0,23425,45213
88,56,3031,17901,818,273,10,0,0,22033,2885,18689,1294,1298,9,0,0,24175,46208
88,57,2831,18301,818,358,17,0,0,22325,2784,18596,1157,1516,1,0,0,24054,46379
88,58,2628,18169,812,364,16,0,0,21989,2664,18300,1215,1642,3,0,0,23824,45813
88,59,2551,18570,805,444,16,0,0,22386,2548,18484,1218,1992,3,0,0,24245,46631
88,60,2212,17279,742,504,12,0,0,20749,2445,17422,1081,2048,0,0,0,22996,43745
88,61,1956,17074,738,489,13,0,0,20270,2309,16866,993,2230,2,0,0,22400,42670
88,62,1766,16500,654,546,14,0,0,19480,2116,16106,1033,2368,2,0,0,21625,41105
88,63,1609,15345,642,555,11,0,0,18162,2003,15159,918,2489,1,0,0,20570,38732
88,64,1462,15393,604,611,11,1,0,18082,1946,14561,876,2760,5,0,0,20148,38230
88,65,1273,14658,517,643,10,0,0,17101,1869,13619,800,2929,2,0,0,19219,36320
88,66,1203,14427,517,751,9,0,0,16907,1701,13406,843,3086,0,0,0,19036,35943
88,67,1078,13584,435,765,7,0,0,15869,1529,12352,756,3296,2,0,0,17935,33804
88,68,928,13888,440,800,3,1,0,16060,1580,12377,691,3636,1,0,0,18285,34345
88,69,893,13680,386,911,7,0,0,15877,1521,11814,664,3826,0,1,0,17826,33703
88,70,773,12289,368,892,6,0,0,14328,1325,10590,560,3796,0,0,0,16271,30599
88,71,736,11725,306,901,5,0,0,13673,1311,9816,565,4010,3,0,0,15705,29378
88,72,597,11437,287,986,5,0,0,13312,1250,9404,517,4325,0,1,0,15497,28809
88,73,577,11451,262,1093,3,0,0,13386,1279,9238,481,4633,1,0,0,15632,29018
88,74,573,11195,244,1153,4,0,0,13169,1199,8844,444,4924,0,0,0,15411,28580
88,75,549,11058,231,1378,3,0,0,13219,1233,8362,441,5459,2,0,0,15497,28716
88,76,463,10202,214,1333,3,0,0,12215,1235,7649,388,5753,0,0,0,15025,27240
88,77,431,10041,191,1529,3,0,1,12196,1112,7395,325,6307,1,0,0,15140,27336
88,78,350,8258,125,1447,3,0,0,10183,998,5879,297,5603,0,0,0,12777,22960
88,79,251,6164,119,1178,0,0,1,7713,760,4187,223,4919,0,0,0,10089,17802
88,80,256,6327,99,1318,0,0,0,8000,877,4251,200,5508,1,0,0,10837,18837
88,81,240,5558,93,1290,1,0,0,7182,804,3569,200,5386,0,0,0,9959,17141
88,82,202,4858,75,1334,0,0,0,6469,728,3123,160,5366,1,0,0,9378,15847
88,83,192,4634,55,1366,1,0,0,6248,788,2729,128,5621,0,1,0,9267,15515
88,84,164,3896,54,1347,0,0,0,5461,655,2385,116,5385,0,0,0,8541,14002
88,85,144,3221,56,1259,2,0,1,4683,652,1844,93,5018,0,0,0,7607,12290
88,86,122,2678,31,1105,0,0,0,3936,509,1426,106,4457,0,0,0,6498,10434
88,87,90,2025,26,1014,0,0,0,3155,456,990,77,4015,0,0,0,5538,8693
88,88,72,1678,17,963,0,0,0,2730,421,828,62,3728,0,0,0,5039,7769
88,89,72,1319,7,808,0,0,0,2206,391,608,49,3207,0,0,0,4255,6461
88,90,52,1006,14,732,0,0,0,1804,342,429,36,2893,0,0,0,3700,5504
88,91,44,725,6,631,0,0,0,1406,264,316,35,2408,0,0,0,3023,4429
88,92,20,517,5,543,1,0,0,1086,240,220,27,1972,0,0,0,2459,3545
88,93,30,330,5,430,0,0,0,795,167,151,24,1617,0,0,0,1959,2754
88,94,24,238,4,289,0,0,0,555,158,111,21,1216,0,0,0,1506,2061
88,95,13,150,3,206,0,0,0,372,99,76,13,897,0,0,0,1085,1457
88,96,5,84,0,134,0,0,0,223,78,27,7,617,0,0,0,729,952
88,97,4,43,0,91,0,0,0,138,56,25,4,406,0,0,0,491,629
88,98,7,29,1,66,0,0,0,103,37,26,8,292,0,0,0,363,466
88,99,9,17,0,47,0,0,0,73,30,17,1,188,0,0,0,236,309
88,100,19,35,0,63,0,0,0,117,66,37,4,350,0,0,0,457,574
88,999,696462,689396,21828,36908,573,14,4,1445185,627458,707914,35904,154199,290,24,0,1525789,2970974
89,0,1310,0,0,0,0,0,0,1310,1257,0,0,0,0,0,0,1257,2567
89,1,1345,0,0,0,0,0,0,1345,1270,0,0,0,0,0,0,1270,2615
89,2,1352,0,0,0,0,0,0,1352,1231,0,0,0,0,0,0,1231,2583
89,3,1366,0,0,0,0,0,0,1366,1273,0,0,0,0,0,0,1273,2639
89,4,1398,0,0,0,0,0,0,1398,1406,0,0,0,0,0,0,1406,2804
89,5,1452,0,0,0,0,0,0,1452,1447,0,0,0,0,0,0,1447,2899
89,6,1563,0,0,0,0,0,0,1563,1540,0,0,0,0,0,0,1540,3103
89,7,1592,0,0,0,0,0,0,1592,1514,0,0,0,0,0,0,1514,3106
89,8,1545,0,0,0,0,0,0,1545,1444,0,0,0,0,0,0,1444,2989
89,9,1611,0,0,0,0,0,0,1611,1470,0,0,0,0,0,0,1470,3081
89,10,1614,0,0,0,0,0,0,1614,1611,0,0,0,0,0,0,1611,3225
89,11,1704,0,0,0,0,0,0,1704,1611,0,0,0,0,0,0,1611,3315
89,12,1708,0,0,0,0,0,0,1708,1636,0,0,0,0,0,0,1636,3344
89,13,1857,0,0,0,0,0,0,1857,1703,0,0,0,0,0,0,1703,3560
89,14,1886,0,0,0,0,0,0,1886,1786,0,0,0,0,0,0,1786,3672
89,15,1867,0,0,0,0,0,0,1867,1840,0,0,0,0,0,0,1840,3707
89,16,1969,0,0,0,0,0,0,1969,1808,0,0,0,0,0,0,1808,3777
89,17,2002,0,0,0,0,0,0,2002,1851,0,0,0,0,0,0,1851,3853
89,18,2126,0,0,0,0,0,0,2126,1811,0,0,0,0,0,0,1811,3937
89,19,2146,1,0,0,0,0,0,2147,1968,2,0,0,0,0,0,1970,4117
89,20,2148,1,0,0,0,0,0,2149,1981,7,0,0,0,0,0,1988,4137
89,21,2154,1,0,0,0,0,0,2155,1941,13,0,0,0,0,0,1954,4109
89,22,2116,3,0,0,0,0,0,2119,1929,20,0,0,0,0,0,1949,4068
89,23,2163,8,1,0,0,0,0,2172,1980,41,4,0,0,0,0,2025,4197
89,24,2266,15,1,0,0,0,0,2282,1972,49,0,0,0,0,0,2021,4303
89,25,2257,37,1,0,0,0,0,2295,1986,90,1,0,2,0,0,2079,4374
89,26,2207,54,1,0,1,0,0,2263,1889,147,3,2,1,0,0,2042,4305
89,27,2243,77,0,0,0,0,0,2320,1861,215,2,0,2,0,0,2080,4400
89,28,2036,111,1,0,0,0,0,2148,1755,295,1,2,0,0,0,2053,4201
89,29,2011,151,1,0,0,0,0,2163,1650,428,4,0,0,0,0,2082,4245
89,30,2111,263,1,1,0,0,0,2376,1560,541,9,2,0,0,0,2112,4488
89,31,2060,378,5,0,0,0,0,2443,1559,764,16,0,0,0,0,2339,4782
89,32,1909,471,5,1,0,0,0,2386,1326,877,19,2,1,0,0,2225,4611
89,33,1784,628,10,0,0,0,0,2422,1292,1000,15,0,0,0,0,2307,4729
89,34,1683,733,10,1,1,0,0,2428,1148,1098,36,10,1,0,0,2293,4721
89,35,1618,823,11,1,1,0,0,2454,1062,1210,35,3,3,0,0,2313,4767
89,36,1387,923,22,1,0,0,0,2333,884,1329,48,6,0,0,0,2267,4600
89,37,1290,1049,24,1,1,0,0,2365,821,1347,44,9,1,0,0,2222,4587
89,38,1287,1220,29,3,1,0,0,2540,836,1466,45,13,0,0,0,2360,4900
89,39,1155,1219,42,1,0,0,0,2417,744,1597,52,9,1,0,0,2403,4820
89,40,1054,1262,36,2,0,0,0,2354,689,1643,55,14,1,0,0,2402,4756
89,41,1049,1434,42,1,0,0,0,2526,648,1625,71,15,0,1,0,2360,4886
89,42,1005,1471,57,4,0,0,0,2537,579,1808,90,23,0,0,0,2500,5037
89,43,952,1497,50,3,1,0,0,2503,508,1721,91,23,0,0,0,2343,4846
89,44,904,1651,57,1,2,0,0,2615,554,1874,108,24,0,1,0,2561,5176
89,45,819,1685,61,11,2,0,0,2578,501,2125,127,44,0,0,0,2797,5375
89,46,846,1806,74,12,1,0,0,2739,532,2090,101,36,1,0,0,2760,5499
89,47,816,1916,75,12,2,0,0,2821,492,2213,125,51,0,0,0,2881,5702
89,48,779,1955,98,11,0,0,0,2843,506,2328,147,62,1,0,0,3044,5887
89,49,733,2068,91,16,1,0,0,2909,462,2319,134,72,0,0,0,2987,5896
89,50,667,2035,108,13,2,0,0,2825,435,2367,144,74,0,0,0,3020,5845
89,51,699,2212,91,19,0,0,0,3021,408,2426,152,92,0,0,0,3078,6099
89,52,629,2285,103,18,1,0,0,3036,429,2520,144,112,0,0,0,3205,6241
89,53,554,2244,124,30,0,0,0,2952,399,2527,162,120,0,0,0,3208,6160
89,54,580,2417,123,29,0,0,0,3149,371,2541,170,146,0,0,0,3228,6377
89,55,533,2515,119,30,1,0,0,3198,407,2669,173,154,0,0,0,3403,6601
89,56,498,2543,99,29,1,0,0,3170,369,2653,145,173,0,0,0,3340,6510
89,57,497,2579,118,56,0,0,0,3250,378,2641,141,170,0,0,0,3330,6580
89,58,446,2743,120,47,1,0,0,3357,339,2633,131,216,0,0,0,3319,6676
89,59,443,2790,126,49,1,0,0,3409,348,2795,143,275,0,0,0,3561,6970
89,60,410,2661,113,65,0,0,0,3249,330,2510,143,268,0,0,0,3251,6500
89,61,381,2491,110,50,1,0,0,3033,308,2467,117,303,0,0,0,3195,6228
89,62,313,2573,104,76,0,0,0,3066,288,2417,119,320,0,0,0,3144,6210
89,63,297,2466,99,73,0,0,0,2935,313,2322,96,380,0,1,0,3112,6047
89,64,303,2382,82,86,0,0,0,2853,294,2280,103,350,0,0,0,3027,5880
89,65,234,2278,72,85,0,0,0,2669,221,2083,101,359,0,0,0,2764,5433
89,66,231,2210,66,112,1,0,0,2620,236,1972,77,446,0,0,0,2731,5351
89,67,179,2111,63,81,0,0,0,2434,215,1922,81,471,0,0,0,2689,5123
89,68,172,2133,82,108,0,0,0,2495,178,1732,83,494,0,0,0,2487,4982
89,69,148,2035,53,106,0,0,0,2342,187,1754,75,517,0,0,0,2533,4875
89,70,151,1942,50,120,0,0,0,2263,163,1609,41,545,0,0,0,2358,4621
89,71,136,1856,61,100,0,0,0,2153,172,1547,57,582,0,0,0,2358,4511
89,72,136,1818,48,148,0,0,0,2150,163,1440,45,581,0,0,0,2229,4379
89,73,129,1766,44,148,0,0,0,2087,151,1430,53,668,0,0,0,2302,4389
89,74,105,1737,39,148,0,0,1,2030,148,1301,35,727,0,0,0,2211,4241
89,75,103,1735,41,186,0,0,0,2065,146,1261,43,822,0,0,0,2272,4337
89,76,75,1615,35,167,0,0,0,1892,145,1168,43,875,0,0,0,2231,4123
89,77,79,1632,38,183,0,0,0,1932,135,1072,41,877,0,0,0,2125,4057
89,78,63,1084,22,157,1,0,0,1327,91,757,18,686,0,0,0,1552,2879
89,79,51,1085,17,161,0,0,0,1314,87,691,18,708,0,0,0,1504,2818
89,80,58,968,8,151,0,0,0,1185,93,673,21,812,0,0,0,1599,2784
89,81,41,883,15,202,0,0,0,1141,91,592,18,814,0,0,0,1515,2656
89,82,36,826,13,177,0,0,0,1052,80,460,20,789,0,0,0,1349,2401
89,83,52,856,18,215,0,0,0,1141,89,559,18,939,0,0,0,1605,2746
89,84,35,828,7,220,0,0,0,1090,99,501,15,1010,1,0,0,1626,2716
89,85,33,694,5,219,0,0,0,951,76,370,12,909,0,0,0,1367,2318
89,86,25,575,7,222,0,0,0,829,74,285,13,943,0,0,0,1315,2144
89,87,28,480,4,227,0,0,0,739,72,264,5,809,0,0,0,1150,1889
89,88,21,392,7,200,0,0,0,620,49,207,3,825,0,0,0,1084,1704
89,89,15,327,6,190,0,0,0,538,51,151,2,717,0,0,0,921,1459
89,90,15,267,3,179,0,0,0,464,46,130,6,670,0,0,0,852,1316
89,91,10,173,2,149,0,0,0,334,35,83,5,583,0,0,0,706,1040
89,92,9,139,2,117,0,0,0,267,35,72,4,506,0,0,0,617,884
89,93,8,94,0,115,0,0,0,217,35,39,2,472,0,0,0,548,765
89,94,5,62,0,79,0,0,0,146,23,33,3,292,0,0,0,351,497
89,95,1,46,1,52,0,0,0,100,20,17,0,245,0,0,0,282,382
89,96,0,24,0,43,0,0,0,67,14,8,2,188,0,0,0,212,279
89,97,0,23,0,33,0,0,0,56,9,7,2,137,0,0,0,155,211
89,98,3,6,1,19,0,0,0,29,4,9,1,108,0,0,0,122,151
89,99,2,8,0,17,0,0,0,27,5,3,1,69,0,0,0,78,105
89,100,4,16,0,27,0,0,0,47,5,23,0,111,0,0,0,139,186
89,999,89898,96571,3275,5616,24,0,1,195385,75983,96275,4430,24881,16,3,0,201588,396973
90,0,3950,0,0,0,0,0,0,3950,3733,0,0,0,0,0,0,3733,7683
90,1,3989,0,0,0,0,0,0,3989,3784,0,0,0,0,0,0,3784,7773
90,2,4027,0,0,0,0,0,0,4027,3821,0,0,0,0,0,0,3821,7848
90,3,4146,0,0,0,0,0,0,4146,3987,0,0,0,0,0,0,3987,8133
90,4,4417,0,0,0,0,0,0,4417,4108,0,0,0,0,0,0,4108,8525
90,5,4468,0,0,0,0,0,0,4468,4079,0,0,0,0,0,0,4079,8547
90,6,4720,0,0,0,0,0,0,4720,4242,0,0,0,0,0,0,4242,8962
90,7,4633,0,0,0,0,0,0,4633,4352,0,0,0,0,0,0,4352,8985
90,8,4683,0,0,0,0,0,0,4683,4389,0,0,0,0,0,0,4389,9072
90,9,4898,0,0,0,0,0,0,4898,4494,0,0,0,0,0,0,4494,9392
90,10,4649,0,0,0,0,0,0,4649,4613,0,0,0,0,0,0,4613,9262
90,11,5078,0,0,0,0,0,0,5078,4694,0,0,0,0,0,0,4694,9772
90,12,5120,0,0,0,0,0,0,5120,4829,0,0,0,0,0,0,4829,9949
90,13,5162,0,0,0,0,0,0,5162,4844,0,0,0,0,0,0,4844,10006
90,14,5311,0,0,0,0,0,0,5311,4964,0,0,0,0,0,0,4964,10275
90,15,5314,0,0,0,0,0,0,5314,5144,0,0,0,0,0,0,5144,10458
90,16,5408,1,0,0,0,0,0,5409,5112,0,0,0,0,0,0,5112,10521
90,17,5543,0,0,0,0,0,0,5543,5103,0,0,0,0,0,0,5103,10646
90,18,5584,0,0,0,0,0,0,5584,5328,0,0,0,0,0,0,5328,10912
90,19,5831,1,0,0,0,0,0,5832,5387,12,0,0,0,0,0,5399,11231
90,20,5760,4,0,0,0,0,0,5764,5426,15,0,0,0,0,0,5441,11205
90,21,5732,9,0,0,0,0,0,5741,5290,55,0,1,0,0,0,5346,11087
90,22,5905,16,2,0,0,0,0,5923,5328,82,0,0,1,0,0,5411,11334
90,23,6127,31,1,0,0,0,0,6159,5335,144,1,0,0,0,0,5480,11639
90,24,6106,49,3,0,1,0,0,6159,5284,213,1,1,0,0,0,5499,11658
90,25,5796,112,4,1,1,0,0,5914,5060,340,1,0,1,0,0,5402,11316
90,26,5788,152,2,0,2,0,0,5944,4795,540,5,0,1,0,0,5341,11285
90,27,5738,245,1,0,0,0,0,5984,4897,695,11,0,2,0,0,5605,11589
90,28,5452,390,1,2,4,0,0,5849,4453,1016,8,0,2,0,0,5479,11328
90,29,5254,592,6,0,3,0,0,5855,4236,1239,17,1,3,0,0,5496,11351
90,30,5406,783,5,1,2,0,0,6197,4216,1683,19,2,4,0,0,5924,12121
90,31,5242,1142,14,1,4,0,0,6403,3961,2121,32,6,2,0,0,6122,12525
90,32,4757,1383,12,1,1,0,0,6154,3462,2567,41,3,2,0,0,6075,12229
90,33,4588,1812,25,0,1,0,0,6426,3255,2890,58,13,6,0,0,6222,12648
90,34,4311,2075,36,5,5,0,0,6432,2939,3106,53,10,1,0,0,6109,12541
90,35,4061,2479,34,4,0,0,0,6578,2749,3694,85,17,6,0,0,6551,13129
90,36,3768,2610,44,6,2,0,0,6430,2436,3746,83,13,5,0,0,6283,12713
90,37,3452,2932,42,5,4,0,0,6435,2237,3906,94,30,4,1,0,6272,12707
90,38,3126,3344,61,2,5,0,0,6538,2074,4067,116,29,3,0,0,6289,12827
90,39,3086,3550,75,7,5,0,0,6723,1934,4451,139,46,1,0,0,6571,13294
90,40,2967,3732,76,6,4,0,0,6785,1841,4525,177,33,2,0,0,6578,13363
90,41,2782,3982,109,11,3,0,0,6887,1731,4776,142,44,0,0,0,6693,13580
90,42,2615,4121,108,11,2,0,0,6857,1588,4889,196,48,2,0,0,6723,13580
90,43,2517,4225,138,18,8,1,0,6907,1504,5045,209,47,3,0,0,6808,13715
90,44,2306,4467,118,17,8,0,0,6916,1528,5137,249,62,2,0,0,6978,13894
90,45,2394,4720,148,27,4,0,0,7293,1396,5275,287,99,4,0,0,7061,14354
90,46,2188,4923,169,20,3,0,0,7303,1378,5485,266,108,4,0,0,7241,14544
90,47,2185,5200,205,25,4,0,0,7619,1416,5819,306,142,2,0,0,7685,15304
90,48,2170,5361,201,26,5,0,0,7763,1372,6026,332,142,2,0,0,7874,15637
90,49,2034,5585,230,28,8,0,0,7885,1333,6324,357,172,4,0,0,8190,16075
90,50,1952,5767,257,47,6,0,0,8029,1243,6396,370,182,1,0,0,8192,16221
90,51,1771,5701,246,40,5,0,0,7763,1203,6484,366,223,3,0,0,8279,16042
90,52,1751,6013,273,62,4,1,0,8104,1156,6607,403,249,0,0,0,8415,16519
90,53,1597,5892,261,64,4,0,0,7818,1152,6502,393,271,3,0,0,8321,16139
90,54,1474,6313,272,70,6,0,0,8135,1138,6766,419,306,1,0,0,8630,16765
90,55,1439,6246,298,89,5,0,0,8077,1043,6733,414,408,0,0,0,8598,16675
90,56,1358,6387,298,92,5,0,0,8140,1017,6717,439,402,3,0,0,8578,16718
90,57,1285,6552,302,109,6,0,0,8254,1007,6770,423,469,0,1,0,8670,16924
90,58,1196,6655,317,102,2,0,0,8272,992,6891,423,553,0,0,0,8859,17131
90,59,1170,6789,303,139,4,0,0,8405,980,6754,392,658,0,0,0,8784,17189
90,60,978,6384,286,133,4,0,0,7785,836,6571,402,601,1,0,0,8411,16196
90,61,913,6214,271,166,5,0,0,7569,851,6549,370,743,1,0,0,8514,16083
90,62,821,6404,260,171,3,0,0,7659,805,6217,341,855,0,0,0,8218,15877
90,63,791,6252,258,194,3,0,0,7498,764,5998,324,866,0,0,0,7952,15450
90,64,634,6290,231,236,0,0,0,7391,770,5659,316,979,0,0,0,7724,15115
90,65,566,5860,209,223,2,0,0,6860,648,5375,316,985,0,0,0,7324,14184
90,66,553,5658,245,246,5,0,0,6707,602,5275,284,1083,1,0,0,7245,13952
90,67,442,5462,208,262,0,0,0,6374,563,4972,252,1160,0,0,0,6947,13321
90,68,457,5526,164,268,2,0,0,6417,537,4713,234,1297,0,0,0,6781,13198
90,69,421,5229,157,281,1,0,0,6089,530,4653,242,1390,0,0,0,6815,12904
90,70,362,4944,159,312,2,0,0,5779,509,4115,195,1402,1,0,0,6222,12001
90,71,315,4624,131,320,4,0,0,5394,412,3701,185,1499,0,0,0,5797,11191
90,72,316,4667,139,347,1,0,0,5470,383,3804,157,1612,0,0,0,5956,11426
90,73,302,4595,129,384,0,0,0,5410,419,3525,182,1738,0,0,0,5864,11274
90,74,254,4444,105,413,0,0,0,5216,384,3462,172,1978,0,0,0,5996,11212
90,75,244,4417,93,422,0,0,0,5176,422,3435,136,2159,1,0,0,6153,11329
90,76,206,4165,101,460,1,0,0,4933,312,3041,97,2221,0,0,0,5671,10604
90,77,190,3961,78,523,2,0,0,4754,331,2745,121,2199,0,0,0,5396,10150
90,78,128,2845,64,385,0,0,0,3422,250,1871,78,1755,0,0,0,3954,7376
90,79,112,2404,43,409,2,0,0,2970,211,1680,62,1800,0,0,0,3753,6723
90,80,106,2521,39,426,0,0,1,3093,271,1569,60,2090,0,0,0,3990,7083
90,81,100,2378,51,458,0,0,0,2987,230,1469,59,2102,0,0,0,3860,6847
90,82,93,2063,37,429,0,0,0,2622,223,1208,43,2083,0,0,0,3557,6179
90,83,79,2219,26,537,0,0,0,2861,227,1308,54,2411,0,0,0,4000,6861
90,84,77,2084,37,587,1,0,0,2786,213,1130,44,2568,0,0,0,3955,6741
90,85,62,1607,22,525,0,0,0,2216,205,890,35,2305,0,0,0,3435,5651
90,86,63,1447,12,484,0,0,0,2006,184,655,35,2252,0,0,0,3126,5132
90,87,67,1085,9,482,0,0,0,1643,146,503,35,2039,0,0,0,2723,4366
90,88,56,1008,9,513,0,0,0,1586,152,464,20,1953,0,0,0,2589,4175
90,89,48,739,7,423,0,0,0,1217,142,336,22,1713,0,0,0,2213,3430
90,90,35,638,5,408,0,0,0,1086,130,261,12,1614,0,0,0,2017,3103
90,91,26,446,3,328,0,0,0,803,90,148,19,1367,0,0,0,1624,2427
90,92,24,351,3,278,0,0,0,656,73,127,13,1098,0,0,0,1311,1967
90,93,23,257,0,255,0,0,0,535,75,92,6,1015,0,0,0,1188,1723
90,94,11,140,0,192,0,0,0,343,56,57,8,735,0,0,0,856,1199
90,95,6,89,3,122,0,0,0,220,46,35,5,588,0,0,0,674,894
90,96,6,65,1,87,0,0,0,159,29,28,2,374,0,0,0,433,592
90,97,4,28,1,62,0,0,0,95,31,16,2,272,0,0,0,321,416
90,98,5,22,1,37,0,0,0,65,18,9,2,200,0,0,0,229,294
90,99,1,15,1,30,0,0,0,47,11,9,2,144,0,0,0,166,213
90,100,7,12,0,40,0,0,0,59,23,10,1,219,0,0,0,253,312
90,999,245441,251902,8295,13896,174,2,1,519711,209506,254188,12272,62254,85,2,0,538307,1058018
91,0,887,0,0,0,0,0,0,887,772,0,0,0,0,0,0,772,1659
91,1,880,0,0,0,0,0,0,880,873,0,0,0,0,0,0,873,1753
91,2,862,0,0,0,0,0,0,862,864,0,0,0,0,0,0,864,1726
91,3,992,0,0,0,0,0,0,992,913,0,0,0,0,0,0,913,1905
91,4,974,0,0,0,0,0,0,974,928,0,0,0,0,0,0,928,1902
91,5,1070,0,0,0,0,0,0,1070,977,0,0,0,0,0,0,977,2047
91,6,1099,0,0,0,0,0,0,1099,1031,0,0,0,0,0,0,1031,2130
91,7,1188,0,0,0,0,0,0,1188,1025,0,0,0,0,0,0,1025,2213
91,8,1225,0,0,0,0,0,0,1225,1105,0,0,0,0,0,0,1105,2330
91,9,1168,0,0,0,0,0,0,1168,1124,0,0,0,0,0,0,1124,2292
91,10,1202,0,0,0,0,0,0,1202,1133,0,0,0,0,0,0,1133,2335
91,11,1292,0,0,0,0,0,0,1292,1274,0,0,0,0,0,0,1274,2566
91,12,1306,0,0,0,0,0,0,1306,1210,0,0,0,0,0,0,1210,2516
91,13,1282,0,0,0,0,0,0,1282,1250,0,0,0,0,0,0,1250,2532
91,14,1304,0,0,0,0,0,0,1304,1189,0,0,0,0,0,0,1189,2493
91,15,1338,0,0,0,0,0,0,1338,1177,0,0,0,0,0,0,1177,2515
91,16,1294,0,0,0,0,0,0,1294,1181,0,0,0,0,0,0,1181,2475
91,17,1272,0,0,0,0,0,0,1272,1156,0,0,0,0,0,0,1156,2428
91,18,1309,1,0,0,0,0,0,1310,1268,0,0,0,0,0,0,1268,2578
91,19,1447,1,0,0,0,0,0,1448,1196,3,0,0,0,0,0,1199,2647
91,20,1370,1,0,0,0,0,0,1371,1142,10,0,0,0,0,0,1152,2523
91,21,1285,7,0,0,0,0,0,1292,1152,21,0,0,0,0,0,1173,2465
91,22,1392,11,0,0,0,0,0,1403,1198,31,0,0,0,0,0,1229,2632
91,23,1453,14,0,0,0,0,0,1467,1196,55,1,0,0,0,0,1252,2719
91,24,1424,16,0,1,0,0,0,1441,1196,70,1,0,0,0,0,1267,2708
91,25,1411,26,0,0,1,0,0,1438,1187,96,1,0,1,0,0,1285,2723
91,26,1334,34,1,5,0,0,0,1374,1156,122,1,0,0,0,0,1279,2653
91,27,1357,60,0,0,0,0,0,1417,1173,137,3,0,2,1,0,1316,2733
91,28,1389,90,1,1,0,0,0,1481,1161,180,4,0,2,0,0,1347,2828
91,29,1393,119,4,5,0,0,0,1521,1079,289,8,1,0,0,0,1377,2898
91,30,1371,135,1,3,0,0,0,1510,1044,286,6,3,1,0,0,1340,2850
91,31,1375,200,4,1,1,0,0,1581,1029,398,5,1,2,0,0,1435,3016
91,32,1393,235,4,1,2,0,0,1635,1037,465,13,0,0,0,0,1515,3150
91,33,1310,343,5,4,0,0,0,1662,891,553,22,1,2,0,0,1469,3131
91,34,1291,419,13,1,1,0,0,1725,866,610,19,4,0,0,0,1499,3224
91,35,1190,470,11,1,2,0,0,1674,800,725,27,4,1,0,0,1557,3231
91,36,1112,541,13,2,0,0,0,1668,779,748,30,3,1,0,0,1561,3229
91,37,1085,604,14,3,2,0,0,1708,747,815,35,5,0,0,0,1602,3310
91,38,1053,647,25,4,0,0,0,1729,738,886,50,9,2,0,0,1685,3414
91,39,998,750,31,3,0,0,0,1782,693,956,46,7,1,0,0,1703,3485
91,40,962,812,31,4,1,0,0,1810,658,950,57,10,1,0,0,1676,3486
91,41,951,890,33,0,1,0,0,1875,662,1092,54,12,0,0,0,1820,3695
91,42,900,988,52,7,1,0,0,1948,559,1135,64,19,0,0,0,1777,3725
91,43,857,1002,48,3,3,0,0,1913,568,1100,93,17,1,0,0,1779,3692
91,44,836,1127,65,9,0,0,0,2037,545,1236,97,22,1,0,0,1901,3938
91,45,847,1203,90,7,2,0,0,2149,480,1234,110,22,0,0,0,1846,3995
91,46,802,1229,62,11,0,0,0,2104,508,1271,119,25,0,0,0,1923,4027
91,47,813,1268,110,9,1,0,0,2201,472,1334,121,28,0,0,0,1955,4156
91,48,759,1335,100,13,1,0,0,2208,507,1430,133,36,1,0,0,2107,4315
91,49,703,1448,97,5,2,0,0,2255,470,1559,174,56,2,0,0,2261,4516
91,50,635,1282,109,15,0,0,0,2041,443,1540,136,45,1,0,0,2165,4206
91,51,600,1445,132,12,1,0,0,2190,398,1626,179,53,0,0,0,2256,4446
91,52,624,1431,139,7,0,0,0,2201,382,1588,183,55,0,0,0,2208,4409
91,53,581,1505,118,8,2,0,0,2214,348,1565,180,71,0,0,0,2164,4378
91,54,528,1578,136,15,1,0,0,2258,337,1570,170,81,0,0,0,2158,4416
91,55,502,1605,132,25,1,0,0,2265,349,1661,175,117,0,0,0,2302,4567
91,56,473,1627,151,19,1,0,0,2271,320,1743,168,76,1,0,0,2308,4579
91,57,468,1665,149,30,0,0,0,2312,271,1801,180,126,0,0,0,2378,4690
91,58,430,1706,169,28,0,0,0,2333,250,1778,173,121,0,0,0,2322,4655
91,59,399,1855,150,30,1,0,0,2435,245,1755,187,161,0,0,0,2348,4783
91,60,367,1707,163,32,1,0,0,2270,251,1783,189,186,1,0,0,2410,4680
91,61,323,1729,166,36,0,0,0,2254,248,1685,146,203,0,0,0,2282,4536
91,62,299,1643,135,50,0,0,0,2127,233,1739,145,200,0,0,0,2317,4444
91,63,285,1711,117,46,0,0,0,2159,208,1699,140,229,1,0,0,2277,4436
91,64,252,1694,110,45,0,0,0,2101,215,1664,117,243,0,0,0,2239,4340
91,65,247,1612,103,59,0,0,0,2021,165,1557,125,236,0,0,0,2083,4104
91,66,233,1619,96,58,0,0,0,2006,171,1525,119,270,0,0,0,2085,4091
91,67,193,1699,107,58,1,0,0,2058,154,1429,111,317,0,0,0,2011,4069
91,68,195,1657,90,72,0,0,0,2014,144,1437,94,370,0,0,0,2045,4059
91,69,168,1643,82,73,0,0,0,1966,148,1439,102,377,0,0,0,2066,4032
91,70,130,1492,81,89,0,0,0,1792,112,1308,87,382,0,0,0,1889,3681
91,71,138,1466,81,101,0,0,0,1786,124,1221,87,429,0,0,0,1861,3647
91,72,118,1365,74,85,0,0,0,1642,110,1175,83,461,0,0,0,1829,3471
91,73,113,1458,67,113,0,0,0,1751,117,1139,62,480,0,0,0,1798,3549
91,74,106,1370,55,125,1,0,0,1657,114,1231,58,547,0,0,0,1950,3607
91,75,113,1437,56,121,1,0,0,1728,113,1079,57,639,0,0,0,1888,3616
91,76,105,1303,46,135,0,0,0,1589,130,973,44,661,0,0,0,1808,3397
91,77,97,1156,38,146,1,0,0,1438,102,875,35,587,0,0,0,1599,3037
91,78,47,830,32,77,0,0,0,986,68,566,32,504,0,0,0,1170,2156
91,79,56,869,24,106,0,0,0,1055,69,577,24,564,0,0,0,1234,2289
91,80,70,818,23,117,0,0,0,1028,72,528,19,611,0,0,0,1230,2258
91,81,61,708,13,121,0,0,0,903,60,454,26,635,0,0,0,1175,2078
91,82,43,655,17,132,0,0,0,847,74,415,27,613,0,0,0,1129,1976
91,83,48,712,24,150,0,0,0,934,64,448,27,818,0,0,0,1357,2291
91,84,43,662,15,158,0,0,0,878,72,308,14,769,0,0,0,1163,2041
91,85,30,527,12,150,0,0,0,719,60,289,19,717,0,0,0,1085,1804
91,86,43,496,6,153,0,0,0,698,62,260,15,713,0,0,0,1050,1748
91,87,28,371,10,127,0,0,0,536,61,169,8,642,0,0,0,880,1416
91,88,27,310,1,131,0,0,0,469,48,157,10,624,0,0,0,839,1308
91,89,16,265,0,125,0,0,0,406,44,110,6,593,0,0,0,753,1159
91,90,18,245,1,105,0,0,0,369,34,98,6,558,0,0,0,696,1065
91,91,12,166,3,90,0,0,0,271,42,58,5,450,0,0,0,555,826
91,92,12,112,2,91,0,0,0,217,30,46,5,456,0,0,0,537,754
91,93,8,114,1,88,0,0,0,211,32,32,3,377,0,0,0,444,655
91,94,6,61,0,68,0,0,0,135,23,22,3,297,0,0,0,345,480
91,95,3,33,0,50,0,0,0,86,17,14,1,214,0,0,0,246,332
91,96,2,33,0,38,0,0,0,73,10,11,1,165,0,0,0,187,260
91,97,2,14,0,22,0,0,0,38,4,5,0,108,0,0,0,117,155
91,98,0,8,0,16,0,0,0,24,4,2,1,78,0,0,0,85,109
91,99,0,5,0,15,0,0,0,20,6,4,0,68,0,0,0,78,98
91,100,1,8,0,22,0,0,0,31,6,9,1,93,0,0,0,109,140
91,999,67105,67508,4051,3888,33,0,0,142585,54503,65964,5079,18675,25,1,0,144247,286832
92,0,996,0,0,0,0,0,0,996,914,0,0,0,0,0,0,914,1910
92,1,1056,0,0,0,0,0,0,1056,890,0,0,0,0,0,0,890,1946
92,2,1044,0,0,0,0,0,0,1044,954,0,0,0,0,0,0,954,1998
92,3,1070,0,0,0,0,0,0,1070,988,0,0,0,0,0,0,988,2058
92,4,1091,0,0,0,0,0,0,1091,1021,0,0,0,0,0,0,1021,2112
92,5,1086,0,0,0,0,0,0,1086,1040,0,0,0,0,0,0,1040,2126
92,6,1228,0,0,0,0,0,0,1228,1128,0,0,0,0,0,0,1128,2356
92,7,1243,0,0,0,0,0,0,1243,1198,0,0,0,0,0,0,1198,2441
92,8,1237,0,0,0,0,0,0,1237,1197,0,0,0,0,0,0,1197,2434
92,9,1274,0,0,0,0,0,0,1274,1236,0,0,0,0,0,0,1236,2510
92,10,1290,0,0,0,0,0,0,1290,1251,0,0,0,0,0,0,1251,2541
92,11,1334,0,0,0,0,0,0,1334,1307,0,0,0,0,0,0,1307,2641
92,12,1402,0,0,0,0,0,0,1402,1249,0,0,0,0,0,0,1249,2651
92,13,1381,0,0,0,0,0,0,1381,1342,0,0,0,0,0,0,1342,2723
92,14,1362,0,0,0,0,0,0,1362,1315,0,0,0,0,0,0,1315,2677
92,15,1433,0,0,0,0,0,0,1433,1363,0,0,0,0,0,0,1363,2796
92,16,1435,0,0,0,0,0,0,1435,1333,0,0,0,0,0,0,1333,2768
92,17,1363,1,0,0,0,0,0,1364,1336,0,0,0,0,0,0,1336,2700
92,18,1454,0,0,0,0,0,0,1454,1432,0,0,0,0,0,0,1432,2886
92,19,1499,2,0,0,0,0,0,1501,1389,3,0,0,0,0,0,1392,2893
92,20,1483,0,0,0,0,0,0,1483,1330,7,0,0,0,0,0,1337,2820
92,21,1505,6,0,0,0,0,0,1511,1293,14,0,0,0,0,0,1307,2818
92,22,1524,3,0,0,0,0,0,1527,1328,31,1,0,0,0,0,1360,2887
92,23,1509,11,0,1,0,0,0,1521,1344,48,1,0,0,0,0,1393,2914
92,24,1510,15,1,0,0,0,0,1526,1280,60,1,0,0,0,0,1341,2867
92,25,1556,28,2,0,0,0,0,1586,1338,82,0,0,0,0,0,1420,3006
92,26,1517,50,0,0,1,0,0,1568,1269,130,0,0,1,0,0,1400,2968
92,27,1478,60,1,2,0,0,0,1541,1294,163,1,1,0,0,0,1459,3000
92,28,1444,97,1,0,1,0,0,1543,1183,194,3,0,1,0,0,1381,2924
92,29,1462,102,2,0,2,0,0,1568,1264,281,5,0,1,0,0,1551,3119
92,30,1435,173,2,2,0,0,0,1612,1181,349,3,1,0,1,0,1535,3147
92,31,1448,254,8,1,0,0,0,1711,1077,443,8,3,0,0,0,1531,3242
92,32,1332,302,9,6,2,0,0,1651,1060,543,9,1,0,0,0,1613,3264
92,33,1301,372,4,2,0,0,0,1679,1011,585,18,3,1,1,0,1619,3298
92,34,1263,445,10,1,2,0,0,1721,826,642,25,3,3,0,0,1499,3220
92,35,1204,557,15,6,0,0,0,1782,927,706,25,3,3,0,0,1664,3446
92,36,1070,574,16,6,2,0,0,1668,800,810,39,5,4,0,0,1658,3326
92,37,1008,673,26,3,2,0,0,1712,772,932,54,6,2,0,0,1766,3478
92,38,1017,755,22,6,0,0,0,1800,757,949,48,4,8,0,0,1766,3566
92,39,1032,800,30,4,5,0,0,1871,690,1029,64,12,3,0,0,1798,3669
92,40,957,877,38,5,1,0,0,1878,615,1121,66,7,2,0,0,1811,3689
92,41,880,941,42,2,1,0,0,1866,665,1130,81,15,3,0,0,1894,3760
92,42,857,946,55,4,5,0,0,1867,576,1176,77,19,2,0,0,1850,3717
92,43,859,1079,64,6,2,0,1,2011,602,1195,98,16,1,0,0,1912,3923
92,44,802,1139,58,6,2,0,0,2007,548,1311,117,38,1,0,0,2015,4022
92,45,800,1201,65,4,0,0,0,2070,531,1468,122,23,1,0,0,2145,4215
92,46,783,1210,92,9,3,0,0,2097,475,1447,122,22,2,0,0,2068,4165
92,47,730,1332,94,10,1,0,0,2167,476,1491,120,37,2,0,0,2126,4293
92,48,711,1354,72,16,2,0,0,2155,507,1538,150,40,0,0,0,2235,4390
92,49,727,1432,113,14,1,0,0,2287,455,1687,165,54,0,0,0,2361,4648
92,50,684,1471,113,11,4,0,0,2283,399,1752,173,41,0,0,0,2365,4648
92,51,676,1587,134,11,2,0,0,2410,429,1752,166,48,0,0,0,2395,4805
92,52,617,1608,158,10,1,0,0,2394,446,1808,196,69,0,0,0,2519,4913
92,53,572,1572,137,17,3,0,0,2301,338,1850,210,72,2,0,0,2472,4773
92,54,589,1745,145,23,0,0,0,2502,371,1947,207,98,0,0,0,2623,5125
92,55,579,1754,163,22,3,0,0,2521,328,1845,199,92,0,0,0,2464,4985
92,56,517,1848,170,22,4,0,1,2562,312,1918,190,108,0,0,0,2528,5090
92,57,462,1902,163,20,2,0,0,2549,284,1994,169,130,0,0,0,2577,5126
92,58,369,1862,172,27,3,0,0,2433,282,2025,210,154,1,0,0,2672,5105
92,59,396,1894,140,36,0,0,0,2466,269,1990,210,149,1,0,0,2619,5085
92,60,320,1818,127,40,1,0,0,2306,236,1874,178,182,0,0,0,2470,4776
92,61,288,1735,148,46,4,0,0,2221,193,1751,157,174,0,0,0,2275,4496
92,62,244,1668,154,36,0,0,0,2102,189,1717,153,189,1,0,0,2249,4351
92,63,242,1683,126,43,3,0,0,2097,193,1678,140,206,0,0,0,2217,4314
92,64,230,1695,109,66,3,0,0,2103,172,1715,122,250,0,0,0,2259,4362
92,65,207,1601,99,58,2,0,0,1967,175,1576,113,270,0,0,0,2134,4101
92,66,202,1576,97,70,0,0,0,1945,143,1488,97,290,0,0,0,2018,3963
92,67,156,1569,110,70,2,0,0,1907,136,1446,103,331,0,0,0,2016,3923
92,68,169,1486,72,75,0,0,0,1802,118,1398,104,360,0,0,0,1980,3782
92,69,129,1500,78,74,1,0,0,1782,129,1382,74,397,0,1,0,1983,3765
92,70,128,1348,76,60,0,0,0,1612,95,1249,73,389,0,0,0,1806,3418
92,71,125,1351,50,80,1,0,0,1607,113,1162,53,400,0,0,0,1728,3335
92,72,109,1359,40,86,0,0,0,1594,74,1139,67,488,0,0,0,1768,3362
92,73,94,1357,50,102,0,0,0,1603,94,1137,63,531,0,0,0,1825,3428
92,74,101,1312,39,104,1,0,0,1557,77,1076,53,601,0,0,0,1807,3364
92,75,96,1373,44,101,0,0,0,1614,86,1086,43,603,1,0,0,1819,3433
92,76,88,1217,40,115,0,0,0,1460,66,921,47,628,0,0,0,1662,3122
92,77,94,1185,31,101,0,0,0,1411,46,854,43,692,0,0,0,1635,3046
92,78,56,898,24,94,0,0,0,1072,46,712,23,586,0,0,0,1367,2439
92,79,58,898,21,95,0,0,0,1072,50,582,28,614,0,0,0,1274,2346
92,80,50,879,15,126,0,0,0,1070,40,559,25,678,0,0,0,1302,2372
92,81,50,778,15,110,1,0,0,954,48,477,13,705,0,0,0,1243,2197
92,82,40,727,9,154,0,0,0,930,38,420,17,757,0,0,0,1232,2162
92,83,35,774,9,138,0,0,0,956,51,394,15,826,0,0,0,1286,2242
92,84,37,697,20,147,0,0,0,901,37,321,9,889,0,0,0,1256,2157
92,85,34,586,8,175,0,0,0,803,40,326,16,820,0,0,0,1202,2005
92,86,30,512,8,164,0,0,0,714,36,227,9,797,0,0,0,1069,1783
92,87,30,421,7,149,0,0,0,607,26,175,5,702,0,0,0,908,1515
92,88,22,383,4,133,0,0,0,542,29,156,6,714,0,0,0,905,1447
92,89,21,253,4,119,0,0,0,397,28,92,4,643,0,0,0,767,1164
92,90,18,233,0,105,1,0,0,357,22,71,6,582,0,0,0,681,1038
92,91,6,148,1,91,0,0,0,246,22,52,1,473,0,0,0,548,794
92,92,12,119,0,98,0,0,0,229,21,40,2,399,0,0,0,462,691
92,93,5,79,3,78,0,0,0,165,20,34,2,367,0,0,0,423,588
92,94,7,66,4,51,0,0,0,128,19,18,1,249,0,0,0,287,415
92,95,1,39,0,45,0,0,0,85,6,8,1,187,0,0,0,202,287
92,96,7,16,0,21,0,0,0,44,4,8,0,146,0,0,0,158,202
92,97,1,6,0,18,0,0,0,25,5,8,0,109,0,0,0,122,147
92,98,2,6,1,11,0,0,0,20,5,3,0,95,0,0,0,103,123
92,99,0,2,0,7,0,0,0,9,2,0,1,61,0,0,0,64,73
92,100,2,7,0,12,0,0,0,21,6,6,0,90,0,0,0,102,123
92,999,69489,69394,3980,3783,77,0,2,146725,57751,69784,5220,19744,47,3,0,152549,299274
93,0,913,0,0,0,0,0,0,913,919,0,0,0,0,0,0,919,1832
93,1,1087,0,0,0,0,0,0,1087,1004,0,0,0,0,0,0,1004,2091
93,2,1122,0,0,0,0,0,0,1122,1097,0,0,0,0,0,0,1097,2219
93,3,1154,0,0,0,0,0,0,1154,1072,0,0,0,0,0,0,1072,2226
93,4,1158,0,0,0,0,0,0,1158,1105,0,0,0,0,0,0,1105,2263
93,5,1187,0,0,0,0,0,0,1187,1138,0,0,0,0,0,0,1138,2325
93,6,1259,0,0,0,0,0,0,1259,1194,0,0,0,0,0,0,1194,2453
93,7,1364,0,0,0,0,0,0,1364,1258,0,0,0,0,0,0,1258,2622
93,8,1375,0,0,0,0,0,0,1375,1268,0,0,0,0,0,0,1268,2643
93,9,1432,0,0,0,0,0,0,1432,1342,0,0,0,0,0,0,1342,2774
93,10,1397,0,0,0,0,0,0,1397,1359,0,0,0,0,0,0,1359,2756
93,11,1429,0,0,0,0,0,0,1429,1388,0,0,0,0,0,0,1388,2817
93,12,1552,0,0,0,0,0,0,1552,1395,0,0,0,0,0,0,1395,2947
93,13,1551,0,0,0,0,0,0,1551,1418,0,0,0,0,0,0,1418,2969
93,14,1501,0,0,0,0,0,0,1501,1433,0,0,0,0,0,0,1433,2934
93,15,1623,0,0,0,0,0,0,1623,1533,0,0,0,0,0,0,1533,3156
93,16,1552,0,0,0,0,0,0,1552,1492,1,0,0,0,0,0,1493,3045
93,17,1639,0,0,0,0,0,0,1639,1463,0,0,0,0,0,0,1463,3102
93,18,1582,1,0,0,0,0,0,1583,1434,2,0,0,0,0,0,1436,3019
93,19,1668,1,0,0,0,0,0,1669,1443,7,0,0,0,0,0,1450,3119
93,20,1544,1,0,0,0,0,0,1545,1473,9,0,0,0,0,0,1482,3027
93,21,1557,2,0,0,0,0,0,1559,1408,8,0,0,0,0,0,1416,2975
93,22,1514,7,0,0,0,0,0,1521,1471,18,0,0,0,0,0,1489,3010
93,23,1621,10,0,0,0,0,0,1631,1391,21,1,0,0,0,0,1413,3044
93,24,1545,15,0,0,0,0,0,1560,1370,32,0,0,0,0,0,1402,2962
93,25,1622,29,0,0,2,0,0,1653,1381,72,1,0,0,0,0,1454,3107
93,26,1565,39,0,0,0,0,0,1604,1296,109,1,0,0,0,0,1406,3010
93,27,1461,52,0,0,1,0,0,1514,1290,136,2,0,1,0,0,1429,2943
93,28,1484,85,1,0,0,0,0,1570,1224,181,5,0,2,0,0,1412,2982
93,29,1449,124,1,0,0,0,0,1574,1210,286,9,0,0,1,0,1506,3080
93,30,1517,170,2,1,3,0,0,1693,1197,338,10,0,0,0,0,1545,3238
93,31,1462,214,2,0,0,0,0,1678,1230,422,12,1,0,0,0,1665,3343
93,32,1308,310,5,2,2,0,0,1627,1103,498,11,1,2,0,0,1615,3242
93,33,1296,393,9,0,1,1,0,1700,1063,619,14,2,1,0,0,1699,3399
93,34,1280,420,14,1,2,0,0,1717,976,639,27,2,1,0,0,1645,3362
93,35,1202,506,16,3,2,0,0,1729,926,737,25,2,0,0,0,1690,3419
93,36,1075,573,17,3,3,0,0,1671,888,813,47,2,2,0,0,1752,3423
93,37,1084,649,20,2,2,0,0,1757,824,898,40,7,3,0,0,1772,3529
93,38,1049,759,21,0,1,0,0,1830,781,913,59,6,1,0,0,1760,3590
93,39,939,861,39,3,5,0,0,1847,723,1052,89,6,2,1,0,1873,3720
93,40,897,869,35,2,1,0,0,1804,700,1087,56,3,1,0,0,1847,3651
93,41,835,883,58,3,3,1,0,1783,684,1203,88,11,1,1,0,1988,3771
93,42,818,962,49,6,3,0,0,1838,589,1263,107,17,0,0,0,1976,3814
93,43,821,1051,61,5,1,0,0,1939,576,1256,112,29,1,1,0,1975,3914
93,44,784,1096,87,9,0,1,0,1977,567,1350,147,23,1,0,0,2088,4065
93,45,796,1223,75,7,3,0,0,2104,522,1463,166,14,2,0,0,2167,4271
93,46,809,1225,81,7,2,0,0,2124,521,1500,156,37,3,0,0,2217,4341
93,47,799,1317,99,5,2,0,0,2222,538,1633,172,34,1,0,0,2378,4600
93,48,743,1386,137,11,2,0,0,2279,517,1648,218,46,0,0,0,2429,4708
93,49,786,1577,137,11,0,0,0,2511,467,1713,209,44,4,0,0,2437,4948
93,50,684,1602,156,16,1,0,0,2459,458,1810,258,50,2,0,0,2578,5037
93,51,647,1703,155,15,1,0,0,2521,439,1914,234,54,1,0,0,2642,5163
93,52,632,1645,179,17,1,0,0,2474,456,1972,206,64,1,0,0,2699,5173
93,53,614,1749,173,20,3,0,0,2559,391,1915,215,69,1,0,0,2591,5150
93,54,590,1845,182,10,3,0,0,2630,417,1963,305,85,3,0,0,2773,5403
93,55,540,1754,183,20,2,0,0,2499,381,1933,255,94,2,0,0,2665,5164
93,56,475,1716,172,25,2,0,0,2390,348,1965,256,119,3,0,0,2691,5081
93,57,446,1879,171,32,4,0,0,2532,351,1988,255,134,2,0,0,2730,5262
93,58,457,1864,221,43,3,0,0,2588,308,1979,238,131,2,0,0,2658,5246
93,59,407,1966,212,38,4,0,0,2627,279,1986,256,165,0,0,0,2686,5313
93,60,328,1903,185,35,1,0,0,2452,258,1843,238,176,0,0,0,2515,4967
93,61,335,1729,180,37,0,0,0,2281,258,1832,196,188,0,0,0,2474,4755
93,62,269,1697,147,41,1,0,0,2155,235,1747,188,213,1,0,0,2384,4539
93,63,230,1640,160,48,1,0,0,2079,213,1625,196,251,2,0,0,2287,4366
93,64,217,1625,128,55,1,0,0,2026,169,1627,189,246,2,0,0,2233,4259
93,65,199,1562,126,38,0,0,0,1925,189,1549,156,258,1,0,0,2153,4078
93,66,166,1585,117,57,2,0,0,1927,173,1549,137,277,0,0,0,2136,4063
93,67,156,1528,111,45,0,0,0,1840,150,1468,102,330,0,0,0,2050,3890
93,68,142,1486,105,73,1,0,0,1807,171,1486,139,311,0,0,0,2107,3914
93,69,143,1410,91,81,1,0,0,1726,140,1358,113,386,1,0,0,1998,3724
93,70,118,1368,76,65,0,0,0,1627,140,1270,117,339,1,0,0,1867,3494
93,71,115,1286,65,72,0,0,0,1538,129,1165,122,432,1,0,0,1849,3387
93,72,81,1297,73,84,0,0,0,1535,116,1320,98,446,0,0,0,1980,3515
93,73,77,1353,57,83,1,0,0,1571,112,1279,82,489,0,0,0,1962,3533
93,74,100,1328,61,84,1,0,0,1574,107,1187,91,533,0,0,0,1918,3492
93,75,91,1348,43,111,0,0,0,1593,126,1118,73,634,0,0,0,1951,3544
93,76,90,1298,50,110,0,0,0,1548,82,1068,80,658,0,0,0,1888,3436
93,77,69,1249,42,124,1,0,0,1485,89,969,63,693,0,0,0,1814,3299
93,78,43,897,24,108,0,0,0,1072,64,667,59,560,0,0,0,1350,2422
93,79,60,955,40,106,0,0,0,1161,64,693,48,651,0,0,0,1456,2617
93,80,54,877,23,108,0,0,0,1062,62,619,40,686,0,0,0,1407,2469
93,81,33,783,23,146,0,0,0,985,68,566,40,671,0,0,0,1345,2330
93,82,52,754,15,133,0,0,0,954,69,496,29,699,0,0,0,1293,2247
93,83,46,778,27,161,1,0,0,1013,64,506,35,846,0,0,0,1451,2464
93,84,34,763,21,157,0,0,0,975,77,472,30,926,0,0,0,1505,2480
93,85,33,617,16,171,0,0,0,837,74,306,20,790,0,0,0,1190,2027
93,86,28,561,11,174,0,0,0,774,63,267,15,762,0,0,0,1107,1881
93,87,15,450,8,160,0,0,0,633,60,199,19,709,0,0,0,987,1620
93,88,17,388,8,160,0,0,0,573,47,179,15,665,0,0,0,906,1479
93,89,11,318,1,122,0,0,0,452,35,140,9,619,0,0,0,803,1255
93,90,15,230,8,103,0,0,0,356,46,110,9,585,0,0,0,750,1106
93,91,8,189,2,116,0,0,0,315,32,71,3,495,0,0,0,601,916
93,92,4,141,2,88,0,0,0,235,25,47,6,434,0,0,0,512,747
93,93,10,108,1,68,0,0,0,187,42,48,6,348,0,0,0,444,631
93,94,4,75,0,49,0,0,0,128,19,19,4,280,0,0,0,322,450
93,95,2,45,2,44,0,0,0,93,11,27,0,189,0,0,0,227,320
93,96,2,38,0,29,0,0,0,69,18,11,3,153,0,0,0,185,254
93,97,1,16,0,17,0,0,0,34,10,8,2,99,0,0,0,119,153
93,98,0,12,0,19,0,0,0,31,8,5,0,86,0,0,0,99,130
93,99,0,12,0,12,0,0,0,24,6,6,0,40,0,0,0,52,76
93,100,3,6,0,12,0,0,0,21,9,3,0,92,0,0,0,104,125
93,999,72100,70238,4819,3823,77,3,0,151060,62319,72277,7034,19497,55,4,0,161186,312246
94,0,1154,0,0,0,0,0,0,1154,1026,0,0,0,0,0,0,1026,2180
94,1,1170,0,0,0,0,0,0,1170,1103,0,0,0,0,0,0,1103,2273
94,2,1228,0,0,0,0,0,0,1228,1220,0,0,0,0,0,0,1220,2448
94,3,1196,0,0,0,0,0,0,1196,1162,0,0,0,0,0,0,1162,2358
94,4,1256,0,0,0,0,0,0,1256,1229,0,0,0,0,0,0,1229,2485
94,5,1313,0,0,0,0,0,0,1313,1305,0,0,0,0,0,0,1305,2618
94,6,1440,0,0,0,0,0,0,1440,1358,0,0,0,0,0,0,1358,2798
94,7,1468,0,0,0,0,0,0,1468,1454,0,0,0,0,0,0,1454,2922
94,8,1530,0,0,0,0,0,0,1530,1452,0,0,0,0,0,0,1452,2982
94,9,1556,0,0,0,0,0,0,1556,1440,0,0,0,0,0,0,1440,2996
94,10,1590,0,0,0,0,0,0,1590,1456,0,0,0,0,0,0,1456,3046
94,11,1706,0,0,0,0,0,0,1706,1552,0,0,0,0,0,0,1552,3258
94,12,1685,0,0,0,0,0,0,1685,1592,0,0,0,0,0,0,1592,3277
94,13,1777,0,0,0,0,0,0,1777,1679,0,0,0,0,0,0,1679,3456
94,14,1795,0,0,0,0,0,0,1795,1610,0,0,0,0,0,0,1610,3405
94,15,1741,0,0,0,0,0,0,1741,1710,0,0,0,0,0,0,1710,3451
94,16,1733,0,0,0,0,0,0,1733,1721,0,0,0,0,0,0,1721,3454
94,17,1774,0,0,0,0,0,0,1774,1639,0,0,0,0,0,0,1639,3413
94,18,1796,0,0,0,0,0,0,1796,1619,1,0,0,0,0,0,1620,3416
94,19,1763,3,0,0,0,0,0,1766,1620,3,0,0,0,0,0,1623,3389
94,20,1827,2,0,0,0,0,0,1829,1642,12,0,0,0,0,0,1654,3483
94,21,1811,2,0,0,0,0,0,1813,1601,14,1,0,0,0,0,1616,3429
94,22,1818,2,0,0,0,0,0,1820,1662,32,2,0,0,0,0,1696,3516
94,23,1936,8,1,0,0,0,0,1945,1624,48,0,0,1,0,0,1673,3618
94,24,1869,24,0,0,0,0,0,1893,1690,67,1,1,0,0,0,1759,3652
94,25,1854,28,2,0,0,0,0,1884,1655,83,0,0,1,0,0,1739,3623
94,26,1908,40,1,0,0,0,0,1949,1580,133,0,0,0,0,0,1713,3662
94,27,1896,84,1,0,0,0,0,1981,1565,176,4,1,1,0,0,1747,3728
94,28,1802,102,1,0,0,0,0,1905,1426,252,4,0,0,0,0,1682,3587
94,29,1694,153,4,0,1,0,0,1852,1377,322,6,0,0,0,0,1705,3557
94,30,1740,194,2,0,0,0,0,1936,1383,425,5,0,3,0,0,1816,3752
94,31,1669,315,3,1,0,0,0,1988,1302,526,8,2,1,0,0,1839,3827
94,32,1606,374,4,0,1,1,0,1986,1114,648,21,0,3,1,0,1787,3773
94,33,1582,433,6,1,1,0,0,2023,1195,751,21,4,0,0,0,1971,3994
94,34,1462,549,14,0,2,0,0,2027,1097,902,27,1,2,0,0,2029,4056
94,35,1407,647,21,1,1,0,0,2077,962,988,40,3,1,0,0,1994,4071
94,36,1248,737,16,6,1,0,0,2008,854,1016,41,4,0,0,0,1915,3923
94,37,1222,835,19,2,1,0,0,2079,835,1117,48,6,3,1,0,2010,4089
94,38,1151,965,37,3,1,0,0,2157,883,1228,75,10,3,1,0,2200,4357
94,39,1117,1063,37,2,1,0,0,2220,750,1267,71,11,1,0,0,2100,4320
94,40,1087,1081,51,1,2,0,0,2222,709,1347,90,9,3,0,0,2158,4380
94,41,1089,1221,68,5,2,0,0,2385,688,1495,108,10,6,0,0,2307,4692
94,42,1049,1203,62,5,1,0,0,2320,682,1446,96,15,1,0,0,2240,4560
94,43,1004,1341,55,3,0,0,0,2403,646,1573,136,26,1,0,0,2382,4785
94,44,997,1455,78,10,3,0,0,2543,572,1702,118,25,3,0,0,2420,4963
94,45,937,1567,93,2,4,0,0,2603,591,1759,143,26,1,0,0,2520,5123
94,46,972,1581,105,7,3,0,0,2668,573,1813,140,29,2,0,0,2557,5225
94,47,885,1677,125,4,2,0,0,2693,610,1961,171,46,0,0,0,2788,5481
94,48,886,1743,122,14,1,0,0,2766,546,2087,207,42,0,0,0,2882,5648
94,49,859,1876,143,10,2,0,0,2890,501,2098,200,53,2,0,0,2854,5744
94,50,788,1917,159,18,2,0,0,2884,466,2155,192,54,1,0,0,2868,5752
94,51,722,1962,154,22,2,0,0,2862,489,2141,214,79,1,0,0,2924,5786
94,52,682,2070,157,14,2,1,0,2926,438,2375,216,96,1,0,0,3126,6052
94,53,656,1978,153,12,0,0,0,2799,387,2285,229,92,1,0,0,2994,5793
94,54,605,2161,194,18,3,0,0,2981,403,2356,226,77,0,0,0,3062,6043
94,55,546,2221,171,25,0,0,0,2963,329,2389,240,118,0,0,0,3076,6039
94,56,477,2287,191,26,2,0,0,2983,357,2470,248,135,1,0,0,3211,6194
94,57,450,2302,208,37,1,0,0,2998,340,2365,232,158,0,0,0,3095,6093
94,58,446,2341,184,48,2,0,0,3021,276,2488,197,189,1,0,0,3151,6172
94,59,438,2288,183,51,1,0,0,2961,289,2392,222,183,0,0,0,3086,6047
94,60,360,2139,173,41,2,0,0,2715,239,2229,182,196,0,0,0,2846,5561
94,61,330,2086,156,47,1,0,0,2620,205,2170,182,254,1,0,0,2812,5432
94,62,311,2027,176,51,1,1,0,2567,256,2228,165,273,0,0,0,2922,5489
94,63,290,2051,155,47,2,0,0,2545,221,2166,179,282,1,0,0,2849,5394
94,64,250,2022,129,52,0,0,0,2453,184,2065,149,333,1,0,0,2732,5185
94,65,260,1957,124,79,0,0,0,2420,193,2021,141,321,0,0,0,2676,5096
94,66,219,1938,119,67,1,0,0,2344,184,1945,131,369,0,0,0,2629,4973
94,67,197,1979,127,76,0,0,0,2379,144,1907,110,399,0,0,0,2560,4939
94,68,204,1907,115,87,0,0,0,2313,142,1957,114,445,0,0,0,2658,4971
94,69,203,1861,87,90,0,0,0,2241,119,1800,98,492,1,0,0,2510,4751
94,70,161,1826,99,79,3,0,0,2168,139,1653,89,512,0,0,0,2393,4561
94,71,167,1816,81,110,1,0,0,2175,109,1645,85,604,0,0,0,2443,4618
94,72,129,1789,63,112,0,0,0,2093,117,1594,71,641,0,0,0,2423,4516
94,73,144,1950,71,106,0,0,0,2271,103,1581,73,681,1,0,0,2439,4710
94,74,148,2031,64,144,0,0,0,2387,117,1528,55,794,0,0,0,2494,4881
94,75,121,1807,50,124,0,0,0,2102,106,1533,72,875,0,0,0,2586,4688
94,76,100,1733,57,160,1,0,0,2051,86,1239,49,910,0,0,0,2284,4335
94,77,103,1709,41,154,0,0,0,2007,84,1146,48,987,0,0,0,2265,4272
94,78,73,1159,32,106,1,0,0,1371,64,805,30,733,0,0,0,1632,3003
94,79,69,1233,20,161,0,0,0,1483,72,754,41,891,0,0,0,1758,3241
94,80,52,1028,24,138,1,0,0,1243,76,686,28,845,0,0,0,1635,2878
94,81,55,985,24,161,0,0,0,1225,63,567,24,853,0,0,0,1507,2732
94,82,54,962,15,164,0,0,0,1195,47,538,26,923,0,0,0,1534,2729
94,83,64,1024,10,217,0,0,0,1315,73,537,19,1032,0,0,0,1661,2976
94,84,59,970,27,203,0,0,0,1259,60,459,17,1178,0,0,0,1714,2973
94,85,40,779,13,188,0,0,0,1020,60,351,12,981,0,0,0,1404,2424
94,86,29,690,11,191,0,0,0,921,44,304,14,993,0,0,0,1355,2276
94,87,32,548,7,159,0,0,0,746,50,232,12,937,0,0,0,1231,1977
94,88,27,485,13,177,0,0,0,702,58,160,7,892,0,0,0,1117,1819
94,89,16,374,3,168,0,0,0,561,35,127,5,834,0,0,0,1001,1562
94,90,12,311,3,167,0,0,0,493,42,108,7,763,0,0,0,920,1413
94,91,15,231,4,107,0,0,0,357,34,71,7,572,0,0,0,684,1041
94,92,10,170,5,115,0,0,0,300,39,42,7,508,0,0,0,596,896
94,93,10,120,1,108,0,0,0,239,22,35,6,515,0,0,0,578,817
94,94,1,75,0,58,0,0,0,134,27,21,4,328,0,0,0,380,514
94,95,1,40,0,52,0,0,0,93,24,21,3,273,0,0,0,321,414
94,96,2,35,0,47,0,0,0,84,13,6,1,206,0,0,0,226,310
94,97,3,20,0,29,0,0,0,52,8,7,0,135,0,0,0,150,202
94,98,1,8,0,20,0,0,0,29,8,10,0,103,0,0,0,121,150
94,99,0,9,0,14,0,0,0,23,9,0,0,67,0,0,0,76,99
94,100,0,11,0,15,0,0,0,26,7,12,2,140,0,0,0,161,187
94,999,83187,88727,4924,4739,59,3,0,181639,68719,88968,6265,25575,50,3,0,189580,371219
95,0,630,0,0,0,0,0,0,630,570,0,0,0,0,0,0,570,1200
95,1,604,0,0,0,0,0,0,604,578,0,0,0,0,0,0,578,1182
95,2,610,0,0,0,0,0,0,610,609,0,0,0,0,0,0,609,1219
95,3,677,0,0,0,0,0,0,677,609,0,0,0,0,0,0,609,1286
95,4,712,0,0,0,0,0,0,712,677,0,0,0,0,0,0,677,1389
95,5,703,0,0,0,0,0,0,703,666,0,0,0,0,0,0,666,1369
95,6,786,0,0,0,0,0,0,786,725,0,0,0,0,0,0,725,1511
95,7,766,0,0,0,0,0,0,766,727,0,0,0,0,0,0,727,1493
95,8,794,0,0,0,0,0,0,794,742,0,0,0,0,0,0,742,1536
95,9,834,0,0,0,0,0,0,834,740,0,0,0,0,0,0,740,1574
95,10,826,0,0,0,0,0,0,826,781,0,0,0,0,0,0,781,1607
95,11,867,0,0,0,0,0,0,867,770,0,0,0,0,0,0,770,1637
95,12,873,0,0,0,0,0,0,873,860,0,0,0,0,0,0,860,1733
95,13,955,0,0,0,0,0,0,955,863,0,0,0,0,0,0,863,1818
95,14,867,0,0,0,0,0,0,867,815,0,0,0,0,0,0,815,1682
95,15,975,0,0,0,0,0,0,975,873,0,0,0,0,0,0,873,1848
95,16,970,0,1,0,0,0,0,971,901,0,0,0,0,0,0,901,1872
95,17,991,0,0,0,0,0,0,991,892,0,0,0,0,0,0,892,1883
95,18,1064,0,0,0,0,0,0,1064,882,0,0,0,0,0,0,882,1946
95,19,1095,2,0,0,0,0,0,1097,899,0,0,0,0,0,0,899,1996
95,20,1090,2,0,0,0,0,0,1092,957,5,0,0,0,0,0,962,2054
95,21,1095,1,0,0,0,0,0,1096,952,13,0,0,0,0,0,965,2061
95,22,1081,5,0,0,1,0,0,1087,961,12,2,0,0,0,0,975,2062
95,23,1121,5,0,2,1,0,0,1129,1017,14,1,0,0,0,0,1032,2161
95,24,1242,16,0,0,1,0,0,1259,1037,31,0,0,0,0,0,1068,2327
95,25,1216,11,0,0,1,0,0,1228,962,55,0,0,0,0,0,1017,2245
95,26,1189,26,0,0,0,0,0,1215,934,61,1,0,0,0,0,996,2211
95,27,1071,54,0,1,2,0,0,1128,906,120,2,0,0,0,0,1028,2156
95,28,1108,63,0,0,0,0,0,1171,901,127,3,1,0,0,0,1032,2203
95,29,1121,80,2,2,0,0,0,1205,822,198,5,1,1,0,0,1027,2232
95,30,1082,134,1,1,2,0,0,1220,799,257,2,1,0,0,0,1059,2279
95,31,1097,157,3,0,2,0,0,1259,828,289,4,0,1,0,0,1122,2381
95,32,1037,190,4,0,0,0,0,1231,715,321,7,0,0,0,0,1043,2274
95,33,972,248,2,0,0,0,0,1222,638,440,12,3,2,0,0,1095,2317
95,34,895,295,9,0,0,0,0,1199,625,428,13,1,0,0,0,1067,2266
95,35,841,351,7,1,0,0,0,1200,596,496,23,5,1,0,0,1121,2321
95,36,824,427,14,1,0,0,0,1266,484,526,29,5,1,0,0,1045,2311
95,37,740,410,8,2,0,0,0,1160,502,525,25,5,2,0,0,1059,2219
95,38,695,481,19,1,2,0,0,1198,459,681,27,6,0,0,0,1173,2371
95,39,656,527,30,1,1,0,0,1215,404,705,42,1,1,0,0,1153,2368
95,40,648,591,19,1,0,0,0,1259,396,731,40,5,0,0,0,1172,2431
95,41,638,616,25,0,3,0,0,1282,396,783,60,6,0,1,0,1246,2528
95,42,614,628,24,2,0,0,0,1268,356,810,60,9,0,0,0,1235,2503
95,43,573,671,32,0,0,0,0,1276,338,839,59,8,0,0,0,1244,2520
95,44,547,787,39,3,0,0,0,1376,301,943,74,24,0,0,0,1342,2718
95,45,535,806,51,2,1,0,0,1395,325,996,59,20,0,0,0,1400,2795
95,46,490,840,61,4,0,0,0,1395,319,1014,59,25,1,0,0,1418,2813
95,47,495,947,60,5,0,0,1,1508,298,974,82,29,0,0,0,1383,2891
95,48,534,997,66,7,0,0,0,1604,317,1154,108,23,0,0,0,1602,3206
95,49,474,1100,65,2,2,0,0,1643,285,1207,98,26,0,0,0,1616,3259
95,50,466,991,69,11,0,0,0,1537,235,1214,101,36,0,0,0,1586,3123
95,51,410,1120,61,9,0,0,0,1600,276,1259,75,34,0,0,0,1644,3244
95,52,395,1089,90,14,1,0,0,1589,206,1232,102,38,0,0,0,1578,3167
95,53,352,1178,80,12,0,0,0,1622,225,1260,101,55,2,0,0,1643,3265
95,54,346,1237,95,16,1,0,0,1695,229,1331,108,70,0,0,0,1738,3433
95,55,356,1208,80,18,0,0,0,1662,236,1301,102,74,0,0,0,1713,3375
95,56,305,1247,93,18,0,0,0,1663,186,1411,115,76,1,0,0,1789,3452
95,57,289,1312,89,19,0,0,0,1709,200,1431,105,93,1,0,0,1830,3539
95,58,268,1371,103,19,1,0,0,1762,183,1356,96,118,0,0,0,1753,3515
95,59,299,1409,73,22,0,0,0,1803,183,1410,99,138,1,0,0,1831,3634
95,60,254,1287,98,26,1,0,0,1666,138,1300,83,124,0,0,0,1645,3311
95,61,190,1294,86,24,1,0,0,1595,144,1307,75,161,0,0,0,1687,3282
95,62,205,1333,64,40,1,0,0,1643,131,1235,87,161,0,0,0,1614,3257
95,63,207,1310,69,28,0,0,0,1614,153,1258,81,194,1,0,0,1687,3301
95,64,166,1218,67,38,0,0,0,1489,139,1245,62,186,0,0,0,1632,3121
95,65,142,1118,62,40,0,0,0,1362,125,1189,66,210,0,0,0,1590,2952
95,66,136,1180,53,40,0,0,0,1409,107,1086,58,235,0,0,0,1486,2895
95,67,129,1187,45,50,0,0,0,1411,103,1070,44,264,0,0,0,1481,2892
95,68,117,1163,40,57,0,0,1,1378,115,1052,49,255,0,0,0,1471,2849
95,69,117,1093,54,58,0,0,0,1322,98,1059,56,291,0,0,0,1504,2826
95,70,90,1045,42,53,0,0,0,1230,95,914,34,266,0,0,0,1309,2539
95,71,108,1087,30,51,0,0,0,1276,95,995,34,312,0,0,0,1436,2712
95,72,71,1030,32,62,0,0,0,1195,85,846,37,315,0,0,0,1283,2478
95,73,57,1090,35,74,0,0,0,1256,83,858,24,406,0,0,1,1372,2628
95,74,72,1089,34,84,0,0,0,1279,82,854,25,463,0,0,0,1424,2703
95,75,65,1057,25,78,0,0,0,1225,87,805,31,447,0,0,0,1370,2595
95,76,70,931,25,77,0,0,0,1103,71,673,21,505,0,0,0,1270,2373
95,77,71,906,17,92,0,0,0,1086,76,626,19,447,0,0,0,1168,2254
95,78,39,630,20,86,0,0,0,775,53,458,10,429,0,0,0,950,1725
95,79,26,630,8,89,0,0,0,753,45,419,10,416,0,0,0,890,1643
95,80,35,555,7,79,0,0,0,676,50,350,13,435,0,0,0,848,1524
95,81,33,508,8,73,0,0,0,622,40,317,14,430,0,0,0,801,1423
95,82,22,518,7,104,0,0,0,651,45,349,13,505,0,0,0,912,1563
95,83,36,566,7,106,0,0,0,715,63,315,11,613,0,0,0,1002,1717
95,84,28,537,7,109,0,0,0,681,60,330,9,662,0,0,0,1061,1742
95,85,24,432,3,124,0,0,0,583,35,191,3,558,0,0,0,787,1370
95,86,21,344,4,144,0,0,0,513,46,208,5,566,0,0,0,825,1338
95,87,19,313,3,114,0,0,0,449,48,162,7,563,0,0,0,780,1229
95,88,12,264,4,117,0,0,0,397,31,113,4,552,0,0,0,700,1097
95,89,15,219,1,111,0,0,0,346,48,113,5,486,0,0,0,652,998
95,90,11,171,0,89,0,0,0,271,38,65,5,423,0,0,0,531,802
95,91,6,109,0,94,0,0,0,209,32,62,4,349,0,0,0,447,656
95,92,5,80,0,73,0,0,0,158,26,49,4,292,0,0,0,371,529
95,93,2,66,3,62,0,0,0,133,23,25,2,266,0,0,0,316,449
95,94,2,46,0,58,0,0,0,106,16,14,0,213,0,0,0,243,349
95,95,2,28,0,36,0,0,0,66,12,12,1,159,0,0,0,184,250
95,96,2,18,0,27,0,0,0,47,7,8,0,145,0,0,0,160,207
95,97,1,10,0,17,0,0,0,28,8,9,1,87,0,0,0,105,133
95,98,0,6,0,13,0,0,0,19,1,0,1,61,0,0,0,63,82
95,99,0,4,0,4,0,0,0,8,3,3,0,46,0,0,0,52,60
95,100,0,5,1,18,0,0,0,24,8,4,1,86,0,0,0,99,123
95,999,48414,50107,2336,2915,25,0,2,103799,38833,49908,2910,14520,16,1,1,106189,209988
96,0,2188,0,0,0,0,0,0,2188,2046,0,0,0,0,0,0,2046,4234
96,1,2207,0,0,0,0,0,0,2207,1970,0,0,0,0,0,0,1970,4177
96,2,2175,0,0,0,0,0,0,2175,2019,0,0,0,0,0,0,2019,4194
96,3,2301,0,0,0,0,0,0,2301,2079,0,0,0,0,0,0,2079,4380
96,4,2323,0,0,0,0,0,0,2323,2179,0,0,0,0,0,0,2179,4502
96,5,2389,0,0,0,0,0,0,2389,2172,0,0,0,0,0,0,2172,4561
96,6,2442,0,0,0,0,0,0,2442,2389,0,0,0,0,0,0,2389,4831
96,7,2638,0,0,0,0,0,0,2638,2374,0,0,0,0,0,0,2374,5012
96,8,2651,0,0,0,0,0,0,2651,2521,0,0,0,0,0,0,2521,5172
96,9,2771,0,0,0,0,0,0,2771,2544,0,0,0,0,0,0,2544,5315
96,10,2770,0,0,0,0,0,0,2770,2595,0,0,0,0,0,0,2595,5365
96,11,2792,0,0,0,0,0,0,2792,2654,0,0,0,0,0,0,2654,5446
96,12,2879,0,0,0,0,0,0,2879,2754,0,0,0,0,0,0,2754,5633
96,13,3060,0,0,0,0,0,0,3060,2849,0,0,0,0,0,0,2849,5909
96,14,3138,0,0,0,0,0,0,3138,3011,0,0,0,0,0,0,3011,6149
96,15,3233,0,0,0,0,0,0,3233,2957,0,0,0,0,0,0,2957,6190
96,16,3185,0,0,0,0,0,0,3185,2957,0,0,0,0,0,0,2957,6142
96,17,3230,0,0,0,0,0,0,3230,3048,0,1,0,0,0,0,3049,6279
96,18,3347,0,0,0,0,0,0,3347,3154,3,0,0,0,0,0,3157,6504
96,19,3577,1,1,0,0,0,0,3579,3234,6,0,0,0,0,0,3240,6819
96,20,3398,0,0,0,0,0,0,3398,3266,16,0,0,0,0,0,3282,6680
96,21,3418,3,0,0,0,0,0,3421,3261,25,0,0,0,0,0,3286,6707
96,22,3513,14,0,0,0,0,0,3527,3180,56,0,0,1,0,0,3237,6764
96,23,3591,17,0,0,0,0,0,3608,3271,88,0,0,0,0,0,3359,6967
96,24,3747,33,3,0,0,0,0,3783,3150,120,1,2,0,0,0,3273,7056
96,25,3768,65,6,0,0,0,0,3839,3071,216,1,1,1,0,0,3290,7129
96,26,3522,109,3,0,0,0,0,3634,2870,324,3,0,0,0,0,3197,6831
96,27,3313,151,5,0,0,0,0,3469,2656,471,8,0,1,0,0,3136,6605
96,28,3184,260,8,0,2,0,0,3454,2371,575,4,0,0,1,0,2951,6405
96,29,3092,375,8,0,0,0,0,3475,2220,763,11,2,0,0,0,2996,6471
96,30,3022,518,7,0,0,0,0,3547,2057,941,25,3,1,1,0,3028,6575
96,31,2927,696,13,1,2,0,0,3639,2011,1210,23,1,1,0,0,3246,6885
96,32,2714,858,11,0,2,0,0,3585,1813,1316,21,5,1,0,0,3156,6741
96,33,2557,1107,24,2,1,0,0,3691,1661,1547,36,7,0,0,0,3251,6942
96,34,2295,1150,25,3,1,0,0,3474,1552,1696,51,7,0,0,0,3306,6780
96,35,2188,1324,27,1,0,0,0,3540,1407,1796,52,7,0,0,0,3262,6802
96,36,1984,1553,36,3,0,0,0,3576,1249,1943,68,9,0,1,0,3270,6846
96,37,1987,1569,38,6,2,0,0,3602,1126,1957,97,14,1,0,0,3195,6797
96,38,1640,1679,62,1,1,0,0,3383,1040,2065,102,14,0,0,0,3221,6604
96,39,1536,1796,58,5,2,0,0,3397,1034,2228,107,20,1,0,0,3390,6787
96,40,1547,1901,65,9,2,0,0,3524,928,2312,126,22,1,0,0,3389,6913
96,41,1483,2113,90,3,4,0,0,3693,904,2485,153,32,1,0,0,3575,7268
96,42,1374,2192,98,9,2,0,0,3675,871,2612,140,42,2,0,0,3667,7342
96,43,1319,2405,117,13,3,0,0,3857,763,2670,170,44,0,0,0,3647,7504
96,44,1342,2443,118,19,1,0,1,3924,811,2779,186,46,0,0,0,3822,7746
96,45,1315,2541,121,13,1,0,0,3991,715,3009,213,56,2,0,0,3995,7986
96,46,1195,2832,149,20,2,0,0,4198,740,3122,197,57,1,0,0,4117,8315
96,47,1228,2903,155,17,2,0,0,4305,717,3216,193,67,0,0,0,4193,8498
96,48,1179,3059,168,25,1,0,0,4432,723,3257,220,93,1,0,0,4294,8726
96,49,1068,3134,180,38,3,0,0,4423,638,3549,230,109,0,0,0,4526,8949
96,50,1023,3093,169,23,1,0,0,4309,658,3420,247,119,0,0,0,4444,8753
96,51,909,3203,174,24,0,0,0,4310,628,3432,231,127,1,0,0,4419,8729
96,52,872,3333,220,28,3,0,0,4456,613,3583,250,152,1,0,0,4599,9055
96,53,829,3291,203,33,0,0,0,4356,570,3513,258,172,0,0,0,4513,8869
96,54,808,3540,190,40,3,0,0,4581,605,3620,252,191,3,0,0,4671,9252
96,55,739,3555,176,35,2,0,0,4507,547,3703,226,223,1,1,0,4701,9208
96,56,685,3688,204,50,2,0,0,4629,558,3801,262,240,0,0,0,4861,9490
96,57,652,3673,250,67,0,0,0,4642,543,3651,244,267,0,0,0,4705,9347
96,58,549,3757,194,77,1,0,0,4578,501,3750,215,288,0,0,0,4754,9332
96,59,569,3794,202,77,2,0,0,4644,522,3833,253,338,0,0,0,4946,9590
96,60,459,3493,203,80,2,0,0,4237,471,3599,197,354,0,0,0,4621,8858
96,61,451,3454,175,81,0,0,0,4161,412,3471,198,357,0,0,0,4438,8599
96,62,385,3361,150,75,0,0,0,3971,420,3213,186,370,0,0,0,4189,8160
96,63,376,3358,154,107,1,0,0,3996,382,3210,175,467,0,0,0,4234,8230
96,64,353,3172,148,114,0,0,0,3787,394,3088,164,461,0,0,0,4107,7894
96,65,302,3095,114,116,0,0,0,3627,309,3041,167,521,0,0,0,4038,7665
96,66,284,2972,112,124,0,0,0,3492,341,2838,148,577,0,0,0,3904,7396
96,67,261,3035,93,125,0,0,0,3514,328,2783,163,618,0,0,0,3892,7406
96,68,227,3019,106,144,1,0,0,3497,302,2651,137,680,0,0,0,3770,7267
96,69,236,3006,105,146,1,0,0,3494,280,2608,110,671,0,0,0,3669,7163
96,70,179,2673,101,182,0,0,0,3135,272,2386,95,702,0,0,0,3455,6590
96,71,179,2595,75,183,0,0,0,3032,260,2180,95,777,0,0,0,3312,6344
96,72,135,2545,67,181,0,0,0,2928,237,2159,109,797,1,0,0,3303,6231
96,73,161,2517,79,194,1,0,0,2952,258,2200,85,885,0,0,0,3428,6380
96,74,124,2727,59,207,0,0,0,3117,246,2158,84,956,0,0,0,3444,6561
96,75,133,2687,67,251,0,0,0,3138,250,2193,76,1242,0,0,0,3761,6899
96,76,131,2465,44,235,0,0,0,2875,253,1826,55,1098,0,0,0,3232,6107
96,77,92,2276,42,283,0,0,0,2693,196,1735,74,1313,0,0,0,3318,6011
96,78,85,1845,43,254,0,0,0,2227,190,1397,57,1078,0,0,0,2722,4949
96,79,63,1610,30,244,0,0,0,1947,162,1192,37,1027,0,0,0,2418,4365
96,80,53,1443,18,237,0,0,0,1751,188,1000,32,1037,0,0,0,2257,4008
96,81,66,1490,23,297,0,0,0,1876,154,933,29,1155,0,0,0,2271,4147
96,82,50,1306,17,270,0,0,0,1643,144,811,26,1162,0,0,0,2143,3786
96,83,51,1287,14,301,0,0,0,1653,157,735,32,1426,0,0,0,2350,4003
96,84,53,1220,17,360,0,0,0,1650,184,636,32,1390,0,0,0,2242,3892
96,85,43,1046,12,313,0,0,0,1414,156,530,13,1330,0,0,0,2029,3443
96,86,25,846,10,276,0,0,0,1157,122,453,17,1289,0,0,0,1881,3038
96,87,30,653,9,308,0,0,0,1000,133,272,17,1209,0,0,0,1631,2631
96,88,25,574,3,262,0,0,0,864,101,258,17,1096,0,0,0,1472,2336
96,89,18,443,3,274,0,0,0,738,103,177,11,1033,0,0,0,1324,2062
96,90,21,347,4,217,0,0,0,589,87,140,7,899,0,0,0,1133,1722
96,91,15,248,1,211,0,0,0,475,76,107,7,763,0,0,0,953,1428
96,92,7,173,3,164,0,0,0,347,46,61,9,623,0,0,0,739,1086
96,93,7,138,1,143,0,0,0,289,51,38,3,577,0,0,0,669,958
96,94,1,105,1,101,0,0,0,208,40,27,0,404,0,0,0,471,679
96,95,1,46,2,105,0,0,0,154,33,14,6,338,0,0,0,391,545
96,96,2,33,0,52,0,0,0,87,29,13,1,257,0,0,0,300,387
96,97,3,19,0,42,0,0,0,64,15,9,1,177,0,0,0,202,266
96,98,1,10,0,34,0,0,0,45,18,3,1,118,0,0,0,140,185
96,99,1,8,0,30,0,0,0,39,7,4,0,99,0,0,0,110,149
96,100,2,10,0,21,0,0,0,33,15,4,0,140,0,0,0,159,192
96,999,138468,141078,5683,7986,54,0,1,293270,117149,140832,7550,34250,23,4,0,299808,593078
97,0,4224,0,0,0,0,0,0,4224,4131,0,0,0,0,0,0,4131,8355
97,1,4452,0,0,0,0,0,0,4452,4181,0,0,0,0,0,0,4181,8633
97,2,4429,0,0,0,0,0,0,4429,4209,0,0,0,0,0,0,4209,8638
97,3,4480,0,0,0,0,0,0,4480,4110,0,0,0,0,0,0,4110,8590
97,4,4637,0,0,0,0,0,0,4637,4465,0,0,0,0,0,0,4465,9102
97,5,4959,0,0,0,0,0,0,4959,4623,0,0,0,0,0,0,4623,9582
97,6,5115,0,0,0,0,0,0,5115,4789,0,0,0,0,0,0,4789,9904
97,7,5287,0,0,0,0,0,0,5287,4859,0,0,0,0,0,0,4859,10146
97,8,5217,0,0,0,0,0,0,5217,4942,0,0,0,0,0,0,4942,10159
97,9,5430,0,0,0,0,0,0,5430,5110,0,0,0,0,0,0,5110,10540
97,10,5445,0,0,0,0,0,0,5445,5129,0,0,0,0,0,0,5129,10574
97,11,5692,0,0,0,0,0,0,5692,5287,0,0,0,0,0,0,5287,10979
97,12,5905,0,0,0,0,0,0,5905,5537,0,0,0,0,0,0,5537,11442
97,13,5896,0,0,0,0,0,0,5896,5799,0,0,0,0,0,0,5799,11695
97,14,5989,0,0,0,0,0,0,5989,5601,0,0,0,0,0,0,5601,11590
97,15,6076,0,0,0,0,0,0,6076,5745,0,0,0,0,0,0,5745,11821
97,16,6100,0,0,0,0,0,0,6100,5809,0,0,0,0,0,0,5809,11909
97,17,6222,0,0,0,0,0,0,6222,5854,0,0,0,0,0,0,5854,12076
97,18,6520,0,0,0,0,0,0,6520,5811,0,0,0,0,0,0,5811,12331
97,19,6406,3,0,0,0,0,0,6409,6204,12,0,0,0,0,0,6216,12625
97,20,6490,5,0,0,0,0,0,6495,6200,23,0,0,0,0,0,6223,12718
97,21,6371,6,1,0,0,0,0,6378,6052,42,0,0,1,0,0,6095,12473
97,22,6691,18,0,0,1,0,0,6710,6110,92,1,0,1,0,0,6204,12914
97,23,6798,38,0,0,0,0,0,6836,6214,137,1,0,2,0,0,6354,13190
97,24,6673,63,0,0,0,0,0,6736,6058,217,0,0,4,1,0,6280,13016
97,25,6555,112,1,0,0,0,0,6668,5954,360,4,0,1,0,0,6319,12987
97,26,6527,183,0,0,0,0,0,6710,5611,505,3,0,3,0,0,6122,12832
97,27,6490,285,2,0,0,1,0,6778,5622,731,5,1,2,0,0,6361,13139
97,28,6122,453,6,0,3,0,0,6584,5145,1112,12,1,4,0,0,6274,12858
97,29,5852,672,3,1,1,0,0,6529,4776,1472,18,0,2,0,0,6268,12797
97,30,5766,971,13,0,5,0,0,6755,4560,1902,24,3,6,0,0,6495,13250
97,31,5554,1276,15,0,10,0,0,6855,4366,2415,36,3,7,0,0,6827,13682
97,32,5305,1685,27,1,8,0,0,7026,3911,2805,52,6,3,0,0,6777,13803
97,33,4788,2182,13,3,4,0,0,6990,3415,3268,50,9,5,0,0,6747,13737
97,34,4395,2376,43,4,11,0,0,6829,3152,3544,89,13,5,0,0,6803,13632
97,35,4259,2989,64,2,12,0,0,7326,2956,4079,103,16,6,0,0,7160,14486
97,36,3882,3104,54,3,7,0,0,7050,2610,4251,127,13,3,0,0,7004,14054
97,37,3489,3399,83,4,9,0,0,6984,2345,4440,168,25,2,1,0,6981,13965
97,38,3281,3648,78,2,7,0,0,7016,2195,4552,185,31,10,0,0,6973,13989
97,39,3074,4066,119,4,9,1,0,7273,2150,4962,214,38,6,0,0,7370,14643
97,40,2907,4355,124,4,11,0,0,7401,1989,5107,257,36,6,0,0,7395,14796
97,41,2785,4535,128,13,9,3,0,7473,1965,5664,233,43,6,0,0,7911,15384
97,42,2698,4780,126,17,5,0,0,7626,1848,5617,289,73,9,0,0,7836,15462
97,43,2518,4895,193,12,4,0,0,7622,1720,5942,321,67,9,0,0,8059,15681
97,44,2480,5410,212,13,7,0,0,8122,1704,6095,406,88,6,0,0,8299,16421
97,45,2551,5705,264,22,4,0,0,8546,1594,6422,415,88,5,0,0,8524,17070
97,46,2466,6013,287,36,8,2,0,8812,1608,6718,462,91,7,0,0,8886,17698
97,47,2362,6236,336,29,6,1,0,8970,1666,7149,489,116,9,0,0,9429,18399
97,48,2331,6631,368,28,10,0,0,9368,1562,7540,564,143,3,0,0,9812,19180
97,49,2236,6878,360,53,6,1,0,9534,1530,7833,594,158,3,0,0,10118,19652
97,50,1989,6953,405,43,1,0,0,9391,1424,7635,580,170,9,0,0,9818,19209
97,51,1924,6910,431,50,6,1,0,9322,1331,7430,599,199,1,0,0,9560,18882
97,52,1782,7029,473,54,4,0,0,9342,1312,7570,594,251,3,0,0,9730,19072
97,53,1665,7234,474,68,4,1,0,9446,1158,7624,594,249,3,0,0,9628,19074
97,54,1563,7206,439,86,5,0,0,9299,1160,7846,667,318,0,0,0,9991,19290
97,55,1392,7387,531,101,7,0,0,9418,1172,7849,610,363,4,0,0,9998,19416
97,56,1335,7694,501,99,3,0,0,9632,1113,7972,597,423,0,0,0,10105,19737
97,57,1181,7994,475,114,5,0,2,9771,1047,8181,593,440,3,0,0,10264,20035
97,58,1157,7923,501,118,2,0,0,9701,1062,8212,654,535,0,0,0,10463,20164
97,59,1072,8091,495,161,8,0,0,9827,1029,8134,585,604,6,0,0,10358,20185
97,60,888,7396,420,160,1,0,0,8865,917,7606,552,608,2,0,0,9685,18550
97,61,812,7328,386,166,7,0,0,8699,890,7306,518,705,2,0,0,9421,18120
97,62,706,7432,372,148,4,0,0,8662,834,7195,526,754,1,0,0,9310,17972
97,63,671,7108,386,208,3,0,0,8376,761,6820,473,851,4,0,0,8909,17285
97,64,581,6867,365,187,1,0,0,8001,716,6931,449,878,0,0,0,8974,16975
97,65,489,6492,311,217,1,0,0,7510,669,6356,404,920,0,0,0,8349,15859
97,66,519,6573,317,270,2,0,0,7681,652,6229,403,1068,0,0,1,8353,16034
97,67,448,6353,274,252,1,0,1,7329,660,6060,353,1132,0,0,0,8205,15534
97,68,392,6154,246,259,2,0,1,7054,561,5716,338,1229,0,0,0,7844,14898
97,69,384,6096,231,319,1,0,0,7031,595,5630,302,1340,0,1,0,7868,14899
97,70,325,5700,222,300,1,0,0,6548,534,5146,302,1418,0,0,0,7400,13948
97,71,298,5547,190,298,2,0,0,6335,502,4949,269,1399,0,0,0,7119,13454
97,72,303,5503,167,382,3,0,0,6358,542,4591,235,1565,1,0,0,6934,13292
97,73,254,5716,176,377,0,0,0,6523,528,4838,265,1780,0,0,0,7411,13934
97,74,267,5474,160,414,1,0,0,6316,589,4458,252,1903,0,0,0,7202,13518
97,75,230,5738,133,504,1,0,0,6606,524,4553,234,2276,0,0,0,7587,14193
97,76,204,5071,129,508,1,0,0,5913,515,4058,177,2319,1,0,0,7070,12983
97,77,197,4894,118,581,2,0,0,5792,452,3763,192,2449,0,0,0,6856,12648
97,78,158,4122,98,515,2,0,0,4895,442,2906,136,2285,0,0,0,5769,10664
97,79,144,3369,64,468,1,0,0,4046,380,2468,102,2137,0,0,0,5087,9133
97,80,121,3216,60,476,0,0,0,3873,341,2190,99,2186,0,0,0,4816,8689
97,81,126,3064,48,549,0,0,0,3787,373,2009,99,2484,0,0,0,4965,8752
97,82,94,2800,46,592,0,0,0,3532,353,1789,81,2364,0,0,0,4587,8119
97,83,118,2861,41,626,0,0,0,3646,338,1604,84,2660,0,0,0,4686,8332
97,84,106,2407,38,641,0,0,0,3192,312,1366,82,2545,0,0,0,4305,7497
97,85,68,2104,38,611,0,0,0,2821,271,1095,48,2638,0,0,0,4052,6873
97,86,64,1810,29,594,0,0,0,2497,277,878,39,2550,0,0,0,3744,6241
97,87,48,1417,20,578,0,0,0,2063,247,652,31,2254,0,0,0,3184,5247
97,88,37,1259,15,556,0,0,0,1867,215,534,36,2180,0,0,0,2965,4832
97,89,52,979,9,546,0,0,0,1586,202,376,27,1955,0,0,0,2560,4146
97,90,28,816,5,464,0,0,0,1313,164,272,27,1754,0,0,0,2217,3530
97,91,25,559,5,405,0,0,0,994,144,186,18,1508,0,0,0,1856,2850
97,92,18,393,5,347,0,0,0,763,129,104,19,1302,1,0,0,1555,2318
97,93,18,321,1,324,0,0,0,664,110,95,10,1113,0,0,0,1328,1992
97,94,10,204,0,216,0,0,0,430,100,63,1,787,0,0,0,951,1381
97,95,5,128,1,149,0,0,0,283,63,34,3,672,0,0,0,772,1055
97,96,3,87,1,124,0,0,0,215,64,19,4,500,0,0,0,587,802
97,97,3,60,1,81,0,0,0,145,34,15,3,317,0,0,0,369,514
97,98,4,27,1,52,0,0,0,84,29,3,0,226,0,0,0,258,342
97,99,4,22,0,37,0,0,0,63,13,5,5,132,0,0,0,155,218
97,100,1,22,0,53,0,0,0,76,37,5,1,277,0,0,0,320,396
97,999,266460,300882,12774,15699,239,11,4,596069,236670,304334,18394,66034,177,3,1,625613,1221682
98,0,1774,0,0,0,0,0,0,1774,1616,0,0,0,0,0,0,1616,3390
98,1,1807,0,0,0,0,0,0,1807,1676,0,0,0,0,0,0,1676,3483
98,2,1843,0,0,0,0,0,0,1843,1782,0,0,0,0,0,0,1782,3625
98,3,1885,0,0,0,0,0,0,1885,1753,0,0,0,0,0,0,1753,3638
98,4,2002,0,0,0,0,0,0,2002,1832,0,0,0,0,0,0,1832,3834
98,5,2033,0,0,0,0,0,0,2033,1940,0,0,0,0,0,0,1940,3973
98,6,2233,0,0,0,0,0,0,2233,2033,0,0,0,0,0,0,2033,4266
98,7,2168,0,0,0,0,0,0,2168,2176,0,0,0,0,0,0,2176,4344
98,8,2290,0,0,0,0,0,0,2290,2201,0,0,0,0,0,0,2201,4491
98,9,2461,0,0,0,0,0,0,2461,2370,0,0,0,0,0,0,2370,4831
98,10,2423,0,0,0,0,0,0,2423,2332,0,0,0,0,0,0,2332,4755
98,11,2674,0,0,0,0,0,0,2674,2437,0,0,0,0,0,0,2437,5111
98,12,2671,0,0,0,0,0,0,2671,2592,0,0,0,0,0,0,2592,5263
98,13,2845,0,0,0,0,0,0,2845,2567,0,0,0,0,0,0,2567,5412
98,14,2764,0,0,0,0,0,0,2764,2627,0,0,0,0,0,0,2627,5391
98,15,2784,0,0,0,0,0,0,2784,2645,0,0,0,0,0,0,2645,5429
98,16,2819,0,0,0,0,0,0,2819,2711,0,0,0,0,0,0,2711,5530
98,17,2808,0,0,0,0,0,0,2808,2758,0,0,0,0,0,0,2758,5566
98,18,2948,0,0,0,0,0,0,2948,2772,0,0,0,0,0,0,2772,5720
98,19,2933,0,0,0,0,0,0,2933,2888,2,0,0,0,0,0,2890,5823
98,20,2975,0,0,0,0,0,0,2975,2933,7,0,0,0,0,0,2940,5915
98,21,2995,3,0,0,0,0,0,2998,2781,9,0,0,0,0,0,2790,5788
98,22,3023,3,0,0,1,0,0,3027,2734,32,0,0,0,0,0,2766,5793
98,23,3031,9,0,0,2,0,0,3042,2740,46,0,0,1,0,0,2787,5829
98,24,3056,21,2,0,1,0,0,3080,2619,58,0,0,1,0,0,2678,5758
98,25,2997,35,1,0,0,0,0,3033,2532,111,0,1,4,0,0,2648,5681
98,26,2840,54,0,0,1,0,0,2895,2486,194,0,0,4,0,0,2684,5579
98,27,2752,112,0,1,3,0,0,2868,2384,250,0,0,2,0,0,2636,5504
98,28,2635,158,2,0,1,0,0,2796,2253,359,5,2,0,0,0,2619,5415
98,29,2603,215,0,0,1,0,0,2819,2119,490,7,0,2,0,0,2618,5437
98,30,2563,335,4,0,3,0,0,2905,2086,648,14,0,2,0,0,2750,5655
98,31,2611,373,5,2,1,0,0,2992,1951,872,14,3,2,0,0,2842,5834
98,32,2354,505,6,1,2,0,0,2868,1837,1007,21,3,2,0,0,2870,5738
98,33,2284,630,10,3,1,1,0,2929,1717,1155,26,7,2,0,0,2907,5836
98,34,2134,753,9,4,2,0,0,2902,1632,1254,39,10,2,0,0,2937,5839
98,35,2082,1030,11,5,4,0,0,3132,1431,1507,50,8,1,0,0,2997,6129
98,36,1852,1140,28,2,2,0,0,3024,1293,1604,59,7,4,0,0,2967,5991
98,37,1794,1317,28,4,0,0,0,3143,1252,1797,67,12,3,0,0,3131,6274
98,38,1642,1386,50,1,3,0,0,3082,1158,1937,86,11,2,0,0,3194,6276
98,39,1617,1537,47,4,2,0,0,3207,1130,2030,108,14,1,2,0,3285,6492
98,40,1544,1712,50,3,3,0,0,3312,1025,2101,121,16,4,0,0,3267,6579
98,41,1459,1791,69,5,1,1,0,3326,940,2164,113,22,3,0,0,3242,6568
98,42,1349,1963,63,6,0,0,1,3382,953,2465,157,18,0,0,0,3593,6975
98,43,1356,2181,103,10,3,0,0,3653,878,2467,151,32,2,0,0,3530,7183
98,44,1335,2304,136,10,3,0,0,3788,843,2820,166,37,2,0,0,3868,7656
98,45,1285,2468,128,10,1,0,0,3892,862,2882,212,36,1,0,0,3993,7885
98,46,1314,2778,132,18,3,1,0,4246,826,3022,222,48,0,0,0,4118,8364
98,47,1275,2868,149,19,1,0,0,4312,814,3158,242,66,0,0,0,4280,8592
98,48,1229,2996,149,25,5,0,0,4404,829,3329,250,74,0,0,0,4482,8886
98,49,1199,3036,183,23,3,0,0,4444,754,3482,250,84,3,0,0,4573,9017
98,50,1002,3100,190,17,2,0,0,4311,687,3267,253,95,1,0,0,4303,8614
98,51,974,3032,184,23,4,0,0,4217,640,3339,252,104,0,0,0,4335,8552
98,52,883,3094,207,27,2,0,0,4213,591,3343,273,139,0,0,0,4346,8559
98,53,799,2999,206,39,3,0,0,4046,571,3246,254,116,1,0,0,4188,8234
98,54,792,3134,244,41,5,0,0,4216,563,3437,296,155,0,0,0,4451,8667
98,55,692,3112,213,48,2,0,0,4067,554,3503,284,200,0,0,0,4541,8608
98,56,653,3240,222,37,4,1,0,4157,547,3407,282,198,3,0,0,4437,8594
98,57,619,3310,208,56,2,1,0,4196,495,3536,284,230,0,0,0,4545,8741
98,58,561,3445,213,66,5,0,0,4290,505,3575,270,261,1,0,0,4612,8902
98,59,458,3439,211,76,3,0,0,4187,524,3568,254,255,0,0,0,4601,8788
98,60,437,3188,204,71,1,0,0,3901,422,3296,239,281,0,0,0,4238,8139
98,61,421,3114,171,69,0,0,0,3775,405,3264,236,352,1,0,0,4258,8033
98,62,384,3220,173,79,0,0,0,3856,360,3381,215,398,0,0,0,4354,8210
98,63,301,3247,185,88,0,0,0,3821,370,3117,198,421,0,0,0,4106,7927
98,64,303,3106,180,96,0,0,0,3685,320,3024,191,472,0,0,0,4007,7692
98,65,266,2958,143,94,1,0,0,3462,357,2883,149,503,1,0,0,3893,7355
98,66,271,2973,141,120,1,0,0,3506,342,2962,164,552,0,0,0,4020,7526
98,67,218,2944,112,114,0,0,0,3388,289,2721,162,601,0,0,0,3773,7161
98,68,208,2959,117,117,0,0,0,3401,305,2808,151,674,0,0,0,3938,7339
98,69,193,2720,113,123,1,0,0,3150,243,2615,137,642,0,0,0,3637,6787
98,70,173,2808,86,147,2,0,0,3216,235,2440,122,736,0,0,0,3533,6749
98,71,147,2551,74,169,3,0,0,2944,228,2318,98,775,0,0,0,3419,6363
98,72,141,2712,84,188,0,0,0,3125,273,2303,99,828,0,0,1,3504,6629
98,73,135,2727,65,188,2,0,0,3117,242,2297,94,943,0,0,0,3576,6693
98,74,120,2709,65,224,1,0,0,3119,247,2119,90,1007,0,0,0,3463,6582
98,75,122,2757,60,238,1,0,0,3178,260,2065,80,1173,0,0,0,3578,6756
98,76,114,2560,51,253,0,0,0,2978,252,1946,74,1171,0,0,0,3443,6421
98,77,93,2310,47,252,1,0,0,2703,228,1811,64,1301,0,0,0,3404,6107
98,78,67,2033,37,240,0,0,0,2377,216,1438,52,1102,0,0,0,2808,5185
98,79,68,1700,23,251,0,0,0,2042,152,1198,47,1167,0,0,0,2564,4606
98,80,72,1566,29,243,0,0,0,1910,155,1049,57,1168,0,0,0,2429,4339
98,81,58,1474,18,280,1,0,0,1831,168,999,46,1225,0,0,0,2438,4269
98,82,54,1387,33,273,0,0,0,1747,161,817,24,1202,0,0,0,2204,3951
98,83,46,1409,19,338,0,0,0,1812,203,830,36,1390,0,0,0,2459,4271
98,84,40,1248,3,290,0,0,0,1581,167,694,20,1407,0,0,0,2288,3869
98,85,24,1040,11,301,0,0,0,1376,145,529,25,1299,0,0,0,1998,3374
98,86,28,864,10,277,0,0,0,1179,129,425,15,1283,0,0,0,1852,3031
98,87,24,670,7,272,0,0,0,973,114,309,12,1097,0,0,0,1532,2505
98,88,32,583,3,252,0,0,0,870,116,208,6,1088,0,0,0,1418,2288
98,89,16,446,5,260,0,0,0,727,107,158,7,969,0,0,0,1241,1968
98,90,13,331,1,216,0,0,0,561,93,111,3,754,0,0,0,961,1522
98,91,12,251,0,171,0,0,0,434,76,73,4,690,0,0,0,843,1277
98,92,10,186,1,135,0,0,0,332,54,53,5,597,0,0,0,709,1041
98,93,2,127,3,145,0,0,0,277,55,38,3,551,0,0,0,647,924
98,94,4,80,3,86,0,0,0,173,31,20,0,393,0,0,0,444,617
98,95,4,58,0,70,0,0,0,132,40,11,0,271,0,0,0,322,454
98,96,5,35,1,49,0,0,0,90,22,6,1,210,0,0,0,239,329
98,97,3,11,0,31,0,0,0,45,17,6,0,138,0,0,0,161,206
98,98,1,8,0,25,0,0,0,34,9,5,1,97,0,0,0,112,146
98,99,0,9,0,20,0,0,0,29,10,3,0,46,0,0,0,59,88
98,100,2,7,0,17,0,0,0,26,16,4,1,123,0,0,0,144,170
98,999,123415,132704,5741,7458,100,5,1,269424,108811,133834,8010,33361,58,2,1,284077,553501
99,0,1175,0,0,0,0,0,0,1175,1162,0,0,0,0,0,0,1162,2337
99,1,1321,0,0,0,0,0,0,1321,1197,0,0,0,0,0,0,1197,2518
99,2,1275,0,0,0,0,0,0,1275,1134,0,0,0,0,0,0,1134,2409
99,3,1299,0,0,0,0,0,0,1299,1210,0,0,0,0,0,0,1210,2509
99,4,1219,0,0,0,0,0,0,1219,1230,0,0,0,0,0,0,1230,2449
99,5,1359,0,0,0,0,0,0,1359,1313,0,0,0,0,0,0,1313,2672
99,6,1375,0,0,0,0,0,0,1375,1396,0,0,0,0,0,0,1396,2771
99,7,1484,0,0,0,0,0,0,1484,1390,0,0,0,0,0,0,1390,2874
99,8,1499,0,0,0,0,0,0,1499,1457,0,0,0,0,0,0,1457,2956
99,9,1577,0,0,0,0,0,0,1577,1504,0,0,0,0,0,0,1504,3081
99,10,1675,0,0,0,0,0,0,1675,1585,0,0,0,0,0,0,1585,3260
99,11,1673,0,0,0,0,0,0,1673,1597,0,0,0,0,0,0,1597,3270
99,12,1781,0,0,0,0,0,0,1781,1617,0,0,0,0,0,0,1617,3398
99,13,1750,0,0,0,0,0,0,1750,1709,0,0,0,0,0,0,1709,3459
99,14,1921,0,0,0,0,0,0,1921,1732,0,0,0,0,0,0,1732,3653
99,15,1825,0,0,0,0,0,0,1825,1741,0,0,0,0,0,0,1741,3566
99,16,1938,0,0,0,0,0,0,1938,1694,0,0,0,0,0,0,1694,3632
99,17,1924,0,0,0,0,0,0,1924,1759,0,0,0,0,0,0,1759,3683
99,18,1943,0,0,0,0,0,0,1943,1761,3,0,0,0,0,0,1764,3707
99,19,2018,0,0,0,0,0,0,2018,1832,5,0,0,0,0,0,1837,3855
99,20,1934,1,0,0,0,0,0,1935,1722,6,0,0,0,0,0,1728,3663
99,21,1975,2,0,0,0,0,0,1977,1817,14,0,0,0,0,0,1831,3808
99,22,1998,3,0,0,1,0,0,2002,1835,22,0,0,0,0,0,1857,3859
99,23,1962,4,0,0,1,0,0,1967,1925,22,0,0,0,1,0,1948,3915
99,24,2076,14,0,0,1,0,0,2091,1857,64,0,0,1,0,0,1922,4013
99,25,2011,19,0,0,0,0,0,2030,1776,86,0,1,0,0,0,1863,3893
99,26,1886,51,0,0,0,0,0,1937,1668,124,1,1,0,0,0,1794,3731
99,27,1944,71,0,0,0,0,0,2015,1645,160,2,1,0,0,0,1808,3823
99,28,1795,124,0,1,1,0,0,1921,1518,276,5,0,1,0,0,1800,3721
99,29,1791,175,3,0,1,0,0,1970,1484,349,9,0,1,0,0,1843,3813
99,30,1824,233,3,1,1,0,0,2062,1468,451,16,0,1,0,0,1936,3998
99,31,1827,315,4,1,3,0,0,2150,1390,646,8,0,2,0,0,2046,4196
99,32,1703,375,6,0,1,0,0,2085,1289,726,13,1,2,0,0,2031,4116
99,33,1644,490,9,2,0,0,0,2145,1202,776,19,1,1,0,0,1999,4144
99,34,1565,565,12,1,4,0,0,2147,1164,882,33,0,2,0,0,2081,4228
99,35,1422,704,12,0,2,0,0,2140,1035,1042,41,6,0,0,0,2124,4264
99,36,1395,811,19,1,4,0,0,2230,1024,1092,59,5,2,0,0,2182,4412
99,37,1265,819,29,3,1,0,0,2117,871,1152,53,4,0,0,0,2080,4197
99,38,1250,953,34,2,4,0,0,2243,823,1291,71,13,0,0,0,2198,4441
99,39,1138,1045,30,1,2,0,0,2216,800,1366,66,7,0,0,0,2239,4455
99,40,1009,1165,32,3,3,0,0,2212,724,1410,79,6,0,0,0,2219,4431
99,41,1007,1247,62,3,6,0,0,2325,685,1616,96,9,1,0,0,2407,4732
99,42,981,1239,59,1,1,0,0,2281,656,1570,104,19,1,0,0,2350,4631
99,43,906,1432,70,2,2,0,0,2412,618,1603,124,18,1,0,0,2364,4776
99,44,954,1539,73,9,5,0,0,2580,619,1764,136,20,1,0,0,2540,5120
99,45,839,1612,98,6,2,0,0,2557,622,1821,150,27,2,1,0,2623,5180
99,46,850,1695,119,10,1,0,0,2675,599,1990,171,38,1,0,0,2799,5474
99,47,834,1833,125,11,4,0,0,2807,618,2038,198,34,1,0,0,2889,5696
99,48,807,1914,145,14,0,0,0,2880,578,2151,215,52,1,0,0,2997,5877
99,49,821,2002,136,15,2,0,0,2976,557,2253,211,56,0,0,0,3077,6053
99,50,702,1901,153,17,4,0,0,2777,539,2176,207,60,0,0,0,2982,5759
99,51,622,1991,148,15,2,0,0,2778,489,2150,208,58,0,0,0,2905,5683
99,52,619,1978,173,21,2,0,0,2793,461,2236,189,87,0,0,0,2973,5766
99,53,567,2082,145,22,2,0,0,2818,451,2253,201,97,1,0,0,3003,5821
99,54,522,2091,182,23,3,0,0,2821,425,2348,229,99,0,0,0,3101,5922
99,55,507,2245,191,28,3,0,0,2974,412,2357,221,126,0,0,0,3116,6090
99,56,437,2321,155,35,4,0,0,2952,459,2328,216,148,0,0,0,3151,6103
99,57,450,2331,177,28,2,0,0,2988,396,2314,176,136,1,0,0,3023,6011
99,58,397,2343,170,54,0,0,0,2964,375,2429,203,163,1,0,0,3171,6135
99,59,366,2413,166,49,2,0,0,2996,406,2452,188,197,0,0,0,3243,6239
99,60,294,2297,157,53,2,0,0,2803,401,2374,190,225,2,0,0,3192,5995
99,61,269,2262,147,59,1,0,0,2738,356,2115,153,243,1,0,0,2868,5606
99,62,266,2247,110,54,2,0,0,2679,320,2308,151,256,0,0,0,3035,5714
99,63,202,2151,136,53,2,0,0,2544,297,2225,151,269,0,0,0,2942,5486
99,64,183,2177,122,86,0,0,0,2568,282,2011,141,335,0,0,0,2769,5337
99,65,185,2034,97,82,2,0,0,2400,248,1935,137,356,0,0,0,2676,5076
99,66,151,2029,128,65,0,0,0,2373,273,1903,123,356,0,0,0,2655,5028
99,67,168,2047,103,56,0,0,0,2374,258,1959,110,356,0,0,0,2683,5057
99,68,139,1904,98,91,0,0,0,2232,255,1817,116,450,1,0,0,2639,4871
99,69,143,1891,70,87,1,0,0,2192,218,1615,81,425,0,0,0,2339,4531
99,70,139,1730,55,118,1,0,0,2043,211,1568,89,478,1,0,0,2347,4390
99,71,109,1763,72,110,1,0,0,2055,240,1561,86,532,1,0,0,2420,4475
99,72,112,1709,72,109,0,0,0,2002,214,1577,66,626,0,0,0,2483,4485
99,73,94,1831,42,150,0,0,0,2117,218,1515,62,671,0,0,0,2466,4583
99,74,94,1830,46,140,2,0,0,2112,222,1524,66,732,0,0,0,2544,4656
99,75,77,1838,45,154,0,0,0,2114,230,1439,79,784,0,0,0,2532,4646
99,76,83,1620,37,189,0,0,0,1929,194,1341,57,792,0,0,0,2384,4313
99,77,77,1504,51,166,1,0,0,1799,180,1200,60,885,0,0,0,2325,4124
99,78,43,1233,32,155,1,0,0,1464,167,886,43,759,0,0,0,1855,3319
99,79,48,1070,24,144,0,0,0,1286,173,793,42,819,0,0,0,1827,3113
99,80,22,1115,21,158,0,0,0,1316,161,733,30,841,0,0,0,1765,3081
99,81,49,1027,27,184,1,0,0,1288,148,679,30,893,0,0,0,1750,3038
99,82,38,906,18,181,1,0,0,1144,126,550,28,822,0,0,0,1526,2670
99,83,31,886,14,210,0,0,0,1141,130,508,24,937,0,0,0,1599,2740
99,84,33,830,9,237,0,0,0,1109,147,481,28,979,0,0,0,1635,2744
99,85,20,705,14,199,0,0,0,938,139,341,18,906,0,0,0,1404,2342
99,86,16,569,9,203,0,0,0,797,115,268,18,834,0,0,0,1235,2032
99,87,20,473,3,197,0,0,0,693,88,210,18,756,0,0,0,1072,1765
99,88,14,368,3,165,0,0,0,550,78,165,13,685,0,0,0,941,1491
99,89,13,307,2,141,0,0,0,463,97,103,5,671,0,0,0,876,1339
99,90,4,244,1,141,0,0,0,390,67,92,7,559,0,0,0,725,1115
99,91,9,187,1,115,0,0,0,312,45,62,14,486,0,0,0,607,919
99,92,9,146,0,84,0,0,0,239,56,51,3,428,0,0,0,538,777
99,93,1,109,0,100,0,0,0,210,40,29,1,363,0,0,0,433,643
99,94,3,78,0,45,0,0,0,126,26,11,1,263,0,0,0,301,427
99,95,3,29,0,42,0,0,0,74,31,11,2,210,0,0,0,254,328
99,96,4,22,0,42,0,0,0,68,17,8,0,161,0,0,0,186,254
99,97,1,23,0,28,0,0,0,52,12,2,1,113,0,0,0,128,180
99,98,1,9,0,23,0,0,0,33,7,1,1,60,0,0,0,69,102
99,99,2,3,0,7,0,0,0,12,11,1,0,48,0,0,0,60,72
99,100,7,11,1,13,0,0,0,32,20,2,0,74,0,0,0,96,128
99,999,83809,89362,4507,5015,95,0,0,182788,75540,89788,6163,22928,31,2,0,194452,377240
100,0,2391,0,0,0,0,0,0,2391,2227,0,0,0,0,0,0,2227,4618
100,1,2524,0,0,0,0,0,0,2524,2352,0,0,0,0,0,0,2352,4876
100,2,2536,0,0,0,0,0,0,2536,2369,0,0,0,0,0,0,2369,4905
100,3,2539,0,0,0,0,0,0,2539,2410,0,0,0,0,0,0,2410,4949
100,4,2736,0,0,0,0,0,0,2736,2476,0,0,0,0,0,0,2476,5212
100,5,2871,0,0,0,0,0,0,2871,2605,0,0,0,0,0,0,2605,5476
100,6,2787,0,0,0,0,0,0,2787,2789,0,0,0,0,0,0,2789,5576
100,7,2953,0,0,0,0,0,0,2953,2831,0,0,0,0,0,0,2831,5784
100,8,2940,0,0,0,0,0,0,2940,2909,0,0,0,0,0,0,2909,5849
100,9,3230,0,0,0,0,0,0,3230,2862,0,0,0,0,0,0,2862,6092
100,10,3309,0,0,0,0,0,0,3309,3085,0,0,0,0,0,0,3085,6394
100,11,3462,0,0,0,0,0,0,3462,3222,0,0,0,0,0,0,3222,6684
100,12,3444,0,0,0,0,0,0,3444,3286,0,0,0,0,0,0,3286,6730
100,13,3666,0,0,0,0,0,0,3666,3399,0,0,0,0,0,0,3399,7065
100,14,3549,0,0,0,0,0,0,3549,3384,0,0,0,0,0,0,3384,6933
100,15,3736,0,0,0,0,0,0,3736,3508,0,0,0,0,0,0,3508,7244
100,16,3839,0,0,0,0,0,0,3839,3454,0,0,0,0,0,0,3454,7293
100,17,3749,0,0,0,0,0,0,3749,3552,0,0,0,0,0,0,3552,7301
100,18,3900,0,0,0,0,0,0,3900,3586,0,0,0,0,0,0,3586,7486
100,19,4061,0,0,0,0,0,0,4061,3833,2,0,0,0,0,0,3835,7896
100,20,4051,0,0,0,0,0,0,4051,3696,7,0,0,0,0,0,3703,7754
100,21,3906,3,0,0,0,0,0,3909,3705,11,1,0,0,0,0,3717,7626
100,22,4115,3,0,1,0,0,0,4119,3805,35,0,0,0,0,0,3840,7959
100,23,4222,12,0,0,0,0,0,4234,3748,50,1,0,0,0,0,3799,8033
100,24,4017,29,1,0,0,0,0,4047,3532,106,0,0,0,0,0,3638,7685
100,25,4067,48,3,0,1,0,0,4119,3552,130,3,0,1,0,0,3686,7805
100,26,3873,74,1,0,0,0,0,3948,3420,231,4,0,1,0,0,3656,7604
100,27,3660,127,2,0,2,0,0,3791,3288,365,3,1,2,0,0,3659,7450
100,28,3709,219,0,0,5,0,0,3933,3162,463,5,1,0,0,0,3631,7564
100,29,3531,296,2,0,3,0,0,3832,3045,620,5,1,2,0,0,3673,7505
100,30,3591,374,8,0,0,0,0,3973,2987,871,22,1,4,0,0,3885,7858
100,31,3674,584,9,0,1,0,0,4268,2920,1090,19,3,1,0,0,4033,8301
100,32,3342,707,12,0,3,0,0,4064,2687,1304,29,5,3,0,0,4028,8092
100,33,3140,896,11,1,6,0,0,4054,2452,1465,31,5,3,1,0,3957,8011
100,34,2934,1033,18,0,2,0,0,3987,2238,1682,50,6,3,0,0,3979,7966
100,35,2862,1283,26,3,5,0,0,4179,2153,1930,66,10,3,1,0,4163,8342
100,36,2626,1414,35,3,4,0,0,4082,1969,2014,76,9,6,1,0,4075,8157
100,37,2506,1661,45,0,2,0,0,4214,1690,2157,95,14,1,1,0,3958,8172
100,38,2325,1781,54,3,4,0,0,4167,1722,2447,121,15,2,0,0,4307,8474
100,39,2285,1948,72,5,3,0,0,4313,1754,2608,141,15,0,0,0,4518,8831
100,40,2214,2051,67,4,2,0,0,4338,1631,2774,158,23,2,0,0,4588,8926
100,41,2110,2313,81,3,7,0,0,4514,1494,2957,169,36,1,0,0,4657,9171
100,42,2026,2436,111,9,5,1,0,4588,1469,3211,214,41,1,0,0,4936,9524
100,43,1991,2776,130,13,5,0,0,4915,1446,3373,239,38,3,0,0,5099,10014
100,44,1942,3116,161,17,9,0,0,5245,1347,3740,263,46,3,0,0,5399,10644
100,45,1861,3298,173,16,5,0,0,5353,1362,3841,302,46,3,0,0,5554,10907
100,46,1902,3338,191,11,5,0,0,5447,1272,4116,284,78,4,0,0,5754,11201
100,47,1848,3775,208,21,5,0,0,5857,1306,4317,335,78,2,0,0,6038,11895
100,48,1709,3947,253,25,3,0,0,5937,1216,4271,376,107,2,0,0,5972,11909
100,49,1535,4153,271,27,5,0,0,5991,1199,4521,380,103,4,0,0,6207,12198
100,50,1425,3999,308,26,4,0,0,5762,1122,4462,389,110,1,0,0,6084,11846
100,51,1317,3997,259,26,3,0,0,5602,958,4354,396,112,0,0,0,5820,11422
100,52,1263,4248,281,30,11,0,0,5833,1003,4479,363,163,1,0,0,6009,11842
100,53,1124,4262,280,39,3,0,0,5708,1004,4538,357,211,0,0,0,6110,11818
100,54,1077,4363,297,61,3,0,0,5801,952,4773,361,205,2,0,0,6293,12094
100,55,1009,4341,346,70,4,0,0,5770,932,4891,376,204,3,0,0,6406,12176
100,56,970,4582,340,63,3,0,0,5958,942,4903,373,221,4,0,0,6443,12401
100,57,886,4701,320,73,3,0,0,5983,962,4953,384,280,1,0,0,6580,12563
100,58,771,4646,307,79,3,0,0,5806,881,4972,367,332,3,0,0,6555,12361
100,59,697,4945,332,96,3,1,0,6074,870,4981,368,355,3,0,0,6577,12651
100,60,603,4614,270,106,5,0,0,5598,788,4634,324,366,1,0,0,6113,11711
100,61,545,4497,283,104,1,0,0,5430,773,4467,274,428,0,0,0,5942,11372
100,62,507,4421,230,117,2,0,0,5277,711,4402,270,495,1,0,0,5879,11156
100,63,441,4386,273,116,4,0,0,5220,657,4359,287,525,1,0,0,5829,11049
100,64,413,4231,223,151,5,0,0,5023,658,4157,229,542,0,0,0,5586,10609
100,65,359,3802,223,142,3,0,0,4529,606,3844,240,624,0,0,0,5314,9843
100,66,355,4050,227,145,1,0,0,4778,571,3962,222,679,0,0,0,5434,10212
100,67,291,4028,177,172,1,0,1,4670,585,3758,175,763,0,0,0,5281,9951
100,68,294,4113,165,175,2,0,0,4749,558,3804,177,808,0,0,0,5347,10096
100,69,273,3837,147,181,1,0,0,4439,542,3515,143,895,0,0,0,5095,9534
100,70,256,3843,125,203,3,0,0,4430,462,3512,195,1012,0,0,0,5181,9611
100,71,184,3500,109,193,0,0,0,3986,427,3117,152,976,1,0,0,4673,8659
100,72,211,3841,125,233,1,0,0,4411,432,3348,152,1179,0,0,0,5111,9522
100,73,177,3902,118,241,0,0,0,4438,472,3182,164,1282,0,0,0,5100,9538
100,74,161,3600,93,281,2,0,0,4137,485,3026,136,1355,1,0,0,5003,9140
100,75,174,3785,89,318,0,0,0,4366,478,3147,126,1609,0,0,0,5360,9726
100,76,158,3567,92,370,0,0,0,4187,439,2804,103,1680,0,0,0,5026,9213
100,77,143,3329,72,375,0,0,0,3919,435,2585,111,1782,0,0,0,4913,8832
100,78,99,2713,49,320,0,0,0,3181,379,1896,92,1536,0,0,0,3903,7084
100,79,88,2329,47,290,0,0,0,2754,338,1602,65,1442,0,0,0,3447,6201
100,80,98,2328,42,356,2,0,0,2826,348,1630,59,1730,0,0,0,3767,6593
100,81,86,2246,37,375,0,0,0,2744,356,1477,51,1771,0,0,0,3655,6399
100,82,89,1974,24,384,0,0,0,2471,344,1274,55,1718,0,0,0,3391,5862
100,83,83,1901,35,418,0,0,0,2437,327,1155,49,1940,0,0,0,3471,5908
100,84,64,1830,31,483,0,0,0,2408,333,1068,45,2175,0,0,0,3621,6029
100,85,43,1599,23,450,0,0,0,2115,313,851,27,2052,0,0,0,3243,5358
100,86,57,1219,12,397,0,0,0,1685,282,643,27,1775,0,0,0,2727,4412
100,87,42,1032,5,402,0,0,0,1481,201,454,23,1715,0,0,0,2393,3874
100,88,29,924,12,407,0,0,0,1372,226,429,28,1638,0,0,0,2321,3693
100,89,35,691,7,337,0,0,0,1070,203,287,12,1519,0,0,0,2021,3091
100,90,22,517,8,316,0,0,0,863,156,214,16,1382,0,0,0,1768,2631
100,91,19,397,2,278,0,0,0,696,136,159,10,1232,0,0,0,1537,2233
100,92,19,307,3,239,0,0,0,568,129,103,6,1037,0,0,0,1275,1843
100,93,13,225,2,214,0,0,0,454,93,71,16,993,0,0,0,1173,1627
100,94,8,149,3,161,0,0,0,321,89,46,8,658,0,0,0,801,1122
100,95,3,78,3,116,0,0,0,200,59,25,2,472,0,0,0,558,758
100,96,4,56,0,74,0,0,0,134,33,12,4,390,0,0,0,439,573
100,97,1,22,0,69,0,0,0,92,37,10,2,241,0,0,0,290,382
100,98,1,18,0,44,0,0,0,63,21,7,2,159,0,0,0,189,252
100,99,1,12,0,22,0,0,0,35,13,5,0,105,0,0,0,123,158
100,100,2,17,1,37,0,0,0,57,14,7,0,181,0,0,0,202,259
100,999,168786,181709,8402,10537,165,2,1,369602,155541,183063,11205,47736,80,4,0,397629,767231
101,0,982,0,0,0,0,0,0,982,984,0,0,0,0,0,0,984,1966
101,1,1107,0,0,0,0,0,0,1107,949,0,0,0,0,0,0,949,2056
101,2,1060,0,0,0,0,0,0,1060,988,0,0,0,0,0,0,988,2048
101,3,1191,0,0,0,0,0,0,1191,1032,0,0,0,0,0,0,1032,2223
101,4,1212,0,0,0,0,0,0,1212,1103,0,0,0,0,0,0,1103,2315
101,5,1209,0,0,0,0,0,0,1209,1123,0,0,0,0,0,0,1123,2332
101,6,1308,0,0,0,0,0,0,1308,1194,0,0,0,0,0,0,1194,2502
101,7,1287,0,0,0,0,0,0,1287,1200,0,0,0,0,0,0,1200,2487
101,8,1314,0,0,0,0,0,0,1314,1273,0,0,0,0,0,0,1273,2587
101,9,1322,0,0,0,0,0,0,1322,1228,0,0,0,0,0,0,1228,2550
101,10,1298,0,0,0,0,0,0,1298,1215,0,0,0,0,0,0,1215,2513
101,11,1496,0,0,0,0,0,0,1496,1321,0,0,0,0,0,0,1321,2817
101,12,1449,0,0,0,0,0,0,1449,1326,0,0,0,0,0,0,1326,2775
101,13,1479,0,0,0,0,0,0,1479,1392,0,0,0,0,0,0,1392,2871
101,14,1590,0,0,0,0,0,0,1590,1435,0,0,0,0,0,0,1435,3025
101,15,1618,0,0,0,0,0,0,1618,1474,0,0,0,0,0,0,1474,3092
101,16,1650,0,0,0,0,0,0,1650,1492,0,0,0,0,0,0,1492,3142
101,17,1648,0,0,0,0,0,0,1648,1546,0,0,0,0,0,0,1546,3194
101,18,1704,0,0,0,0,0,0,1704,1527,0,0,0,0,0,0,1527,3231
101,19,1783,0,0,0,0,0,0,1783,1634,2,0,0,1,0,0,1637,3420
101,20,1797,1,0,0,0,0,0,1798,1574,5,1,0,0,0,0,1580,3378
101,21,1846,0,0,0,0,0,0,1846,1638,7,1,0,0,0,0,1646,3492
101,22,1880,2,0,0,0,0,0,1882,1627,11,0,0,0,0,0,1638,3520
101,23,1879,9,0,0,0,0,0,1888,1670,20,0,0,0,0,0,1690,3578
101,24,1894,13,1,0,0,0,0,1908,1688,40,1,0,0,0,0,1729,3637
101,25,1936,17,1,0,0,0,0,1954,1545,95,2,0,1,0,0,1643,3597
101,26,1847,45,0,0,0,0,0,1892,1477,128,1,0,0,0,0,1606,3498
101,27,1810,64,0,0,0,0,0,1874,1397,220,1,1,0,0,0,1619,3493
101,28,1756,91,1,0,0,0,0,1848,1427,272,1,1,0,0,0,1701,3549
101,29,1725,166,1,0,0,0,0,1892,1372,354,4,2,0,0,0,1732,3624
101,30,1684,239,3,0,1,0,0,1927,1241,435,5,0,0,0,0,1681,3608
101,31,1721,293,5,0,1,0,0,2020,1284,576,8,5,1,0,0,1874,3894
101,32,1477,417,7,1,0,0,0,1902,1106,686,11,2,0,0,0,1805,3707
101,33,1479,514,3,0,1,0,0,1997,1035,809,14,0,0,0,0,1858,3855
101,34,1431,596,9,3,1,0,0,2040,907,903,22,4,0,0,0,1836,3876
101,35,1286,729,8,3,1,0,0,2027,839,958,31,3,1,0,0,1832,3859
101,36,1247,745,17,0,0,0,0,2009,764,1031,34,4,2,0,0,1835,3844
101,37,1123,845,14,2,2,0,0,1986,683,1109,25,7,1,0,0,1825,3811
101,38,1147,949,17,2,1,0,0,2116,666,1152,38,5,0,0,0,1861,3977
101,39,1019,1032,31,1,0,0,0,2083,665,1244,50,9,0,0,0,1968,4051
101,40,984,1023,24,2,0,0,0,2033,587,1296,61,17,0,0,0,1961,3994
101,41,911,1103,33,0,1,0,0,2048,595,1430,49,16,0,0,0,2090,4138
101,42,844,1138,27,6,0,0,0,2015,480,1431,63,13,0,0,0,1987,4002
101,43,814,1204,48,5,0,0,0,2071,479,1453,72,11,0,0,0,2015,4086
101,44,826,1289,39,4,0,0,0,2158,428,1515,79,27,2,0,0,2051,4209
101,45,799,1394,53,2,0,0,0,2248,422,1629,76,21,0,0,0,2148,4396
101,46,772,1428,59,11,0,0,0,2270,405,1754,93,24,0,0,0,2276,4546
101,47,795,1594,68,10,1,0,0,2468,468,1828,106,44,0,0,0,2446,4914
101,48,726,1604,79,10,0,0,0,2419,455,1971,102,38,0,0,0,2566,4985
101,49,740,1739,78,6,1,0,0,2564,437,1941,101,52,0,0,0,2531,5095
101,50,663,1767,82,15,2,0,0,2529,423,2002,121,57,1,0,0,2604,5133
101,51,644,1805,97,19,0,0,0,2565,430,2084,136,69,1,0,0,2720,5285
101,52,587,1922,85,21,0,0,0,2615,388,2126,119,72,0,0,0,2705,5320
101,53,540,1977,104,24,1,0,0,2646,376,2203,122,93,0,0,0,2794,5440
101,54,568,2213,105,24,1,0,0,2911,371,2247,120,110,0,0,0,2848,5759
101,55,547,2125,93,24,0,0,0,2789,349,2228,136,139,0,0,0,2852,5641
101,56,496,2246,107,40,0,0,0,2889,346,2385,135,158,1,0,0,3025,5914
101,57,470,2118,80,36,1,0,0,2705,335,2333,117,169,0,0,0,2954,5659
101,58,489,2246,97,40,0,0,0,2872,337,2298,131,170,0,0,0,2936,5808
101,59,429,2332,110,55,0,0,0,2926,336,2399,134,203,0,0,0,3072,5998
101,60,381,2228,118,51,0,0,0,2778,327,2276,103,208,1,0,0,2915,5693
101,61,388,2395,97,46,0,0,0,2926,295,2240,118,239,0,0,0,2892,5818
101,62,315,2240,93,61,0,0,0,2709,272,2163,104,295,0,0,0,2834,5543
101,63,278,2227,82,58,0,0,0,2645,269,2126,112,303,0,0,0,2810,5455
101,64,304,2048,74,61,0,0,0,2487,253,1964,81,330,0,0,0,2628,5115
101,65,247,2035,79,61,2,0,0,2424,257,1867,76,318,0,0,0,2518,4942
101,66,237,1886,81,63,0,0,0,2267,213,1906,66,391,0,0,0,2576,4843
101,67,203,1974,80,83,0,0,0,2340,214,1824,75,431,0,0,0,2544,4884
101,68,194,1987,72,100,1,0,0,2354,175,1706,59,392,0,0,0,2332,4686
101,69,181,1917,52,88,0,0,0,2238,195,1691,72,480,0,0,0,2438,4676
101,70,171,1794,53,99,0,0,0,2117,188,1478,58,472,0,0,0,2196,4313
101,71,132,1689,44,112,0,0,0,1977,189,1467,47,492,0,0,0,2195,4172
101,72,114,1640,48,116,0,0,0,1918,131,1397,31,571,0,0,0,2130,4048
101,73,110,1733,38,130,0,0,0,2011,150,1308,41,623,0,0,0,2122,4133
101,74,114,1726,36,123,0,0,0,1999,137,1233,48,692,0,0,0,2110,4109
101,75,107,1629,33,140,0,0,0,1909,149,1226,33,837,0,0,0,2245,4154
101,76,108,1411,21,141,0,0,0,1681,136,1088,27,808,0,0,0,2059,3740
101,77,84,1274,27,143,0,0,0,1528,114,945,22,764,0,0,0,1845,3373
101,78,53,890,19,111,0,0,0,1073,102,643,19,647,0,0,0,1411,2484
101,79,52,903,13,112,0,0,0,1080,83,550,12,649,0,0,0,1294,2374
101,80,49,842,8,151,0,0,0,1050,80,542,15,654,0,0,0,1291,2341
101,81,35,777,10,139,0,0,0,961,68,492,14,736,0,0,0,1310,2271
101,82,44,756,8,165,0,0,0,973,72,466,10,734,0,0,0,1282,2255
101,83,54,842,16,192,0,0,0,1104,68,423,16,930,0,0,0,1437,2541
101,84,31,820,9,188,0,0,0,1048,80,452,8,955,0,0,0,1495,2543
101,85,25,738,12,225,0,0,0,1000,90,332,6,967,0,0,0,1395,2395
101,86,32,578,8,217,0,0,0,835,79,288,11,946,0,0,0,1324,2159
101,87,29,510,6,210,0,0,0,755,61,202,3,896,0,0,0,1162,1917
101,88,22,447,3,161,0,0,0,633,70,183,7,797,0,0,0,1057,1690
101,89,16,334,2,183,0,0,0,535,60,152,4,820,0,0,0,1036,1571
101,90,11,268,3,172,0,0,0,454,39,98,4,703,0,0,0,844,1298
101,91,6,195,0,161,0,0,0,362,39,72,4,550,0,0,0,665,1027
101,92,11,141,0,111,0,0,0,263,35,45,5,494,0,0,0,579,842
101,93,10,85,1,99,0,0,0,195,30,26,1,452,0,0,0,509,704
101,94,4,79,0,92,0,0,0,175,29,25,2,342,0,0,0,398,573
101,95,5,39,1,66,0,0,0,111,20,14,0,233,0,0,0,267,378
101,96,1,38,0,52,0,0,0,91,11,12,1,192,0,0,0,216,307
101,97,2,14,0,27,0,0,0,43,9,4,1,136,0,0,0,150,193
101,98,0,6,0,25,0,0,0,31,10,5,1,89,0,0,0,105,136
101,99,1,2,0,13,0,0,0,16,4,6,0,62,0,0,0,72,88
101,100,2,7,0,32,0,0,0,41,7,5,0,99,0,0,0,111,152
101,999,77498,84178,2833,4946,19,0,0,169474,63298,83552,3640,23275,13,0,0,173778,343252
102,0,595,0,0,0,0,0,0,595,537,0,0,0,0,0,0,537,1132
102,1,616,0,0,0,0,0,0,616,535,0,0,0,0,0,0,535,1151
102,2,677,0,0,0,0,0,0,677,617,0,0,0,0,0,0,617,1294
102,3,660,0,0,0,0,0,0,660,645,0,0,0,0,0,0,645,1305
102,4,712,0,0,0,0,0,0,712,643,0,0,0,0,0,0,643,1355
102,5,675,0,0,0,0,0,0,675,718,0,0,0,0,0,0,718,1393
102,6,759,0,0,0,0,0,0,759,679,0,0,0,0,0,0,679,1438
102,7,776,0,0,0,0,0,0,776,756,0,0,0,0,0,0,756,1532
102,8,766,0,0,0,0,0,0,766,712,0,0,0,0,0,0,712,1478
102,9,753,0,0,0,0,0,0,753,788,0,0,0,0,0,0,788,1541
102,10,803,0,0,0,0,0,0,803,741,0,0,0,0,0,0,741,1544
102,11,836,0,0,0,0,0,0,836,790,0,0,0,0,0,0,790,1626
102,12,828,0,0,0,0,0,0,828,810,0,0,0,0,0,0,810,1638
102,13,863,0,0,0,0,0,0,863,844,0,0,0,0,0,0,844,1707
102,14,898,0,0,0,0,0,0,898,844,0,0,0,0,0,0,844,1742
102,15,936,0,0,0,0,0,0,936,871,0,0,0,0,0,0,871,1807
102,16,930,0,0,0,0,0,0,930,842,1,0,0,0,0,0,843,1773
102,17,1027,0,0,0,0,0,0,1027,853,0,0,0,0,0,0,853,1880
102,18,1011,1,0,0,0,0,0,1012,875,1,0,0,0,0,0,876,1888
102,19,1060,1,0,0,0,0,0,1061,1015,1,0,0,0,0,0,1016,2077
102,20,1126,0,0,0,0,0,0,1126,944,9,0,0,0,0,0,953,2079
102,21,1053,1,0,0,0,0,0,1054,968,10,0,0,0,0,0,978,2032
102,22,1072,1,0,0,0,0,0,1073,903,25,0,0,0,0,0,928,2001
102,23,1173,12,0,0,0,0,0,1185,927,31,0,0,0,0,0,958,2143
102,24,1133,14,0,0,0,0,0,1147,929,29,0,0,0,0,0,958,2105
102,25,1135,14,1,0,0,0,0,1150,838,60,1,0,2,0,0,901,2051
102,26,1081,26,0,0,1,0,0,1108,910,75,1,0,0,0,0,986,2094
102,27,1075,39,1,0,0,0,0,1115,824,115,1,0,0,0,0,940,2055
102,28,1013,59,2,0,0,0,0,1074,760,159,0,0,0,0,0,919,1993
102,29,955,84,1,0,0,0,0,1040,739,212,4,1,0,0,0,956,1996
102,30,944,111,3,0,0,0,0,1058,738,218,9,0,2,0,0,967,2025
102,31,1022,166,0,0,0,0,0,1188,682,285,5,0,0,0,0,972,2160
102,32,919,226,3,1,0,0,0,1149,642,366,10,1,2,0,0,1021,2170
102,33,922,287,9,0,1,0,0,1219,575,491,15,0,2,0,0,1083,2302
102,34,848,314,6,1,1,0,0,1170,533,461,13,4,0,0,0,1011,2181
102,35,771,362,9,1,0,0,0,1143,471,562,27,0,0,0,0,1060,2203
102,36,717,433,15,2,0,0,0,1167,434,540,21,4,1,0,0,1000,2167
102,37,677,417,12,1,1,0,0,1108,395,574,25,1,2,0,0,997,2105
102,38,583,497,15,2,1,0,0,1098,371,697,33,6,1,0,0,1108,2206
102,39,601,538,13,1,2,0,0,1155,345,723,29,9,1,0,0,1107,2262
102,40,575,591,18,2,0,0,0,1186,329,765,47,3,0,0,0,1144,2330
102,41,508,632,30,2,0,0,0,1172,334,769,46,8,0,0,0,1157,2329
102,42,522,682,34,4,1,0,0,1243,302,799,57,16,1,0,0,1175,2418
102,43,466,707,30,2,1,0,0,1206,297,818,39,11,0,0,0,1165,2371
102,44,468,763,35,4,0,0,0,1270,252,874,62,15,1,0,0,1204,2474
102,45,505,837,44,2,0,0,0,1388,264,959,61,18,0,0,0,1302,2690
102,46,431,802,46,2,0,0,0,1281,274,1008,101,17,0,0,0,1400,2681
102,47,468,954,54,1,0,0,0,1477,255,992,105,27,0,0,0,1379,2856
102,48,405,939,73,6,0,0,0,1423,245,1048,99,35,0,0,0,1427,2850
102,49,409,984,70,13,2,0,0,1478,221,1125,91,28,0,0,0,1465,2943
102,50,370,1019,82,5,1,0,0,1477,247,1001,118,28,1,0,0,1395,2872
102,51,319,1010,90,8,3,0,0,1430,220,1096,100,32,1,0,0,1449,2879
102,52,380,945,88,6,0,0,0,1419,214,1111,98,57,1,0,0,1481,2900
102,53,304,1064,61,11,0,0,0,1440,202,1148,93,49,0,0,0,1492,2932
102,54,288,1028,69,12,0,0,0,1397,193,1118,82,62,0,0,0,1455,2852
102,55,258,1089,63,11,1,0,0,1422,195,1151,82,69,1,0,0,1498,2920
102,56,268,1077,79,17,2,0,0,1443,191,1156,89,66,2,0,0,1504,2947
102,57,215,1107,71,23,0,0,0,1416,196,1199,84,68,0,0,0,1547,2963
102,58,215,1120,75,19,0,0,0,1429,176,1234,59,74,0,0,0,1543,2972
102,59,189,1239,74,23,0,0,0,1525,181,1213,80,101,0,0,0,1575,3100
102,60,183,1131,78,33,0,0,0,1425,172,1094,58,117,0,0,0,1441,2866
102,61,151,1098,75,23,1,0,0,1348,138,1153,65,104,0,0,0,1460,2808
102,62,161,1047,78,21,0,0,0,1307,132,1183,64,130,0,0,0,1509,2816
102,63,121,1101,49,28,0,0,0,1299,137,1090,58,157,0,0,0,1442,2741
102,64,132,1089,55,33,0,0,0,1309,141,1075,43,149,0,0,0,1408,2717
102,65,109,1097,42,24,1,0,0,1273,120,1030,44,174,0,0,0,1368,2641
102,66,108,1010,42,25,0,0,0,1185,134,995,47,195,0,0,0,1371,2556
102,67,106,1082,47,38,0,0,0,1273,114,975,39,223,0,0,0,1351,2624
102,68,96,1024,28,38,0,0,0,1186,100,955,32,212,0,0,0,1299,2485
102,69,63,1021,39,44,0,0,0,1167,100,921,32,235,1,0,0,1289,2456
102,70,67,914,36,54,0,0,0,1071,87,781,15,248,0,0,0,1131,2202
102,71,60,906,30,52,0,0,0,1048,88,764,32,282,0,0,0,1166,2214
102,72,55,879,25,54,0,0,0,1013,75,766,38,291,0,0,0,1170,2183
102,73,71,892,34,58,0,0,0,1055,79,793,22,326,0,0,0,1220,2275
102,74,49,912,19,78,0,0,0,1058,62,764,23,357,0,0,0,1206,2264
102,75,46,975,18,73,0,0,0,1112,82,739,16,390,0,0,0,1227,2339
102,76,44,832,20,90,0,0,0,986,72,599,12,407,0,0,0,1090,2076
102,77,33,722,10,72,0,0,0,837,53,476,13,393,0,0,0,935,1772
102,78,18,575,11,49,0,0,0,653,56,392,7,356,0,0,0,811,1464
102,79,28,567,11,57,0,0,0,663,52,350,6,390,0,0,0,798,1461
102,80,19,525,5,71,0,0,0,620,46,273,12,421,0,0,0,752,1372
102,81,24,462,4,67,0,0,0,557,52,267,8,408,0,0,0,735,1292
102,82,15,432,6,63,0,0,0,516,40,226,6,393,0,0,0,665,1181
102,83,22,480,7,90,0,0,0,599,52,226,2,510,0,0,0,790,1389
102,84,17,437,3,110,0,0,0,567,40,222,3,518,0,0,0,783,1350
102,85,17,359,4,74,0,0,0,454,39,173,5,493,0,0,0,710,1164
102,86,16,328,3,88,0,0,0,435,40,136,7,507,0,0,0,690,1125
102,87,15,260,5,78,0,0,0,358,33,122,3,470,0,0,0,628,986
102,88,11,195,4,87,0,0,0,297,29,81,0,426,0,0,0,536,833
102,89,8,178,3,83,0,0,0,272,27,58,2,353,0,0,0,440,712
102,90,5,135,1,82,0,0,0,223,22,40,5,351,0,0,0,418,641
102,91,4,116,0,76,0,0,0,196,24,27,2,261,0,0,0,314,510
102,92,4,75,0,73,0,0,0,152,10,17,0,230,0,0,0,257,409
102,93,5,58,3,52,0,0,0,118,18,17,1,201,0,0,0,237,355
102,94,1,35,0,29,0,0,0,65,14,7,0,138,0,0,0,159,224
102,95,1,21,1,27,0,0,0,50,8,5,1,117,0,0,0,131,181
102,96,1,19,1,22,0,0,0,43,8,4,0,78,0,0,0,90,133
102,97,0,11,1,17,0,0,0,29,2,1,0,68,0,0,0,71,100
102,98,0,5,0,9,0,0,0,14,2,3,0,40,0,0,0,45,59
102,99,1,6,0,9,0,0,0,16,0,0,0,16,0,0,0,16,32
102,100,2,2,0,9,0,0,0,13,4,3,1,42,0,0,0,50,63
102,999,44453,45205,2074,2342,20,0,0,94094,36335,45032,2511,11987,22,0,0,95887,189981
103,0,2324,0,0,0,0,0,0,2324,2242,0,0,0,0,0,0,2242,4566
103,1,2395,0,0,0,0,0,0,2395,2235,0,0,0,0,0,0,2235,4630
103,2,2392,0,0,0,0,0,0,2392,2246,0,0,0,0,0,0,2246,4638
103,3,2439,0,0,0,0,0,0,2439,2453,0,0,0,0,0,0,2453,4892
103,4,2610,0,0,0,0,0,0,2610,2489,0,0,0,0,0,0,2489,5099
103,5,2777,0,0,0,0,0,0,2777,2555,0,0,0,0,0,0,2555,5332
103,6,2753,0,0,0,0,0,0,2753,2757,0,0,0,0,0,0,2757,5510
103,7,2933,0,0,0,0,0,0,2933,2760,0,0,0,0,0,0,2760,5693
103,8,2844,0,0,0,0,0,0,2844,2821,0,0,0,0,0,0,2821,5665
103,9,2920,0,0,0,0,0,0,2920,2774,0,0,0,0,0,0,2774,5694
103,10,2870,0,0,0,0,0,0,2870,2877,0,0,0,0,0,0,2877,5747
103,11,3016,0,0,0,0,0,0,3016,2810,0,0,0,0,0,0,2810,5826
103,12,3105,0,0,0,0,0,0,3105,2893,0,0,0,0,0,0,2893,5998
103,13,3019,0,0,0,0,0,0,3019,2907,0,0,0,0,0,0,2907,5926
103,14,3251,0,0,0,0,0,0,3251,3053,0,0,0,0,0,0,3053,6304
103,15,3081,0,0,0,0,0,0,3081,3044,0,0,0,0,0,0,3044,6125
103,16,3195,0,1,0,0,0,0,3196,3001,0,0,0,0,0,0,3001,6197
103,17,3448,1,0,0,0,0,0,3449,3083,0,0,0,0,0,0,3083,6532
103,18,3395,0,0,0,0,0,0,3395,3041,0,0,0,0,0,0,3041,6436
103,19,3507,1,0,0,0,0,0,3508,3152,4,0,0,0,0,0,3156,6664
103,20,3379,0,0,0,0,0,0,3379,3204,10,0,0,0,0,0,3214,6593
103,21,3484,9,0,0,0,0,0,3493,3132,30,0,0,0,0,0,3162,6655
103,22,3393,13,1,0,0,0,0,3407,3176,37,0,0,0,0,0,3213,6620
103,23,3542,18,1,0,0,0,0,3561,3161,83,3,0,1,0,0,3248,6809
103,24,3529,31,0,0,0,0,0,3560,3109,134,3,1,0,0,0,3247,6807
103,25,3573,61,2,0,1,0,0,3637,3051,186,1,0,0,0,0,3238,6875
103,26,3454,95,3,1,0,0,0,3553,2947,284,3,0,1,0,0,3235,6788
103,27,3587,152,1,0,0,0,0,3740,2825,416,7,1,0,0,0,3249,6989
103,28,3365,227,2,1,2,0,0,3597,2704,555,4,1,3,0,0,3267,6864
103,29,3398,381,3,1,1,0,0,3784,2703,726,12,1,3,0,0,3445,7229
103,30,3368,521,3,2,0,0,0,3894,2502,983,12,2,1,0,0,3500,7394
103,31,3191,636,10,1,1,0,0,3839,2369,1255,16,2,3,0,0,3645,7484
103,32,3114,802,6,1,1,0,0,3924,2207,1442,25,8,1,0,0,3683,7607
103,33,2901,985,13,3,1,0,0,3903,2151,1580,40,8,2,0,0,3781,7684
103,34,2792,1215,20,0,1,0,0,4028,1994,1919,44,10,1,1,0,3969,7997
103,35,2603,1430,18,3,2,0,0,4056,1803,2057,61,9,3,0,0,3933,7989
103,36,2473,1524,30,2,4,0,0,4033,1659,2221,78,5,2,0,0,3965,7998
103,37,2280,1638,33,0,3,0,0,3954,1518,2375,74,21,2,0,0,3990,7944
103,38,2211,1869,42,2,1,0,0,4125,1489,2447,89,20,0,0,0,4045,8170
103,39,2119,2149,47,4,1,0,0,4320,1347,2601,99,25,2,0,0,4074,8394
103,40,1978,2232,53,1,1,0,0,4265,1207,2769,107,15,1,0,0,4099,8364
103,41,1862,2350,66,0,1,0,0,4279,1179,2920,126,34,0,0,0,4259,8538
103,42,1763,2473,67,6,5,0,0,4314,1126,3034,131,24,0,0,0,4315,8629
103,43,1632,2661,102,13,1,0,0,4409,1070,3088,156,40,0,0,0,4354,8763
103,44,1602,2782,88,13,1,0,0,4486,1048,3215,169,43,0,0,0,4475,8961
103,45,1529,2888,111,13,0,0,0,4541,941,3358,212,55,2,0,0,4568,9109
103,46,1547,3010,115,7,0,0,0,4679,935,3510,199,74,2,0,0,4720,9399
103,47,1521,3187,134,20,1,0,0,4863,903,3713,206,89,1,0,0,4912,9775
103,48,1419,3388,134,17,1,0,0,4959,886,3691,236,94,0,0,0,4907,9866
103,49,1280,3376,143,24,0,1,0,4824,851,3906,223,83,0,0,1,5064,9888
103,50,1240,3400,178,27,0,0,0,4845,830,3919,257,135,0,0,0,5141,9986
103,51,1215,3600,191,36,1,0,0,5043,789,3991,257,159,0,0,0,5196,10239
103,52,1147,3542,170,32,0,0,0,4891,701,4038,290,175,1,0,0,5205,10096
103,53,1027,3656,177,39,0,0,0,4899,743,3959,272,223,0,0,0,5197,10096
103,54,1030,3807,242,51,1,0,0,5131,733,4376,275,225,0,0,0,5609,10740
103,55,1041,3783,187,42,1,0,0,5054,731,4169,266,247,0,0,0,5413,10467
103,56,913,3996,197,68,2,0,0,5176,633,4296,275,292,1,0,0,5497,10673
103,57,825,4037,199,73,0,0,0,5134,663,4206,247,299,0,0,0,5415,10549
103,58,776,4039,186,76,0,0,0,5077,654,4281,254,345,1,0,0,5535,10612
103,59,737,4224,221,112,3,0,0,5297,617,4436,250,407,0,0,0,5710,11007
103,60,699,4052,187,92,0,1,0,5031,561,4075,238,473,1,0,0,5348,10379
103,61,622,4061,164,99,0,0,0,4946,542,4159,206,471,0,0,0,5378,10324
103,62,580,4072,188,117,0,0,0,4957,510,4039,175,543,0,0,0,5267,10224
103,63,547,4044,189,130,0,0,0,4910,486,3934,220,605,0,0,0,5245,10155
103,64,504,4025,168,122,0,0,0,4819,456,3769,180,663,0,0,0,5068,9887
103,65,470,3646,150,119,0,0,0,4385,412,3460,189,691,1,0,0,4753,9138
103,66,386,3881,145,132,0,0,0,4544,419,3414,159,763,0,0,0,4755,9299
103,67,386,3663,124,150,0,0,0,4323,378,3376,173,792,0,0,0,4719,9042
103,68,331,3627,126,123,0,0,0,4207,363,3293,140,912,0,0,0,4708,8915
103,69,296,3709,126,187,1,0,0,4319,351,3098,125,919,0,0,0,4493,8812
103,70,244,3363,116,181,1,0,0,3905,310,2857,131,993,0,0,0,4291,8196
103,71,236,3177,86,180,0,0,0,3679,271,2707,124,1026,0,0,0,4128,7807
103,72,215,3192,77,202,0,0,0,3686,281,2595,122,1141,0,0,0,4139,7825
103,73,209,3209,81,228,1,0,0,3728,279,2493,104,1200,0,0,0,4076,7804
103,74,184,3219,106,266,0,0,0,3775,259,2398,101,1344,0,0,0,4102,7877
103,75,163,3120,75,231,0,0,0,3589,258,2338,92,1445,0,0,0,4133,7722
103,76,151,2940,58,289,0,0,0,3438,241,2017,86,1580,0,0,0,3924,7362
103,77,156,2544,49,293,0,0,0,3042,215,1765,66,1471,0,0,0,3517,6559
103,78,97,1851,27,234,0,0,0,2209,136,1190,35,1189,0,0,0,2550,4759
103,79,106,1891,46,250,0,0,0,2293,163,1140,31,1308,0,0,0,2642,4935
103,80,82,1715,34,233,0,0,0,2064,164,1008,39,1303,0,0,0,2514,4578
103,81,76,1601,23,267,0,0,0,1967,143,904,30,1351,0,0,0,2428,4395
103,82,65,1504,24,290,0,0,0,1883,124,781,42,1342,0,0,0,2289,4172
103,83,73,1520,21,350,0,0,0,1964,126,805,36,1633,0,0,0,2600,4564
103,84,60,1464,18,365,0,0,0,1907,137,706,32,1645,0,0,0,2520,4427
103,85,50,1184,9,365,0,0,0,1608,120,568,27,1610,0,0,0,2325,3933
103,86,41,1068,14,338,0,0,0,1461,127,455,14,1457,0,0,0,2053,3514
103,87,35,902,8,318,0,0,0,1263,118,379,15,1376,0,0,0,1888,3151
103,88,42,723,6,310,0,0,0,1081,104,265,10,1364,0,0,0,1743,2824
103,89,34,618,4,278,0,0,0,934,94,206,14,1176,0,0,0,1490,2424
103,90,28,419,5,287,0,0,0,739,89,154,7,1060,0,0,0,1310,2049
103,91,13,349,4,237,0,0,0,603,74,131,8,969,0,0,0,1182,1785
103,92,13,223,3,190,0,0,0,429,69,85,11,750,0,0,0,915,1344
103,93,5,196,1,168,0,0,0,370,52,84,7,661,0,0,0,804,1174
103,94,8,128,2,133,0,0,0,271,35,39,8,504,0,0,0,586,857
103,95,5,71,0,101,0,0,0,177,26,28,1,364,0,0,0,419,596
103,96,3,56,1,80,0,0,0,140,29,16,0,264,0,0,0,309,449
103,97,0,26,0,55,0,0,0,81,21,10,0,195,0,0,0,226,307
103,98,1,27,0,36,0,0,0,64,16,13,4,139,0,0,0,172,236
103,99,2,17,0,19,0,0,0,38,13,12,0,96,0,0,0,121,159
103,100,6,41,0,32,0,0,0,79,17,22,0,170,0,0,0,209,288
103,999,153338,161327,5662,8768,41,2,0,329138,130073,161008,7981,42130,36,1,1,341230,670368
104,0,1186,0,0,0,0,0,0,1186,1128,0,0,0,0,0,0,1128,2314
104,1,1242,0,0,0,0,0,0,1242,1158,0,0,0,0,0,0,1158,2400
104,2,1256,0,0,0,0,0,0,1256,1211,0,0,0,0,0,0,1211,2467
104,3,1287,0,0,0,0,0,0,1287,1215,0,0,0,0,0,0,1215,2502
104,4,1359,0,0,0,0,0,0,1359,1256,0,0,0,0,0,0,1256,2615
104,5,1360,0,0,0,0,0,0,1360,1308,0,0,0,0,0,0,1308,2668
104,6,1475,0,0,0,0,0,0,1475,1379,0,0,0,0,0,0,1379,2854
104,7,1532,0,0,0,0,0,0,1532,1461,0,0,0,0,0,0,1461,2993
104,8,1512,0,0,0,0,0,0,1512,1435,0,0,0,0,0,0,1435,2947
104,9,1553,0,0,0,0,0,0,1553,1433,0,0,0,0,0,0,1433,2986
104,10,1479,0,0,0,0,0,0,1479,1446,0,0,0,0,0,0,1446,2925
104,11,1643,0,0,0,0,0,0,1643,1516,0,0,0,0,0,0,1516,3159
104,12,1582,0,0,0,0,0,0,1582,1445,0,0,0,0,0,0,1445,3027
104,13,1552,0,0,0,0,0,0,1552,1543,0,0,0,0,0,0,1543,3095
104,14,1568,0,0,0,0,0,0,1568,1504,0,0,0,0,0,0,1504,3072
104,15,1576,0,0,0,0,0,0,1576,1619,0,0,0,0,0,0,1619,3195
104,16,1697,0,0,0,0,0,0,1697,1555,0,0,0,0,0,0,1555,3252
104,17,1800,0,0,0,0,0,0,1800,1552,0,0,0,0,0,0,1552,3352
104,18,1648,0,0,0,0,0,0,1648,1537,0,0,0,0,0,0,1537,3185
104,19,1830,0,0,0,0,0,0,1830,1625,7,0,0,0,0,0,1632,3462
104,20,1754,0,0,0,0,0,0,1754,1614,7,0,0,0,0,0,1621,3375
104,21,1779,4,0,0,0,0,0,1783,1555,16,0,0,0,0,0,1571,3354
104,22,1773,9,0,0,0,0,0,1782,1694,32,0,0,0,0,0,1726,3508
104,23,1820,11,1,0,0,0,0,1832,1667,39,0,0,0,0,0,1706,3538
104,24,1731,14,0,0,0,0,0,1745,1664,67,0,0,0,0,0,1731,3476
104,25,1830,40,1,0,0,0,0,1871,1588,123,2,0,0,0,0,1713,3584
104,26,1727,61,1,0,0,0,0,1789,1496,167,1,1,0,0,0,1665,3454
104,27,1729,87,1,0,0,0,0,1817,1400,240,2,0,0,0,0,1642,3459
104,28,1706,119,1,0,0,0,0,1826,1410,341,5,0,1,0,0,1757,3583
104,29,1616,183,6,0,1,0,0,1806,1277,424,9,0,0,0,0,1710,3516
104,30,1581,279,1,0,1,0,0,1862,1240,556,9,1,1,0,0,1807,3669
104,31,1593,375,1,0,1,0,0,1970,1240,701,9,0,0,0,0,1950,3920
104,32,1538,467,8,0,0,0,0,2013,1158,767,13,1,0,0,0,1939,3952
104,33,1504,554,8,3,0,0,0,2069,1031,851,24,1,1,0,0,1908,3977
104,34,1402,655,11,0,1,0,0,2069,882,1014,15,1,1,0,0,1913,3982
104,35,1321,796,14,1,0,0,0,2132,857,1114,36,3,0,0,0,2010,4142
104,36,1142,824,21,1,2,0,0,1990,756,1170,31,8,0,0,0,1965,3955
104,37,1140,934,19,0,0,0,0,2093,700,1210,44,6,2,0,0,1962,4055
104,38,1071,1001,26,1,0,0,0,2099,686,1266,56,5,0,0,0,2013,4112
104,39,1029,1092,35,4,0,0,0,2160,673,1290,77,10,1,0,0,2051,4211
104,40,935,1148,27,4,1,0,0,2115,567,1504,76,6,0,0,0,2153,4268
104,41,840,1202,49,2,1,0,0,2094,579,1523,66,18,0,0,0,2186,4280
104,42,828,1265,39,7,2,0,0,2141,543,1479,67,17,0,0,0,2106,4247
104,43,817,1281,53,4,1,0,0,2156,459,1613,83,23,1,0,0,2179,4335
104,44,818,1301,50,8,1,0,0,2178,504,1613,102,30,0,0,0,2249,4427
104,45,772,1506,68,5,0,0,0,2351,471,1666,91,25,0,0,0,2253,4604
104,46,708,1539,76,4,0,0,0,2327,490,1764,95,39,0,0,0,2388,4715
104,47,691,1599,69,5,1,0,0,2365,478,1852,113,43,1,0,0,2487,4852
104,48,677,1596,76,13,1,0,0,2363,439,1818,116,47,0,0,0,2420,4783
104,49,713,1656,78,12,0,0,0,2459,413,1863,123,62,1,0,0,2462,4921
104,50,639,1607,92,13,4,0,0,2355,378,1873,136,65,0,0,0,2452,4807
104,51,585,1643,109,17,2,0,0,2356,369,1931,142,78,0,0,0,2520,4876
104,52,558,1724,100,18,0,0,0,2400,380,2092,160,79,1,0,0,2712,5112
104,53,524,1876,111,16,0,0,0,2527,385,2062,140,96,0,0,0,2683,5210
104,54,527,1912,99,22,1,0,0,2561,386,2107,147,88,0,0,0,2728,5289
104,55,455,1945,103,16,0,0,0,2519,360,2049,160,123,0,0,0,2692,5211
104,56,441,1947,131,30,1,0,0,2550,340,2157,145,149,1,1,0,2793,5343
104,57,459,1937,117,27,1,0,0,2541,352,2214,141,160,1,0,0,2868,5409
104,58,384,2000,130,32,1,0,0,2547,307,2136,117,163,2,0,0,2725,5272
104,59,442,2111,117,52,1,0,0,2723,349,2272,136,230,0,0,0,2987,5710
104,60,329,2081,100,35,0,0,0,2545,280,2214,114,230,0,0,0,2838,5383
104,61,335,2027,102,45,0,0,0,2509,291,2157,128,224,0,0,0,2800,5309
104,62,286,2005,107,53,1,0,0,2452,265,2030,111,255,0,0,0,2661,5113
104,63,319,2126,100,49,0,0,0,2594,235,1981,100,335,1,0,0,2652,5246
104,64,263,1947,93,70,1,0,0,2374,258,1936,100,342,0,0,0,2636,5010
104,65,238,1873,87,62,1,0,0,2261,224,1772,98,342,0,0,0,2436,4697
104,66,205,1966,86,77,0,0,0,2334,196,1811,94,356,0,0,0,2457,4791
104,67,202,1918,65,77,0,0,0,2262,188,1691,90,395,0,0,0,2364,4626
104,68,189,1925,81,63,0,0,0,2258,153,1621,81,445,0,0,0,2300,4558
104,69,166,1876,73,81,0,0,0,2196,177,1615,82,467,0,0,0,2341,4537
104,70,149,1842,64,100,0,0,0,2155,167,1427,75,484,0,0,0,2153,4308
104,71,126,1667,62,97,0,0,0,1952,141,1280,55,507,0,0,0,1983,3935
104,72,109,1630,52,123,0,0,0,1914,160,1324,59,594,0,0,0,2137,4051
104,73,121,1602,39,108,0,0,0,1870,179,1300,65,623,0,0,0,2167,4037
104,74,83,1611,47,110,0,0,0,1851,134,1145,57,684,0,0,0,2020,3871
104,75,117,1529,39,124,1,0,0,1810,136,1163,43,754,0,0,0,2096,3906
104,76,94,1494,39,138,0,0,0,1765,126,989,34,765,0,0,0,1914,3679
104,77,78,1291,27,151,0,0,0,1547,144,929,32,806,0,0,0,1911,3458
104,78,42,958,24,107,0,0,0,1131,86,616,30,608,0,0,0,1340,2471
104,79,59,984,15,119,0,0,0,1177,93,566,24,644,0,0,0,1327,2504
104,80,46,900,23,127,0,0,0,1096,87,518,19,711,0,0,0,1335,2431
104,81,34,859,21,131,0,0,0,1045,72,462,25,780,0,0,0,1339,2384
104,82,40,700,11,110,0,0,0,861,93,426,17,690,0,0,0,1226,2087
104,83,40,780,7,165,0,0,0,992,88,407,22,809,0,0,0,1326,2318
104,84,29,677,11,170,0,0,0,887,78,327,16,771,0,0,0,1192,2079
104,85,27,563,11,138,0,0,0,739,59,299,6,746,0,0,0,1110,1849
104,86,23,543,7,160,0,0,0,733,74,219,9,758,0,0,0,1060,1793
104,87,16,410,7,166,0,0,0,599,53,217,11,718,0,0,0,999,1598
104,88,26,338,4,147,0,0,0,515,56,155,10,698,0,0,0,919,1434
104,89,13,316,2,150,0,0,0,481,58,126,9,598,0,0,0,791,1272
104,90,14,273,2,153,0,0,0,442,42,95,6,558,0,0,0,701,1143
104,91,7,178,0,126,0,0,0,311,35,83,2,502,0,0,0,622,933
104,92,11,146,2,104,0,0,0,263,25,40,4,441,0,0,0,510,773
104,93,5,87,1,86,0,0,0,179,33,36,6,354,0,0,0,429,608
104,94,3,55,1,54,0,0,0,113,24,24,0,300,0,0,0,348,461
104,95,0,41,1,38,0,0,0,80,17,24,2,186,0,0,0,229,309
104,96,4,28,1,37,0,0,0,70,17,14,2,138,0,0,0,171,241
104,97,0,16,0,24,0,0,0,40,8,8,1,94,0,0,0,111,151
104,98,0,11,0,25,0,0,0,36,7,6,0,76,0,0,0,89,125
104,99,0,8,0,17,0,0,0,25,9,10,0,50,0,0,0,69,94
104,100,0,16,0,19,0,0,0,35,9,5,1,73,0,0,0,88,123
104,999,77584,81597,3263,4253,29,0,0,166726,66040,82058,4329,21489,16,1,0,173933,340659
105,0,2072,0,0,0,0,0,0,2072,1972,0,0,0,0,0,0,1972,4044
105,1,1982,0,0,0,0,0,0,1982,1937,0,0,0,0,0,0,1937,3919
105,2,1932,0,0,0,0,0,0,1932,1903,0,0,0,0,0,0,1903,3835
105,3,2095,0,0,0,0,0,0,2095,2007,0,0,0,0,0,0,2007,4102
105,4,2168,0,0,0,0,0,0,2168,2095,0,0,0,0,0,0,2095,4263
105,5,2268,0,0,0,0,0,0,2268,2151,0,0,0,0,0,0,2151,4419
105,6,2358,0,0,0,0,0,0,2358,2174,0,0,0,0,0,0,2174,4532
105,7,2292,0,0,0,0,0,0,2292,2164,0,0,0,0,0,0,2164,4456
105,8,2463,0,0,0,0,0,0,2463,2261,0,0,0,0,0,0,2261,4724
105,9,2463,0,0,0,0,0,0,2463,2262,0,0,0,0,0,0,2262,4725
105,10,2482,0,0,0,0,0,0,2482,2324,0,0,0,0,0,0,2324,4806
105,11,2481,0,0,0,0,0,0,2481,2326,0,0,0,0,0,0,2326,4807
105,12,2518,0,0,0,0,0,0,2518,2444,0,0,0,0,0,0,2444,4962
105,13,2728,0,0,0,0,0,0,2728,2491,0,0,0,0,0,0,2491,5219
105,14,2732,0,0,0,0,0,0,2732,2472,0,0,0,0,0,0,2472,5204
105,15,2659,0,0,0,0,0,0,2659,2591,0,0,0,0,0,0,2591,5250
105,16,2784,0,0,0,0,0,0,2784,2604,0,0,0,0,0,0,2604,5388
105,17,2832,0,0,0,0,0,0,2832,2639,0,0,0,0,0,0,2639,5471
105,18,2783,0,0,0,0,0,0,2783,2649,3,0,0,0,0,0,2652,5435
105,19,2893,0,0,0,0,0,0,2893,2596,8,0,0,0,0,0,2604,5497
105,20,2803,5,0,0,0,0,0,2808,2563,28,0,0,0,0,0,2591,5399
105,21,2734,8,1,0,0,0,0,2743,2521,48,0,0,0,0,0,2569,5312
105,22,2775,18,0,0,0,0,0,2793,2560,93,0,0,0,0,0,2653,5446
105,23,2843,29,0,0,0,0,0,2872,2587,135,1,0,0,0,0,2723,5595
105,24,2858,34,2,1,1,0,0,2896,2465,217,1,0,0,0,0,2683,5579
105,25,2712,104,0,0,0,0,0,2816,2373,328,0,2,0,0,0,2703,5519
105,26,2574,145,2,0,0,0,0,2721,2159,429,1,1,0,0,0,2590,5311
105,27,2526,203,1,1,0,0,0,2731,1985,626,6,0,0,0,0,2617,5348
105,28,2325,352,5,0,2,0,0,2684,1904,806,4,0,0,0,0,2714,5398
105,29,2283,499,2,0,1,0,0,2785,1696,896,11,1,0,0,0,2604,5389
105,30,2300,589,2,0,5,0,0,2896,1647,1134,16,2,0,0,0,2799,5695
105,31,2061,767,5,0,0,0,0,2833,1520,1364,18,2,1,0,0,2905,5738
105,32,1950,922,9,5,0,0,0,2886,1421,1451,24,5,0,0,0,2901,5787
105,33,1873,1133,11,3,0,0,0,3020,1298,1562,33,5,2,0,0,2900,5920
105,34,1873,1249,16,0,1,0,0,3139,1196,1788,36,4,3,0,0,3027,6166
105,35,1630,1446,19,4,1,0,0,3100,1105,1965,43,10,1,0,0,3124,6224
105,36,1530,1499,21,2,0,0,0,3052,1074,2096,41,9,0,0,0,3220,6272
105,37,1445,1649,27,6,1,0,0,3128,946,2043,73,18,0,0,0,3080,6208
105,38,1384,1706,29,1,0,0,0,3120,881,2164,58,17,0,0,0,3120,6240
105,39,1308,1842,41,8,0,0,0,3199,810,2223,74,17,0,0,0,3124,6323
105,40,1184,1875,44,9,1,0,0,3113,789,2301,90,19,0,0,0,3199,6312
105,41,1223,1972,49,6,3,0,0,3253,743,2414,106,21,0,0,0,3284,6537
105,42,1160,2057,58,5,0,0,0,3280,705,2394,121,27,1,0,0,3248,6528
105,43,1130,2190,63,12,2,0,0,3397,758,2485,108,31,1,0,0,3383,6780
105,44,1135,2214,65,9,0,1,0,3424,689,2685,126,31,1,0,0,3532,6956
105,45,1058,2285,68,12,0,0,0,3423,665,2573,125,59,0,0,0,3422,6845
105,46,984,2329,76,14,1,0,0,3404,703,2784,155,53,0,0,0,3695,7099
105,47,1028,2556,95,15,1,0,0,3695,698,2920,174,66,1,0,0,3859,7554
105,48,966,2472,99,22,1,0,0,3560,639,2989,188,86,1,0,0,3903,7463
105,49,992,2610,91,18,0,0,0,3711,644,2991,144,77,0,0,0,3856,7567
105,50,978,2620,109,21,0,0,0,3728,583,2943,171,118,0,0,0,3815,7543
105,51,838,2512,115,25,0,0,0,3490,625,2984,180,127,0,0,0,3916,7406
105,52,815,2698,122,25,0,0,0,3660,582,3030,195,136,0,0,0,3943,7603
105,53,740,2615,122,28,0,0,0,3505,545,2963,181,156,0,0,0,3845,7350
105,54,757,2789,131,29,0,0,0,3706,552,3202,184,168,1,0,0,4107,7813
105,55,714,2874,137,27,0,0,0,3752,585,3129,192,171,0,0,0,4077,7829
105,56,694,2877,144,45,2,0,0,3762,549,3112,176,232,0,0,0,4069,7831
105,57,640,2911,136,55,0,0,0,3742,484,3231,170,255,0,0,0,4140,7882
105,58,638,2954,156,59,0,0,0,3807,454,3147,186,312,0,0,0,4099,7906
105,59,583,3005,140,45,0,0,0,3773,500,3173,173,352,0,0,0,4198,7971
105,60,518,2893,123,60,0,0,0,3594,414,2989,181,357,0,0,0,3941,7535
105,61,517,2971,131,57,0,0,0,3676,407,2951,129,390,0,0,0,3877,7553
105,62,473,2857,108,62,1,0,0,3501,404,2997,158,454,1,0,0,4014,7515
105,63,450,2814,122,72,0,0,0,3458,403,2771,156,526,0,0,0,3856,7314
105,64,419,2849,122,89,0,0,0,3479,368,2671,123,530,0,0,0,3692,7171
105,65,341,2614,93,85,0,0,0,3133,318,2468,131,527,1,0,0,3445,6578
105,66,339,2740,119,104,0,0,0,3302,316,2489,118,643,0,0,0,3566,6868
105,67,291,2637,100,105,0,0,0,3133,269,2372,108,621,0,0,0,3370,6503
105,68,305,2652,90,106,0,0,0,3153,275,2256,111,674,0,0,0,3316,6469
105,69,287,2602,85,118,0,0,0,3092,245,2219,77,789,0,0,0,3330,6422
105,70,261,2376,79,134,0,0,0,2850,262,2000,93,714,0,0,0,3069,5919
105,71,222,2272,65,124,0,0,0,2683,225,1841,74,789,0,0,0,2929,5612
105,72,233,2294,68,161,0,0,0,2756,217,1792,85,919,0,0,0,3013,5769
105,73,167,2351,49,166,0,0,0,2733,217,1763,80,981,0,0,0,3041,5774
105,74,165,2294,58,190,0,0,0,2707,232,1601,63,1051,0,0,0,2947,5654
105,75,175,2304,56,201,0,0,0,2736,198,1568,55,1223,0,0,0,3044,5780
105,76,158,2159,45,197,0,0,0,2559,178,1523,56,1253,0,0,0,3010,5569
105,77,134,1927,39,193,0,0,0,2293,165,1209,51,1231,0,0,0,2656,4949
105,78,107,1449,37,170,0,0,0,1763,177,940,38,1005,0,0,0,2160,3923
105,79,103,1368,27,187,0,0,0,1685,134,819,35,1028,0,0,0,2016,3701
105,80,79,1332,19,192,0,0,0,1622,157,734,30,1124,0,0,0,2045,3667
105,81,68,1251,12,214,0,0,0,1545,136,582,18,1149,0,0,0,1885,3430
105,82,93,1190,15,208,0,0,0,1506,119,569,28,1220,0,0,0,1936,3442
105,83,74,1216,16,243,0,0,0,1549,133,527,22,1243,0,0,0,1925,3474
105,84,66,1018,19,247,0,0,0,1350,123,472,18,1276,0,0,0,1889,3239
105,85,42,822,11,230,0,0,0,1105,108,404,30,1194,0,0,0,1736,2841
105,86,55,700,5,222,0,0,0,982,96,258,12,1064,0,0,0,1430,2412
105,87,48,610,7,222,0,0,0,887,91,259,9,1107,0,0,0,1466,2353
105,88,34,526,5,240,0,0,0,805,105,209,10,977,0,0,0,1301,2106
105,89,26,422,5,218,0,0,0,671,80,137,13,943,0,0,0,1173,1844
105,90,20,345,1,223,0,0,0,589,70,112,10,853,0,0,0,1045,1634
105,91,18,255,0,153,0,0,0,426,64,64,5,734,0,0,0,867,1293
105,92,16,189,2,142,0,0,0,349,62,61,7,585,0,0,0,715,1064
105,93,13,128,1,130,0,0,0,272,48,33,2,480,0,0,0,563,835
105,94,6,107,2,85,0,0,0,200,40,27,6,351,0,0,0,424,624
105,95,7,53,2,76,0,0,0,138,33,16,3,294,0,0,0,346,484
105,96,5,39,1,54,0,0,0,99,22,15,4,233,0,0,0,274,373
105,97,2,24,0,40,0,0,0,66,19,7,1,163,0,0,0,190,256
105,98,3,16,1,28,0,0,0,48,10,3,1,104,0,0,0,118,166
105,99,0,12,1,21,0,0,0,34,14,5,0,95,0,0,0,114,148
105,100,2,16,0,31,0,0,0,49,12,7,3,117,0,0,0,139,188
105,999,117371,123308,3954,6312,24,1,0,250970,100231,124597,5739,33601,15,0,0,264183,515153
106,0,1511,0,0,0,0,0,0,1511,1465,0,0,0,0,0,0,1465,2976
106,1,1562,0,0,0,0,0,0,1562,1468,0,0,0,0,0,0,1468,3030
106,2,1611,0,0,0,0,0,0,1611,1459,0,0,0,0,0,0,1459,3070
106,3,1582,0,0,0,0,0,0,1582,1529,0,0,0,0,0,0,1529,3111
106,4,1692,0,0,0,0,0,0,1692,1482,0,0,0,0,0,0,1482,3174
106,5,1682,0,0,0,0,0,0,1682,1557,0,0,0,0,0,0,1557,3239
106,6,1723,0,0,0,0,0,0,1723,1636,0,0,0,0,0,0,1636,3359
106,7,1763,0,0,0,0,0,0,1763,1639,0,0,0,0,0,0,1639,3402
106,8,1729,0,0,0,0,0,0,1729,1675,0,0,0,0,0,0,1675,3404
106,9,1788,0,0,0,0,0,0,1788,1715,0,0,0,0,0,0,1715,3503
106,10,1759,0,0,0,0,0,0,1759,1740,0,0,0,0,0,0,1740,3499
106,11,1767,0,0,0,0,0,0,1767,1836,0,0,0,0,0,0,1836,3603
106,12,1823,0,0,0,0,0,0,1823,1801,0,0,0,0,0,0,1801,3624
106,13,1928,0,0,0,0,0,0,1928,1810,0,0,0,0,0,0,1810,3738
106,14,2033,0,0,0,0,0,0,2033,1928,0,0,0,0,0,0,1928,3961
106,15,2005,0,0,0,0,0,0,2005,1999,0,0,0,0,0,0,1999,4004
106,16,2091,0,0,0,0,0,0,2091,2001,0,0,0,0,0,0,2001,4092
106,17,2153,0,0,0,0,0,0,2153,1988,0,0,0,0,0,0,1988,4141
106,18,2301,0,0,0,0,0,0,2301,2070,0,0,0,0,0,0,2070,4371
106,19,2491,0,0,0,0,0,0,2491,2136,5,0,0,0,0,0,2141,4632
106,20,2371,0,0,0,0,0,0,2371,2102,12,0,0,0,0,0,2114,4485
106,21,2278,3,0,1,0,0,0,2282,2092,20,0,0,0,0,0,2112,4394
106,22,2327,6,0,0,0,0,0,2333,2090,44,0,1,1,0,0,2136,4469
106,23,2488,20,1,0,0,0,0,2509,2071,62,2,0,0,0,0,2135,4644
106,24,2485,26,3,0,0,0,0,2514,2028,102,0,0,1,0,0,2131,4645
106,25,2381,35,0,0,0,0,0,2416,1991,159,3,1,1,0,0,2155,4571
106,26,2333,58,2,0,0,1,0,2394,1805,228,0,0,0,0,0,2033,4427
106,27,2261,102,1,0,0,0,0,2364,1780,294,5,0,0,0,0,2079,4443
106,28,2162,156,0,0,0,0,0,2318,1655,400,8,0,0,0,0,2063,4381
106,29,2167,231,2,0,0,0,0,2400,1538,594,13,1,0,0,0,2146,4546
106,30,1940,355,3,2,0,0,0,2300,1401,686,13,3,1,0,0,2104,4404
106,31,1892,477,6,0,2,0,0,2377,1305,886,14,3,2,0,0,2210,4587
106,32,1806,591,9,0,1,0,0,2407,1140,919,17,4,0,0,0,2080,4487
106,33,1640,648,10,1,0,0,0,2299,1088,1069,19,4,0,0,0,2180,4479
106,34,1579,841,8,0,4,0,0,2432,994,1236,36,7,1,0,0,2274,4706
106,35,1403,932,19,0,1,0,0,2355,922,1316,43,7,2,0,0,2290,4645
106,36,1319,934,19,3,1,0,0,2276,748,1333,37,9,2,1,0,2130,4406
106,37,1271,1091,19,1,0,0,0,2382,680,1433,40,8,0,0,0,2161,4543
106,38,1171,1208,32,1,1,0,0,2413,698,1467,70,9,3,0,0,2247,4660
106,39,1072,1319,32,5,0,0,0,2428,658,1648,80,10,1,0,0,2397,4825
106,40,1070,1337,38,2,1,0,0,2448,602,1620,95,9,1,0,0,2327,4775
106,41,979,1445,55,4,2,0,0,2485,550,1775,105,20,0,0,0,2450,4935
106,42,954,1495,61,1,0,1,0,2512,497,1800,113,27,3,0,0,2440,4952
106,43,902,1649,63,8,3,0,0,2625,507,1969,117,32,0,0,0,2625,5250
106,44,848,1686,93,8,1,0,0,2636,465,2054,118,32,2,0,0,2671,5307
106,45,892,1786,98,7,1,0,0,2784,422,2031,149,33,2,0,0,2637,5421
106,46,789,1823,89,7,4,0,0,2712,429,2199,159,34,1,0,0,2822,5534
106,47,778,2016,126,7,1,0,0,2928,414,2299,145,41,2,0,0,2901,5829
106,48,800,2200,135,8,3,0,0,3146,422,2369,190,40,2,0,0,3023,6169
106,49,748,2242,173,13,3,0,0,3179,416,2541,178,61,0,0,0,3196,6375
106,50,682,2318,126,19,2,0,0,3147,376,2544,181,80,0,0,0,3181,6328
106,51,613,2260,139,20,2,0,0,3034,345,2510,204,76,0,0,0,3135,6169
106,52,586,2328,144,23,0,0,0,3081,342,2708,211,73,0,0,0,3334,6415
106,53,560,2369,183,23,3,0,1,3139,357,2684,207,106,3,0,0,3357,6496
106,54,547,2613,181,22,0,0,0,3363,350,2745,223,139,1,0,0,3458,6821
106,55,445,2536,156,32,1,0,0,3170,295,2660,213,137,1,0,0,3306,6476
106,56,459,2557,154,33,2,0,0,3205,273,2620,195,159,0,0,0,3247,6452
106,57,389,2527,132,37,4,0,0,3089,319,2563,189,170,0,0,0,3241,6330
106,58,334,2398,165,30,3,0,0,2930,298,2534,202,189,0,0,0,3223,6153
106,59,339,2639,177,61,3,0,0,3219,285,2682,202,223,1,0,0,3393,6612
106,60,284,2546,142,57,1,0,1,3031,277,2543,166,239,0,0,0,3225,6256
106,61,306,2484,154,42,1,0,0,2987,274,2521,146,274,0,0,1,3216,6203
106,62,268,2330,138,56,0,0,0,2792,243,2389,138,295,0,0,0,3065,5857
106,63,257,2413,134,53,0,0,0,2857,237,2333,122,336,0,0,0,3028,5885
106,64,204,2249,96,65,0,0,0,2614,198,2142,113,344,1,0,0,2798,5412
106,65,200,2298,97,69,0,0,0,2664,197,2071,104,395,0,0,0,2767,5431
106,66,187,2162,110,80,1,0,0,2540,212,2042,113,383,0,0,0,2750,5290
106,67,183,2196,107,87,1,0,0,2574,212,2026,106,451,0,0,0,2795,5369
106,68,190,2214,89,80,0,0,0,2573,191,1914,92,514,0,0,0,2711,5284
106,69,160,2164,73,111,1,0,0,2509,185,1868,78,560,0,0,0,2691,5200
106,70,133,1841,72,123,0,0,0,2169,170,1582,99,537,0,0,0,2388,4557
106,71,145,1908,85,118,1,0,0,2257,159,1623,80,598,0,0,0,2460,4717
106,72,140,1946,77,111,0,0,0,2274,151,1582,67,636,0,0,0,2436,4710
106,73,118,1901,49,145,0,0,0,2213,170,1532,79,701,0,0,0,2482,4695
106,74,95,1916,47,137,0,0,0,2195,148,1571,56,883,0,0,0,2658,4853
106,75,88,1948,46,135,0,0,0,2217,162,1508,51,865,0,0,0,2586,4803
106,76,84,1852,39,149,0,0,0,2124,133,1304,41,1017,0,0,0,2495,4619
106,77,81,1655,40,186,0,0,0,1962,131,1198,40,1003,0,0,0,2372,4334
106,78,59,1351,37,170,0,0,0,1617,106,903,32,842,0,0,0,1883,3500
106,79,62,1287,28,165,0,0,0,1542,105,820,32,929,0,0,0,1886,3428
106,80,46,1255,26,192,0,0,0,1519,97,770,29,1024,0,0,0,1920,3439
106,81,47,1149,26,209,0,0,0,1431,88,646,23,1059,0,0,0,1816,3247
106,82,43,988,14,190,0,0,0,1235,86,553,25,949,0,0,0,1613,2848
106,83,54,1136,15,226,0,0,0,1431,87,509,28,1224,0,0,0,1848,3279
106,84,27,985,18,228,0,0,0,1258,86,431,19,1209,0,0,0,1745,3003
106,85,24,823,9,200,0,0,0,1056,90,294,15,1071,0,0,0,1470,2526
106,86,30,645,10,185,0,0,0,870,88,255,14,949,0,0,0,1306,2176
106,87,23,546,9,184,0,0,0,762,74,188,10,887,0,0,0,1159,1921
106,88,17,415,6,207,0,0,0,645,72,158,8,819,0,0,0,1057,1702
106,89,14,407,3,164,0,0,0,588,51,98,13,751,0,0,0,913,1501
106,90,12,308,3,154,0,0,0,477,48,73,7,648,0,0,0,776,1253
106,91,7,199,3,118,0,0,0,327,39,60,4,520,0,0,0,623,950
106,92,7,142,1,107,0,0,0,257,34,30,6,469,0,0,0,539,796
106,93,6,129,2,100,0,0,0,237,27,29,4,459,0,0,0,519,756
106,94,2,73,0,65,0,0,0,140,27,15,3,330,0,0,0,375,515
106,95,4,36,0,53,0,0,0,93,19,12,1,229,0,0,0,261,354
106,96,1,20,1,26,0,0,0,48,15,6,1,169,0,0,0,191,239
106,97,2,15,0,27,0,0,0,44,11,7,2,132,0,0,0,152,196
106,98,0,6,0,16,0,0,0,22,11,3,0,85,0,0,0,99,121
106,99,0,4,0,10,0,0,0,14,9,4,0,73,0,0,0,86,100
106,100,4,8,0,12,0,0,0,24,9,3,2,104,0,0,0,118,142
106,999,92668,101207,4460,5191,55,2,2,203585,76413,100436,5765,26710,35,1,1,209361,412946
107,0,4732,0,0,0,0,0,0,4732,4616,0,0,0,0,0,0,4616,9348
107,1,5136,0,0,0,0,0,0,5136,4639,0,0,0,0,0,0,4639,9775
107,2,4948,0,0,0,0,0,0,4948,4752,0,0,0,0,0,0,4752,9700
107,3,5205,0,0,0,0,0,0,5205,4845,0,0,0,0,0,0,4845,10050
107,4,5311,0,0,0,0,0,0,5311,5102,0,0,0,0,0,0,5102,10413
107,5,5529,0,0,0,0,0,0,5529,5178,0,0,0,0,0,0,5178,10707
107,6,5603,0,0,0,0,0,0,5603,5295,0,0,0,0,0,0,5295,10898
107,7,5492,0,0,0,0,0,0,5492,5223,0,0,0,0,0,0,5223,10715
107,8,5749,0,0,0,0,0,0,5749,5542,0,0,0,0,0,0,5542,11291
107,9,5986,0,0,0,0,0,0,5986,5625,0,0,0,0,0,0,5625,11611
107,10,5808,0,0,0,0,0,0,5808,5486,0,0,0,0,0,0,5486,11294
107,11,6107,0,0,0,0,0,0,6107,5844,0,0,0,0,0,0,5844,11951
107,12,6136,0,0,0,0,0,0,6136,5806,0,0,0,0,0,0,5806,11942
107,13,6287,0,0,0,0,0,0,6287,6044,0,0,0,0,0,0,6044,12331
107,14,6474,0,0,0,0,0,0,6474,6157,0,0,0,0,0,0,6157,12631
107,15,6524,0,0,0,0,0,0,6524,6134,0,0,0,0,0,0,6134,12658
107,16,6466,0,1,0,0,0,0,6467,6217,0,1,0,0,0,0,6218,12685
107,17,6632,0,0,0,0,0,0,6632,6210,0,0,0,0,0,0,6210,12842
107,18,6772,2,0,0,0,0,0,6774,6410,5,0,0,0,0,0,6415,13189
107,19,6977,1,0,0,0,0,0,6978,6426,33,0,0,0,0,0,6459,13437
107,20,6510,8,1,0,0,0,0,6519,6118,53,0,0,0,0,0,6171,12690
107,21,6505,24,0,0,0,0,0,6529,6118,94,0,0,0,0,0,6212,12741
107,22,6517,37,1,0,0,0,0,6555,5963,163,1,0,1,0,0,6128,12683
107,23,6477,75,4,0,0,0,0,6556,5814,270,1,0,0,0,0,6085,12641
107,24,6432,131,1,0,1,0,0,6565,5707,419,3,0,2,0,0,6131,12696
107,25,6125,206,1,0,0,0,0,6332,5360,638,5,1,2,0,0,6006,12338
107,26,6046,364,0,0,1,0,0,6411,5238,927,5,0,2,0,0,6172,12583
107,27,5711,509,3,0,2,0,0,6225,5031,1223,6,0,1,0,0,6261,12486
107,28,5453,769,3,0,0,0,0,6225,4568,1548,11,2,3,0,0,6132,12357
107,29,5344,1018,5,1,4,0,0,6372,4281,2061,18,2,3,2,0,6367,12739
107,30,5108,1409,11,0,6,0,0,6534,4056,2466,36,4,4,1,0,6567,13101
107,31,5052,1855,16,3,4,0,0,6930,4000,3015,29,6,4,0,0,7054,13984
107,32,4536,2246,24,2,7,2,0,6817,3328,3360,56,7,6,1,0,6758,13575
107,33,4315,2534,29,1,7,0,0,6886,3120,3652,71,5,2,0,0,6850,13736
107,34,4030,2954,33,1,6,0,0,7024,2802,4054,78,12,9,0,0,6955,13979
107,35,3742,3283,43,5,7,0,0,7080,2632,4309,92,14,9,0,0,7056,14136
107,36,3304,3483,62,2,4,1,0,6856,2394,4398,132,26,12,0,0,6962,13818
107,37,3036,3748,71,6,5,1,0,6867,2221,4632,159,22,8,0,0,7042,13909
107,38,2839,3949,83,4,9,0,0,6884,2129,4881,145,26,7,0,0,7188,14072
107,39,2862,4238,94,5,7,0,0,7206,1988,5149,204,29,5,2,0,7377,14583
107,40,2552,4430,117,15,16,2,0,7132,1813,5345,207,35,9,0,0,7409,14541
107,41,2449,4840,126,9,11,1,0,7436,1762,5544,262,51,8,2,0,7629,15065
107,42,2348,4793,146,9,7,0,0,7303,1703,5647,265,54,12,0,0,7681,14984
107,43,2329,5204,178,14,11,1,0,7737,1618,6100,335,75,5,0,0,8133,15870
107,44,2272,5358,228,22,15,0,0,7895,1582,6233,351,80,9,1,0,8256,16151
107,45,2171,5610,224,32,10,2,0,8049,1529,6356,390,84,6,1,0,8366,16415
107,46,2099,5618,251,25,10,2,0,8005,1514,6504,418,113,10,0,0,8559,16564
107,47,2040,6018,302,28,6,1,0,8395,1509,6782,466,109,3,0,0,8869,17264
107,48,2070,6330,338,32,11,0,0,8781,1531,6891,479,142,7,0,0,9050,17831
107,49,2080,6565,342,36,5,0,0,9028,1458,7157,521,186,5,0,0,9327,18355
107,50,1811,6568,375,50,13,0,0,8817,1363,6946,534,188,5,0,0,9036,17853
107,51,1767,6569,363,42,9,0,0,8750,1333,7112,585,234,4,0,0,9268,18018
107,52,1626,6773,426,69,10,1,1,8906,1381,7194,587,272,6,0,0,9440,18346
107,53,1582,6747,418,63,3,0,0,8813,1292,7113,586,336,3,1,0,9331,18144
107,54,1501,7026,439,91,8,0,0,9065,1258,7385,611,350,6,0,0,9610,18675
107,55,1381,7016,446,90,11,0,0,8944,1333,7204,638,373,3,0,0,9551,18495
107,56,1347,7020,450,115,5,0,0,8937,1232,7192,602,416,3,1,0,9446,18383
107,57,1196,7073,466,111,5,0,1,8852,1215,7278,642,484,3,0,0,9622,18474
107,58,1177,7130,449,116,4,0,0,8876,1176,7219,603,597,1,1,0,9597,18473
107,59,1136,7256,467,159,4,0,0,9022,1095,7362,632,645,0,0,1,9735,18757
107,60,945,6936,429,157,10,0,0,8477,1103,7047,576,655,1,0,0,9382,17859
107,61,873,6903,392,192,5,0,0,8365,1065,6839,537,806,1,0,0,9248,17613
107,62,833,6730,388,190,3,0,0,8144,987,6627,500,764,2,0,0,8880,17024
107,63,761,6580,348,188,5,0,0,7882,988,6520,442,846,4,0,0,8800,16682
107,64,706,6315,331,240,2,0,0,7594,903,6032,453,1047,0,0,0,8435,16029
107,65,701,6165,314,250,4,0,0,7434,815,5816,412,1114,1,0,0,8158,15592
107,66,633,6117,315,251,5,0,0,7321,829,5753,381,1232,1,0,0,8196,15517
107,67,559,6084,291,238,2,1,0,7175,818,5505,347,1271,3,0,0,7944,15119
107,68,516,5793,295,275,1,1,1,6882,736,5205,339,1412,0,0,0,7692,14574
107,69,465,5764,249,316,1,0,0,6795,755,5145,336,1648,0,0,0,7884,14679
107,70,433,5437,212,328,6,0,0,6416,723,4620,296,1498,0,0,0,7137,13553
107,71,390,5278,180,368,1,0,0,6217,673,4609,287,1740,0,0,0,7309,13526
107,72,378,5094,167,383,5,0,0,6027,666,4190,296,1798,0,0,0,6950,12977
107,73,396,5234,174,422,2,0,0,6228,661,4183,283,1988,1,0,0,7116,13344
107,74,320,4922,141,436,0,0,1,5820,618,3948,220,2293,0,0,0,7079,12899
107,75,367,5032,149,497,0,0,0,6045,688,3800,207,2457,0,0,0,7152,13197
107,76,289,4738,125,514,0,0,0,5666,665,3468,220,2569,0,0,0,6922,12588
107,77,243,4245,130,481,1,0,0,5100,565,2970,173,2638,3,0,0,6349,11449
107,78,193,3543,90,493,1,0,1,4321,494,2431,140,2285,0,0,0,5350,9671
107,79,177,3177,72,486,1,0,0,3913,450,2120,128,2496,0,0,0,5194,9107
107,80,149,2716,63,435,0,0,0,3363,410,1749,117,2209,0,0,0,4485,7848
107,81,136,2583,57,524,0,0,0,3300,416,1530,96,2404,0,0,0,4446,7746
107,82,118,2435,38,546,0,0,0,3137,408,1336,89,2482,0,0,0,4315,7452
107,83,127,2316,41,584,0,0,0,3068,427,1312,86,2797,0,0,0,4622,7690
107,84,110,2189,45,559,0,0,0,2903,384,1046,71,2661,1,0,0,4163,7066
107,85,105,1871,43,553,0,0,0,2572,337,904,71,2580,0,0,0,3892,6464
107,86,94,1485,18,477,0,0,0,2074,315,647,55,2364,0,0,0,3381,5455
107,87,63,1258,15,442,0,0,0,1778,276,478,48,2140,0,0,0,2942,4720
107,88,58,984,17,455,0,0,0,1514,231,386,37,2077,0,0,0,2731,4245
107,89,58,777,11,464,1,0,0,1311,215,276,36,1945,0,0,0,2472,3783
107,90,38,708,5,430,0,0,0,1181,205,207,24,1671,0,0,0,2107,3288
107,91,43,472,5,338,0,0,0,858,145,134,26,1362,0,0,0,1667,2525
107,92,25,352,2,286,0,0,0,665,137,109,15,1166,0,0,0,1427,2092
107,93,17,274,1,233,0,0,0,525,118,60,14,1073,0,0,0,1265,1790
107,94,12,171,3,173,0,0,0,359,99,41,4,702,0,0,0,846,1205
107,95,8,99,3,134,0,0,0,244,70,20,8,559,0,0,0,657,901
107,96,4,64,3,95,0,0,0,166,52,9,3,419,0,0,0,483,649
107,97,3,30,0,85,0,0,0,118,50,10,5,302,0,0,0,367,485
107,98,4,20,0,52,0,0,0,76,23,5,4,217,0,0,0,249,325
107,99,2,9,0,45,0,0,0,56,14,3,1,160,0,0,0,178,234
107,100,6,16,0,39,0,0,0,61,32,4,2,219,0,0,0,257,318
107,999,266110,287703,12199,14812,300,16,5,581145,242682,289008,18152,69046,206,13,1,619108,1200253
108,0,1943,0,0,0,0,0,0,1943,1892,0,0,0,0,0,0,1892,3835
108,1,2001,0,0,0,0,0,0,2001,1921,0,0,0,0,0,0,1921,3922
108,2,2149,0,0,0,0,0,0,2149,1991,0,0,0,0,0,0,1991,4140
108,3,2154,0,0,0,0,0,0,2154,2038,0,0,0,0,0,0,2038,4192
108,4,2164,0,0,0,0,0,0,2164,2122,0,0,0,0,0,0,2122,4286
108,5,2386,0,0,0,0,0,0,2386,2149,0,0,0,0,0,0,2149,4535
108,6,2422,0,0,0,0,0,0,2422,2334,0,0,0,0,0,0,2334,4756
108,7,2355,0,0,0,0,0,0,2355,2218,0,0,0,0,0,0,2218,4573
108,8,2398,0,0,0,0,0,0,2398,2304,0,0,0,0,0,0,2304,4702
108,9,2545,0,0,0,0,0,0,2545,2456,0,0,0,0,0,0,2456,5001
108,10,2481,0,0,0,0,0,0,2481,2472,0,0,0,0,0,0,2472,4953
108,11,2645,0,0,0,0,0,0,2645,2485,0,0,0,0,0,0,2485,5130
108,12,2639,0,0,0,0,0,0,2639,2524,0,0,0,0,0,0,2524,5163
108,13,2756,0,0,0,0,0,0,2756,2689,0,0,0,0,0,0,2689,5445
108,14,2736,0,0,0,0,0,0,2736,2624,0,0,0,0,0,0,2624,5360
108,15,2838,0,0,0,0,0,0,2838,2766,0,0,0,0,0,0,2766,5604
108,16,2921,0,0,0,0,0,0,2921,2747,0,1,0,0,0,0,2748,5669
108,17,3035,0,0,0,0,0,0,3035,2713,0,0,0,0,0,0,2713,5748
108,18,3056,0,1,0,0,0,0,3057,2657,2,0,0,0,0,0,2659,5716
108,19,3123,5,0,0,0,0,0,3128,2839,3,1,0,1,0,0,2844,5972
108,20,3031,1,0,0,0,0,0,3032,2815,11,0,0,1,0,0,2827,5859
108,21,3015,6,0,0,0,0,0,3021,2802,37,0,0,0,0,0,2839,5860
108,22,3182,13,0,0,0,0,0,3195,2821,56,0,0,1,0,0,2878,6073
108,23,3169,16,2,0,0,0,0,3187,2814,83,1,0,0,0,0,2898,6085
108,24,3019,28,0,0,3,0,0,3050,2853,118,1,0,0,0,0,2972,6022
108,25,3006,66,2,0,1,0,0,3075,2698,147,4,0,0,0,0,2849,5924
108,26,2959,79,1,0,0,0,0,3039,2553,260,5,0,1,0,0,2819,5858
108,27,2982,145,1,0,0,0,0,3128,2565,401,2,0,0,0,0,2968,6096
108,28,2918,194,0,1,0,0,0,3113,2429,509,10,0,1,0,0,2949,6062
108,29,2837,317,3,0,1,0,0,3158,2355,685,7,0,0,0,0,3047,6205
108,30,2847,441,5,0,0,0,0,3293,2330,829,11,2,3,0,0,3175,6468
108,31,2769,565,11,0,2,0,0,3347,2243,1072,17,2,4,0,0,3338,6685
108,32,2616,753,8,0,0,1,0,3378,1977,1273,28,4,1,0,0,3283,6661
108,33,2505,911,29,1,4,0,0,3450,1934,1456,34,1,2,0,0,3427,6877
108,34,2305,1002,17,0,0,0,0,3324,1908,1613,43,5,2,0,0,3571,6895
108,35,2288,1185,26,0,1,0,0,3500,1714,1702,57,12,0,0,0,3485,6985
108,36,2132,1369,21,1,4,0,0,3527,1550,1760,56,15,4,0,0,3385,6912
108,37,1922,1568,34,1,0,0,0,3525,1403,1978,80,19,2,0,1,3483,7008
108,38,1845,1593,54,2,2,0,0,3496,1352,2033,105,12,4,1,0,3507,7003
108,39,1780,1674,67,8,0,0,0,3529,1315,2120,110,16,5,0,0,3566,7095
108,40,1634,1751,68,7,3,0,0,3463,1117,2230,129,18,1,0,0,3495,6958
108,41,1615,1926,83,5,1,0,0,3630,1152,2411,153,33,2,0,0,3751,7381
108,42,1550,1942,91,6,3,0,0,3592,1017,2487,170,32,2,0,0,3708,7300
108,43,1414,2248,80,3,2,0,0,3747,1013,2608,175,26,4,0,0,3826,7573
108,44,1384,2277,111,6,1,0,0,3779,1018,2663,188,37,3,1,0,3910,7689
108,45,1348,2442,121,7,5,0,0,3923,990,2775,202,52,1,0,0,4020,7943
108,46,1395,2477,168,14,0,0,1,4055,941,2860,239,63,1,0,0,4104,8159
108,47,1335,2657,194,16,1,0,0,4203,923,3188,253,65,0,0,0,4429,8632
108,48,1330,2815,206,17,2,0,0,4370,932,3145,271,68,1,0,0,4417,8787
108,49,1269,2916,201,25,2,0,0,4413,940,3427,293,88,0,0,0,4748,9161
108,50,1165,3011,214,26,1,0,0,4417,820,3463,349,123,1,0,0,4756,9173
108,51,1174,3079,246,26,3,0,0,4528,782,3634,345,119,0,0,0,4880,9408
108,52,1043,3245,232,40,1,0,0,4561,803,3620,334,156,0,0,0,4913,9474
108,53,1005,3133,231,31,2,0,0,4402,736,3469,339,156,2,0,0,4702,9104
108,54,951,3265,245,34,3,0,0,4498,729,3683,360,172,0,0,0,4944,9442
108,55,905,3354,276,47,6,0,0,4588,705,3579,374,237,0,0,0,4895,9483
108,56,885,3459,286,55,3,0,0,4688,688,3641,375,252,0,0,0,4956,9644
108,57,801,3504,296,58,3,0,0,4662,695,3726,346,276,0,0,0,5043,9705
108,58,733,3469,269,50,0,0,0,4521,688,3799,349,281,0,1,0,5118,9639
108,59,748,3588,294,77,2,0,0,4709,643,3787,358,328,0,0,0,5116,9825
108,60,623,3530,267,72,1,0,0,4493,619,3507,285,375,1,0,0,4787,9280
108,61,592,3480,259,87,6,1,0,4425,550,3696,297,440,0,0,0,4983,9408
108,62,539,3415,229,104,1,0,0,4288,557,3450,308,493,1,0,0,4809,9097
108,63,510,3535,259,114,1,0,0,4419,553,3453,274,536,0,0,0,4816,9235
108,64,510,3320,230,100,1,0,0,4161,540,3186,253,566,0,0,0,4545,8706
108,65,436,3186,198,120,1,0,0,3941,481,3114,235,625,0,0,0,4455,8396
108,66,410,3189,197,140,2,0,0,3938,463,3111,232,672,1,0,0,4479,8417
108,67,379,3150,172,149,0,0,0,3850,422,2950,188,720,0,0,0,4280,8130
108,68,393,3231,180,156,1,0,0,3961,402,2849,204,744,0,0,0,4199,8160
108,69,338,3119,165,169,1,0,0,3792,379,2733,191,820,0,0,0,4123,7915
108,70,301,2880,148,160,3,0,0,3492,335,2543,157,878,0,0,0,3913,7405
108,71,268,2707,143,182,1,0,0,3301,339,2320,155,891,0,0,0,3705,7006
108,72,236,2762,139,175,1,0,0,3313,328,2209,155,966,0,0,0,3658,6971
108,73,223,2756,118,222,0,0,0,3319,331,2193,134,1160,0,0,0,3818,7137
108,74,229,2704,100,259,0,0,1,3293,320,2168,109,1134,0,0,0,3731,7024
108,75,201,2800,95,276,2,0,0,3374,307,2091,117,1372,0,0,0,3887,7261
108,76,178,2614,107,286,1,0,0,3186,316,1817,131,1360,0,0,0,3624,6810
108,77,181,2335,62,267,1,0,0,2846,293,1612,101,1391,0,0,0,3397,6243
108,78,130,1763,60,230,0,0,0,2183,235,1184,70,1215,0,0,0,2704,4887
108,79,94,1667,41,242,0,0,0,2044,209,1080,74,1239,0,0,0,2602,4646
108,80,96,1536,47,260,0,0,0,1939,207,951,48,1279,0,0,0,2485,4424
108,81,89,1505,31,277,0,0,0,1902,171,896,63,1420,0,0,0,2550,4452
108,82,99,1427,24,292,0,0,0,1842,211,743,66,1478,0,0,0,2498,4340
108,83,80,1375,33,360,0,0,0,1848,187,706,55,1630,0,0,0,2578,4426
108,84,76,1254,29,343,0,0,0,1702,178,556,42,1500,0,0,0,2276,3978
108,85,70,986,18,289,0,0,0,1363,164,451,36,1453,0,0,0,2104,3467
108,86,51,837,11,304,1,0,0,1204,135,376,24,1332,0,0,0,1867,3071
108,87,36,740,11,277,0,0,0,1064,179,302,29,1279,0,0,0,1789,2853
108,88,42,593,7,270,1,0,0,913,151,225,13,1241,0,0,0,1630,2543
108,89,23,525,9,244,0,0,0,801,107,183,17,1160,0,0,0,1467,2268
108,90,35,383,6,226,0,0,0,650,111,110,17,1023,0,0,0,1261,1911
108,91,26,256,5,211,0,0,0,498,106,62,9,860,0,0,0,1037,1535
108,92,13,212,1,179,0,0,0,405,86,67,12,729,0,0,0,894,1299
108,93,14,169,4,134,0,0,0,321,79,34,5,620,0,0,0,738,1059
108,94,9,80,3,90,0,0,0,182,50,26,5,456,0,0,0,537,719
108,95,4,57,0,65,0,0,0,126,49,20,9,361,0,0,0,439,565
108,96,4,37,0,46,0,0,0,87,20,8,2,236,0,0,0,266,353
108,97,2,19,2,27,0,0,0,50,21,3,1,186,0,0,0,211,261
108,98,2,15,1,17,0,0,0,35,24,11,4,137,0,0,0,176,211
108,99,4,15,0,13,0,0,0,32,19,6,0,103,0,0,0,128,160
108,100,7,22,0,20,0,0,0,49,19,19,1,139,0,0,0,178,227
108,999,135111,138675,7605,8018,88,2,2,289501,119957,139364,10303,38889,53,3,1,308570,598071
109,0,1483,0,0,0,0,0,0,1483,1463,0,0,0,0,0,0,1463,2946
109,1,1587,0,0,0,0,0,0,1587,1508,0,0,0,0,0,0,1508,3095
109,2,1570,0,0,0,0,0,0,1570,1442,0,0,0,0,0,0,1442,3012
109,3,1525,0,0,0,0,0,0,1525,1532,0,0,0,0,0,0,1532,3057
109,4,1620,0,0,0,0,0,0,1620,1532,0,0,0,0,0,0,1532,3152
109,5,1735,0,0,0,0,0,0,1735,1557,0,0,0,0,0,0,1557,3292
109,6,1649,0,0,0,0,0,0,1649,1693,0,0,0,0,0,0,1693,3342
109,7,1704,0,0,0,0,0,0,1704,1599,0,0,0,0,0,0,1599,3303
109,8,1771,0,0,0,0,0,0,1771,1593,0,0,0,0,0,0,1593,3364
109,9,1821,0,0,0,0,0,0,1821,1727,0,0,0,0,0,0,1727,3548
109,10,1813,0,0,0,0,0,0,1813,1643,0,0,0,0,0,0,1643,3456
109,11,1919,0,0,0,0,0,0,1919,1819,0,0,0,0,0,0,1819,3738
109,12,1911,0,0,0,0,0,0,1911,1914,0,0,0,0,0,0,1914,3825
109,13,2075,0,0,0,0,0,0,2075,1882,0,0,0,0,0,0,1882,3957
109,14,2057,0,0,0,0,0,0,2057,1970,0,0,0,0,0,0,1970,4027
109,15,2184,0,0,0,0,0,0,2184,1949,0,0,0,0,0,0,1949,4133
109,16,2233,0,0,0,0,0,0,2233,2043,0,0,0,0,0,0,2043,4276
109,17,2331,0,0,0,0,0,0,2331,2085,0,0,0,0,0,0,2085,4416
109,18,2475,0,0,0,0,0,0,2475,2176,3,0,0,0,0,0,2179,4654
109,19,2480,0,0,0,0,0,0,2480,2184,13,0,0,0,0,0,2197,4677
109,20,2290,5,0,0,0,0,0,2295,2151,29,0,0,0,0,0,2180,4475
109,21,2299,13,0,0,0,0,0,2312,2147,53,0,0,0,0,0,2200,4512
109,22,2377,21,0,0,1,0,0,2399,2155,63,0,0,0,0,0,2218,4617
109,23,2497,27,0,0,0,0,0,2524,2136,108,2,0,0,0,0,2246,4770
109,24,2357,45,2,0,0,0,0,2404,2131,188,0,0,0,0,0,2319,4723
109,25,2361,79,1,0,0,0,0,2441,2025,239,1,0,0,0,0,2265,4706
109,26,2227,122,1,0,0,0,0,2350,1769,332,0,0,1,0,0,2102,4452
109,27,2190,182,1,0,0,0,0,2373,1668,454,3,0,0,0,0,2125,4498
109,28,2005,252,3,0,2,0,0,2262,1495,598,5,1,1,0,0,2100,4362
109,29,1928,327,0,0,0,0,0,2255,1387,712,5,2,0,0,0,2106,4361
109,30,1844,466,4,0,1,0,0,2315,1211,882,13,1,0,0,0,2107,4422
109,31,1682,638,3,0,2,0,0,2325,1128,1128,28,2,1,0,0,2287,4612
109,32,1561,698,7,0,0,0,0,2266,1000,1193,16,3,0,0,0,2212,4478
109,33,1461,932,7,0,0,0,0,2400,972,1338,33,1,2,0,0,2346,4746
109,34,1347,964,10,0,2,0,0,2323,800,1443,18,4,1,0,0,2266,4589
109,35,1292,1180,17,2,0,0,0,2491,724,1552,38,7,0,0,0,2321,4812
109,36,1095,1168,14,0,0,0,0,2277,637,1531,37,1,0,0,0,2206,4483
109,37,1065,1267,23,1,0,0,0,2356,623,1605,53,11,0,0,0,2292,4648
109,38,997,1305,26,2,0,0,0,2330,571,1705,49,8,1,0,0,2334,4664
109,39,887,1456,33,3,0,0,0,2379,536,1733,63,9,1,0,0,2342,4721
109,40,794,1502,37,4,0,0,0,2337,449,1806,70,18,1,0,0,2344,4681
109,41,781,1497,34,1,2,0,0,2315,436,1860,55,18,0,0,0,2369,4684
109,42,795,1719,46,2,2,0,0,2564,418,1974,75,25,4,0,0,2496,5060
109,43,751,1813,59,4,1,0,0,2628,424,2002,100,30,0,0,0,2556,5184
109,44,761,1841,58,7,2,0,0,2669,363,2045,113,23,0,0,0,2544,5213
109,45,688,1861,63,6,1,0,0,2619,351,2153,105,35,1,0,0,2645,5264
109,46,668,1965,76,15,3,0,0,2727,374,2246,120,33,1,0,0,2774,5501
109,47,681,2141,91,5,1,0,0,2919,404,2219,137,59,0,0,0,2819,5738
109,48,697,2113,82,15,1,0,0,2908,387,2480,121,63,0,0,0,3051,5959
109,49,639,2156,98,10,3,0,0,2906,428,2517,153,66,0,0,0,3164,6070
109,50,567,2185,85,15,2,0,0,2854,423,2488,135,85,1,0,0,3132,5986
109,51,627,2241,110,14,2,0,0,2994,377,2417,140,83,0,0,0,3017,6011
109,52,557,2356,127,18,2,0,0,3060,369,2645,141,108,2,0,0,3265,6325
109,53,542,2324,119,33,3,0,0,3021,396,2671,160,97,1,1,0,3326,6347
109,54,530,2610,119,25,1,0,0,3285,415,2665,150,134,0,0,0,3364,6649
109,55,516,2483,130,28,1,0,0,3158,392,2684,136,172,0,0,0,3384,6542
109,56,479,2561,120,43,1,0,0,3204,397,2828,131,174,0,0,0,3530,6734
109,57,441,2481,120,27,3,0,0,3072,408,2633,130,190,1,0,0,3362,6434
109,58,397,2549,118,32,0,0,0,3096,388,2615,141,243,0,0,0,3387,6483
109,59,397,2707,127,46,1,0,0,3278,376,2668,125,261,0,0,0,3430,6708
109,60,327,2429,92,60,1,0,1,2910,325,2432,106,235,0,0,0,3098,6008
109,61,312,2322,102,61,1,0,0,2798,324,2332,109,289,0,0,0,3054,5852
109,62,315,2338,109,66,0,0,0,2828,290,2319,83,303,0,0,0,2995,5823
109,63,259,2405,106,64,1,0,0,2835,342,2384,100,384,0,0,0,3210,6045
109,64,254,2256,86,61,2,0,0,2659,292,2178,91,403,0,0,0,2964,5623
109,65,251,2134,81,66,0,0,0,2532,281,2061,69,395,0,0,0,2806,5338
109,66,231,2263,85,69,2,0,0,2650,245,2054,71,476,0,0,0,2846,5496
109,67,197,2130,65,72,2,0,0,2466,239,2033,71,458,0,0,0,2801,5267
109,68,188,2059,56,89,0,0,0,2392,268,1914,63,567,0,0,0,2812,5204
109,69,164,2142,53,97,1,0,0,2457,238,1778,68,602,0,0,0,2686,5143
109,70,145,1809,59,105,1,0,0,2119,188,1608,60,604,0,0,0,2460,4579
109,71,144,1869,51,86,0,0,0,2150,167,1538,56,661,0,0,0,2422,4572
109,72,114,1788,49,113,0,0,0,2064,202,1501,64,685,0,0,0,2452,4516
109,73,110,1761,44,140,0,0,0,2055,193,1439,39,782,0,0,0,2453,4508
109,74,120,1942,43,129,1,0,0,2235,183,1427,41,898,0,0,0,2549,4784
109,75,112,1819,38,141,0,0,0,2110,197,1317,36,911,0,0,0,2461,4571
109,76,107,1795,29,167,0,0,0,2098,172,1233,46,1111,0,0,0,2562,4660
109,77,104,1521,23,174,1,0,0,1823,137,979,27,1057,0,0,0,2200,4023
109,78,52,1330,14,159,0,0,0,1555,119,786,24,943,0,0,0,1872,3427
109,79,63,1210,24,131,0,0,0,1428,131,703,22,939,0,0,0,1795,3223
109,80,57,1033,10,154,0,0,0,1254,124,586,25,878,0,0,0,1613,2867
109,81,53,944,8,138,1,0,0,1144,110,496,15,914,0,0,0,1535,2679
109,82,45,892,13,143,0,0,0,1093,141,474,16,954,0,0,0,1585,2678
109,83,54,1029,14,197,0,0,0,1294,136,430,16,1176,0,0,0,1758,3052
109,84,36,938,8,193,0,0,0,1175,120,386,13,1173,0,0,0,1692,2867
109,85,27,799,8,211,0,0,0,1045,113,319,8,1113,0,0,0,1553,2598
109,86,31,671,9,187,0,0,0,898,107,230,7,1034,0,0,0,1378,2276
109,87,27,518,3,161,0,0,0,709,85,139,8,915,0,0,0,1147,1856
109,88,15,433,5,186,0,0,0,639,82,109,4,822,0,0,0,1017,1656
109,89,12,368,3,206,0,0,0,589,72,87,6,733,0,0,0,898,1487
109,90,11,284,2,134,0,0,0,431,50,69,4,653,0,0,0,776,1207
109,91,6,203,1,129,0,0,0,339,58,52,5,550,0,0,0,665,1004
109,92,7,165,1,137,0,0,0,310,64,22,2,452,0,0,0,540,850
109,93,7,123,1,100,0,0,0,231,47,21,5,411,0,0,0,484,715
109,94,2,77,0,61,0,0,0,140,40,10,0,242,0,0,0,292,432
109,95,1,57,0,46,0,0,0,104,24,7,2,231,0,0,0,264,368
109,96,3,38,0,39,0,0,0,80,10,2,0,163,0,0,0,175,255
109,97,1,16,0,32,0,0,0,49,9,2,0,120,0,0,0,131,180
109,98,0,10,0,15,0,0,0,25,11,4,0,75,0,0,0,90,115
109,99,0,8,0,20,0,0,0,28,6,0,1,61,0,0,0,68,96
109,100,1,8,1,23,0,0,0,33,7,3,0,71,0,0,0,81,114
109,999,89978,102188,3267,4920,54,0,1,200408,76501,101982,4185,27411,20,1,0,210100,410508
110,0,901,0,0,0,0,0,0,901,837,0,0,0,0,0,0,837,1738
110,1,928,0,0,0,0,0,0,928,835,0,0,0,0,0,0,835,1763
110,2,944,0,0,0,0,0,0,944,883,0,0,0,0,0,0,883,1827
110,3,950,0,0,0,0,0,0,950,878,0,0,0,0,0,0,878,1828
110,4,944,0,0,0,0,0,0,944,868,0,0,0,0,0,0,868,1812
110,5,998,0,0,0,0,0,0,998,995,0,0,0,0,0,0,995,1993
110,6,1027,0,0,0,0,0,0,1027,950,0,0,0,0,0,0,950,1977
110,7,1064,0,0,0,0,0,0,1064,1042,0,0,0,0,0,0,1042,2106
110,8,1125,0,0,0,0,0,0,1125,1035,0,0,0,0,0,0,1035,2160
110,9,1090,0,0,0,0,0,0,1090,1110,0,0,0,0,0,0,1110,2200
110,10,1106,0,0,0,0,0,0,1106,1043,0,0,0,0,0,0,1043,2149
110,11,1219,0,0,0,0,0,0,1219,1185,0,0,0,0,0,0,1185,2404
110,12,1179,0,0,0,0,0,0,1179,1104,0,0,0,0,0,0,1104,2283
110,13,1275,0,0,0,0,0,0,1275,1183,0,0,0,0,0,0,1183,2458
110,14,1299,0,0,0,0,0,0,1299,1238,0,0,0,0,0,0,1238,2537
110,15,1349,0,0,0,0,0,0,1349,1241,0,0,0,0,0,0,1241,2590
110,16,1364,0,0,0,0,0,0,1364,1219,0,0,0,0,0,0,1219,2583
110,17,1535,0,0,0,0,0,0,1535,1296,0,0,0,0,0,0,1296,2831
110,18,1521,0,0,0,0,0,0,1521,1381,3,0,0,0,0,0,1384,2905
110,19,1525,2,0,0,0,0,0,1527,1425,18,0,0,0,0,0,1443,2970
110,20,1437,2,0,0,0,0,0,1439,1344,14,0,0,0,0,0,1358,2797
110,21,1463,5,0,0,0,0,0,1468,1309,33,0,1,0,0,0,1343,2811
110,22,1472,18,0,0,0,0,0,1490,1350,44,0,0,1,0,0,1395,2885
110,23,1428,21,0,0,0,0,0,1449,1278,75,0,0,0,0,0,1353,2802
110,24,1442,38,0,0,1,0,0,1481,1325,126,0,0,0,0,0,1451,2932
110,25,1463,50,0,0,0,0,0,1513,1159,159,4,0,0,0,0,1322,2835
110,26,1328,79,0,0,0,0,0,1407,1129,193,1,0,0,0,0,1323,2730
110,27,1231,121,0,0,0,0,0,1352,977,296,6,0,1,0,0,1280,2632
110,28,1226,171,1,0,0,0,0,1398,974,355,4,1,0,0,0,1334,2732
110,29,1157,248,3,0,0,0,0,1408,842,443,6,1,0,0,0,1292,2700
110,30,1099,313,3,1,0,0,0,1416,845,541,15,1,0,0,0,1402,2818
110,31,1009,407,9,0,0,0,0,1425,757,611,16,0,0,0,0,1384,2809
110,32,975,504,9,0,0,0,0,1488,661,746,24,3,1,0,0,1435,2923
110,33,854,518,14,0,0,0,0,1386,567,839,24,2,1,0,0,1433,2819
110,34,852,630,10,0,0,0,0,1492,455,827,30,4,0,0,0,1316,2808
110,35,713,699,19,2,0,1,0,1434,462,889,24,4,0,0,0,1379,2813
110,36,656,692,18,0,0,0,0,1366,423,928,26,4,0,0,0,1381,2747
110,37,588,730,29,0,0,0,0,1347,382,942,37,3,1,0,0,1365,2712
110,38,562,845,23,0,0,0,0,1430,340,995,52,4,2,0,0,1393,2823
110,39,501,822,24,1,0,0,0,1348,344,994,55,11,0,0,0,1404,2752
110,40,486,916,34,2,1,0,0,1439,297,1098,64,13,0,0,0,1472,2911
110,41,433,910,49,2,1,0,0,1395,264,1070,60,9,0,0,0,1403,2798
110,42,412,975,40,5,0,0,0,1432,273,1153,68,17,0,0,0,1511,2943
110,43,445,1011,47,1,0,0,0,1504,258,1184,78,19,0,0,0,1539,3043
110,44,441,1024,60,4,2,0,0,1531,263,1249,82,18,0,0,0,1612,3143
110,45,432,1070,67,2,0,0,0,1571,216,1265,81,19,1,0,0,1582,3153
110,46,425,1163,62,5,1,0,0,1656,222,1210,93,23,1,0,0,1549,3205
110,47,391,1189,80,8,0,0,0,1668,227,1330,114,23,0,1,0,1695,3363
110,48,365,1262,86,8,1,1,0,1723,239,1388,95,34,0,0,0,1756,3479
110,49,332,1323,78,8,0,0,0,1741,216,1444,117,49,1,0,0,1827,3568
110,50,334,1313,89,14,0,0,0,1750,233,1458,135,67,1,1,0,1895,3645
110,51,348,1337,93,16,1,0,0,1795,214,1533,108,63,0,0,0,1918,3713
110,52,326,1364,88,22,0,0,0,1800,224,1526,107,65,0,1,0,1923,3723
110,53,273,1405,82,12,0,0,0,1772,252,1552,116,78,0,0,0,1998,3770
110,54,307,1423,97,11,1,0,0,1839,219,1610,117,77,0,0,0,2023,3862
110,55,275,1440,103,25,1,0,0,1844,214,1556,127,93,0,0,0,1990,3834
110,56,234,1568,98,20,2,0,0,1922,208,1626,106,95,0,0,0,2035,3957
110,57,243,1519,109,25,1,0,0,1897,208,1584,115,130,0,0,0,2037,3934
110,58,234,1533,97,23,0,0,0,1887,247,1614,105,136,0,0,0,2102,3989
110,59,202,1568,94,28,2,0,0,1894,220,1676,118,175,1,0,0,2190,4084
110,60,192,1572,72,31,0,0,0,1867,233,1452,87,159,1,0,0,1932,3799
110,61,150,1466,84,27,0,0,0,1727,205,1520,98,199,0,0,0,2022,3749
110,62,150,1401,62,39,0,0,0,1652,197,1420,77,204,0,0,0,1898,3550
110,63,160,1559,72,40,0,0,0,1831,199,1416,71,255,0,0,0,1941,3772
110,64,110,1383,64,46,0,0,0,1603,168,1371,80,238,0,0,0,1857,3460
110,65,126,1321,54,51,0,0,0,1552,170,1266,63,289,0,0,0,1788,3340
110,66,111,1270,53,39,0,0,0,1473,161,1212,67,289,0,0,0,1729,3202
110,67,89,1218,48,46,0,0,0,1401,130,1188,57,322,0,0,0,1697,3098
110,68,82,1330,46,77,0,0,0,1535,124,1135,56,333,0,0,0,1648,3183
110,69,80,1246,43,62,0,0,0,1431,123,1101,63,381,0,0,0,1668,3099
110,70,64,1056,43,55,0,0,0,1218,125,937,40,362,0,0,0,1464,2682
110,71,63,1034,33,55,0,0,0,1185,113,918,31,415,0,0,0,1477,2662
110,72,67,1088,31,62,0,0,0,1248,119,851,38,424,0,0,0,1432,2680
110,73,63,1045,25,70,0,0,0,1203,125,828,42,460,0,0,0,1455,2658
110,74,60,1110,22,105,1,0,0,1298,113,816,37,585,0,0,0,1551,2849
110,75,41,1080,21,92,1,0,0,1235,113,799,43,601,0,0,0,1556,2791
110,76,51,1030,21,91,0,0,0,1193,110,694,19,650,0,0,0,1473,2666
110,77,40,905,22,104,0,0,0,1071,90,548,16,598,0,0,0,1252,2323
110,78,47,729,10,90,0,0,0,876,94,482,6,610,0,0,0,1192,2068
110,79,35,669,14,87,1,0,0,806,81,380,16,566,0,0,0,1043,1849
110,80,32,636,5,84,0,0,0,757,74,319,6,595,0,0,0,994,1751
110,81,25,580,4,88,0,0,0,697,64,265,9,556,0,0,0,894,1591
110,82,28,503,7,92,0,0,0,630,80,265,11,579,0,0,0,935,1565
110,83,25,565,7,111,0,0,0,708,83,242,8,682,0,0,0,1015,1723
110,84,18,451,8,127,0,0,0,604,67,198,10,654,0,0,0,929,1533
110,85,12,466,6,108,0,0,0,592,61,155,11,722,0,0,0,949,1541
110,86,15,323,3,126,0,0,0,467,58,101,4,512,0,0,0,675,1142
110,87,5,294,3,125,0,0,0,427,60,78,5,551,0,0,0,694,1121
110,88,7,214,6,101,0,0,0,328,53,60,2,467,0,0,0,582,910
110,89,10,196,2,95,0,0,0,303,40,53,4,391,0,0,0,488,791
110,90,12,151,3,105,0,0,0,271,39,35,4,402,0,0,0,480,751
110,91,7,95,1,71,0,0,0,174,47,21,3,304,0,0,0,375,549
110,92,1,71,1,52,0,0,0,125,34,17,0,247,0,0,0,298,423
110,93,3,66,0,46,0,0,0,115,17,6,2,225,0,0,0,250,365
110,94,4,39,1,34,0,0,0,78,11,6,1,131,0,0,0,149,227
110,95,0,22,0,21,0,0,0,43,9,2,3,116,0,0,0,130,173
110,96,2,9,0,23,0,0,0,34,7,4,0,75,0,0,0,86,120
110,97,1,9,0,15,0,0,0,25,14,1,0,42,0,0,0,57,82
110,98,2,8,0,12,0,0,0,22,4,2,1,36,0,0,0,43,65
110,99,0,5,0,10,0,0,0,15,5,1,0,23,0,0,0,29,44
110,100,0,6,0,9,0,0,0,15,5,1,0,39,0,0,0,45,60
110,999,53727,60449,2612,2969,18,2,0,119777,47010,60363,3421,16531,13,3,0,127341,247118
111,0,530,0,0,0,0,0,0,530,488,0,0,0,0,0,0,488,1018
111,1,510,0,0,0,0,0,0,510,496,0,0,0,0,0,0,496,1006
111,2,530,0,0,0,0,0,0,530,514,0,0,0,0,0,0,514,1044
111,3,531,0,0,0,0,0,0,531,507,0,0,0,0,0,0,507,1038
111,4,548,0,0,0,0,0,0,548,534,0,0,0,0,0,0,534,1082
111,5,572,0,0,0,0,0,0,572,574,0,0,0,0,0,0,574,1146
111,6,639,0,0,0,0,0,0,639,555,0,0,0,0,0,0,555,1194
111,7,569,0,0,0,0,0,0,569,605,0,0,0,0,0,0,605,1174
111,8,624,0,0,0,0,0,0,624,607,0,0,0,0,0,0,607,1231
111,9,592,0,0,0,0,0,0,592,592,0,0,0,0,0,0,592,1184
111,10,596,0,0,0,0,0,0,596,613,0,0,0,0,0,0,613,1209
111,11,659,0,0,0,0,0,0,659,590,0,0,0,0,0,0,590,1249
111,12,711,0,0,0,0,0,0,711,658,0,0,0,0,0,0,658,1369
111,13,688,0,0,0,0,0,0,688,713,0,0,0,0,0,0,713,1401
111,14,799,0,0,0,0,0,0,799,692,0,0,0,0,0,0,692,1491
111,15,761,0,0,0,0,0,0,761,727,0,0,0,0,0,0,727,1488
111,16,774,0,0,0,0,0,0,774,738,0,0,0,0,0,0,738,1512
111,17,862,1,0,0,0,0,0,863,727,0,0,0,0,0,0,727,1590
111,18,853,0,0,0,0,0,0,853,788,3,0,0,0,0,0,791,1644
111,19,848,0,0,0,0,0,0,848,769,1,0,0,0,0,0,770,1618
111,20,898,1,0,0,0,0,0,899,765,6,0,0,0,0,0,771,1670
111,21,828,5,0,0,0,0,0,833,842,10,0,0,0,0,0,852,1685
111,22,865,1,0,0,0,0,0,866,868,13,1,0,1,0,0,883,1749
111,23,891,11,0,0,0,0,0,902,841,25,0,0,0,0,0,866,1768
111,24,947,10,0,0,0,0,0,957,817,50,0,0,0,0,0,867,1824
111,25,881,18,1,0,0,0,0,900,764,69,0,0,0,0,0,833,1733
111,26,848,30,0,0,0,0,0,878,696,76,1,0,0,0,0,773,1651
111,27,817,38,0,0,0,0,0,855,688,110,1,0,1,0,0,800,1655
111,28,805,65,2,0,0,0,0,872,679,169,2,0,0,0,0,850,1722
111,29,779,85,0,0,0,0,0,864,601,225,3,0,0,0,0,829,1693
111,30,798,145,5,0,0,0,0,948,514,289,5,0,0,0,0,808,1756
111,31,703,161,3,0,0,0,0,867,551,268,5,1,0,0,0,825,1692
111,32,660,206,3,0,0,0,0,869,450,399,6,0,0,0,0,855,1724
111,33,597,250,2,0,1,0,0,850,436,427,6,0,0,0,0,869,1719
111,34,554,331,1,1,0,0,0,887,392,415,17,1,0,0,0,825,1712
111,35,510,364,8,0,0,0,0,882,326,494,22,3,0,0,0,845,1727
111,36,460,356,11,0,0,0,0,827,314,508,24,3,1,0,0,850,1677
111,37,443,423,10,1,0,0,0,877,310,518,14,5,0,0,0,847,1724
111,38,420,439,9,1,0,0,0,869,259,587,24,2,0,0,0,872,1741
111,39,418,481,10,0,0,0,0,909,232,607,35,7,0,0,0,881,1790
111,40,358,486,13,1,1,0,0,859,212,579,28,5,0,0,0,824,1683
111,41,351,518,25,0,1,0,0,895,212,629,29,7,0,0,0,877,1772
111,42,338,575,20,2,0,0,0,935,192,634,39,7,0,0,0,872,1807
111,43,333,580,31,2,0,0,0,946,195,665,44,7,0,0,0,911,1857
111,44,295,605,17,4,1,0,0,922,162,693,46,10,1,0,0,912,1834
111,45,276,577,33,0,0,0,0,886,167,712,63,17,0,0,0,959,1845
111,46,244,636,36,4,0,0,0,920,184,807,56,12,0,0,0,1059,1979
111,47,281,674,34,2,0,0,0,991,191,814,52,18,0,0,0,1075,2066
111,48,264,744,38,4,0,0,0,1050,163,875,61,23,0,0,0,1122,2172
111,49,254,792,46,4,1,0,0,1097,160,842,64,25,0,0,0,1091,2188
111,50,255,760,50,13,0,0,0,1078,148,858,61,35,0,0,0,1102,2180
111,51,229,797,67,5,0,0,0,1098,197,918,48,37,0,0,0,1200,2298
111,52,227,837,55,11,0,0,0,1130,143,946,66,32,0,0,0,1187,2317
111,53,208,845,51,5,0,0,0,1109,155,972,55,44,0,0,0,1226,2335
111,54,177,927,61,13,0,0,0,1178,141,1012,62,51,0,0,0,1266,2444
111,55,185,960,46,13,0,0,0,1204,135,1047,75,59,0,0,0,1316,2520
111,56,186,954,54,14,0,0,0,1208,122,980,72,66,0,0,0,1240,2448
111,57,177,1013,53,10,0,0,0,1253,159,967,56,45,0,0,0,1227,2480
111,58,155,948,74,17,0,0,0,1194,140,943,54,73,0,0,0,1210,2404
111,59,154,991,46,23,0,0,0,1214,160,1004,46,103,0,0,0,1313,2527
111,60,121,918,42,20,0,1,0,1102,155,953,51,96,0,0,0,1255,2357
111,61,127,959,49,27,0,0,0,1162,123,902,49,117,0,0,0,1191,2353
111,62,113,895,43,15,0,0,0,1066,122,922,57,127,0,0,0,1228,2294
111,63,107,927,42,23,0,0,0,1099,149,930,37,145,0,0,0,1261,2360
111,64,92,927,29,22,1,0,0,1071,106,865,35,139,0,0,0,1145,2216
111,65,75,838,30,25,0,0,0,968,109,832,41,159,0,0,0,1141,2109
111,66,90,790,26,29,0,0,0,935,128,812,35,179,0,0,0,1154,2089
111,67,64,835,31,32,0,0,0,962,108,739,44,184,0,0,0,1075,2037
111,68,66,825,29,52,0,0,0,972,110,757,35,188,0,0,0,1090,2062
111,69,74,796,23,34,0,0,0,927,115,772,27,205,0,0,0,1119,2046
111,70,75,765,25,29,0,0,0,894,119,629,38,223,0,0,0,1009,1903
111,71,58,719,26,45,0,1,0,849,106,645,23,252,0,0,0,1026,1875
111,72,42,735,17,44,0,0,0,838,86,617,16,264,0,0,0,983,1821
111,73,48,717,21,49,0,0,0,835,105,608,25,296,0,0,0,1034,1869
111,74,50,737,24,67,0,0,0,878,97,596,20,351,0,0,0,1064,1942
111,75,40,722,15,77,0,0,0,854,83,509,15,390,0,0,0,997,1851
111,76,44,647,13,67,0,0,0,771,82,491,15,345,0,0,0,933,1704
111,77,35,547,6,70,0,0,0,658,60,367,15,328,0,0,0,770,1428
111,78,22,448,8,58,0,0,0,536,60,332,5,344,0,0,0,741,1277
111,79,38,413,10,53,0,0,0,514,43,249,6,340,0,0,0,638,1152
111,80,19,364,8,59,0,0,0,450,50,225,9,331,0,0,0,615,1065
111,81,22,337,7,72,0,0,0,438,30,186,12,320,0,0,0,548,986
111,82,25,322,7,58,0,0,0,412,39,210,6,357,0,0,0,612,1024
111,83,18,391,3,67,0,0,0,479,56,197,10,453,0,0,0,716,1195
111,84,12,375,2,73,0,0,0,462,51,177,8,474,0,0,0,710,1172
111,85,18,327,5,92,0,0,0,442,50,145,4,427,0,0,0,626,1068
111,86,13,244,6,93,0,0,0,356,38,81,3,370,0,0,0,492,848
111,87,11,238,1,86,0,0,0,336,40,63,4,330,0,0,0,437,773
111,88,5,158,3,73,0,0,0,239,33,57,1,301,0,0,0,392,631
111,89,12,148,2,83,0,0,0,245,35,28,4,327,0,0,0,394,639
111,90,11,109,0,53,0,0,0,173,22,38,1,251,0,0,0,312,485
111,91,7,89,0,55,0,0,0,151,18,18,1,221,0,0,0,258,409
111,92,1,46,0,44,0,0,0,91,20,15,1,210,0,0,0,246,337
111,93,2,40,1,41,0,0,0,84,11,3,1,173,0,0,0,188,272
111,94,2,32,0,39,0,0,0,73,9,8,1,118,0,0,0,136,209
111,95,4,18,1,18,0,0,0,41,11,2,2,80,0,0,0,95,136
111,96,0,8,0,22,0,0,0,30,8,1,1,62,0,0,0,72,102
111,97,0,8,0,14,0,0,0,22,2,1,0,43,0,0,0,46,68
111,98,1,2,0,10,0,0,0,13,5,0,1,33,0,0,0,39,52
111,99,0,2,0,6,0,0,0,8,1,3,0,20,0,0,0,24,32
111,100,1,3,0,12,0,0,0,16,7,0,0,29,0,0,0,36,52
111,999,33830,37061,1470,2058,6,2,0,74427,29772,37151,1902,10300,4,0,0,79129,153556
112,0,4364,0,0,0,0,0,0,4364,4068,0,0,0,0,0,0,4068,8432
112,1,4608,0,0,0,0,0,0,4608,4292,0,0,0,0,0,0,4292,8900
112,2,4619,0,0,0,0,0,0,4619,4405,0,0,0,0,0,0,4405,9024
112,3,4711,0,0,0,0,0,0,4711,4413,0,0,0,0,0,0,4413,9124
112,4,4848,0,0,0,0,0,0,4848,4545,0,0,0,0,0,0,4545,9393
112,5,4969,0,0,0,0,0,0,4969,4868,0,0,0,0,0,0,4868,9837
112,6,5157,0,0,0,0,0,0,5157,4733,0,0,0,0,0,0,4733,9890
112,7,5104,0,0,0,0,0,0,5104,5003,0,0,0,0,0,0,5003,10107
112,8,5418,0,0,0,0,0,0,5418,5071,0,0,0,0,0,0,5071,10489
112,9,5475,0,0,0,0,0,0,5475,5077,0,0,0,0,0,0,5077,10552
112,10,5327,0,0,0,0,0,0,5327,5018,0,0,0,0,0,0,5018,10345
112,11,5420,0,0,0,0,0,0,5420,5235,0,0,0,0,0,0,5235,10655
112,12,5467,0,0,0,0,0,0,5467,5361,0,0,0,0,0,0,5361,10828
112,13,5619,0,0,0,0,0,0,5619,5347,0,0,0,0,0,0,5347,10966
112,14,5751,0,0,0,0,0,0,5751,5353,0,0,0,0,0,0,5353,11104
112,15,5938,0,0,0,0,0,0,5938,5535,0,0,0,0,0,0,5535,11473
112,16,5745,0,0,0,0,0,0,5745,5529,0,0,0,0,0,0,5529,11274
112,17,6053,0,0,0,0,0,0,6053,5422,0,0,0,0,0,0,5422,11475
112,18,6152,1,0,1,0,0,0,6154,5630,4,0,0,0,0,0,5634,11788
112,19,6267,3,0,0,0,0,0,6270,5634,15,0,1,0,0,0,5650,11920
112,20,5985,8,0,0,0,0,0,5993,5572,35,0,2,0,0,0,5609,11602
112,21,5854,17,0,0,0,0,0,5871,5458,77,0,1,1,0,0,5537,11408
112,22,5791,26,0,0,0,0,0,5817,5365,118,3,1,0,0,0,5487,11304
112,23,5952,61,0,0,1,0,0,6014,5280,237,2,0,2,0,0,5521,11535
112,24,5809,102,1,0,2,0,0,5914,5253,332,5,0,3,0,0,5593,11507
112,25,5693,156,3,0,0,0,0,5852,5049,489,3,1,4,0,0,5546,11398
112,26,5565,270,1,2,2,0,0,5840,4826,678,8,1,0,0,0,5513,11353
112,27,5421,432,1,0,0,0,0,5854,4626,924,10,2,1,0,0,5563,11417
112,28,5098,609,6,0,1,0,0,5714,4350,1274,11,1,3,0,0,5639,11353
112,29,5080,832,8,0,2,0,0,5922,4310,1562,22,2,2,0,0,5898,11820
112,30,4903,1095,11,0,3,0,0,6012,4047,2004,35,4,8,0,0,6098,12110
112,31,5009,1472,11,1,1,0,0,6494,3826,2350,33,5,6,0,0,6220,12714
112,32,4519,1864,21,1,5,1,0,6411,3529,2852,57,7,3,0,0,6448,12859
112,33,4339,2179,28,1,7,0,0,6554,3295,3062,79,20,4,0,0,6460,13014
112,34,3919,2427,41,5,3,0,0,6395,3118,3359,91,18,4,0,0,6590,12985
112,35,3783,2684,67,1,4,0,1,6540,2693,3760,96,17,6,1,0,6573,13113
112,36,3401,2997,73,2,3,0,0,6476,2575,3884,110,17,2,0,0,6588,13064
112,37,3173,3307,74,2,3,0,0,6559,2267,3974,141,21,6,0,0,6409,12968
112,38,2985,3480,89,8,5,0,0,6567,2150,4362,176,25,10,1,0,6724,13291
112,39,2850,3796,115,8,8,0,0,6777,2115,4535,211,42,3,0,0,6906,13683
112,40,2656,3859,134,10,5,0,0,6664,1857,4486,188,38,2,1,0,6572,13236
112,41,2622,4130,156,8,8,0,0,6924,1798,4814,225,50,6,0,0,6893,13817
112,42,2429,4174,158,19,8,1,0,6789,1706,4955,274,52,7,0,0,6994,13783
112,43,2312,4425,177,13,9,1,0,6937,1620,5109,269,72,8,1,0,7079,14016
112,44,2209,4585,178,24,7,0,0,7003,1550,5322,324,83,2,0,0,7281,14284
112,45,2280,4851,215,27,5,0,0,7378,1558,5551,372,102,7,0,0,7590,14968
112,46,2053,5018,256,29,8,0,0,7364,1554,5519,349,109,2,0,0,7533,14897
112,47,2134,5164,269,38,5,0,0,7610,1491,6008,400,124,3,0,0,8026,15636
112,48,1936,5426,271,42,13,2,0,7690,1345,6128,448,142,4,0,0,8067,15757
112,49,2011,5679,323,44,3,0,0,8060,1423,6239,464,168,5,1,0,8300,16360
112,50,1832,5477,339,46,10,0,1,7705,1235,6275,476,194,2,1,0,8183,15888
112,51,1717,5873,339,46,6,0,0,7981,1232,6172,484,212,8,0,0,8108,16089
112,52,1622,5917,334,50,7,0,0,7930,1226,6486,506,207,6,0,0,8431,16361
112,53,1429,5837,364,53,5,0,0,7688,1185,6360,559,266,4,0,0,8374,16062
112,54,1384,6070,344,69,8,0,0,7875,1098,6497,561,337,0,2,0,8495,16370
112,55,1295,6150,386,78,4,0,0,7913,1046,6433,504,372,3,0,0,8358,16271
112,56,1240,6225,370,103,6,0,0,7944,1011,6571,529,419,3,0,0,8533,16477
112,57,1173,6181,395,103,4,0,0,7856,1000,6486,504,451,2,0,0,8443,16299
112,58,1058,6088,417,110,6,0,0,7679,955,6382,528,465,1,1,0,8332,16011
112,59,1010,6341,414,107,7,0,0,7879,962,6451,522,587,2,0,0,8524,16403
112,60,915,6028,358,158,4,0,1,7464,804,6126,476,585,0,0,0,7991,15455
112,61,769,6141,401,137,5,0,0,7453,840,6063,466,681,1,0,0,8051,15504
112,62,758,5942,351,189,2,0,0,7242,792,6050,448,732,0,0,0,8022,15264
112,63,688,5898,340,163,1,0,0,7090,742,5976,409,873,0,0,0,8000,15090
112,64,656,5626,297,207,4,0,0,6790,700,5493,403,886,0,0,0,7482,14272
112,65,569,5489,281,184,3,0,0,6526,635,5299,375,954,0,0,0,7263,13789
112,66,509,5483,257,215,3,1,0,6468,649,5188,367,1060,0,0,1,7265,13733
112,67,485,5274,231,226,2,0,0,6218,564,5007,321,1213,0,0,0,7105,13323
112,68,441,5301,238,260,3,0,0,6243,555,4812,305,1273,0,1,0,6946,13189
112,69,409,5061,223,293,3,0,0,5989,572,4687,332,1372,0,0,0,6963,12952
112,70,362,4857,195,265,2,0,0,5681,480,4187,313,1413,0,0,0,6393,12074
112,71,350,4544,173,308,1,0,0,5376,511,3862,263,1492,1,0,0,6129,11505
112,72,316,4444,153,305,1,0,0,5219,500,3655,205,1532,0,0,0,5892,11111
112,73,288,4463,147,355,3,0,0,5256,516,3589,278,1728,0,0,0,6111,11367
112,74,262,4234,147,352,0,0,0,4995,426,3307,210,1837,1,0,0,5781,10776
112,75,285,4398,123,404,2,0,0,5212,423,3269,205,2181,0,0,0,6078,11290
112,76,245,4115,119,440,1,0,0,4920,398,3052,197,2314,0,0,0,5961,10881
112,77,216,3594,101,431,2,0,0,4344,389,2621,177,2291,0,0,0,5478,9822
112,78,153,2904,70,381,0,0,0,3508,340,1925,118,1969,0,0,0,4352,7860
112,79,163,2577,69,372,0,0,0,3181,331,1680,130,1972,0,0,0,4113,7294
112,80,119,2305,69,393,0,0,0,2886,305,1444,112,2002,0,0,0,3863,6749
112,81,115,2153,38,399,0,0,0,2705,287,1225,80,2090,0,0,0,3682,6387
112,82,90,2055,37,412,0,0,0,2594,266,1069,84,2066,0,0,0,3485,6079
112,83,94,2058,53,473,0,0,0,2678,282,1110,114,2511,0,0,0,4017,6695
112,84,100,1813,28,500,1,0,0,2442,241,848,78,2459,0,0,0,3626,6068
112,85,80,1576,22,456,0,0,0,2134,253,709,64,2260,0,0,0,3286,5420
112,86,61,1228,18,386,0,0,0,1693,198,547,69,1934,0,0,0,2748,4441
112,87,60,1038,18,392,0,0,0,1508,194,370,46,1805,0,0,0,2415,3923
112,88,39,929,20,382,0,0,0,1370,163,295,45,1837,0,0,0,2340,3710
112,89,33,774,12,402,0,0,0,1221,171,229,38,1710,0,0,0,2148,3369
112,90,26,574,11,342,0,0,0,953,156,173,16,1501,0,0,0,1846,2799
112,91,23,432,6,276,0,0,0,737,103,96,25,1131,0,0,0,1355,2092
112,92,16,297,2,208,0,0,0,523,95,82,20,981,0,0,0,1178,1701
112,93,22,230,4,175,1,0,0,432,88,50,19,863,0,0,0,1020,1452
112,94,12,137,2,134,0,0,0,285,74,26,10,608,0,0,0,718,1003
112,95,12,78,2,97,0,0,0,189,47,20,10,475,0,0,0,552,741
112,96,11,46,0,74,0,0,0,131,37,11,3,335,0,0,0,386,517
112,97,5,27,1,41,0,0,0,74,32,9,4,246,0,0,0,291,365
112,98,11,16,2,27,0,0,0,56,24,5,1,165,0,0,0,195,251
112,99,9,10,0,29,0,0,0,48,20,5,2,104,0,0,0,131,179
112,100,15,11,1,33,0,0,0,60,33,9,1,159,0,0,0,202,262
112,999,248335,249448,11009,12327,228,6,3,521356,221331,252311,16418,60238,148,10,1,550457,1071813
113,0,1300,0,0,0,0,0,0,1300,1216,0,0,0,0,0,0,1216,2516
113,1,1416,0,0,0,0,0,0,1416,1280,0,0,0,0,0,0,1280,2696
113,2,1388,0,0,0,0,0,0,1388,1387,0,0,0,0,0,0,1387,2775
113,3,1407,0,0,0,0,0,0,1407,1298,0,0,0,0,0,0,1298,2705
113,4,1427,0,0,0,0,0,0,1427,1291,0,0,0,0,0,0,1291,2718
113,5,1445,0,0,0,0,0,0,1445,1404,0,0,0,0,0,0,1404,2849
113,6,1504,0,0,0,0,0,0,1504,1461,0,0,0,0,0,0,1461,2965
113,7,1541,0,0,0,0,0,0,1541,1425,0,0,0,0,0,0,1425,2966
113,8,1503,0,0,0,0,0,0,1503,1465,0,0,0,0,0,0,1465,2968
113,9,1523,0,0,0,0,0,0,1523,1425,0,0,0,0,0,0,1425,2948
113,10,1543,0,0,0,0,0,0,1543,1427,0,0,0,0,0,0,1427,2970
113,11,1549,0,0,0,0,0,0,1549,1524,0,0,0,0,0,0,1524,3073
113,12,1672,0,0,0,0,0,0,1672,1503,0,0,0,0,0,0,1503,3175
113,13,1642,0,0,0,0,0,0,1642,1536,0,0,0,0,0,0,1536,3178
113,14,1680,0,0,0,0,0,0,1680,1650,0,0,0,0,0,0,1650,3330
113,15,1710,0,0,0,0,0,0,1710,1624,0,0,0,0,0,0,1624,3334
113,16,1641,1,0,0,0,0,0,1642,1548,0,0,0,0,0,0,1548,3190
113,17,1801,0,0,0,0,0,0,1801,1572,0,0,0,0,0,0,1572,3373
113,18,1862,0,0,0,0,0,0,1862,1552,6,0,0,0,0,0,1558,3420
113,19,1863,1,0,0,0,0,0,1864,1603,11,0,0,0,0,0,1614,3478
113,20,1872,0,0,0,0,0,0,1872,1589,30,0,0,0,0,0,1619,3491
113,21,1812,7,0,0,0,0,0,1819,1571,43,0,0,0,0,0,1614,3433
113,22,1828,19,0,1,0,0,0,1848,1583,76,0,0,0,0,0,1659,3507
113,23,2001,24,1,0,0,0,0,2026,1527,106,0,0,0,0,0,1633,3659
113,24,2052,52,0,0,0,0,0,2104,1477,160,0,0,0,0,0,1637,3741
113,25,1882,53,0,0,0,0,0,1935,1433,196,1,0,0,0,0,1630,3565
113,26,1890,101,0,0,1,0,0,1992,1366,362,3,0,1,0,0,1732,3724
113,27,1741,160,3,0,0,0,0,1904,1299,425,0,0,0,0,0,1724,3628
113,28,1749,185,4,0,0,0,0,1938,1220,556,14,0,5,0,0,1795,3733
113,29,1682,310,3,1,1,0,0,1997,1112,549,6,0,1,0,0,1668,3665
113,30,1630,381,5,0,1,0,0,2017,1112,750,13,1,0,0,0,1876,3893
113,31,1541,517,8,0,0,0,0,2066,990,807,15,0,0,0,0,1812,3878
113,32,1367,580,12,1,0,0,0,1960,883,937,26,1,1,0,0,1848,3808
113,33,1359,741,10,0,1,0,0,2111,815,1008,29,2,1,0,0,1855,3966
113,34,1272,773,15,1,1,0,0,2062,722,1086,30,4,4,0,0,1846,3908
113,35,1212,971,23,0,3,0,0,2209,733,1131,27,6,1,0,0,1898,4107
113,36,1119,1000,23,3,0,0,0,2145,708,1252,46,6,2,0,0,2014,4159
113,37,1095,1036,25,2,5,0,0,2163,607,1290,45,8,1,0,0,1951,4114
113,38,915,1161,27,1,0,0,0,2104,540,1317,66,13,2,0,0,1938,4042
113,39,875,1178,34,1,3,0,0,2091,550,1361,64,13,1,0,0,1989,4080
113,40,837,1221,43,3,2,0,0,2106,494,1433,71,10,0,0,0,2008,4114
113,41,877,1353,42,3,6,0,0,2281,478,1490,80,12,1,0,0,2061,4342
113,42,819,1369,53,6,2,0,0,2249,390,1561,72,19,1,0,0,2043,4292
113,43,712,1491,62,4,0,0,0,2269,408,1579,87,19,1,0,0,2094,4363
113,44,696,1397,78,2,1,0,0,2174,399,1513,108,33,2,0,0,2055,4229
113,45,698,1506,73,7,1,0,0,2285,399,1662,118,22,0,0,0,2201,4486
113,46,641,1554,82,3,2,0,0,2282,375,1679,101,24,0,0,0,2179,4461
113,47,660,1670,75,6,1,0,0,2412,348,1832,130,31,0,0,0,2341,4753
113,48,613,1748,89,11,3,0,0,2464,371,1802,142,45,0,0,0,2360,4824
113,49,587,1815,101,6,1,0,0,2510,351,1901,155,50,0,0,0,2457,4967
113,50,537,1772,116,13,2,0,0,2440,343,1817,148,57,2,0,0,2367,4807
113,51,501,1735,108,15,0,0,0,2359,310,1785,143,54,1,0,0,2293,4652
113,52,469,1759,122,17,1,0,0,2368,313,1926,142,57,0,0,0,2438,4806
113,53,357,1850,118,21,1,0,0,2347,278,1826,149,74,0,0,0,2327,4674
113,54,392,1924,117,26,0,0,0,2459,258,1871,160,85,0,0,0,2374,4833
113,55,342,1845,121,27,3,0,0,2338,245,1967,163,102,0,0,0,2477,4815
113,56,315,1888,124,29,4,0,0,2360,254,1934,143,119,0,0,0,2450,4810
113,57,324,1899,115,29,1,0,0,2368,223,1862,148,132,0,0,0,2365,4733
113,58,309,1931,95,21,1,0,0,2357,214,1845,109,135,0,0,0,2303,4660
113,59,264,1898,106,36,0,0,0,2304,209,1778,126,147,0,0,0,2260,4564
113,60,235,1805,93,29,0,0,0,2162,203,1793,120,180,1,0,0,2297,4459
113,61,239,1817,130,36,2,0,0,2224,210,1734,116,176,0,0,0,2236,4460
113,62,204,1782,103,44,1,0,0,2134,194,1716,116,185,0,0,0,2211,4345
113,63,166,1763,81,50,0,0,0,2060,191,1718,107,246,0,0,0,2262,4322
113,64,171,1672,92,59,0,0,0,1994,158,1617,99,254,0,0,0,2128,4122
113,65,143,1540,79,55,0,0,0,1817,150,1457,95,287,0,0,0,1989,3806
113,66,125,1576,56,58,2,0,0,1817,147,1396,86,280,0,0,0,1909,3726
113,67,111,1540,62,62,2,0,0,1777,141,1451,59,321,0,0,0,1972,3749
113,68,110,1497,52,62,2,0,0,1723,114,1329,67,337,0,0,0,1847,3570
113,69,92,1504,58,76,0,0,0,1730,123,1403,71,365,0,0,0,1962,3692
113,70,85,1331,53,64,0,0,0,1533,105,1145,63,423,0,0,0,1736,3269
113,71,82,1259,44,58,1,0,0,1444,127,1115,51,413,0,0,0,1706,3150
113,72,93,1210,35,94,0,0,0,1432,99,1069,44,467,0,0,0,1679,3111
113,73,68,1267,34,93,0,0,0,1462,92,1034,42,492,0,0,0,1660,3122
113,74,72,1373,39,100,0,0,0,1584,114,1029,47,613,0,0,0,1803,3387
113,75,54,1251,36,124,2,0,0,1467,115,1020,44,653,0,0,0,1832,3299
113,76,69,1272,35,118,0,0,0,1494,117,957,42,735,0,0,0,1851,3345
113,77,48,1036,29,113,0,0,0,1226,100,780,41,645,0,0,0,1566,2792
113,78,34,924,18,97,0,0,0,1073,78,563,32,559,0,0,0,1232,2305
113,79,33,808,19,103,0,0,0,963,74,497,22,570,0,0,0,1163,2126
113,80,28,754,17,102,0,0,0,901,68,400,26,661,0,0,0,1155,2056
113,81,29,677,13,102,0,0,0,821,72,383,19,648,0,0,0,1122,1943
113,82,28,679,17,108,0,0,0,832,78,334,16,730,0,0,0,1158,1990
113,83,29,761,21,148,0,0,0,959,87,315,18,843,0,0,0,1263,2222
113,84,30,654,7,138,0,0,0,829,99,235,17,837,0,0,0,1188,2017
113,85,15,524,10,136,0,0,0,685,59,202,8,763,0,0,0,1032,1717
113,86,13,435,6,95,0,0,0,549,56,136,6,631,0,0,0,829,1378
113,87,13,380,5,127,0,0,0,525,55,112,12,621,0,0,0,800,1325
113,88,9,330,2,107,0,0,0,448,46,83,8,536,0,0,0,673,1121
113,89,11,247,2,102,0,0,0,362,39,58,5,493,0,0,0,595,957
113,90,8,171,4,101,0,0,0,284,36,29,8,432,0,0,0,505,789
113,91,5,128,2,81,0,0,0,216,35,20,3,404,0,0,0,462,678
113,92,5,106,0,70,0,0,0,181,32,20,3,318,0,0,0,373,554
113,93,3,61,0,71,0,0,0,135,21,6,2,240,0,0,0,269,404
113,94,4,43,1,43,0,0,0,91,14,9,3,179,0,0,0,205,296
113,95,3,35,0,34,0,0,0,72,13,4,6,133,0,0,0,156,228
113,96,2,19,0,25,0,0,0,46,12,0,2,93,0,0,0,107,153
113,97,2,11,1,20,0,0,0,34,10,5,0,74,0,0,0,89,123
113,98,2,4,0,10,0,0,0,16,11,0,1,56,0,0,0,68,84
113,99,0,3,0,5,0,0,0,8,3,1,0,43,0,0,0,47,55
113,100,0,4,0,9,0,0,0,13,3,3,0,57,0,0,0,63,76
113,999,75734,77129,3289,3425,60,0,0,159637,61189,75700,4407,18274,29,0,0,159599,319236
114,0,1368,0,0,0,0,0,0,1368,1245,0,0,0,0,0,0,1245,2613
114,1,1511,0,0,0,0,0,0,1511,1309,0,0,0,0,0,0,1309,2820
114,2,1490,0,0,0,0,0,0,1490,1475,0,0,0,0,0,0,1475,2965
114,3,1525,0,0,0,0,0,0,1525,1441,0,0,0,0,0,0,1441,2966
114,4,1605,0,0,0,0,0,0,1605,1444,0,0,0,0,0,0,1444,3049
114,5,1598,0,0,0,0,0,0,1598,1533,0,0,0,0,0,0,1533,3131
114,6,1682,0,0,0,0,0,0,1682,1484,0,0,0,0,0,0,1484,3166
114,7,1660,0,0,0,0,0,0,1660,1618,0,0,0,0,0,0,1618,3278
114,8,1729,0,0,0,0,0,0,1729,1588,0,0,0,0,0,0,1588,3317
114,9,1765,0,0,0,0,0,0,1765,1682,0,0,0,0,0,0,1682,3447
114,10,1751,0,0,0,0,0,0,1751,1658,0,0,0,0,0,0,1658,3409
114,11,1926,0,0,0,0,0,0,1926,1729,0,0,0,0,0,0,1729,3655
114,12,1918,0,0,0,0,0,0,1918,1708,0,0,0,0,0,0,1708,3626
114,13,1868,0,0,0,0,0,0,1868,1852,0,0,0,0,0,0,1852,3720
114,14,1995,0,0,0,0,0,0,1995,1790,0,0,0,0,0,0,1790,3785
114,15,1977,0,0,0,0,0,0,1977,1907,0,0,0,0,0,0,1907,3884
114,16,2022,0,0,0,0,0,0,2022,1757,0,0,0,0,0,0,1757,3779
114,17,2099,0,0,0,0,0,0,2099,1843,0,0,0,0,0,0,1843,3942
114,18,2087,0,0,0,0,0,0,2087,1917,3,0,0,0,0,0,1920,4007
114,19,2165,1,0,0,0,0,0,2166,1912,11,0,0,1,0,0,1924,4090
114,20,2145,3,0,0,0,0,0,2148,1907,17,1,0,0,0,0,1925,4073
114,21,2062,6,0,0,0,0,0,2068,1850,19,0,0,1,0,0,1870,3938
114,22,2102,11,0,0,0,0,0,2113,1812,55,0,0,1,0,0,1868,3981
114,23,2096,17,1,0,0,0,0,2114,1845,65,0,1,0,0,0,1911,4025
114,24,2030,39,0,0,0,0,0,2069,1829,97,4,1,1,0,0,1932,4001
114,25,2008,54,2,0,0,0,0,2064,1735,195,2,0,1,0,0,1933,3997
114,26,1908,79,2,0,0,0,0,1989,1684,209,1,0,0,0,0,1894,3883
114,27,1865,110,2,0,0,0,0,1977,1641,270,5,1,2,0,0,1919,3896
114,28,1910,168,0,0,0,0,0,2078,1560,358,2,0,2,0,0,1922,4000
114,29,1823,221,2,0,3,0,0,2049,1336,493,6,2,2,0,0,1839,3888
114,30,1821,290,1,0,2,0,0,2114,1439,604,16,1,3,0,0,2063,4177
114,31,1808,413,5,0,3,0,0,2229,1369,736,13,1,2,0,0,2121,4350
114,32,1625,522,12,0,1,0,0,2160,1256,847,19,4,2,0,0,2128,4288
114,33,1606,591,16,0,1,0,0,2214,1164,975,26,3,6,1,0,2175,4389
114,34,1464,700,11,0,2,0,0,2177,1063,1127,31,2,3,0,0,2226,4403
114,35,1486,808,13,1,5,0,0,2313,999,1155,22,7,2,0,0,2185,4498
114,36,1365,930,22,3,2,0,0,2322,892,1195,50,4,3,0,0,2144,4466
114,37,1251,1035,32,3,3,0,1,2325,865,1319,50,5,5,0,1,2245,4570
114,38,1235,1079,35,2,4,0,0,2355,758,1448,68,5,4,0,0,2283,4638
114,39,1116,1238,39,2,3,0,0,2398,764,1494,70,13,1,0,0,2342,4740
114,40,1055,1306,59,1,1,0,0,2422,691,1584,73,14,2,0,0,2364,4786
114,41,1051,1428,61,3,3,0,0,2546,643,1682,92,21,2,0,1,2441,4987
114,42,989,1453,63,3,1,0,0,2509,609,1691,92,25,6,0,0,2423,4932
114,43,914,1595,73,10,3,0,0,2595,548,1807,137,25,0,0,0,2517,5112
114,44,931,1550,91,7,2,0,0,2581,553,1879,141,22,3,0,0,2598,5179
114,45,917,1668,90,14,2,0,0,2691,557,1989,164,38,2,0,0,2750,5441
114,46,812,1808,110,7,2,1,0,2740,507,2056,160,31,4,0,0,2758,5498
114,47,900,1936,131,10,2,0,0,2979,489,2083,176,40,2,0,0,2790,5769
114,48,809,1967,125,14,4,0,0,2919,470,2178,210,53,3,0,0,2914,5833
114,49,797,2067,153,15,4,0,0,3036,490,2389,205,73,3,0,0,3160,6196
114,50,741,2155,147,16,4,0,0,3063,414,2289,223,60,4,0,0,2990,6053
114,51,721,2040,187,21,3,0,0,2972,410,2337,221,88,0,0,0,3056,6028
114,52,650,2183,163,20,2,0,0,3018,389,2384,222,99,1,0,0,3095,6113
114,53,567,2162,187,23,3,0,0,2942,370,2399,230,122,0,0,0,3121,6063
114,54,553,2315,211,33,2,0,0,3114,337,2335,264,119,0,0,0,3055,6169
114,55,510,2190,184,42,0,0,0,2926,324,2275,224,111,0,0,0,2934,5860
114,56,447,2289,180,39,1,0,0,2956,313,2432,196,132,2,0,0,3075,6031
114,57,432,2254,183,45,3,0,0,2917,254,2380,222,171,0,0,0,3027,5944
114,58,383,2300,174,50,1,0,0,2908,260,2263,204,174,0,0,0,2901,5809
114,59,399,2412,144,49,0,0,0,3004,251,2313,199,212,1,0,0,2976,5980
114,60,330,2306,173,44,0,0,0,2853,261,2351,182,226,0,0,0,3020,5873
114,61,275,2281,165,53,3,0,0,2777,244,2271,175,262,0,0,0,2952,5729
114,62,297,2168,145,56,0,0,0,2666,211,2238,158,288,0,0,0,2895,5561
114,63,246,2185,140,63,1,1,0,2636,203,2119,178,298,0,0,0,2798,5434
114,64,242,2143,149,87,2,0,0,2623,192,2040,122,357,0,0,0,2711,5334
114,65,213,2037,99,78,0,0,0,2427,159,1962,103,388,0,0,0,2612,5039
114,66,214,2005,107,75,4,1,0,2406,177,1866,120,445,0,0,0,2608,5014
114,67,167,1889,103,88,1,0,0,2248,146,1703,89,424,0,0,0,2362,4610
114,68,181,1944,89,110,0,0,0,2324,156,1800,103,503,2,0,0,2564,4888
114,69,152,1871,54,122,2,0,0,2201,152,1776,92,488,0,0,0,2508,4709
114,70,120,1704,71,105,0,0,0,2000,138,1510,70,556,0,0,0,2274,4274
114,71,129,1709,50,115,1,0,0,2004,122,1438,72,564,0,0,0,2196,4200
114,72,122,1645,69,129,0,0,0,1965,124,1395,55,601,0,0,0,2175,4140
114,73,105,1676,61,148,0,0,0,1990,143,1414,75,721,0,0,0,2353,4343
114,74,73,1704,48,117,0,0,0,1942,113,1348,55,755,0,0,0,2271,4213
114,75,111,1768,42,163,0,0,0,2084,124,1321,69,888,1,0,0,2403,4487
114,76,85,1858,52,175,0,0,0,2170,128,1296,45,972,0,0,0,2441,4611
114,77,81,1512,31,181,0,0,0,1805,118,1082,39,934,0,0,0,2173,3978
114,78,55,1303,17,174,0,0,0,1549,113,884,46,837,0,0,0,1880,3429
114,79,47,1130,22,145,0,0,0,1344,71,683,28,867,1,0,0,1650,2994
114,80,56,982,16,155,0,0,0,1209,77,612,18,820,1,0,0,1528,2737
114,81,39,875,19,159,0,0,0,1092,99,504,22,869,0,0,0,1494,2586
114,82,34,829,16,179,0,0,0,1058,85,465,28,865,0,0,0,1443,2501
114,83,41,878,18,195,0,0,0,1132,82,436,14,1046,0,0,0,1578,2710
114,84,36,731,16,184,1,0,0,968,68,346,19,946,0,0,0,1379,2347
114,85,25,635,13,179,0,0,0,852,63,246,14,957,0,0,0,1280,2132
114,86,17,441,8,182,0,0,0,648,63,160,6,695,0,0,0,924,1572
114,87,17,422,7,150,0,0,0,596,40,118,11,669,0,0,0,838,1434
114,88,14,352,3,175,0,0,0,544,48,128,7,654,0,0,0,837,1381
114,89,13,255,4,148,0,0,0,420,42,60,5,573,0,0,0,680,1100
114,90,9,214,2,116,0,0,0,341,29,49,6,481,0,0,0,565,906
114,91,6,162,2,86,0,0,0,256,26,32,5,420,0,0,0,483,739
114,92,4,92,1,97,0,0,0,194,33,25,1,370,0,0,0,429,623
114,93,4,74,1,72,0,0,0,151,23,14,4,319,0,0,0,360,511
114,94,4,46,0,56,0,0,0,106,10,11,0,200,0,0,0,221,327
114,95,3,26,0,36,0,0,0,65,13,8,0,135,0,0,0,156,221
114,96,3,16,0,25,0,0,0,44,10,1,1,105,0,0,0,117,161
114,97,0,14,0,16,0,0,0,30,9,1,2,91,0,0,0,103,133
114,98,0,1,0,11,0,0,0,12,5,1,0,56,0,0,0,62,74
114,99,1,6,1,10,0,0,0,18,5,1,0,42,0,0,0,48,66
114,100,1,7,0,16,0,0,0,24,8,5,1,66,0,0,0,80,104
114,999,88617,91289,4725,4908,87,3,1,189630,73472,91157,6081,23433,82,1,2,194228,383858
115,0,1167,0,0,0,0,0,0,1167,1138,0,0,0,0,0,0,1138,2305
115,1,1293,0,0,0,0,0,0,1293,1213,0,0,0,0,0,0,1213,2506
115,2,1284,0,0,0,0,0,0,1284,1340,0,0,0,0,0,0,1340,2624
115,3,1326,0,0,0,0,0,0,1326,1278,0,0,0,0,0,0,1278,2604
115,4,1425,0,0,0,0,0,0,1425,1452,0,0,0,0,0,0,1452,2877
115,5,1549,0,0,0,0,0,0,1549,1468,0,0,0,0,0,0,1468,3017
115,6,1712,0,0,0,0,0,0,1712,1569,0,0,0,0,0,0,1569,3281
115,7,1710,0,0,0,0,0,0,1710,1637,0,0,0,0,0,0,1637,3347
115,8,1822,0,0,0,0,0,0,1822,1664,0,0,0,0,0,0,1664,3486
115,9,1837,0,0,0,0,0,0,1837,1737,0,0,0,0,0,0,1737,3574
115,10,1869,0,0,0,0,0,0,1869,1732,0,0,0,0,0,0,1732,3601
115,11,2018,0,0,0,0,0,0,2018,1858,0,0,0,0,0,0,1858,3876
115,12,2099,0,0,0,0,0,0,2099,2005,0,0,0,0,0,0,2005,4104
115,13,2210,0,0,0,0,0,0,2210,2036,0,0,0,0,0,0,2036,4246
115,14,2165,0,0,0,0,0,0,2165,2002,0,0,0,0,0,0,2002,4167
115,15,2212,0,0,0,0,0,0,2212,2059,0,0,0,0,0,0,2059,4271
115,16,2207,0,0,0,0,0,0,2207,2077,0,0,0,0,0,0,2077,4284
115,17,2141,0,0,0,0,0,0,2141,2027,0,0,0,0,0,0,2027,4168
115,18,2178,0,0,0,0,0,0,2178,2074,0,0,0,0,0,0,2074,4252
115,19,2180,2,1,0,0,0,0,2183,1990,4,0,0,0,0,0,1994,4177
115,20,2244,0,0,0,0,0,0,2244,2090,4,0,0,0,0,0,2094,4338
115,21,2133,3,0,0,0,0,0,2136,2072,11,0,0,0,0,0,2083,4219
115,22,2133,2,0,0,0,0,0,2135,2032,11,1,0,0,0,0,2044,4179
115,23,2306,5,0,0,1,0,0,2312,2006,15,0,0,0,0,0,2021,4333
115,24,2333,20,0,0,0,0,0,2353,2018,45,2,0,0,0,0,2065,4418
115,25,2209,19,1,0,1,0,0,2230,1974,51,1,0,0,0,0,2026,4256
115,26,2266,26,1,0,0,0,0,2293,1938,95,1,0,0,0,0,2034,4327
115,27,2248,45,2,0,0,0,0,2295,1936,139,2,0,0,0,0,2077,4372
115,28,2245,86,0,1,2,0,0,2334,1829,193,6,0,1,0,0,2029,4363
115,29,2231,123,4,0,1,0,0,2359,1834,259,3,0,0,0,0,2096,4455
115,30,2173,173,4,0,0,0,0,2350,1869,331,11,0,3,1,0,2215,4565
115,31,2247,211,5,0,1,0,0,2464,1858,488,16,0,1,0,0,2363,4827
115,32,2212,293,12,0,1,0,0,2518,1755,561,15,4,4,1,0,2340,4858
115,33,2088,426,9,1,7,1,0,2532,1724,680,27,3,2,0,0,2436,4968
115,34,2122,471,19,1,4,0,0,2617,1581,844,36,6,1,0,0,2468,5085
115,35,2000,545,17,0,4,0,0,2566,1528,949,59,5,4,1,0,2546,5112
115,36,1973,683,17,1,3,1,0,2678,1490,1033,47,6,2,0,0,2578,5256
115,37,1885,799,28,1,3,0,0,2716,1405,1103,89,7,1,0,0,2605,5321
115,38,1819,886,43,0,4,0,0,2752,1337,1300,84,15,0,0,0,2736,5488
115,39,1785,950,60,1,3,0,0,2799,1209,1373,110,11,2,1,0,2706,5505
115,40,1625,1077,66,3,2,0,0,2773,1301,1417,111,14,2,0,0,2845,5618
115,41,1703,1253,75,4,1,0,0,3036,1256,1512,149,27,1,0,0,2945,5981
115,42,1684,1293,85,3,5,0,0,3070,1174,1625,181,21,0,0,0,3001,6071
115,43,1647,1502,112,8,3,0,0,3272,1148,1723,195,23,4,0,0,3093,6365
115,44,1558,1529,113,10,0,0,0,3210,1233,1847,205,25,1,0,0,3311,6521
115,45,1702,1756,138,12,3,0,0,3611,1161,2075,217,30,3,0,0,3486,7097
115,46,1664,1855,170,8,5,0,0,3702,1122,2133,243,30,1,1,0,3530,7232
115,47,1636,2020,193,10,6,0,0,3865,1108,2281,299,54,4,0,0,3746,7611
115,48,1704,2120,239,13,4,0,0,4080,1177,2440,295,62,5,0,0,3979,8059
115,49,1680,2252,252,17,5,0,0,4206,1116,2540,315,78,2,1,0,4052,8258
115,50,1629,2395,250,18,2,0,0,4294,1097,2605,370,80,1,0,0,4153,8447
115,51,1445,2352,273,20,9,0,0,4099,986,2598,364,94,2,0,0,4044,8143
115,52,1319,2372,248,23,2,0,0,3964,945,2692,397,104,1,0,0,4139,8103
115,53,1242,2453,330,23,3,0,0,4051,886,2626,383,109,2,0,0,4006,8057
115,54,1238,2489,333,38,3,0,0,4101,853,2690,367,166,1,0,0,4077,8178
115,55,1078,2574,317,47,3,0,0,4019,790,2732,377,144,2,0,0,4045,8064
115,56,1005,2613,334,33,4,0,0,3989,757,2785,354,186,2,0,0,4084,8073
115,57,983,2663,333,48,1,0,0,4028,750,2856,377,181,3,0,0,4167,8195
115,58,916,2847,336,48,2,0,0,4149,723,2845,364,206,0,0,0,4138,8287
115,59,830,2793,360,50,2,0,0,4035,669,2947,378,244,2,0,0,4240,8275
115,60,736,2681,333,52,2,0,0,3804,614,2808,323,327,1,0,0,4073,7877
115,61,683,2709,330,73,2,1,0,3798,534,2639,312,312,1,0,0,3798,7596
115,62,589,2670,281,71,4,0,0,3615,513,2666,289,320,0,0,0,3788,7403
115,63,558,2663,271,97,3,0,0,3592,468,2577,267,386,2,0,0,3700,7292
115,64,498,2527,216,87,4,1,0,3333,433,2450,264,404,0,0,0,3551,6884
115,65,445,2522,206,99,0,0,0,3272,399,2489,221,426,1,0,0,3536,6808
115,66,424,2532,197,93,3,0,1,3250,362,2365,222,477,0,0,0,3426,6676
115,67,420,2416,178,125,5,0,0,3144,360,2225,209,485,1,0,0,3280,6424
115,68,385,2354,190,132,5,0,0,3066,361,2151,175,551,3,0,0,3241,6307
115,69,409,2351,176,142,3,0,0,3081,340,2130,176,581,0,0,0,3227,6308
115,70,341,2216,170,118,1,0,0,2846,321,1959,150,521,0,0,0,2951,5797
115,71,314,2129,132,141,0,0,0,2716,349,1905,130,643,0,0,0,3027,5743
115,72,285,2076,113,155,2,0,0,2631,298,1866,108,743,0,0,0,3015,5646
115,73,260,2147,98,169,1,0,0,2675,319,1744,115,774,0,0,0,2952,5627
115,74,249,2047,104,193,0,0,1,2594,261,1690,96,792,0,0,0,2839,5433
115,75,244,1947,102,192,0,0,0,2485,307,1675,100,856,0,0,0,2938,5423
115,76,218,1931,92,196,0,0,0,2437,275,1463,84,927,1,0,0,2750,5187
115,77,185,1790,88,201,0,0,0,2264,239,1313,87,935,0,0,0,2574,4838
115,78,148,1562,53,177,0,0,0,1940,251,1148,60,950,0,0,0,2409,4349
115,79,173,1489,44,206,2,0,0,1914,241,1077,59,995,0,0,0,2372,4286
115,80,124,1354,37,203,3,0,0,1721,224,898,48,1063,0,0,0,2233,3954
115,81,140,1288,36,222,0,0,0,1686,204,849,44,1145,0,0,0,2242,3928
115,82,116,1109,30,216,0,0,0,1471,229,683,40,1121,0,0,0,2073,3544
115,83,148,1128,37,260,1,0,0,1574,226,652,29,1237,0,0,0,2144,3718
115,84,110,976,25,251,0,0,0,1362,197,542,38,1187,0,0,0,1964,3326
115,85,95,815,22,223,0,0,0,1155,219,389,21,1099,0,0,0,1728,2883
115,86,83,660,16,208,0,0,0,967,169,337,17,1043,0,0,0,1566,2533
115,87,61,570,18,214,0,0,0,863,173,252,11,843,0,0,0,1279,2142
115,88,67,419,6,175,0,0,0,667,162,162,12,848,0,0,0,1184,1851
115,89,71,394,5,202,0,0,0,672,137,130,10,812,0,0,0,1089,1761
115,90,55,288,3,161,0,0,0,507,118,100,11,705,0,0,0,934,1441
115,91,39,248,2,135,0,0,0,424,116,72,5,552,0,0,0,745,1169
115,92,32,174,4,119,0,0,0,329,97,37,4,491,0,0,0,629,958
115,93,21,132,2,100,0,0,0,255,74,31,2,450,0,0,0,557,812
115,94,13,74,0,85,0,0,0,172,74,24,0,331,0,0,0,429,601
115,95,13,55,1,55,0,0,0,124,45,10,3,243,0,0,0,301,425
115,96,6,36,1,36,0,0,0,79,28,10,0,172,0,0,0,210,289
115,97,9,24,0,23,0,0,0,56,37,2,1,121,0,0,0,161,217
115,98,0,16,0,15,0,0,0,31,22,2,0,80,0,0,0,104,135
115,99,1,7,0,11,0,0,0,19,7,3,1,79,0,0,0,90,109
115,100,1,6,0,15,0,0,0,22,16,2,1,105,0,0,0,124,146
115,999,116113,102508,8399,6090,141,4,2,233257,99912,101985,10196,28067,70,6,0,240236,473493
116,0,525,0,0,0,0,0,0,525,464,0,0,0,0,0,0,464,989
116,1,540,0,0,0,0,0,0,540,467,0,0,0,0,0,0,467,1007
116,2,577,0,0,0,0,0,0,577,534,0,0,0,0,0,0,534,1111
116,3,553,0,0,0,0,0,0,553,551,0,0,0,0,0,0,551,1104
116,4,642,0,0,0,0,0,0,642,579,0,0,0,0,0,0,579,1221
116,5,676,0,0,0,0,0,0,676,604,0,0,0,0,0,0,604,1280
116,6,700,0,0,0,0,0,0,700,673,0,0,0,0,0,0,673,1373
116,7,693,0,0,0,0,0,0,693,685,0,0,0,0,0,0,685,1378
116,8,735,0,0,0,0,0,0,735,699,0,0,0,0,0,0,699,1434
116,9,777,0,0,0,0,0,0,777,740,0,0,0,0,0,0,740,1517
116,10,825,0,0,0,0,0,0,825,746,0,0,0,0,0,0,746,1571
116,11,862,0,0,0,0,0,0,862,769,0,0,0,0,0,0,769,1631
116,12,860,0,0,0,0,0,0,860,844,0,0,0,0,0,0,844,1704
116,13,938,0,0,0,0,0,0,938,846,0,0,0,0,0,0,846,1784
116,14,969,0,0,0,0,0,0,969,797,0,0,0,0,0,0,797,1766
116,15,925,0,0,0,0,0,0,925,866,0,0,0,0,0,0,866,1791
116,16,921,0,0,0,0,0,0,921,826,0,0,0,0,0,0,826,1747
116,17,975,0,0,0,0,0,0,975,859,0,0,0,0,0,0,859,1834
116,18,979,0,0,1,0,0,0,980,914,0,0,0,0,0,0,914,1894
116,19,977,0,0,0,0,0,0,977,860,1,0,0,0,0,0,861,1838
116,20,991,0,0,0,0,0,0,991,887,0,0,0,0,0,0,887,1878
116,21,912,0,0,0,0,0,0,912,862,1,0,0,0,0,0,863,1775
116,22,1009,1,0,0,0,0,0,1010,932,5,0,0,0,0,0,937,1947
116,23,1006,3,0,0,0,0,0,1009,909,10,0,0,0,0,0,919,1928
116,24,1000,1,0,0,0,0,0,1001,877,13,3,0,0,0,0,893,1894
116,25,981,4,2,0,0,0,0,987,896,17,0,0,0,0,0,913,1900
116,26,1006,16,0,0,0,0,0,1022,858,31,0,0,0,0,0,889,1911
116,27,986,12,0,0,1,0,0,999,826,53,0,0,0,0,0,879,1878
116,28,1038,39,0,0,0,0,0,1077,841,74,0,0,0,0,0,915,1992
116,29,1004,41,0,0,1,0,0,1046,799,83,2,0,0,0,0,884,1930
116,30,949,48,1,0,0,0,0,998,774,130,6,0,0,0,0,910,1908
116,31,968,69,3,0,0,0,0,1040,708,192,1,0,0,0,0,901,1941
116,32,971,95,4,0,1,0,0,1071,743,221,3,3,0,0,0,970,2041
116,33,925,131,3,0,1,0,0,1060,696,298,9,2,1,1,0,1007,2067
116,34,863,170,3,0,2,0,0,1038,633,289,11,1,0,1,0,935,1973
116,35,888,238,5,0,0,0,0,1131,614,372,17,4,0,0,0,1007,2138
116,36,708,245,9,2,0,0,0,964,569,367,19,3,2,0,0,960,1924
116,37,745,285,12,0,1,0,0,1043,544,455,17,2,0,0,0,1018,2061
116,38,744,331,13,1,1,0,0,1090,481,470,23,6,0,0,0,980,2070
116,39,753,348,11,3,1,0,0,1116,493,483,23,2,1,0,0,1002,2118
116,40,720,382,10,0,0,0,0,1112,497,541,40,9,0,1,0,1088,2200
116,41,687,437,23,0,0,0,0,1147,446,582,36,5,0,0,0,1069,2216
116,42,658,481,20,1,1,0,0,1161,434,652,47,9,0,0,0,1142,2303
116,43,668,565,25,3,2,0,0,1263,414,645,43,10,1,0,0,1113,2376
116,44,698,540,33,2,2,0,0,1275,376,706,52,13,0,0,0,1147,2422
116,45,683,647,44,6,0,0,0,1380,419,867,71,11,1,0,0,1369,2749
116,46,674,701,49,5,0,0,0,1429,374,839,70,21,1,0,0,1305,2734
116,47,708,693,42,1,1,0,0,1445,400,889,89,24,0,0,0,1402,2847
116,48,673,734,47,4,3,0,0,1461,377,918,82,22,1,0,0,1400,2861
116,49,668,856,66,5,1,0,0,1596,348,937,80,36,0,0,0,1401,2997
116,50,588,852,71,5,1,0,0,1517,357,1014,84,45,0,0,0,1500,3017
116,51,599,839,86,7,0,0,0,1531,329,1015,100,54,0,0,0,1498,3029
116,52,537,961,69,7,0,0,0,1574,330,1057,99,31,1,0,0,1518,3092
116,53,536,926,89,5,0,0,0,1556,317,1061,99,46,0,0,0,1523,3079
116,54,545,996,111,10,1,0,0,1663,325,1126,99,66,0,0,0,1616,3279
116,55,528,1009,91,14,0,0,0,1642,307,1101,103,78,0,0,0,1589,3231
116,56,532,1091,88,13,1,0,0,1725,305,1175,107,91,1,0,0,1679,3404
116,57,478,1152,101,17,2,0,0,1750,297,1226,105,94,0,0,0,1722,3472
116,58,457,1104,72,17,2,0,0,1652,290,1149,84,111,0,0,0,1634,3286
116,59,378,1245,107,22,0,0,0,1752,302,1249,97,135,0,0,0,1783,3535
116,60,356,1134,81,23,0,0,0,1594,305,1151,69,133,0,0,0,1658,3252
116,61,341,1138,92,32,0,0,0,1603,284,1107,78,162,0,0,0,1631,3234
116,62,361,1073,88,29,0,0,0,1551,245,1172,70,178,0,0,0,1665,3216
116,63,312,1070,70,34,0,0,0,1486,225,1068,49,153,0,0,0,1495,2981
116,64,293,1088,73,31,0,0,0,1485,194,1082,73,163,0,0,0,1512,2997
116,65,286,1072,64,39,0,0,0,1461,217,989,54,197,0,0,0,1457,2918
116,66,248,1035,50,35,1,0,0,1369,224,1013,58,220,1,0,0,1516,2885
116,67,269,1024,53,54,0,0,0,1400,218,990,49,251,0,0,0,1508,2908
116,68,230,1011,45,44,0,0,0,1330,230,965,41,250,0,0,0,1486,2816
116,69,235,1014,64,48,0,0,0,1361,204,928,47,276,0,0,0,1455,2816
116,70,198,935,42,48,0,0,0,1223,209,813,39,263,0,0,0,1324,2547
116,71,211,992,39,55,0,0,0,1297,190,799,26,305,0,0,0,1320,2617
116,72,181,872,31,50,0,0,0,1134,164,730,36,337,1,0,0,1268,2402
116,73,167,861,28,77,0,0,0,1133,175,711,22,395,0,0,0,1303,2436
116,74,149,837,24,57,0,0,0,1067,159,663,20,366,0,0,0,1208,2275
116,75,154,849,38,66,0,0,0,1107,170,654,27,421,0,0,0,1272,2379
116,76,147,759,14,51,0,0,0,971,145,555,18,435,0,0,0,1153,2124
116,77,121,687,22,79,0,0,0,909,151,469,17,448,0,0,0,1085,1994
116,78,122,631,19,80,0,0,0,852,162,467,10,455,0,0,0,1094,1946
116,79,116,624,19,77,0,0,0,836,169,416,14,515,0,0,0,1114,1950
116,80,96,535,15,63,0,0,0,709,162,356,8,512,0,0,0,1038,1747
116,81,92,534,11,81,0,0,0,718,140,347,9,534,0,0,0,1030,1748
116,82,73,472,6,56,0,0,0,607,121,258,8,539,0,0,0,926,1533
116,83,86,491,9,76,0,0,0,662,155,261,9,614,0,0,0,1039,1701
116,84,64,433,7,89,0,0,0,593,157,200,1,576,0,0,0,934,1527
116,85,68,370,1,80,0,0,0,519,146,169,4,549,0,0,0,868,1387
116,86,49,259,2,93,0,0,0,403,126,117,5,469,0,0,0,717,1120
116,87,34,275,0,81,0,0,0,390,126,106,4,471,0,0,0,707,1097
116,88,32,220,5,56,0,0,0,313,117,76,1,425,0,0,0,619,932
116,89,29,169,1,73,0,0,0,272,112,43,5,378,0,0,0,538,810
116,90,17,161,4,64,0,0,0,246,90,35,7,339,0,0,0,471,717
116,91,21,119,0,49,0,0,0,189,81,35,0,316,0,0,0,432,621
116,92,14,96,0,50,0,0,0,160,52,13,2,257,0,0,0,324,484
116,93,9,65,0,58,0,0,0,132,50,18,2,229,0,0,0,299,431
116,94,12,47,0,35,0,0,0,94,54,14,0,162,0,0,0,230,324
116,95,9,40,0,30,0,0,0,79,39,4,1,150,0,0,0,194,273
116,96,5,23,1,13,0,0,0,42,23,3,0,88,0,0,0,114,156
116,97,0,13,0,23,0,0,0,36,17,2,0,87,0,0,0,106,142
116,98,3,7,0,18,0,0,0,28,9,1,0,60,0,0,0,70,98
116,99,0,2,0,12,0,0,0,14,5,3,0,39,0,0,0,47,61
116,100,2,5,0,18,0,0,0,25,15,3,0,68,0,0,0,86,111
116,999,51323,41330,2328,2278,27,0,0,97286,42346,41120,2604,13719,12,3,0,99804,197090
117,0,965,0,0,0,0,0,0,965,887,0,0,0,0,0,0,887,1852
117,1,1062,0,0,0,0,0,0,1062,987,0,0,0,0,0,0,987,2049
117,2,1128,0,0,0,0,0,0,1128,1075,0,0,0,0,0,0,1075,2203
117,3,1140,0,0,0,0,0,0,1140,1032,0,0,0,0,0,0,1032,2172
117,4,1191,0,0,0,0,0,0,1191,1185,0,0,0,0,0,0,1185,2376
117,5,1229,0,0,0,0,0,0,1229,1159,0,0,0,0,0,0,1159,2388
117,6,1397,0,0,0,0,0,0,1397,1280,0,0,0,0,0,0,1280,2677
117,7,1518,0,0,0,0,0,0,1518,1345,0,0,0,0,0,0,1345,2863
117,8,1659,0,0,0,0,0,0,1659,1481,0,0,0,0,0,0,1481,3140
117,9,1624,0,0,0,0,0,0,1624,1485,0,0,0,0,0,0,1485,3109
117,10,1647,0,0,0,0,0,0,1647,1540,0,0,0,0,0,0,1540,3187
117,11,1813,0,0,0,0,0,0,1813,1707,0,0,0,0,0,0,1707,3520
117,12,1792,0,0,0,0,0,0,1792,1679,0,0,0,0,0,0,1679,3471
117,13,1864,0,0,0,0,0,0,1864,1770,0,0,0,0,0,0,1770,3634
117,14,1959,0,0,0,0,0,0,1959,1756,0,0,0,0,0,0,1756,3715
117,15,1868,0,0,0,0,0,0,1868,1788,0,0,0,0,0,0,1788,3656
117,16,1824,2,0,0,0,0,0,1826,1771,0,0,0,0,0,0,1771,3597
117,17,1945,0,0,0,0,0,0,1945,1788,0,0,0,0,0,0,1788,3733
117,18,1910,0,0,0,0,0,0,1910,1710,0,0,0,0,0,0,1710,3620
117,19,1845,0,0,0,0,0,0,1845,1743,1,0,0,0,0,0,1744,3589
117,20,1943,1,0,0,0,0,0,1944,1807,0,0,0,0,0,0,1807,3751
117,21,1836,1,0,0,0,0,0,1837,1721,5,0,0,0,0,0,1726,3563
117,22,1908,5,0,0,0,0,0,1913,1813,9,0,0,0,0,0,1822,3735
117,23,1933,3,0,0,0,0,0,1936,1758,13,1,0,0,0,0,1772,3708
117,24,1895,5,0,0,0,0,0,1900,1703,27,0,1,0,0,0,1731,3631
117,25,1897,16,0,0,2,0,0,1915,1587,31,1,0,0,0,0,1619,3534
117,26,1797,18,3,0,1,0,0,1819,1621,54,0,0,2,0,0,1677,3496
117,27,1846,42,1,0,0,0,0,1889,1610,90,1,0,3,0,0,1704,3593
117,28,1933,60,2,0,2,0,0,1997,1609,131,4,0,2,0,0,1746,3743
117,29,1934,96,4,0,3,0,0,2037,1661,188,3,1,1,0,0,1854,3891
117,30,1849,120,0,0,3,0,0,1972,1670,258,6,0,0,0,0,1934,3906
117,31,1902,162,7,0,5,0,0,2076,1644,356,13,1,2,0,0,2016,4092
117,32,1915,239,6,0,3,0,0,2163,1642,427,22,2,3,0,0,2096,4259
117,33,2014,362,9,0,2,0,0,2387,1657,540,21,2,4,0,0,2224,4611
117,34,1842,408,9,1,3,0,0,2263,1580,588,26,3,6,0,0,2203,4466
117,35,1900,494,17,1,2,0,0,2414,1523,724,42,10,2,0,0,2301,4715
117,36,1776,525,22,1,5,0,0,2329,1444,835,55,3,4,0,0,2341,4670
117,37,1671,607,29,2,6,0,1,2316,1467,881,61,4,6,1,0,2420,4736
117,38,1675,713,37,1,4,0,0,2430,1455,938,64,5,8,0,0,2470,4900
117,39,1635,849,44,2,8,0,0,2538,1354,1000,80,4,4,0,0,2442,4980
117,40,1683,912,50,3,6,0,0,2654,1301,1180,109,9,3,0,0,2602,5256
117,41,1638,1048,53,2,6,0,0,2747,1332,1346,116,9,3,0,0,2806,5553
117,42,1555,1019,79,5,4,0,0,2662,1281,1448,134,23,4,1,1,2892,5554
117,43,1560,1244,75,0,8,1,0,2888,1264,1460,144,13,5,1,0,2887,5775
117,44,1568,1252,107,7,10,0,0,2944,1201,1535,158,18,1,0,0,2913,5857
117,45,1507,1454,116,9,6,0,0,3092,1259,1663,199,27,7,1,0,3156,6248
117,46,1593,1513,121,3,8,1,0,3239,1222,1802,213,31,2,0,0,3270,6509
117,47,1579,1602,155,6,7,0,0,3349,1235,1935,221,36,1,0,0,3428,6777
117,48,1590,1821,195,13,5,0,0,3624,1256,2152,264,39,3,0,0,3714,7338
117,49,1619,1977,229,9,5,0,0,3839,1300,2211,291,48,6,1,0,3857,7696
117,50,1571,2067,245,13,8,0,0,3904,1139,2295,311,67,4,0,0,3816,7720
117,51,1398,2082,215,27,5,0,0,3727,1146,2296,385,67,1,0,0,3895,7622
117,52,1261,2049,254,26,7,0,0,3597,1080,2422,339,85,1,0,0,3927,7524
117,53,1194,2135,262,22,4,0,0,3617,950,2333,350,101,3,0,0,3737,7354
117,54,1148,2131,302,20,6,0,0,3607,857,2490,351,106,0,0,0,3804,7411
117,55,975,2192,258,22,5,0,0,3452,874,2431,384,110,0,0,0,3799,7251
117,56,1026,2277,283,33,5,0,0,3624,808,2464,353,124,5,0,0,3754,7378
117,57,912,2317,278,45,5,0,0,3557,801,2461,374,139,2,0,0,3777,7334
117,58,794,2432,303,58,2,0,0,3589,776,2559,387,194,3,0,0,3919,7508
117,59,802,2502,296,44,1,1,0,3646,675,2614,331,201,2,0,1,3824,7470
117,60,643,2376,327,44,2,0,0,3392,684,2420,346,226,0,0,0,3676,7068
117,61,559,2310,290,65,2,0,0,3226,578,2399,364,225,2,0,0,3568,6794
117,62,510,2214,230,61,4,0,0,3019,562,2335,313,274,0,0,0,3484,6503
117,63,440,2245,251,71,2,0,0,3009,518,2168,288,273,1,0,0,3248,6257
117,64,407,2190,238,86,2,0,0,2923,505,2218,307,330,0,0,0,3360,6283
117,65,332,2159,218,70,2,0,0,2781,428,2068,290,321,2,0,0,3109,5890
117,66,335,2118,203,84,2,1,0,2743,437,2108,255,401,0,0,0,3201,5944
117,67,290,2116,181,94,3,0,0,2684,359,2172,248,429,1,0,0,3209,5893
117,68,259,2075,176,94,2,0,0,2606,367,1933,192,431,1,0,0,2924,5530
117,69,223,2038,156,119,2,0,0,2538,392,1989,238,448,0,0,0,3067,5605
117,70,178,1914,157,123,1,0,0,2373,352,1813,203,515,0,0,0,2883,5256
117,71,182,1894,122,128,2,0,0,2328,290,1761,195,524,1,0,0,2771,5099
117,72,163,1806,120,114,1,0,0,2204,296,1717,169,544,0,0,0,2726,4930
117,73,139,1822,137,166,1,0,0,2265,291,1594,176,668,0,0,0,2729,4994
117,74,142,1782,76,148,0,0,0,2148,257,1575,142,674,0,0,0,2648,4796
117,75,126,1754,94,154,0,0,0,2128,259,1554,148,719,0,0,0,2680,4808
117,76,100,1679,100,178,0,0,1,2058,274,1414,114,800,0,0,0,2602,4660
117,77,78,1639,68,185,0,0,0,1970,257,1186,109,766,0,0,0,2318,4288
117,78,102,1432,41,169,0,0,0,1744,211,1098,104,842,0,0,0,2255,3999
117,79,69,1237,57,181,0,0,0,1544,206,928,66,722,0,0,0,1922,3466
117,80,58,1094,48,165,0,0,0,1365,198,827,61,885,0,0,0,1971,3336
117,81,72,1151,52,212,0,0,0,1487,204,789,52,950,0,0,0,1995,3482
117,82,42,1040,42,186,0,0,0,1310,200,701,56,925,0,0,0,1882,3192
117,83,57,1034,30,224,0,0,0,1345,203,611,61,1046,0,0,0,1921,3266
117,84,52,900,22,194,0,0,0,1168,185,497,50,935,0,0,0,1667,2835
117,85,49,743,14,169,0,0,0,975,148,386,41,853,0,0,0,1428,2403
117,86,40,586,20,198,0,0,0,844,136,328,28,821,0,0,0,1313,2157
117,87,33,518,18,181,0,0,0,750,128,244,17,823,0,0,0,1212,1962
117,88,17,376,7,147,0,0,0,547,121,192,17,691,0,0,0,1021,1568
117,89,13,329,6,145,0,0,0,493,106,158,18,707,0,0,0,989,1482
117,90,17,281,4,143,0,0,0,445,100,112,18,611,0,0,0,841,1286
117,91,15,202,2,99,0,0,0,318,90,77,5,478,0,0,0,650,968
117,92,10,154,2,108,0,0,0,274,64,43,10,434,0,0,0,551,825
117,93,10,132,1,83,0,0,0,226,48,31,2,400,0,0,0,481,707
117,94,5,71,1,61,0,0,0,138,56,25,7,328,0,0,1,417,555
117,95,2,35,1,52,0,0,0,90,48,18,2,236,0,0,0,304,394
117,96,3,34,0,37,0,0,0,74,28,9,3,184,0,0,0,224,298
117,97,0,21,0,18,0,0,0,39,26,5,0,116,0,0,0,147,186
117,98,2,10,0,11,0,0,0,23,13,2,1,85,0,0,0,101,124
117,99,2,6,0,10,0,0,0,18,11,0,1,49,0,0,0,61,79
117,100,1,6,0,20,0,0,0,27,12,2,1,86,0,0,0,101,128
117,999,101231,88277,7578,5172,190,4,2,202454,92899,89700,10532,23258,111,5,3,216508,418962
118,0,973,0,0,0,0,0,0,973,1015,0,0,0,0,0,0,1015,1988
118,1,1076,0,0,0,0,0,0,1076,961,0,0,0,0,0,0,961,2037
118,2,1097,0,0,0,0,0,0,1097,1066,0,0,0,0,0,0,1066,2163
118,3,1096,0,0,0,0,0,0,1096,1075,0,0,0,0,0,0,1075,2171
118,4,1149,0,0,0,0,0,0,1149,1112,0,0,0,0,0,0,1112,2261
118,5,1224,0,0,0,0,0,0,1224,1110,0,0,0,0,0,0,1110,2334
118,6,1257,0,0,0,0,0,0,1257,1174,0,0,0,0,0,0,1174,2431
118,7,1317,0,0,0,0,0,0,1317,1267,0,0,0,0,0,0,1267,2584
118,8,1329,0,0,0,0,0,0,1329,1246,0,0,0,0,0,0,1246,2575
118,9,1426,0,0,0,0,0,0,1426,1318,0,0,0,0,0,0,1318,2744
118,10,1406,0,0,0,0,0,0,1406,1422,0,0,0,0,0,0,1422,2828
118,11,1469,0,0,0,0,0,0,1469,1358,0,0,0,0,0,0,1358,2827
118,12,1577,0,0,0,0,0,0,1577,1368,0,0,0,0,0,0,1368,2945
118,13,1564,0,0,0,0,0,0,1564,1453,0,0,0,0,0,0,1453,3017
118,14,1646,0,0,0,0,0,0,1646,1503,0,0,0,0,0,0,1503,3149
118,15,1613,0,0,0,0,0,0,1613,1490,0,0,0,0,0,0,1490,3103
118,16,1627,0,0,0,0,0,0,1627,1530,0,0,0,0,0,0,1530,3157
118,17,1594,0,0,0,0,0,0,1594,1482,0,0,0,0,0,0,1482,3076
118,18,1537,0,0,0,0,0,0,1537,1437,1,0,0,0,0,0,1438,2975
118,19,1557,0,0,0,1,0,0,1558,1519,6,0,0,0,0,0,1525,3083
118,20,1541,1,0,0,0,0,0,1542,1392,12,0,0,0,0,0,1404,2946
118,21,1527,2,0,0,0,0,0,1529,1376,22,0,0,0,0,0,1398,2927
118,22,1626,4,0,0,0,0,0,1630,1347,46,0,0,0,0,0,1393,3023
118,23,1617,17,3,0,0,0,0,1637,1427,79,1,0,0,0,0,1507,3144
118,24,1614,25,1,0,0,0,0,1640,1341,99,4,0,0,0,0,1444,3084
118,25,1580,50,1,0,1,0,0,1632,1273,155,1,1,1,0,0,1431,3063
118,26,1526,78,3,0,1,0,0,1608,1229,175,1,0,0,1,0,1406,3014
118,27,1615,86,2,0,0,0,0,1703,1193,249,6,0,0,0,0,1448,3151
118,28,1411,150,3,0,1,0,0,1565,1046,286,4,1,1,1,0,1339,2904
118,29,1461,188,3,0,1,0,0,1653,1022,355,8,4,0,0,0,1389,3042
118,30,1338,253,5,0,0,0,0,1596,986,426,6,0,1,1,0,1420,3016
118,31,1350,335,6,0,4,0,0,1695,967,526,14,0,2,0,0,1509,3204
118,32,1303,365,8,2,2,0,0,1680,890,658,20,2,0,0,0,1570,3250
118,33,1230,466,11,6,0,0,0,1713,849,698,16,1,2,0,0,1566,3279
118,34,1143,514,10,4,1,0,0,1672,791,741,22,1,3,0,0,1558,3230
118,35,1092,572,15,3,1,0,0,1683,755,863,33,3,2,0,0,1656,3339
118,36,967,670,17,1,3,0,0,1658,641,866,49,6,0,0,0,1562,3220
118,37,910,720,34,0,1,0,0,1665,647,947,64,10,1,0,0,1669,3334
118,38,905,764,32,0,1,0,0,1702,657,1015,54,7,0,0,0,1733,3435
118,39,866,899,33,1,5,0,0,1804,615,1002,73,4,3,1,0,1698,3502
118,40,887,854,41,5,0,0,0,1787,595,1054,79,8,0,0,0,1736,3523
118,41,853,999,49,1,0,0,0,1902,629,1182,116,13,1,0,0,1941,3843
118,42,876,1061,58,8,0,0,0,2003,578,1190,110,13,0,0,0,1891,3894
118,43,833,1115,69,8,3,0,0,2028,600,1211,125,19,0,1,0,1956,3984
118,44,840,1168,85,8,0,0,0,2101,553,1276,114,30,3,0,0,1976,4077
118,45,933,1278,89,6,1,0,0,2307,592,1341,163,33,1,0,0,2130,4437
118,46,851,1342,115,7,1,0,0,2316,551,1415,158,21,2,0,0,2147,4463
118,47,898,1389,107,6,3,0,0,2403,572,1496,165,46,1,1,0,2281,4684
118,48,901,1410,133,10,5,0,0,2459,591,1574,186,37,0,0,0,2388,4847
118,49,857,1552,155,18,3,0,0,2585,557,1729,267,49,0,0,0,2602,5187
118,50,832,1574,134,9,2,0,0,2551,520,1665,241,44,1,0,0,2471,5022
118,51,723,1577,174,11,1,0,0,2486,475,1855,239,53,0,0,0,2622,5108
118,52,728,1618,202,24,1,0,0,2573,483,1738,245,66,0,0,0,2532,5105
118,53,693,1567,211,13,1,0,0,2485,493,1791,266,77,0,0,0,2627,5112
118,54,676,1682,207,19,3,0,0,2587,459,1785,257,75,0,0,0,2576,5163
118,55,624,1798,197,28,1,0,0,2648,461,1798,256,96,2,0,0,2613,5261
118,56,561,1767,210,29,3,0,0,2570,415,1827,292,96,0,1,0,2631,5201
118,57,497,1683,216,34,3,0,0,2433,396,1756,287,122,0,0,0,2561,4994
118,58,519,1743,202,19,2,0,0,2485,345,1740,269,117,1,0,0,2472,4957
118,59,470,1803,221,29,2,0,0,2525,369,1827,272,129,1,0,0,2598,5123
118,60,425,1711,203,36,1,0,0,2376,302,1795,238,152,0,0,0,2487,4863
118,61,376,1600,202,40,1,0,0,2219,281,1679,220,175,0,0,0,2355,4574
118,62,355,1633,175,53,1,0,0,2217,202,1637,217,164,0,0,0,2220,4437
118,63,293,1533,179,34,2,0,0,2041,200,1545,218,188,0,0,0,2151,4192
118,64,297,1523,163,52,0,0,0,2035,186,1535,219,237,0,0,0,2177,4212
118,65,237,1400,161,45,1,0,0,1844,185,1453,188,217,1,0,0,2044,3888
118,66,259,1420,121,55,2,0,0,1857,174,1451,181,246,1,0,0,2053,3910
118,67,219,1420,122,68,0,0,0,1829,156,1301,155,303,0,0,0,1915,3744
118,68,200,1346,118,60,0,0,0,1724,140,1309,132,305,1,0,0,1887,3611
118,69,182,1338,106,74,1,0,0,1701,148,1318,157,335,0,0,0,1958,3659
118,70,176,1344,110,80,0,0,0,1710,121,1249,125,328,0,0,0,1823,3533
118,71,174,1312,88,82,0,0,0,1656,120,1303,127,378,0,0,0,1928,3584
118,72,175,1281,65,102,0,0,0,1623,125,1195,111,415,0,0,0,1846,3469
118,73,162,1352,76,120,0,0,0,1710,109,1210,103,459,1,0,0,1882,3592
118,74,147,1287,79,102,0,0,0,1615,95,1096,82,490,0,0,0,1763,3378
118,75,128,1402,74,129,0,0,0,1733,97,1176,91,536,0,0,0,1900,3633
118,76,117,1274,45,138,0,0,0,1574,95,1080,63,608,0,0,0,1846,3420
118,77,128,1350,51,153,0,0,0,1682,107,1087,68,673,0,0,0,1935,3617
118,78,84,913,37,110,0,0,0,1144,64,669,50,502,0,0,0,1285,2429
118,79,105,1010,32,151,0,0,0,1298,72,739,47,698,0,0,0,1556,2854
118,80,99,931,34,152,1,0,0,1217,68,718,49,679,0,0,0,1514,2731
118,81,94,887,36,147,0,0,0,1164,89,648,49,750,0,0,0,1536,2700
118,82,80,834,12,159,0,0,0,1085,61,539,38,770,0,0,0,1408,2493
118,83,75,788,28,197,0,0,0,1088,72,488,36,865,0,0,0,1461,2549
118,84,53,735,12,162,0,0,1,963,76,408,25,878,0,0,0,1387,2350
118,85,50,622,13,172,0,0,0,857,52,339,22,844,0,0,0,1257,2114
118,86,42,545,12,144,0,0,0,743,50,254,26,784,0,0,0,1114,1857
118,87,28,374,9,145,0,0,0,556,53,181,16,705,0,0,0,955,1511
118,88,32,335,8,143,0,0,0,518,27,137,19,630,0,0,0,813,1331
118,89,26,232,5,104,0,0,0,367,49,105,13,615,0,0,0,782,1149
118,90,17,202,1,105,0,0,0,325,39,70,8,535,0,0,0,652,977
118,91,11,161,2,92,0,0,0,266,24,51,10,517,0,0,0,602,868
118,92,13,127,5,55,0,0,0,200,37,35,4,433,0,0,0,509,709
118,93,8,90,4,73,0,0,0,175,25,28,3,374,0,0,0,430,605
118,94,4,50,1,56,0,0,0,111,22,10,3,339,0,0,0,374,485
118,95,5,37,1,33,0,0,0,76,20,8,3,237,0,0,0,268,344
118,96,2,19,1,30,0,0,0,52,16,4,3,180,0,0,0,203,255
118,97,1,9,0,20,0,0,0,30,12,3,1,163,0,0,0,179,209
118,98,1,13,0,19,0,0,0,33,7,2,1,104,0,0,0,114,147
118,99,0,5,0,12,0,0,0,17,4,1,0,71,0,0,0,76,93
118,100,2,8,0,20,0,0,0,30,7,1,1,108,0,0,0,117,147
118,999,74090,69592,5453,4033,68,0,1,153237,60373,70334,7605,19174,33,7,0,157526,310763
119,0,228,0,0,0,0,0,0,228,219,0,0,0,0,0,0,219,447
119,1,259,0,0,0,0,0,0,259,236,0,0,0,0,0,0,236,495
119,2,233,0,0,0,0,0,0,233,223,0,0,0,0,0,0,223,456
119,3,255,0,0,0,0,0,0,255,195,0,0,0,0,0,0,195,450
119,4,270,0,0,0,0,0,0,270,263,0,0,0,0,0,0,263,533
119,5,269,0,0,0,0,0,0,269,286,0,0,0,0,0,0,286,555
119,6,289,0,0,0,0,0,0,289,282,0,0,0,0,0,0,282,571
119,7,280,0,0,0,0,0,0,280,287,0,0,0,0,0,0,287,567
119,8,324,0,0,0,0,0,0,324,276,0,0,0,0,0,0,276,600
119,9,329,0,0,0,0,0,0,329,268,0,0,0,0,0,0,268,597
119,10,316,0,0,0,0,0,0,316,297,0,0,0,0,0,0,297,613
119,11,322,0,0,0,0,0,0,322,304,0,0,0,0,0,0,304,626
119,12,300,0,0,0,0,0,0,300,300,0,0,0,0,0,0,300,600
119,13,334,0,0,0,0,0,0,334,309,0,0,0,0,0,0,309,643
119,14,329,0,0,0,0,0,0,329,296,0,0,0,0,0,0,296,625
119,15,347,0,0,0,0,0,0,347,297,0,0,0,0,0,0,297,644
119,16,341,0,0,0,0,0,0,341,329,0,0,0,0,0,0,329,670
119,17,344,0,0,0,0,0,0,344,311,0,0,0,0,0,0,311,655
119,18,367,0,0,0,0,0,0,367,352,0,0,0,0,0,0,352,719
119,19,385,0,0,0,0,0,0,385,308,0,0,0,0,0,0,308,693
119,20,379,0,0,0,0,0,0,379,298,1,0,0,0,0,0,299,678
119,21,385,5,0,0,0,0,0,390,356,1,0,0,0,0,0,357,747
119,22,398,1,0,0,0,0,0,399,342,4,0,0,1,0,0,347,746
119,23,404,1,0,0,0,0,0,405,335,10,0,0,0,0,0,345,750
119,24,406,5,0,1,0,0,0,412,319,7,0,0,1,0,0,327,739
119,25,463,10,0,0,0,0,0,473,342,11,1,0,1,0,0,355,828
119,26,421,14,1,0,0,0,0,436,322,28,0,0,0,0,0,350,786
119,27,408,21,1,0,0,0,0,430,335,34,0,0,0,0,0,369,799
119,28,380,28,0,0,0,0,0,408,340,49,3,0,0,0,0,392,800
119,29,422,24,0,0,0,0,0,446,321,56,0,0,1,0,0,378,824
119,30,397,45,0,0,0,0,0,442,320,80,1,0,0,0,0,401,843
119,31,388,66,1,0,0,0,0,455,308,117,2,0,0,0,0,427,882
119,32,408,62,1,0,0,0,0,471,269,125,4,1,0,0,0,399,870
119,33,370,91,1,0,0,0,0,462,252,167,3,2,0,0,0,424,886
119,34,336,99,2,1,0,0,0,438,244,179,4,0,0,0,0,427,865
119,35,353,157,2,0,0,0,0,512,231,186,9,1,1,0,0,428,940
119,36,323,132,5,0,0,0,0,460,203,236,4,1,0,0,0,444,904
119,37,323,194,6,0,0,0,0,523,196,224,8,2,0,0,0,430,953
119,38,271,224,9,0,0,0,0,504,189,256,5,1,0,0,0,451,955
119,39,292,219,2,0,0,0,0,513,165,245,13,5,1,0,0,429,942
119,40,237,230,13,1,0,0,0,481,156,247,9,3,0,0,0,415,896
119,41,249,228,10,0,0,0,0,487,160,283,11,6,0,0,0,460,947
119,42,216,278,8,2,1,0,0,505,161,311,22,3,0,0,0,497,1002
119,43,219,271,7,1,1,0,0,499,126,335,21,4,0,0,0,486,985
119,44,217,274,13,2,1,0,0,507,127,337,16,2,0,0,0,482,989
119,45,200,303,13,1,0,0,0,517,125,349,16,5,0,0,0,495,1012
119,46,200,336,20,2,0,0,0,558,121,351,27,6,0,0,0,505,1063
119,47,191,380,28,2,0,0,0,601,124,374,21,7,0,0,0,526,1127
119,48,177,404,22,3,2,0,0,608,102,370,29,10,0,0,0,511,1119
119,49,192,408,13,0,3,0,0,616,99,439,34,17,0,0,0,589,1205
119,50,178,378,22,4,0,0,0,582,98,452,37,16,0,0,0,603,1185
119,51,145,395,30,2,1,0,0,573,94,440,32,7,0,0,0,573,1146
119,52,158,392,27,6,1,0,0,584,85,494,33,17,0,0,0,629,1213
119,53,148,391,24,0,0,0,0,563,75,452,38,25,0,0,0,590,1153
119,54,123,404,29,4,0,0,0,560,78,488,41,21,0,0,0,628,1188
119,55,142,443,32,7,0,0,0,624,72,524,36,31,0,0,0,663,1287
119,56,149,450,32,6,0,0,0,637,78,506,43,34,0,0,0,661,1298
119,57,122,502,22,2,0,0,0,648,91,481,29,46,0,0,0,647,1295
119,58,120,476,35,7,0,0,0,638,71,496,34,52,0,0,0,653,1291
119,59,105,522,37,7,1,0,0,672,66,520,34,59,0,0,0,679,1351
119,60,105,494,25,15,0,0,0,639,57,509,27,46,0,0,0,639,1278
119,61,100,445,32,17,1,0,0,595,60,473,32,53,0,0,0,618,1213
119,62,81,463,32,12,0,0,0,588,54,470,14,69,0,0,0,607,1195
119,63,81,500,18,12,1,0,0,612,63,471,24,81,0,0,0,639,1251
119,64,64,495,19,13,0,0,0,591,58,456,29,87,0,0,0,630,1221
119,65,73,440,22,19,1,0,0,555,46,438,15,81,0,0,0,580,1135
119,66,68,473,25,17,0,0,0,583,54,415,16,107,0,0,0,592,1175
119,67,55,507,19,18,0,0,0,599,33,419,22,85,0,0,0,559,1158
119,68,57,446,20,19,1,0,0,543,53,411,22,96,0,0,0,582,1125
119,69,60,478,16,26,0,0,0,580,41,402,18,118,1,0,0,580,1160
119,70,38,436,20,30,0,0,0,524,40,384,12,126,0,0,0,562,1086
119,71,36,445,15,18,0,0,0,514,49,349,12,116,0,0,0,526,1040
119,72,22,397,14,28,0,0,0,461,38,315,9,133,0,0,0,495,956
119,73,34,397,12,27,0,0,0,470,31,321,8,161,0,0,0,521,991
119,74,33,428,17,35,0,0,0,513,33,326,12,181,0,0,0,552,1065
119,75,34,385,10,46,0,0,0,475,34,292,5,180,0,0,0,511,986
119,76,26,380,13,42,0,0,0,461,32,287,10,187,0,0,0,516,977
119,77,23,342,6,42,0,0,0,413,22,237,9,172,0,0,0,440,853
119,78,25,242,6,37,0,0,0,310,15,166,2,148,0,0,0,331,641
119,79,15,227,6,27,0,0,0,275,16,162,9,166,0,0,0,353,628
119,80,18,191,2,37,0,0,0,248,19,144,3,148,0,0,0,314,562
119,81,14,204,5,46,0,0,0,269,19,119,7,150,0,0,0,295,564
119,82,9,193,6,32,0,0,0,240,24,130,3,189,0,0,0,346,586
119,83,13,204,2,49,0,0,0,268,22,125,6,210,0,0,0,363,631
119,84,11,200,5,52,0,0,0,268,14,115,2,238,0,0,0,369,637
119,85,5,174,2,34,0,0,0,215,14,102,2,184,0,0,0,302,517
119,86,12,138,0,46,0,0,0,196,16,66,3,212,0,0,0,297,493
119,87,5,122,0,54,0,0,0,181,9,69,2,226,0,0,0,306,487
119,88,5,100,2,50,0,0,0,157,17,42,2,182,0,0,0,243,400
119,89,11,85,1,51,0,0,0,148,13,31,4,178,0,0,0,226,374
119,90,5,69,1,43,0,0,0,118,20,40,2,174,0,0,0,236,354
119,91,5,48,0,30,0,0,0,83,9,25,2,143,0,0,0,179,262
119,92,1,47,0,32,0,0,0,80,9,17,1,143,0,0,0,170,250
119,93,2,32,0,26,0,0,0,60,9,11,2,115,0,0,0,137,197
119,94,0,20,0,21,0,0,0,41,6,8,1,91,0,0,0,106,147
119,95,0,13,0,16,0,0,0,29,9,6,0,62,0,0,0,77,106
119,96,2,7,0,9,0,0,0,18,3,5,0,52,0,0,0,60,78
119,97,1,10,1,6,0,0,0,18,6,2,0,48,0,0,0,56,74
119,98,0,4,0,3,0,0,0,7,3,2,0,27,0,0,0,32,39
119,99,1,1,0,6,0,0,0,8,2,3,0,25,0,0,0,30,38
119,100,1,6,0,6,0,0,0,13,3,1,1,40,0,0,0,45,58
119,999,18287,19151,842,1210,15,0,0,39505,14509,18631,970,5614,7,0,0,39731,79236
120,0,357,0,0,0,0,0,0,357,322,0,0,0,0,0,0,322,679
120,1,355,0,0,0,0,0,0,355,315,0,0,0,0,0,0,315,670
120,2,391,0,0,0,0,0,0,391,366,0,0,0,0,0,0,366,757
120,3,376,0,0,0,0,0,0,376,366,0,0,0,0,0,0,366,742
120,4,408,0,0,0,0,0,0,408,377,0,0,0,0,0,0,377,785
120,5,425,0,0,0,0,0,0,425,428,0,0,0,0,0,0,428,853
120,6,494,0,0,0,0,0,0,494,445,0,0,0,0,0,0,445,939
120,7,511,0,0,0,0,0,0,511,424,0,0,0,0,0,0,424,935
120,8,473,0,0,0,0,0,0,473,472,0,0,0,0,0,0,472,945
120,9,523,0,0,0,0,0,0,523,455,0,0,0,0,0,0,455,978
120,10,510,0,0,0,0,0,0,510,521,0,0,0,0,0,0,521,1031
120,11,516,0,0,0,0,0,0,516,469,0,0,0,0,0,0,469,985
120,12,594,0,0,0,0,0,0,594,530,0,0,0,0,0,0,530,1124
120,13,588,0,0,0,0,0,0,588,593,0,0,0,0,0,0,593,1181
120,14,613,0,0,0,0,0,0,613,518,0,0,0,0,0,0,518,1131
120,15,616,0,0,0,0,0,0,616,553,0,0,0,0,0,0,553,1169
120,16,605,0,0,0,0,0,0,605,599,0,0,0,0,0,0,599,1204
120,17,644,0,0,0,0,0,0,644,534,0,0,0,0,0,0,534,1178
120,18,660,0,0,0,0,0,0,660,595,0,0,0,0,0,0,595,1255
120,19,619,0,0,0,0,0,0,619,599,0,0,0,0,0,0,599,1218
120,20,682,0,0,0,0,0,0,682,584,1,0,0,0,0,0,585,1267
120,21,620,0,0,0,0,0,0,620,601,1,0,0,0,0,0,602,1222
120,22,669,1,0,0,0,0,0,670,630,1,0,0,0,0,0,631,1301
120,23,697,1,0,0,0,0,0,698,611,7,0,0,0,0,0,618,1316
120,24,695,2,0,0,0,0,0,697,632,11,0,0,0,0,0,643,1340
120,25,687,2,0,0,0,0,0,689,574,12,0,0,0,0,0,586,1275
120,26,715,3,0,0,0,0,0,718,572,26,1,0,0,0,0,599,1317
120,27,658,7,0,0,0,0,0,665,572,23,1,0,0,0,0,596,1261
120,28,671,25,0,0,0,0,0,696,543,58,0,0,0,0,0,601,1297
120,29,650,22,1,0,0,1,0,674,562,65,5,0,0,1,0,633,1307
120,30,692,40,1,0,0,0,0,733,520,85,4,0,0,0,0,609,1342
120,31,672,41,4,0,1,0,0,718,595,102,1,0,1,0,0,699,1417
120,32,746,70,1,0,0,0,0,817,549,145,6,1,2,0,0,703,1520
120,33,654,111,1,0,0,0,0,766,567,167,6,0,2,1,0,743,1509
120,34,667,129,1,0,1,0,0,798,486,190,5,1,1,0,0,683,1481
120,35,642,108,2,0,0,0,0,752,484,240,10,1,0,0,0,735,1487
120,36,658,209,2,0,1,0,0,870,463,282,6,1,1,0,0,753,1623
120,37,564,168,6,0,0,1,0,739,451,297,11,2,2,0,0,763,1502
120,38,630,203,10,0,0,0,0,843,409,340,15,4,1,1,0,770,1613
120,39,601,266,17,1,0,0,0,885,422,401,22,1,0,0,0,846,1731
120,40,622,303,10,0,0,0,0,935,421,393,23,1,0,0,0,838,1773
120,41,635,342,12,2,0,0,0,991,367,457,32,10,0,0,0,866,1857
120,42,557,377,16,0,0,0,0,950,392,453,34,5,0,0,0,884,1834
120,43,551,377,19,0,0,0,0,947,383,500,38,7,0,0,0,928,1875
120,44,526,418,29,0,2,0,0,975,355,549,48,12,0,0,0,964,1939
120,45,563,483,24,6,1,0,0,1077,332,618,42,7,2,0,0,1001,2078
120,46,531,508,26,6,0,0,0,1071,339,639,43,15,0,0,0,1036,2107
120,47,537,562,39,4,1,1,0,1144,327,635,47,11,0,0,0,1020,2164
120,48,526,555,34,2,0,0,0,1117,340,705,71,22,0,0,0,1138,2255
120,49,520,664,45,6,0,0,0,1235,321,731,67,16,1,0,0,1136,2371
120,50,456,635,42,3,1,0,0,1137,293,757,76,26,0,0,0,1152,2289
120,51,440,680,56,6,1,0,0,1183,280,776,69,26,0,0,0,1151,2334
120,52,422,738,56,6,0,0,0,1222,279,856,79,31,0,0,0,1245,2467
120,53,433,741,57,6,1,0,0,1238,258,811,66,30,1,0,0,1166,2404
120,54,395,794,58,9,0,0,0,1256,243,863,71,39,0,0,0,1216,2472
120,55,345,750,58,7,1,0,0,1161,249,862,74,34,0,0,0,1219,2380
120,56,359,821,65,17,2,0,0,1264,226,899,89,57,0,0,0,1271,2535
120,57,309,848,79,11,1,0,0,1248,226,981,94,51,0,0,0,1352,2600
120,58,299,883,68,20,0,0,0,1270,200,919,92,90,0,0,0,1301,2571
120,59,283,880,92,18,0,0,0,1273,209,1005,91,70,0,0,0,1375,2648
120,60,257,846,71,24,0,0,0,1198,180,1015,74,65,0,0,0,1334,2532
120,61,240,939,67,18,1,0,0,1265,191,934,56,103,0,0,0,1284,2549
120,62,243,889,71,21,0,0,0,1224,178,914,68,102,0,0,0,1262,2486
120,63,210,858,55,22,0,0,0,1145,141,892,53,114,0,0,0,1200,2345
120,64,226,891,56,23,0,0,0,1196,115,857,55,141,0,0,0,1168,2364
120,65,186,827,53,27,0,0,0,1093,127,880,56,157,0,0,0,1220,2313
120,66,181,860,55,29,0,0,0,1125,145,841,44,163,0,0,0,1193,2318
120,67,170,834,54,23,0,0,0,1081,148,776,44,177,1,0,0,1146,2227
120,68,145,862,41,36,0,0,0,1084,120,781,43,179,1,0,0,1124,2208
120,69,143,848,50,38,0,1,0,1080,112,754,37,217,0,0,0,1120,2200
120,70,141,847,34,40,0,0,0,1062,122,711,47,207,0,0,0,1087,2149
120,71,130,763,32,48,0,0,0,973,109,698,33,218,0,0,0,1058,2031
120,72,129,779,37,52,0,0,0,997,122,617,31,275,0,0,0,1045,2042
120,73,139,781,31,75,0,0,0,1026,125,608,29,266,0,0,0,1028,2054
120,74,112,734,25,59,0,0,0,930,104,595,28,285,0,0,0,1012,1942
120,75,94,691,24,73,0,0,0,882,122,557,18,283,0,0,0,980,1862
120,76,97,652,15,71,0,0,0,835,108,519,25,315,0,0,0,967,1802
120,77,78,609,22,65,0,0,0,774,106,439,19,320,0,0,0,884,1658
120,78,84,556,15,70,0,0,0,725,102,369,13,314,0,0,0,798,1523
120,79,79,552,13,86,0,0,0,730,117,396,10,424,0,0,0,947,1677
120,80,60,481,11,63,0,0,0,615,99,353,12,397,0,0,0,861,1476
120,81,64,456,9,80,0,0,0,609,98,310,10,394,0,0,0,812,1421
120,82,58,387,13,66,0,0,0,524,78,219,8,353,0,0,0,658,1182
120,83,70,388,10,98,0,0,0,566,127,229,7,487,0,0,0,850,1416
120,84,62,387,14,108,0,0,0,571,100,197,8,418,0,0,0,723,1294
120,85,36,297,6,86,0,0,0,425,83,172,6,395,0,0,0,656,1081
120,86,34,254,1,70,0,0,0,359,86,109,2,383,0,0,0,580,939
120,87,47,210,1,72,0,0,0,330,99,99,9,370,0,0,0,577,907
120,88,31,163,1,68,0,0,0,263,76,72,6,357,0,0,0,511,774
120,89,21,152,5,69,0,0,0,247,65,56,5,322,0,0,0,448,695
120,90,24,126,1,71,0,0,0,222,48,35,5,339,0,0,0,427,649
120,91,16,107,5,47,0,0,0,175,61,28,0,264,0,0,0,353,528
120,92,9,65,1,51,0,0,0,126,36,30,1,217,0,0,0,284,410
120,93,14,39,1,40,0,0,0,94,46,13,5,168,0,0,0,232,326
120,94,5,35,0,36,0,0,0,76,28,8,0,150,0,0,0,186,262
120,95,3,20,0,22,0,0,0,45,26,7,1,115,0,0,0,149,194
120,96,4,12,0,17,0,0,0,33,15,5,0,86,0,0,0,106,139
120,97,2,10,0,13,0,0,0,25,9,3,0,62,0,0,0,74,99
120,98,1,4,0,6,0,0,0,11,10,0,2,41,0,0,0,53,64
120,99,1,2,0,9,0,0,0,12,9,1,0,31,0,0,0,41,53
120,100,2,2,0,6,0,0,0,10,8,2,0,40,0,0,0,50,60
120,999,36505,32982,1831,2128,15,4,0,73465,30149,32964,2209,10285,16,3,0,75626,149091
121,0,452,0,0,0,0,0,0,452,405,0,0,0,0,0,0,405,857
121,1,450,0,0,0,0,0,0,450,409,0,0,0,0,0,0,409,859
121,2,439,0,0,0,0,0,0,439,455,0,0,0,0,0,0,455,894
121,3,481,0,0,0,0,0,0,481,446,0,0,0,0,0,0,446,927
121,4,485,0,0,0,0,0,0,485,490,0,0,0,0,0,0,490,975
121,5,504,0,0,0,0,0,0,504,536,0,0,0,0,0,0,536,1040
121,6,539,0,0,0,0,0,0,539,454,0,0,0,0,0,0,454,993
121,7,596,0,0,0,0,0,0,596,560,0,0,0,0,0,0,560,1156
121,8,575,0,0,0,0,0,0,575,544,0,0,0,0,0,0,544,1119
121,9,621,0,0,0,0,0,0,621,576,0,0,0,0,0,0,576,1197
121,10,640,0,0,0,0,0,0,640,562,0,0,0,0,0,0,562,1202
121,11,690,0,0,0,0,0,0,690,621,0,0,0,0,0,0,621,1311
121,12,617,0,0,0,0,0,0,617,662,0,0,0,0,0,0,662,1279
121,13,686,0,0,0,0,0,0,686,681,0,0,0,0,0,0,681,1367
121,14,668,0,0,0,0,0,0,668,724,0,0,0,0,0,0,724,1392
121,15,733,0,0,0,0,0,0,733,696,0,0,0,0,0,0,696,1429
121,16,772,0,0,0,0,0,0,772,713,0,0,0,0,0,0,713,1485
121,17,781,0,0,0,0,0,0,781,691,0,0,0,0,0,0,691,1472
121,18,784,0,0,0,0,0,0,784,699,1,0,0,0,0,0,700,1484
121,19,781,0,0,0,0,0,0,781,683,2,1,0,0,0,0,686,1467
121,20,813,1,1,0,0,0,0,815,726,4,0,0,0,0,0,730,1545
121,21,794,2,0,0,0,0,0,796,716,6,0,0,0,0,0,722,1518
121,22,764,2,0,0,0,0,0,766,735,15,0,0,0,0,0,750,1516
121,23,843,3,2,0,1,0,0,849,719,22,1,0,0,1,0,743,1592
121,24,852,9,1,0,0,0,0,862,711,23,2,1,1,0,0,738,1600
121,25,831,14,1,0,0,0,0,846,674,40,3,0,0,0,0,717,1563
121,26,789,27,2,0,0,0,0,818,640,59,2,0,1,0,0,702,1520
121,27,726,38,0,0,1,1,0,766,626,61,2,0,1,1,0,691,1457
121,28,703,48,3,0,0,0,0,754,598,124,2,0,0,0,0,724,1478
121,29,661,62,3,0,0,0,0,726,599,139,5,0,0,0,0,743,1469
121,30,697,91,4,0,0,0,0,792,535,193,7,0,0,0,0,735,1527
121,31,698,139,8,0,1,0,0,846,538,203,6,1,1,0,0,749,1595
121,32,697,165,9,1,1,0,0,873,523,228,6,1,1,0,0,759,1632
121,33,600,194,7,0,1,1,0,803,470,259,13,3,0,0,0,745,1548
121,34,585,209,2,0,3,0,0,799,420,278,13,4,1,0,0,716,1515
121,35,616,229,11,0,2,0,0,858,447,349,15,1,5,1,0,818,1676
121,36,495,233,10,1,3,0,0,742,356,325,24,3,3,0,0,711,1453
121,37,496,306,12,1,4,0,0,819,336,370,33,2,1,0,0,742,1561
121,38,479,286,18,2,3,0,0,788,346,403,41,6,1,0,0,797,1585
121,39,491,311,27,0,4,0,0,833,320,421,34,5,3,0,0,783,1616
121,40,454,352,26,1,1,0,0,834,307,401,41,11,2,0,0,762,1596
121,41,452,374,28,2,1,0,0,857,387,473,51,4,1,0,0,916,1773
121,42,406,388,42,2,2,0,0,840,327,521,58,6,3,0,0,915,1755
121,43,451,423,31,4,1,0,0,910,364,547,73,8,2,0,0,994,1904
121,44,435,409,51,3,2,0,0,900,329,526,74,6,0,0,0,935,1835
121,45,483,548,52,3,4,0,0,1090,364,626,97,13,0,0,0,1100,2190
121,46,472,579,53,7,3,0,0,1114,341,660,92,15,2,0,0,1110,2224
121,47,492,584,76,7,1,0,0,1160,317,743,117,28,0,0,0,1205,2365
121,48,485,642,74,4,2,0,0,1207,357,764,127,28,6,0,0,1282,2489
121,49,507,701,101,4,3,0,0,1316,327,843,126,25,1,0,0,1322,2638
121,50,534,724,86,4,4,0,0,1352,287,830,135,26,0,0,0,1278,2630
121,51,466,781,102,7,1,0,0,1357,307,861,183,28,3,0,0,1382,2739
121,52,453,803,121,9,6,0,0,1392,275,937,176,31,1,0,0,1420,2812
121,53,432,838,139,7,1,0,0,1417,265,946,176,51,1,0,0,1439,2856
121,54,395,900,125,10,2,0,0,1432,256,961,172,41,1,0,0,1431,2863
121,55,406,873,154,13,4,0,0,1450,252,1019,195,55,1,1,0,1523,2973
121,56,360,919,144,16,0,0,0,1439,253,994,198,84,2,0,0,1531,2970
121,57,340,998,144,17,5,0,0,1504,225,968,175,56,0,0,0,1424,2928
121,58,328,983,147,23,1,0,0,1482,204,1082,219,78,0,0,0,1583,3065
121,59,322,997,190,23,5,0,0,1537,202,1072,202,82,1,0,0,1559,3096
121,60,256,988,136,21,0,0,0,1401,148,984,184,78,0,0,0,1394,2795
121,61,245,892,144,29,3,0,0,1313,139,927,167,91,1,0,0,1325,2638
121,62,201,952,145,27,0,0,0,1325,136,941,192,128,2,0,0,1399,2724
121,63,201,896,119,37,1,0,0,1254,127,923,167,130,0,0,0,1347,2601
121,64,179,864,135,31,1,0,0,1210,119,826,134,161,0,0,0,1240,2450
121,65,165,836,105,43,0,0,0,1149,102,835,144,145,0,0,0,1226,2375
121,66,136,892,128,39,1,0,0,1196,107,848,118,181,0,0,0,1254,2450
121,67,144,857,103,45,2,0,0,1151,103,792,122,177,0,0,0,1194,2345
121,68,121,853,95,39,1,0,0,1109,100,848,135,196,0,0,0,1279,2388
121,69,118,851,77,43,0,0,0,1089,81,838,123,211,0,0,1,1254,2343
121,70,99,857,85,46,0,0,1,1088,81,765,87,234,0,0,0,1167,2255
121,71,108,837,85,70,0,0,0,1100,80,789,93,244,0,0,0,1206,2306
121,72,80,814,63,77,0,0,0,1034,61,743,99,284,0,0,0,1187,2221
121,73,76,806,68,71,0,0,0,1021,76,829,61,335,0,0,0,1301,2322
121,74,90,869,69,89,0,0,0,1117,65,730,77,324,0,0,0,1196,2313
121,75,93,875,67,101,0,0,0,1136,78,747,65,377,1,0,0,1268,2404
121,76,81,786,52,83,0,0,0,1002,58,671,62,390,0,0,0,1181,2183
121,77,70,732,42,112,1,0,0,957,62,641,58,412,0,0,0,1173,2130
121,78,53,556,30,99,0,0,0,738,52,413,53,348,0,0,0,866,1604
121,79,67,590,27,97,0,0,0,781,55,446,30,420,0,0,0,951,1732
121,80,52,527,28,103,0,0,0,710,44,380,30,446,0,0,0,900,1610
121,81,49,530,20,102,0,0,0,701,41,397,43,489,0,0,0,970,1671
121,82,51,482,27,113,1,0,0,674,63,359,41,511,0,0,0,974,1648
121,83,49,511,16,130,0,0,0,706,51,348,40,600,0,0,0,1039,1745
121,84,31,461,11,125,0,0,0,628,52,312,41,588,0,0,0,993,1621
121,85,41,369,11,141,0,0,0,562,55,251,22,621,0,0,0,949,1511
121,86,26,313,16,121,0,0,0,476,48,180,20,518,0,0,0,766,1242
121,87,22,276,8,117,0,0,0,423,30,135,15,494,0,0,0,674,1097
121,88,23,219,8,92,0,0,0,342,35,110,15,511,0,0,0,671,1013
121,89,10,190,9,90,0,0,0,299,51,70,14,462,0,0,0,597,896
121,90,7,119,3,73,0,0,0,202,40,57,10,429,0,0,0,536,738
121,91,14,96,0,68,0,0,0,178,25,35,7,378,0,0,0,445,623
121,92,8,69,1,62,0,0,0,140,24,24,3,328,0,0,0,379,519
121,93,5,68,1,60,0,0,0,134,20,23,2,262,0,0,0,307,441
121,94,4,27,0,37,0,0,0,68,20,4,3,228,0,0,0,255,323
121,95,1,18,0,26,0,0,0,45,10,5,4,152,0,0,0,171,216
121,96,2,13,0,21,0,0,0,36,9,4,4,141,0,0,0,158,194
121,97,2,8,0,12,0,0,0,22,10,4,0,81,0,0,0,95,117
121,98,1,2,0,9,0,0,0,12,4,0,0,50,0,0,0,54,66
121,99,0,3,0,2,0,0,0,5,4,1,1,42,0,0,0,48,53
121,100,2,0,0,7,0,0,0,9,12,2,1,64,0,0,0,79,88
121,999,37580,37089,3941,2881,84,2,1,81578,31066,37536,5384,12964,50,4,1,87005,168583
122,0,1056,0,0,0,0,0,0,1056,993,0,0,0,0,0,0,993,2049
122,1,1086,0,0,0,0,0,0,1086,1040,0,0,0,0,0,0,1040,2126
122,2,1104,0,0,0,0,0,0,1104,1034,0,0,0,0,0,0,1034,2138
122,3,1128,0,0,0,0,0,0,1128,1106,0,0,0,0,0,0,1106,2234
122,4,1268,0,0,0,0,0,0,1268,1134,0,0,0,0,0,0,1134,2402
122,5,1289,0,0,0,0,0,0,1289,1169,0,0,0,0,0,0,1169,2458
122,6,1441,0,0,0,0,0,0,1441,1275,0,0,0,0,0,0,1275,2716
122,7,1287,0,0,0,0,0,0,1287,1368,0,0,0,0,0,0,1368,2655
122,8,1515,0,0,0,0,0,0,1515,1426,0,0,0,0,0,0,1426,2941
122,9,1433,0,0,0,0,0,0,1433,1374,0,0,0,0,0,0,1374,2807
122,10,1494,0,0,0,0,0,0,1494,1473,0,0,0,0,0,0,1473,2967
122,11,1573,0,0,0,0,0,0,1573,1543,0,0,0,0,0,0,1543,3116
122,12,1616,0,0,0,0,0,0,1616,1564,0,0,0,0,0,0,1564,3180
122,13,1760,0,0,0,0,0,0,1760,1599,0,0,0,0,0,0,1599,3359
122,14,1788,0,0,0,0,0,0,1788,1574,0,0,0,0,0,0,1574,3362
122,15,1747,0,0,0,0,0,0,1747,1669,0,0,0,0,0,0,1669,3416
122,16,1742,0,0,0,0,0,0,1742,1642,0,0,0,0,0,0,1642,3384
122,17,1674,0,0,0,0,0,0,1674,1635,0,0,0,0,0,0,1635,3309
122,18,1760,0,0,0,0,0,0,1760,1628,0,0,0,0,0,0,1628,3388
122,19,1678,0,0,0,0,0,0,1678,1591,1,0,0,0,0,0,1592,3270
122,20,1656,1,0,0,0,0,0,1657,1615,6,0,0,0,0,0,1621,3278
122,21,1732,0,0,0,0,0,0,1732,1703,15,0,0,0,0,0,1718,3450
122,22,1708,4,0,1,0,0,0,1713,1603,34,0,0,0,0,0,1637,3350
122,23,1790,6,0,0,0,0,0,1796,1602,50,3,0,0,0,0,1655,3451
122,24,1793,11,2,0,1,0,0,1807,1519,68,4,1,0,0,0,1592,3399
122,25,1793,28,3,0,0,0,0,1824,1467,97,1,0,1,0,0,1566,3390
122,26,1771,41,2,0,1,0,0,1815,1448,152,1,0,0,0,0,1601,3416
122,27,1797,63,5,0,1,0,0,1866,1394,222,7,0,2,0,0,1625,3491
122,28,1635,99,3,1,2,0,0,1740,1314,280,8,0,1,0,0,1603,3343
122,29,1614,163,4,0,3,0,0,1784,1230,348,9,0,1,0,0,1588,3372
122,30,1476,222,8,0,2,0,0,1708,1176,463,5,0,4,0,0,1648,3356
122,31,1496,287,3,0,3,0,0,1789,1091,537,11,1,1,0,0,1641,3430
122,32,1401,338,7,1,1,1,0,1749,1005,599,16,2,2,0,0,1624,3373
122,33,1318,404,9,1,2,0,0,1734,905,678,16,4,2,0,0,1605,3339
122,34,1256,512,15,3,2,0,0,1788,881,762,23,2,2,0,0,1670,3458
122,35,1145,620,20,2,4,0,0,1791,843,858,34,1,3,0,0,1739,3530
122,36,1044,690,20,0,4,0,0,1758,734,915,43,4,1,0,0,1697,3455
122,37,1071,704,29,1,3,0,0,1808,615,956,43,6,4,0,0,1624,3432
122,38,958,773,26,4,1,0,0,1762,677,1036,46,11,3,1,0,1774,3536
122,39,944,825,34,3,1,0,0,1807,615,1047,70,11,4,0,0,1747,3554
122,40,863,899,37,1,3,1,0,1804,596,1144,99,2,4,0,0,1845,3649
122,41,921,1034,44,6,2,0,0,2007,580,1219,91,11,1,0,0,1902,3909
122,42,912,1074,67,6,4,0,0,2063,584,1266,76,23,3,0,0,1952,4015
122,43,826,1060,70,9,2,0,0,1967,572,1282,105,16,0,0,0,1975,3942
122,44,871,1136,70,5,1,0,0,2083,587,1353,108,20,2,0,0,2070,4153
122,45,823,1230,100,6,2,2,0,2163,557,1535,133,19,1,0,0,2245,4408
122,46,829,1414,102,9,1,0,0,2355,534,1627,163,22,3,0,0,2349,4704
122,47,889,1514,100,14,1,0,0,2518,563,1630,157,35,1,0,0,2386,4904
122,48,873,1619,133,16,3,0,0,2644,502,1734,218,38,4,0,0,2496,5140
122,49,909,1682,143,17,3,0,0,2754,552,1783,215,43,3,0,1,2597,5351
122,50,816,1733,168,12,1,0,0,2730,520,1815,240,58,1,0,0,2634,5364
122,51,778,1691,176,16,2,0,0,2663,478,1921,236,39,3,0,0,2677,5340
122,52,781,1698,185,16,3,0,0,2683,489,1866,237,73,0,0,0,2665,5348
122,53,690,1855,187,19,1,0,0,2752,444,1872,229,81,3,0,0,2629,5381
122,54,724,1870,209,16,2,0,0,2821,428,1924,254,61,1,0,0,2668,5489
122,55,691,1902,212,16,2,1,0,2824,426,1968,264,79,2,0,0,2739,5563
122,56,620,1898,226,22,7,0,0,2773,407,2014,284,101,2,0,0,2808,5581
122,57,608,2097,216,25,1,0,1,2948,377,2155,245,92,2,0,0,2871,5819
122,58,556,2024,202,27,5,0,0,2814,405,2068,263,128,1,0,0,2865,5679
122,59,545,2038,247,41,2,0,0,2873,337,1988,215,129,1,0,0,2670,5543
122,60,446,1922,192,29,3,0,0,2592,330,1906,243,126,1,0,0,2606,5198
122,61,394,1845,204,56,4,0,0,2503,299,1780,217,168,2,0,0,2466,4969
122,62,349,1787,173,41,2,0,0,2352,269,1814,177,176,0,0,0,2436,4788
122,63,338,1770,143,54,3,0,0,2308,283,1716,182,195,1,0,0,2377,4685
122,64,310,1724,159,46,1,0,0,2240,262,1708,167,204,1,0,0,2342,4582
122,65,293,1675,135,47,4,0,0,2154,207,1646,163,225,2,0,0,2243,4397
122,66,251,1604,117,50,0,0,0,2022,236,1587,115,268,2,0,0,2208,4230
122,67,221,1726,122,76,4,0,0,2149,190,1561,125,289,1,0,1,2167,4316
122,68,239,1619,98,75,4,0,0,2035,188,1497,100,317,0,0,0,2102,4137
122,69,195,1565,83,78,0,0,1,1922,192,1416,113,322,2,0,0,2045,3967
122,70,187,1497,79,75,0,0,0,1838,159,1380,108,345,0,0,0,1992,3830
122,71,178,1525,62,91,3,0,0,1859,145,1321,86,379,0,0,0,1931,3790
122,72,179,1476,72,96,0,0,1,1824,183,1392,86,428,0,0,0,2089,3913
122,73,171,1473,69,122,0,0,0,1835,163,1352,75,503,0,0,0,2093,3928
122,74,184,1508,59,117,0,0,0,1868,168,1299,71,537,0,0,0,2075,3943
122,75,144,1486,64,144,1,0,0,1839,159,1224,70,618,0,0,0,2071,3910
122,76,149,1386,57,143,1,0,0,1736,149,1143,55,653,0,0,0,2000,3736
122,77,127,1395,41,167,0,0,0,1730,145,1049,49,692,0,0,0,1935,3665
122,78,99,1051,29,146,0,0,0,1325,94,771,46,564,0,0,0,1475,2800
122,79,95,1026,24,149,0,0,0,1294,99,720,37,696,0,0,0,1552,2846
122,80,76,939,19,130,0,0,0,1164,98,735,36,625,0,0,0,1494,2658
122,81,79,889,25,147,0,0,0,1140,113,611,29,758,0,0,0,1511,2651
122,82,92,879,14,183,1,0,0,1169,113,585,22,801,0,0,0,1521,2690
122,83,95,883,16,179,0,0,0,1173,126,559,19,828,0,0,0,1532,2705
122,84,88,766,12,198,0,0,0,1064,127,428,13,886,0,0,0,1454,2518
122,85,65,715,6,181,0,0,0,967,122,400,20,886,0,0,0,1428,2395
122,86,43,545,9,164,0,0,0,761,100,282,11,805,0,0,0,1198,1959
122,87,46,391,4,159,0,0,0,600,85,198,12,720,0,0,0,1015,1615
122,88,36,318,5,130,0,0,0,489,78,144,11,728,0,0,0,961,1450
122,89,24,264,7,119,0,0,0,414,75,79,4,629,0,0,0,787,1201
122,90,23,229,2,109,0,0,0,363,76,83,5,578,0,0,0,742,1105
122,91,19,167,4,95,0,0,0,285,59,54,3,540,0,0,0,656,941
122,92,13,124,1,73,0,0,0,211,59,39,4,424,0,0,0,526,737
122,93,10,86,2,58,0,0,0,156,43,21,4,360,0,0,0,428,584
122,94,8,47,0,46,0,0,0,101,36,11,3,262,0,0,0,312,413
122,95,7,28,0,44,0,0,0,79,25,8,0,223,0,0,0,256,335
122,96,3,18,0,30,0,0,0,51,25,9,4,166,0,0,0,204,255
122,97,2,15,0,21,0,0,0,38,18,3,1,107,0,0,0,129,167
122,98,3,6,0,15,0,0,0,24,11,0,0,70,0,0,0,81,105
122,99,0,2,0,7,0,0,0,9,8,0,1,61,0,0,0,70,79
122,100,1,3,0,14,0,0,0,18,10,2,0,85,0,0,0,97,115
122,999,79644,75633,5192,4220,110,5,3,164807,66539,75821,6659,19360,81,1,2,168463,333270
123,0,780,0,0,0,0,0,0,780,763,0,0,0,0,0,0,763,1543
123,1,873,0,0,0,0,0,0,873,779,0,0,0,0,0,0,779,1652
123,2,848,0,0,0,0,0,0,848,861,0,0,0,0,0,0,861,1709
123,3,859,0,0,0,0,0,0,859,806,0,0,0,0,0,0,806,1665
123,4,927,0,0,0,0,0,0,927,888,0,0,0,0,0,0,888,1815
123,5,993,0,0,0,0,0,0,993,867,0,0,0,0,0,0,867,1860
123,6,1036,0,0,0,0,0,0,1036,946,0,0,0,0,0,0,946,1982
123,7,1056,0,0,0,0,0,0,1056,1025,0,0,0,0,0,0,1025,2081
123,8,1059,0,0,0,0,0,0,1059,1035,0,0,0,0,0,0,1035,2094
123,9,1116,0,0,0,0,0,0,1116,1057,0,0,0,0,0,0,1057,2173
123,10,1106,0,0,0,0,0,0,1106,1019,0,0,0,0,0,0,1019,2125
123,11,1134,0,0,0,0,0,0,1134,1064,0,0,0,0,0,0,1064,2198
123,12,1184,0,0,0,0,0,0,1184,1050,0,0,0,0,0,0,1050,2234
123,13,1144,0,0,0,0,0,0,1144,1115,0,0,0,0,0,0,1115,2259
123,14,1299,0,0,0,0,0,0,1299,1161,0,0,0,0,0,0,1161,2460
123,15,1223,0,0,0,0,0,0,1223,1083,0,0,0,0,0,0,1083,2306
123,16,1234,0,1,0,0,0,0,1235,1105,0,0,0,0,0,0,1105,2340
123,17,1202,0,0,0,0,0,0,1202,1110,0,0,0,0,0,0,1110,2312
123,18,1207,0,0,0,0,0,0,1207,1098,0,0,0,0,0,0,1098,2305
123,19,1184,0,0,0,0,0,0,1184,1157,4,0,0,0,0,0,1161,2345
123,20,1172,1,0,0,0,0,0,1173,1081,10,0,0,0,0,0,1091,2264
123,21,1077,2,0,0,0,0,0,1079,1051,20,2,0,0,0,0,1073,2152
123,22,1193,3,0,0,0,0,0,1196,1017,34,1,0,0,0,0,1052,2248
123,23,1192,8,0,0,0,0,0,1200,1036,51,1,0,0,0,0,1088,2288
123,24,1208,14,0,0,0,0,0,1222,1015,80,4,0,0,0,0,1099,2321
123,25,1213,26,1,0,0,1,0,1241,963,110,2,0,1,0,0,1076,2317
123,26,1143,43,0,0,0,0,0,1186,966,144,4,0,0,0,0,1114,2300
123,27,1169,70,4,0,0,0,0,1243,964,180,3,0,0,0,0,1147,2390
123,28,1125,87,3,0,0,0,0,1215,885,226,8,1,2,0,0,1122,2337
123,29,1053,125,5,0,2,1,0,1186,860,311,8,1,2,0,0,1182,2368
123,30,1038,185,3,0,1,0,0,1227,758,350,9,0,2,0,0,1119,2346
123,31,1071,248,4,0,3,0,0,1326,787,419,7,1,1,1,0,1216,2542
123,32,934,307,5,0,1,0,0,1247,697,500,18,1,5,0,0,1221,2468
123,33,928,325,7,2,1,0,0,1263,724,511,13,2,2,0,0,1252,2515
123,34,924,426,13,0,1,0,0,1364,655,590,12,3,3,0,0,1263,2627
123,35,847,483,12,0,2,0,0,1344,574,695,25,1,4,0,0,1299,2643
123,36,849,507,18,1,0,0,0,1375,542,744,32,7,2,0,0,1327,2702
123,37,779,567,26,2,1,2,0,1377,516,753,44,10,1,0,0,1324,2701
123,38,699,672,29,1,5,0,0,1406,482,765,40,7,1,0,0,1295,2701
123,39,741,620,19,0,0,0,0,1380,464,886,56,5,2,0,0,1413,2793
123,40,700,720,43,3,2,0,0,1468,447,830,55,10,3,1,0,1346,2814
123,41,655,805,37,5,2,0,0,1504,406,911,73,16,4,0,0,1410,2914
123,42,627,791,52,7,0,0,0,1477,427,910,80,13,5,0,0,1435,2912
123,43,597,885,60,7,2,0,0,1551,385,1025,77,18,3,0,0,1508,3059
123,44,590,954,57,5,3,0,0,1609,402,1020,86,20,1,0,0,1529,3138
123,45,594,958,65,6,1,0,0,1624,377,1106,102,14,3,0,0,1602,3226
123,46,628,1071,73,6,5,0,0,1783,398,1115,122,20,0,0,0,1655,3438
123,47,617,1062,74,8,1,0,0,1762,352,1181,124,24,1,0,0,1682,3444
123,48,636,1125,78,5,6,0,0,1850,405,1309,130,21,2,0,0,1867,3717
123,49,592,1234,106,4,7,0,1,1944,383,1343,147,38,3,0,0,1914,3858
123,50,565,1248,103,8,3,0,0,1927,351,1293,131,28,0,0,0,1803,3730
123,51,533,1305,115,4,1,0,0,1958,381,1292,160,30,1,0,0,1864,3822
123,52,529,1279,120,12,3,0,0,1943,295,1352,161,51,1,0,0,1860,3803
123,53,521,1338,130,14,2,0,0,2005,282,1308,158,49,0,0,0,1797,3802
123,54,467,1336,141,19,3,0,0,1966,288,1426,184,57,0,0,0,1955,3921
123,55,463,1358,153,19,2,0,0,1995,292,1383,176,66,1,0,0,1918,3913
123,56,429,1386,148,15,2,0,0,1980,270,1454,177,69,2,0,0,1972,3952
123,57,419,1426,142,27,2,0,0,2016,230,1376,171,94,1,0,0,1872,3888
123,58,367,1471,161,33,1,0,0,2033,199,1402,191,93,1,0,0,1886,3919
123,59,330,1356,156,26,4,0,0,1872,191,1332,152,102,0,0,0,1777,3649
123,60,302,1351,114,26,3,0,0,1796,200,1230,151,119,0,0,0,1700,3496
123,61,249,1243,130,35,3,0,0,1660,145,1260,134,108,0,0,0,1647,3307
123,62,271,1162,100,35,1,0,0,1569,148,1163,120,145,0,0,0,1576,3145
123,63,181,1173,122,34,3,0,0,1513,141,1128,139,172,1,0,0,1581,3094
123,64,199,1201,87,33,1,0,0,1521,132,1120,111,188,2,0,0,1553,3074
123,65,185,1085,74,48,0,0,0,1392,114,1011,111,187,1,0,0,1424,2816
123,66,154,1075,96,47,1,0,0,1373,126,986,103,227,0,0,0,1442,2815
123,67,134,1059,61,53,0,0,0,1307,90,1024,93,247,0,0,0,1454,2761
123,68,129,976,81,51,0,0,0,1237,94,988,85,203,0,0,0,1370,2607
123,69,125,992,59,51,0,0,0,1227,89,971,74,272,0,0,0,1406,2633
123,70,112,949,61,57,0,0,0,1179,74,810,62,248,0,0,0,1194,2373
123,71,114,958,53,63,0,0,0,1188,77,829,69,315,1,0,0,1291,2479
123,72,108,905,44,72,0,0,0,1129,75,801,46,261,0,0,0,1183,2312
123,73,131,973,41,81,0,0,0,1226,72,799,56,358,1,0,1,1287,2513
123,74,107,952,35,85,0,0,0,1179,70,760,51,418,0,0,0,1299,2478
123,75,99,932,45,109,2,0,0,1187,60,759,49,397,0,0,0,1265,2452
123,76,74,844,27,97,0,0,0,1042,72,680,36,457,0,0,0,1245,2287
123,77,64,829,31,110,0,0,0,1034,55,667,37,476,0,0,0,1235,2269
123,78,59,590,21,100,0,0,0,770,50,451,25,406,0,0,0,932,1702
123,79,55,591,22,96,0,0,0,764,56,426,23,444,0,0,0,949,1713
123,80,50,543,14,99,0,0,0,706,60,398,24,498,0,0,0,980,1686
123,81,63,518,14,95,1,0,0,691,50,353,18,497,0,0,0,918,1609
123,82,46,484,9,118,0,0,0,657,55,269,18,580,0,0,0,922,1579
123,83,49,457,14,114,0,0,0,634,44,291,23,598,0,0,0,956,1590
123,84,53,432,7,139,0,0,0,631,49,241,15,612,0,0,0,917,1548
123,85,44,334,11,141,0,0,0,530,41,177,14,611,0,0,0,843,1373
123,86,24,286,4,114,0,0,0,428,54,160,10,518,0,0,0,742,1170
123,87,27,214,4,84,0,0,0,329,41,116,6,502,0,0,0,665,994
123,88,17,183,3,95,0,0,0,298,41,77,3,450,0,0,0,571,869
123,89,15,133,3,60,0,0,0,211,31,55,2,388,0,0,0,476,687
123,90,12,125,4,53,0,0,0,194,20,33,7,325,0,0,0,385,579
123,91,10,65,1,62,0,0,0,138,14,31,7,334,0,0,0,386,524
123,92,7,48,1,39,0,0,0,95,22,19,1,279,0,0,0,321,416
123,93,8,54,1,32,0,0,0,95,21,6,1,208,0,0,0,236,331
123,94,8,34,0,25,0,0,0,67,18,6,0,162,0,0,0,186,253
123,95,1,8,1,32,0,0,0,42,7,12,0,103,0,0,0,122,164
123,96,2,9,1,9,0,0,0,21,11,1,0,87,0,0,0,99,120
123,97,0,3,0,18,0,0,0,21,7,0,1,61,0,0,0,69,90
123,98,2,6,0,4,0,0,0,12,1,1,0,46,0,0,0,48,60
123,99,0,1,0,3,0,0,0,4,5,1,0,35,0,0,0,41,45
123,100,0,0,0,5,0,0,0,5,8,0,0,47,0,0,0,55,60
123,999,55968,51604,3560,2863,84,4,1,114084,45327,51861,4671,13461,66,2,1,115389,229473
124,0,1015,0,0,0,0,0,0,1015,938,0,0,0,0,0,0,938,1953
124,1,1062,0,0,0,0,0,0,1062,1014,0,0,0,0,0,0,1014,2076
124,2,1105,0,0,0,0,0,0,1105,989,0,0,0,0,0,0,989,2094
124,3,1141,0,0,0,0,0,0,1141,1078,0,0,0,0,0,0,1078,2219
124,4,1221,0,0,0,0,0,0,1221,1126,0,0,0,0,0,0,1126,2347
124,5,1327,0,0,0,0,0,0,1327,1153,0,0,0,0,0,0,1153,2480
124,6,1332,0,0,0,0,0,0,1332,1238,0,0,0,0,0,0,1238,2570
124,7,1353,0,0,0,0,0,0,1353,1345,0,0,0,0,0,0,1345,2698
124,8,1471,0,0,0,0,0,0,1471,1443,0,0,0,0,0,0,1443,2914
124,9,1574,0,0,0,0,0,0,1574,1438,0,0,0,0,0,0,1438,3012
124,10,1596,0,0,0,0,0,0,1596,1445,0,0,0,0,0,0,1445,3041
124,11,1616,0,0,0,0,0,0,1616,1509,0,0,0,0,0,0,1509,3125
124,12,1591,0,0,0,0,0,0,1591,1571,0,0,0,0,0,0,1571,3162
124,13,1720,0,0,0,0,0,0,1720,1679,0,0,0,0,0,0,1679,3399
124,14,1684,0,0,0,0,0,0,1684,1660,0,0,0,0,0,0,1660,3344
124,15,1745,0,0,0,0,0,0,1745,1700,0,0,0,0,0,0,1700,3445
124,16,1761,0,0,0,0,0,0,1761,1654,0,0,0,0,0,0,1654,3415
124,17,1737,0,0,0,0,0,0,1737,1556,0,0,0,0,0,0,1556,3293
124,18,1715,0,0,0,0,0,0,1715,1614,1,0,0,0,0,0,1615,3330
124,19,1658,0,0,0,0,0,0,1658,1609,4,0,0,0,0,0,1613,3271
124,20,1688,2,0,0,0,0,0,1690,1558,8,0,0,0,0,0,1566,3256
124,21,1718,2,0,0,0,0,0,1720,1517,11,0,0,2,0,0,1530,3250
124,22,1694,4,2,0,0,0,0,1700,1614,27,0,0,0,0,0,1641,3341
124,23,1785,11,0,0,0,0,0,1796,1547,60,2,0,0,0,0,1609,3405
124,24,1793,22,2,0,0,0,0,1817,1544,70,3,0,0,0,0,1617,3434
124,25,1635,34,1,0,0,0,0,1670,1431,90,4,0,1,0,0,1526,3196
124,26,1644,41,2,0,0,0,0,1687,1472,112,8,0,1,0,0,1593,3280
124,27,1623,58,4,0,0,0,0,1685,1379,179,8,0,1,0,0,1567,3252
124,28,1617,106,1,0,1,0,0,1725,1256,228,4,0,4,0,0,1492,3217
124,29,1536,149,3,0,1,0,0,1689,1276,311,10,0,3,1,0,1601,3290
124,30,1522,205,9,0,1,0,0,1737,1158,391,15,1,6,0,0,1571,3308
124,31,1475,244,10,0,2,0,0,1731,1160,467,16,1,3,0,0,1647,3378
124,32,1417,338,8,3,1,0,0,1767,1169,503,13,1,6,0,0,1692,3459
124,33,1286,406,9,3,2,0,0,1706,1123,633,35,4,2,0,0,1797,3503
124,34,1331,435,17,0,3,0,1,1787,1054,730,38,1,4,1,0,1828,3615
124,35,1243,516,21,4,1,0,0,1785,990,788,48,4,6,0,0,1836,3621
124,36,1134,532,20,0,3,0,1,1690,911,802,52,4,6,0,0,1775,3465
124,37,1068,611,36,1,2,0,0,1718,917,915,75,11,4,1,0,1923,3641
124,38,1129,725,40,3,8,0,0,1905,855,986,97,11,2,1,0,1952,3857
124,39,1109,809,38,5,2,0,0,1963,901,1066,77,15,2,0,0,2061,4024
124,40,1037,859,47,0,3,0,0,1946,940,1084,109,14,5,0,0,2152,4098
124,41,1079,965,59,2,5,0,0,2110,890,1189,121,21,2,2,0,2225,4335
124,42,1034,1059,71,7,3,0,0,2174,877,1183,112,19,4,2,0,2197,4371
124,43,1048,996,73,4,3,0,0,2124,821,1239,155,26,2,0,0,2243,4367
124,44,986,1171,115,8,8,0,0,2288,817,1377,132,31,2,0,0,2359,4647
124,45,1047,1222,96,17,5,0,0,2387,852,1432,158,36,4,0,0,2482,4869
124,46,1081,1352,118,9,4,1,0,2565,780,1593,195,35,2,0,0,2605,5170
124,47,1013,1442,155,7,7,0,0,2624,849,1635,250,35,4,0,0,2773,5397
124,48,1029,1518,164,13,5,0,0,2729,798,1778,247,56,3,0,0,2882,5611
124,49,1072,1603,178,19,5,0,0,2877,862,1807,273,51,2,0,0,2995,5872
124,50,971,1680,184,13,4,1,0,2853,719,1893,272,64,1,0,0,2949,5802
124,51,918,1704,191,18,11,0,0,2842,699,1895,265,70,2,0,0,2931,5773
124,52,891,1786,211,13,13,0,0,2914,692,1890,297,75,1,0,0,2955,5869
124,53,770,1752,232,12,4,0,1,2771,684,1942,323,84,2,0,0,3035,5806
124,54,812,1843,215,20,1,0,0,2891,632,1902,317,85,2,0,0,2938,5829
124,55,692,1887,244,23,8,0,0,2854,590,1958,336,98,1,0,0,2983,5837
124,56,686,1800,256,33,5,0,0,2780,581,1860,287,99,1,0,0,2828,5608
124,57,621,1930,255,32,5,0,0,2843,496,1864,331,135,1,0,0,2827,5670
124,58,613,1850,241,45,6,0,0,2755,458,1842,328,134,0,0,0,2762,5517
124,59,554,1972,238,28,8,0,0,2800,467,2051,363,129,1,0,0,3011,5811
124,60,472,1750,240,50,5,0,0,2517,425,1832,342,149,0,0,0,2748,5265
124,61,445,1737,267,41,0,0,0,2490,318,1870,324,155,0,1,0,2668,5158
124,62,377,1687,214,38,4,1,0,2321,305,1797,275,201,0,0,0,2578,4899
124,63,342,1677,194,48,5,0,0,2266,282,1748,264,226,0,0,0,2520,4786
124,64,327,1644,194,41,4,0,0,2210,246,1674,261,235,0,0,0,2416,4626
124,65,264,1591,161,62,6,0,0,2084,292,1565,238,286,2,0,0,2383,4467
124,66,262,1599,179,68,0,0,0,2108,226,1547,202,277,0,0,0,2252,4360
124,67,247,1491,163,73,3,0,0,1977,191,1467,185,276,0,0,0,2119,4096
124,68,199,1493,139,57,0,0,0,1888,192,1383,179,327,0,0,0,2081,3969
124,69,167,1395,135,76,2,0,0,1775,162,1457,151,300,0,0,0,2070,3845
124,70,180,1312,106,88,0,0,0,1686,162,1329,158,338,1,0,0,1988,3674
124,71,146,1342,84,94,2,0,0,1668,148,1319,133,360,0,0,0,1960,3628
124,72,134,1353,101,96,0,0,0,1684,121,1314,136,400,1,0,0,1972,3656
124,73,114,1432,85,111,7,0,0,1749,110,1263,130,479,0,0,0,1982,3731
124,74,126,1399,77,127,2,0,0,1731,115,1272,129,510,0,0,0,2026,3757
124,75,117,1424,76,154,1,0,0,1772,112,1260,95,601,0,0,0,2068,3840
124,76,108,1381,72,134,1,0,0,1696,86,1163,89,635,0,0,0,1973,3669
124,77,91,1335,74,143,0,0,0,1643,114,1130,97,662,0,0,0,2003,3646
124,78,87,1004,52,113,1,0,0,1257,74,810,71,579,0,0,0,1534,2791
124,79,65,1002,47,134,0,0,0,1248,91,773,66,630,0,0,0,1560,2808
124,80,73,1033,41,165,0,0,0,1312,79,744,57,669,0,0,0,1549,2861
124,81,50,874,33,141,0,0,0,1098,82,568,54,679,0,0,0,1383,2481
124,82,63,834,37,166,3,0,0,1103,51,565,51,741,0,0,0,1408,2511
124,83,69,831,17,171,0,0,0,1088,65,581,49,851,0,0,0,1546,2634
124,84,74,769,18,186,1,0,0,1048,58,458,43,822,0,0,0,1381,2429
124,85,54,712,19,200,0,0,0,985,67,408,31,923,0,0,0,1429,2414
124,86,45,566,12,180,0,0,0,803,57,282,25,794,0,0,0,1158,1961
124,87,31,438,9,154,0,0,0,632,47,195,28,720,0,0,0,990,1622
124,88,35,375,6,152,0,0,0,568,48,164,21,729,0,0,0,962,1530
124,89,22,324,4,164,1,0,0,515,49,132,18,735,0,0,0,934,1449
124,90,22,262,4,120,0,0,0,408,32,75,14,580,0,0,0,701,1109
124,91,12,171,6,96,0,0,0,285,19,49,7,502,0,0,0,577,862
124,92,17,164,0,92,0,0,0,273,32,39,4,456,0,0,0,531,804
124,93,9,91,2,80,0,0,0,182,27,30,4,422,0,0,0,483,665
124,94,3,64,2,60,0,0,0,129,23,12,5,282,0,0,0,322,451
124,95,8,41,0,59,0,0,0,108,18,5,4,246,0,0,0,273,381
124,96,1,24,0,31,0,0,0,56,9,4,1,182,0,0,0,196,252
124,97,4,16,0,29,0,0,0,49,13,5,1,134,0,0,0,153,202
124,98,0,8,0,11,0,0,0,19,4,1,0,79,0,0,0,84,103
124,99,0,5,0,10,0,0,0,15,5,0,0,61,0,0,0,66,81
124,100,3,5,0,11,0,0,0,19,5,1,0,100,0,0,0,106,125
124,999,81690,72296,6436,4368,188,3,3,164984,71657,74087,9318,19683,99,9,0,174853,339837
125,0,805,0,0,0,0,0,0,805,702,0,0,0,0,0,0,702,1507
125,1,770,0,0,0,0,0,0,770,727,0,0,0,0,0,0,727,1497
125,2,870,0,0,0,0,0,0,870,784,0,0,0,0,0,0,784,1654
125,3,885,0,0,0,0,0,0,885,831,0,0,0,0,0,0,831,1716
125,4,959,0,0,0,0,0,0,959,876,0,0,0,0,0,0,876,1835
125,5,1012,0,0,0,0,0,0,1012,943,0,0,0,0,0,0,943,1955
125,6,1126,0,0,0,0,0,0,1126,1000,0,0,0,0,0,0,1000,2126
125,7,1120,0,0,0,0,0,0,1120,1078,0,0,0,0,0,0,1078,2198
125,8,1126,0,0,0,0,0,0,1126,1029,0,0,0,0,0,0,1029,2155
125,9,1205,0,0,0,0,0,0,1205,1092,0,0,0,0,0,0,1092,2297
125,10,1198,0,0,0,0,0,0,1198,1108,0,0,0,0,0,0,1108,2306
125,11,1267,0,0,0,0,0,0,1267,1231,0,0,0,0,0,0,1231,2498
125,12,1285,0,0,0,0,0,0,1285,1233,0,0,0,0,0,0,1233,2518
125,13,1440,0,0,0,0,0,0,1440,1243,0,0,0,0,0,0,1243,2683
125,14,1430,0,0,0,0,0,0,1430,1297,0,0,0,0,0,0,1297,2727
125,15,1442,0,0,0,0,0,0,1442,1319,0,0,0,0,0,0,1319,2761
125,16,1433,0,0,0,0,0,0,1433,1338,0,0,0,0,0,0,1338,2771
125,17,1486,0,0,0,0,0,0,1486,1376,0,0,0,0,0,0,1376,2862
125,18,1500,0,0,0,0,0,0,1500,1342,1,0,0,0,0,0,1343,2843
125,19,1371,0,0,0,0,0,0,1371,1297,1,0,0,0,0,0,1298,2669
125,20,1378,1,0,0,0,0,0,1379,1235,6,0,0,0,0,0,1241,2620
125,21,1381,0,0,0,0,0,0,1381,1224,9,0,0,0,0,0,1233,2614
125,22,1355,0,3,0,0,0,0,1358,1172,24,2,0,0,0,0,1198,2556
125,23,1397,5,8,0,0,0,0,1410,1209,29,2,0,0,0,0,1240,2650
125,24,1321,17,4,0,0,0,0,1342,1093,36,5,0,0,0,0,1134,2476
125,25,1321,19,3,0,0,0,0,1343,1155,54,1,0,0,0,0,1210,2553
125,26,1304,17,4,0,0,0,0,1325,1031,78,1,1,0,0,0,1111,2436
125,27,1248,39,1,0,0,0,0,1288,995,136,3,0,1,0,0,1135,2423
125,28,1230,64,6,0,1,0,0,1301,972,165,3,0,0,0,0,1140,2441
125,29,1141,90,0,0,0,0,0,1231,940,245,7,1,1,0,0,1194,2425
125,30,1165,140,4,0,2,0,0,1311,937,266,10,0,1,0,0,1214,2525
125,31,1176,187,7,0,0,0,0,1370,964,350,11,3,3,0,0,1331,2701
125,32,1112,261,7,3,0,0,0,1383,863,441,16,3,3,0,0,1326,2709
125,33,1262,338,6,4,4,0,0,1614,828,470,19,2,2,0,0,1321,2935
125,34,1150,348,10,10,1,0,0,1519,877,575,22,0,2,0,0,1476,2995
125,35,1110,424,12,5,1,0,0,1552,869,631,33,1,3,0,0,1537,3089
125,36,1045,554,20,4,0,0,0,1623,779,751,47,8,4,0,0,1589,3212
125,37,941,560,39,7,3,1,0,1551,773,794,65,12,2,1,0,1647,3198
125,38,938,671,40,3,0,0,0,1652,674,843,76,13,3,0,0,1609,3261
125,39,902,708,40,9,3,0,0,1662,687,943,62,14,2,0,0,1708,3370
125,40,922,757,42,7,5,0,0,1733,670,947,73,8,1,0,0,1699,3432
125,41,874,873,55,0,1,0,0,1803,715,1022,78,20,5,1,0,1841,3644
125,42,799,975,63,18,2,0,0,1857,638,1017,109,25,4,0,0,1793,3650
125,43,850,909,65,12,3,0,0,1839,628,1014,95,33,1,2,0,1773,3612
125,44,769,966,70,15,4,0,0,1824,544,1190,113,38,0,1,0,1886,3710
125,45,832,1050,92,21,4,0,0,1999,648,1120,123,44,2,0,0,1937,3936
125,46,819,1074,63,20,4,0,0,1980,608,1193,172,38,2,0,0,2013,3993
125,47,795,1150,116,18,4,0,0,2083,622,1348,165,46,3,0,0,2184,4267
125,48,845,1216,118,28,3,0,0,2210,591,1352,158,58,2,1,0,2162,4372
125,49,779,1276,111,21,7,1,1,2196,535,1417,189,54,2,0,0,2197,4393
125,50,773,1335,148,23,10,0,0,2289,581,1461,235,48,4,0,0,2329,4618
125,51,750,1345,143,20,4,0,0,2262,494,1401,214,61,0,0,0,2170,4432
125,52,601,1434,150,15,11,0,0,2211,471,1491,212,85,2,0,0,2261,4472
125,53,624,1470,137,10,6,0,0,2247,414,1424,196,93,0,0,0,2127,4374
125,54,550,1507,149,13,3,0,0,2222,416,1453,209,77,3,0,0,2158,4380
125,55,504,1453,150,17,4,0,0,2128,383,1499,206,88,1,0,0,2177,4305
125,56,462,1344,159,21,1,1,0,1988,335,1488,202,89,2,0,0,2116,4104
125,57,446,1423,201,27,8,0,0,2105,339,1480,213,98,3,0,0,2133,4238
125,58,406,1460,180,33,5,0,0,2084,281,1504,216,119,1,0,0,2121,4205
125,59,353,1478,155,35,5,0,0,2026,234,1538,193,135,2,0,0,2102,4128
125,60,311,1356,171,32,4,0,0,1874,236,1372,196,133,1,0,0,1938,3812
125,61,245,1359,148,34,0,0,0,1786,193,1374,197,143,0,0,0,1907,3693
125,62,202,1237,134,29,3,0,0,1605,187,1297,195,123,1,0,0,1803,3408
125,63,182,1260,117,45,0,0,0,1604,163,1238,175,157,0,0,0,1733,3337
125,64,198,1172,106,58,0,0,0,1534,153,1164,146,141,1,0,0,1605,3139
125,65,161,1138,125,48,1,0,0,1473,125,1170,143,184,0,0,0,1622,3095
125,66,148,1185,96,51,0,0,0,1480,136,1115,125,184,0,0,0,1560,3040
125,67,115,1155,70,58,0,0,0,1398,128,1113,116,224,0,0,0,1581,2979
125,68,110,1137,76,58,1,0,0,1382,100,1097,97,231,0,0,0,1525,2907
125,69,85,1009,90,82,1,0,0,1267,94,1014,114,251,1,0,0,1474,2741
125,70,72,1011,56,78,0,0,0,1217,90,961,81,244,1,0,0,1377,2594
125,71,87,980,59,74,1,0,0,1201,75,983,89,275,0,0,0,1422,2623
125,72,73,985,47,68,1,0,0,1174,62,911,66,305,0,0,0,1344,2518
125,73,60,996,45,79,1,0,0,1181,57,936,73,334,0,0,0,1400,2581
125,74,80,1022,54,76,0,0,0,1232,72,963,63,398,0,0,0,1496,2728
125,75,69,1078,39,97,1,0,0,1284,68,899,70,431,0,0,0,1468,2752
125,76,60,1017,42,105,0,0,0,1224,63,882,62,465,0,0,1,1473,2697
125,77,66,1010,33,101,2,0,0,1212,70,819,66,490,0,0,0,1445,2657
125,78,53,757,24,81,0,0,0,915,44,641,39,416,0,0,0,1140,2055
125,79,23,696,16,108,0,0,0,843,56,574,41,466,0,0,0,1137,1980
125,80,35,718,16,114,1,0,0,884,48,552,30,496,0,0,0,1126,2010
125,81,43,603,13,100,0,0,0,759,44,442,35,487,0,0,0,1008,1767
125,82,33,600,13,122,0,0,0,768,43,428,25,528,0,0,0,1024,1792
125,83,49,610,12,147,0,0,0,818,40,438,30,667,0,0,0,1175,1993
125,84,44,573,10,153,0,0,0,780,49,357,27,630,0,0,0,1063,1843
125,85,30,547,9,149,0,0,0,735,49,289,20,726,0,0,0,1084,1819
125,86,23,383,12,129,0,0,0,547,35,213,20,611,0,0,0,879,1426
125,87,22,332,7,140,0,0,0,501,29,173,10,528,0,0,0,740,1241
125,88,18,267,6,117,0,0,0,408,30,126,12,540,0,0,0,708,1116
125,89,14,203,7,97,0,0,0,321,21,82,4,478,0,0,0,585,906
125,90,11,162,2,87,0,0,0,262,32,65,9,430,0,0,0,536,798
125,91,13,133,4,76,0,0,0,226,17,46,7,392,0,0,0,462,688
125,92,8,100,4,60,0,0,0,172,11,42,2,323,0,0,0,378,550
125,93,7,71,1,64,0,0,0,143,25,25,2,282,0,0,0,334,477
125,94,5,46,1,35,0,0,0,87,8,5,2,215,0,0,0,230,317
125,95,3,34,0,31,0,0,0,68,8,3,0,182,0,0,0,193,261
125,96,1,15,1,35,0,0,0,52,6,7,1,110,0,0,0,124,176
125,97,1,13,0,16,0,0,0,30,7,0,0,91,0,0,0,98,128
125,98,0,6,0,9,0,0,0,15,5,0,0,59,0,0,0,64,79
125,99,0,1,1,10,0,0,0,12,8,1,0,53,0,0,0,62,74
125,100,0,3,0,11,0,0,0,14,8,0,0,70,0,0,0,78,92
125,999,64120,55918,4248,3483,126,3,1,127899,53965,57024,6146,14808,72,6,1,132022,259921
126,0,629,0,0,0,0,0,0,629,607,0,0,0,0,0,0,607,1236
126,1,716,0,0,0,0,0,0,716,635,0,0,0,0,0,0,635,1351
126,2,650,0,0,0,0,0,0,650,626,0,0,0,0,0,0,626,1276
126,3,718,0,0,0,0,0,0,718,656,0,0,0,0,0,0,656,1374
126,4,699,0,0,0,0,0,0,699,732,0,0,0,0,0,0,732,1431
126,5,777,0,0,0,0,0,0,777,698,0,0,0,0,0,0,698,1475
126,6,769,0,0,0,0,0,0,769,719,0,0,0,0,0,0,719,1488
126,7,754,0,0,0,0,0,0,754,746,0,0,0,0,0,0,746,1500
126,8,816,0,0,0,0,0,0,816,738,0,0,0,0,0,0,738,1554
126,9,783,0,0,0,0,0,0,783,736,0,0,0,0,0,0,736,1519
126,10,805,0,0,0,0,0,0,805,745,0,0,0,0,0,0,745,1550
126,11,847,0,0,0,0,0,0,847,760,0,0,0,0,0,0,760,1607
126,12,868,0,0,0,0,0,0,868,791,0,0,0,0,0,0,791,1659
126,13,875,0,0,0,0,0,0,875,919,0,0,0,0,0,0,919,1794
126,14,917,0,0,0,0,0,0,917,804,0,0,0,0,0,0,804,1721
126,15,972,0,0,0,0,0,0,972,845,0,0,0,0,0,0,845,1817
126,16,878,0,0,0,0,0,0,878,815,0,0,0,0,0,0,815,1693
126,17,893,0,0,0,0,0,0,893,909,0,0,0,0,0,0,909,1802
126,18,968,0,0,0,0,0,0,968,905,0,0,0,0,0,0,905,1873
126,19,1014,0,0,0,0,0,0,1014,929,2,0,0,0,0,0,931,1945
126,20,972,3,0,0,0,0,0,975,845,5,0,0,0,0,0,850,1825
126,21,889,5,0,0,0,0,0,894,810,15,0,0,0,0,0,825,1719
126,22,929,4,0,0,0,0,0,933,856,17,0,0,0,0,0,873,1806
126,23,921,4,0,0,0,0,0,925,914,37,1,0,0,0,0,952,1877
126,24,931,13,0,0,0,0,0,944,796,54,0,0,0,0,0,850,1794
126,25,919,13,0,0,0,0,0,932,791,85,0,0,0,0,0,876,1808
126,26,800,42,1,0,0,0,0,843,699,124,0,0,0,0,0,823,1666
126,27,800,54,0,0,0,0,0,854,687,169,1,1,0,0,0,858,1712
126,28,791,84,1,0,0,0,0,876,616,203,2,0,0,0,0,821,1697
126,29,738,137,0,0,0,0,0,875,637,258,5,0,0,0,0,900,1775
126,30,752,164,2,0,0,0,0,918,564,333,8,0,0,0,0,905,1823
126,31,774,202,2,0,0,0,0,978,511,362,14,0,1,0,0,888,1866
126,32,662,275,2,0,0,0,0,939,482,440,11,2,0,1,0,936,1875
126,33,678,311,8,1,0,0,0,998,420,495,11,3,0,0,0,929,1927
126,34,623,403,6,0,0,0,0,1032,400,522,8,3,0,0,0,933,1965
126,35,605,416,8,1,0,0,0,1030,353,580,14,3,0,0,0,950,1980
126,36,560,461,14,0,0,0,0,1035,350,615,26,4,1,0,0,996,2031
126,37,490,507,12,1,0,0,0,1010,261,633,32,4,0,0,0,930,1940
126,38,480,490,9,2,0,0,0,981,235,691,25,2,0,0,0,953,1934
126,39,439,565,17,1,0,0,0,1022,259,654,27,6,0,0,0,946,1968
126,40,424,555,23,0,0,0,0,1002,249,679,25,5,0,0,0,958,1960
126,41,427,614,23,1,0,0,0,1065,228,697,49,7,0,0,0,981,2046
126,42,366,617,20,0,0,0,0,1003,212,736,38,8,0,0,0,994,1997
126,43,374,688,27,1,0,0,0,1090,213,779,40,12,0,0,0,1044,2134
126,44,358,707,40,7,1,0,0,1113,205,757,38,8,0,0,0,1008,2121
126,45,317,723,35,5,0,0,0,1080,198,797,47,12,0,1,0,1055,2135
126,46,302,683,25,5,0,0,0,1015,174,868,47,17,0,0,0,1106,2121
126,47,310,788,40,5,0,0,0,1143,190,823,64,23,0,0,0,1100,2243
126,48,274,749,57,8,0,0,0,1088,187,882,52,22,0,0,0,1143,2231
126,49,277,842,41,6,0,0,0,1166,198,907,57,35,0,0,0,1197,2363
126,50,241,796,68,13,0,0,0,1118,190,892,49,32,0,0,0,1163,2281
126,51,263,859,49,7,0,0,0,1178,172,950,60,35,0,0,0,1217,2395
126,52,239,865,54,8,0,0,0,1166,178,962,59,38,0,0,0,1237,2403
126,53,236,882,35,10,0,0,0,1163,158,917,52,52,0,0,0,1179,2342
126,54,224,876,57,9,0,0,0,1166,173,979,57,68,2,0,0,1279,2445
126,55,207,873,53,13,0,0,0,1146,147,981,58,56,0,0,0,1242,2388
126,56,186,890,45,9,0,0,0,1130,160,989,55,79,0,0,0,1283,2413
126,57,168,937,42,18,0,0,0,1165,150,963,45,85,0,0,0,1243,2408
126,58,172,932,40,18,0,0,0,1162,158,948,56,81,0,0,0,1243,2405
126,59,166,1029,49,26,0,0,0,1270,137,961,52,95,0,0,0,1245,2515
126,60,119,963,44,17,0,0,0,1143,127,966,36,94,0,0,0,1223,2366
126,61,104,946,41,17,0,0,0,1108,117,958,50,112,0,0,0,1237,2345
126,62,128,985,48,23,0,0,0,1184,140,883,34,137,0,0,0,1194,2378
126,63,100,943,32,23,0,0,0,1098,113,861,37,132,0,0,0,1143,2241
126,64,86,882,51,22,0,0,0,1041,117,839,30,153,0,0,0,1139,2180
126,65,89,836,37,29,0,0,0,991,68,781,37,167,0,0,0,1053,2044
126,66,75,932,28,38,0,0,0,1073,78,738,35,169,0,0,0,1020,2093
126,67,74,860,19,42,0,0,0,995,84,769,29,193,0,0,0,1075,2070
126,68,62,853,28,28,0,0,0,971,89,737,29,210,0,0,0,1065,2036
126,69,62,849,24,43,0,0,0,978,80,692,31,228,0,0,0,1031,2009
126,70,66,750,35,45,0,0,0,896,85,640,21,237,0,0,0,983,1879
126,71,46,718,16,45,0,0,0,825,59,591,25,232,0,0,0,907,1732
126,72,31,725,14,42,0,0,0,812,71,558,14,246,0,0,0,889,1701
126,73,40,764,19,45,0,0,0,868,63,563,15,290,0,0,0,931,1799
126,74,52,692,20,56,0,0,0,820,67,577,13,344,0,0,0,1001,1821
126,75,25,689,17,54,0,0,0,785,54,531,16,334,0,0,0,935,1720
126,76,32,632,9,65,0,0,0,738,61,434,10,367,0,0,0,872,1610
126,77,21,598,11,60,0,0,0,690,57,377,11,354,0,0,0,799,1489
126,78,27,460,9,69,0,0,0,565,50,297,15,321,0,0,0,683,1248
126,79,18,419,6,56,0,0,0,499,33,266,7,294,0,0,0,600,1099
126,80,24,375,2,57,0,0,0,458,34,209,10,314,0,0,0,567,1025
126,81,17,354,8,58,1,0,0,438,34,201,4,335,0,0,0,574,1012
126,82,18,313,6,52,0,0,0,389,30,164,6,350,0,0,0,550,939
126,83,11,355,4,72,0,0,0,442,34,163,13,418,0,0,0,628,1070
126,84,12,275,5,75,0,0,0,367,36,152,8,365,0,0,0,561,928
126,85,7,266,4,62,0,0,0,339,33,130,5,330,0,0,0,498,837
126,86,5,204,4,79,0,0,0,292,18,99,5,354,0,0,0,476,768
126,87,5,188,4,68,0,0,0,265,22,65,5,320,0,0,0,412,677
126,88,6,151,1,83,0,0,0,241,21,46,1,272,0,0,0,340,581
126,89,3,120,1,60,0,0,0,184,12,41,0,232,0,0,0,285,469
126,90,2,100,1,54,0,0,0,157,11,30,1,205,0,0,0,247,404
126,91,3,72,0,51,0,0,0,126,19,21,0,180,0,0,0,220,346
126,92,2,34,1,45,0,0,0,82,13,20,0,166,0,0,0,199,281
126,93,5,37,0,45,0,0,0,87,10,11,0,104,0,0,0,125,212
126,94,0,19,0,26,0,0,0,45,5,3,2,83,0,0,0,93,138
126,95,1,20,0,25,0,0,0,46,3,4,0,67,0,0,0,74,120
126,96,0,8,0,15,0,0,0,23,5,2,0,52,0,0,0,59,82
126,97,1,5,0,13,0,0,0,19,3,1,1,31,0,0,0,36,55
126,98,0,5,0,6,0,0,0,11,0,1,0,25,0,0,0,26,37
126,99,0,2,0,3,0,0,0,5,0,1,0,21,0,0,0,22,27
126,100,1,0,0,6,0,0,0,7,4,3,0,21,0,0,0,28,35
126,999,38012,38457,1454,1949,2,0,0,79874,32438,38186,1741,9657,4,2,0,82028,161902
127,0,584,0,0,0,0,0,0,584,527,0,0,0,0,0,0,527,1111
127,1,595,0,0,0,0,0,0,595,522,0,0,0,0,0,0,522,1117
127,2,543,0,0,0,0,0,0,543,543,0,0,0,0,0,0,543,1086
127,3,598,0,0,0,0,0,0,598,557,0,0,0,0,0,0,557,1155
127,4,620,0,0,0,0,0,0,620,542,0,0,0,0,0,0,542,1162
127,5,602,0,0,0,0,0,0,602,610,0,0,0,0,0,0,610,1212
127,6,622,0,0,0,0,0,0,622,588,0,0,0,0,0,0,588,1210
127,7,610,0,0,0,0,0,0,610,595,0,0,0,0,0,0,595,1205
127,8,655,0,0,0,0,0,0,655,615,0,0,0,0,0,0,615,1270
127,9,684,0,0,0,0,0,0,684,627,0,0,0,0,0,0,627,1311
127,10,658,0,0,0,0,0,0,658,592,0,0,0,0,0,0,592,1250
127,11,732,0,0,0,0,0,0,732,642,0,0,0,0,0,0,642,1374
127,12,679,0,0,0,0,0,0,679,657,0,0,0,0,0,0,657,1336
127,13,733,0,0,0,0,0,0,733,723,0,0,0,0,0,0,723,1456
127,14,710,0,0,0,0,0,0,710,705,0,0,0,0,0,0,705,1415
127,15,745,0,0,0,0,0,0,745,782,0,0,0,0,0,0,782,1527
127,16,804,0,0,0,0,0,0,804,742,0,0,0,0,0,0,742,1546
127,17,772,0,0,0,0,0,0,772,770,0,0,0,0,0,0,770,1542
127,18,853,0,0,0,0,0,0,853,753,0,0,0,0,0,0,753,1606
127,19,825,0,0,0,0,0,0,825,798,2,0,0,0,0,0,800,1625
127,20,876,0,0,0,0,0,0,876,760,4,0,0,0,0,0,764,1640
127,21,808,1,0,0,0,0,0,809,737,16,0,0,0,0,0,753,1562
127,22,927,1,1,0,0,0,0,929,757,38,0,0,0,0,0,795,1724
127,23,934,4,0,0,0,0,0,938,714,33,0,0,0,0,0,747,1685
127,24,887,14,0,0,0,0,0,901,718,56,0,0,0,0,0,774,1675
127,25,899,33,0,0,0,0,0,932,723,75,0,0,0,0,0,798,1730
127,26,855,43,0,0,0,0,0,898,716,128,0,0,0,0,0,844,1742
127,27,829,61,0,0,0,0,0,890,620,167,1,0,0,0,0,788,1678
127,28,784,93,0,0,0,0,0,877,618,214,2,0,0,0,0,834,1711
127,29,781,119,1,0,0,0,0,901,552,251,3,1,0,0,0,807,1708
127,30,730,164,0,0,0,0,0,894,496,341,5,0,0,0,0,842,1736
127,31,714,231,1,0,0,0,0,946,493,410,3,0,0,0,0,906,1852
127,32,603,258,2,0,0,0,0,863,419,402,2,0,0,0,0,823,1686
127,33,622,311,2,0,0,0,0,935,392,473,7,1,0,0,0,873,1808
127,34,591,348,2,0,0,0,0,941,333,499,9,2,0,0,0,843,1784
127,35,536,405,4,0,0,0,0,945,366,528,6,0,0,0,0,900,1845
127,36,492,406,3,1,0,0,0,902,288,563,5,3,0,0,0,859,1761
127,37,435,455,6,1,0,0,0,897,309,584,18,5,0,0,0,916,1813
127,38,421,449,8,1,0,0,0,879,260,645,17,2,0,0,0,924,1803
127,39,427,522,7,2,1,0,0,959,251,574,14,5,0,0,0,844,1803
127,40,398,515,6,0,0,0,0,919,191,580,19,5,0,0,0,795,1714
127,41,349,553,14,0,0,0,0,916,199,692,17,10,0,0,0,918,1834
127,42,339,529,17,2,1,0,0,888,218,658,21,7,0,0,0,904,1792
127,43,303,595,13,1,0,0,0,912,167,674,27,10,0,0,0,878,1790
127,44,290,618,10,0,0,0,0,918,206,710,30,11,0,0,0,957,1875
127,45,321,607,15,3,0,0,0,946,220,707,22,12,0,0,0,961,1907
127,46,310,638,20,4,0,0,0,972,182,775,39,17,0,0,0,1013,1985
127,47,294,683,19,1,0,0,0,997,182,864,33,19,0,0,0,1098,2095
127,48,300,735,31,5,0,0,0,1071,161,796,52,18,0,0,0,1027,2098
127,49,264,708,25,3,0,0,0,1000,179,883,36,28,0,0,0,1126,2126
127,50,256,773,27,4,0,0,0,1060,160,867,37,30,0,0,0,1094,2154
127,51,270,771,21,12,0,0,0,1074,166,853,50,34,0,0,0,1103,2177
127,52,247,813,32,8,0,0,0,1100,142,867,22,57,0,0,0,1088,2188
127,53,240,724,33,5,0,0,0,1002,167,884,42,44,1,0,0,1138,2140
127,54,245,805,34,7,0,0,0,1091,163,977,47,46,0,0,0,1233,2324
127,55,217,849,34,15,1,0,0,1116,166,919,41,58,0,0,0,1184,2300
127,56,216,837,36,16,0,0,0,1105,164,889,33,65,0,0,0,1151,2256
127,57,218,903,31,8,0,0,0,1160,144,993,30,80,0,0,0,1247,2407
127,58,191,855,36,19,0,0,0,1101,129,882,38,83,0,0,0,1132,2233
127,59,205,944,30,17,0,0,0,1196,145,999,37,98,0,0,0,1279,2475
127,60,185,903,30,12,0,0,0,1130,95,927,30,114,0,0,0,1166,2296
127,61,154,888,27,21,0,0,0,1090,135,943,32,113,0,0,0,1223,2313
127,62,167,840,25,25,0,0,0,1057,104,904,27,137,0,0,0,1172,2229
127,63,153,852,42,18,0,0,0,1065,96,909,28,137,0,0,0,1170,2235
127,64,131,839,25,28,0,0,0,1023,100,837,40,153,0,0,0,1130,2153
127,65,120,808,22,33,0,0,0,983,78,754,29,139,0,0,0,1000,1983
127,66,135,771,27,30,0,0,0,963,98,756,26,174,0,0,0,1054,2017
127,67,113,803,23,32,0,0,0,971,71,678,21,198,0,0,0,968,1939
127,68,95,829,26,31,1,0,0,982,88,655,24,202,0,0,0,969,1951
127,69,104,761,16,35,0,0,0,916,61,671,25,194,0,0,0,951,1867
127,70,87,795,23,34,0,0,0,939,78,607,19,222,0,0,0,926,1865
127,71,67,716,20,37,0,0,0,840,69,548,19,225,0,0,0,861,1701
127,72,62,749,22,32,0,0,0,865,64,534,17,219,0,0,0,834,1699
127,73,60,723,21,45,0,0,0,849,59,531,19,273,0,0,0,882,1731
127,74,59,728,13,53,0,0,0,853,65,508,11,311,0,0,0,895,1748
127,75,45,696,15,66,1,0,0,823,54,490,16,339,0,0,0,899,1722
127,76,57,671,10,62,0,0,0,800,53,404,10,331,0,0,0,798,1598
127,77,33,583,8,49,0,0,0,673,55,367,9,327,0,0,0,758,1431
127,78,29,480,17,50,0,0,0,576,42,290,8,266,0,0,0,606,1182
127,79,24,418,4,61,0,0,0,507,32,230,5,263,0,0,0,530,1037
127,80,24,350,8,69,0,0,0,451,50,224,8,287,0,0,0,569,1020
127,81,14,361,6,67,0,0,0,448,26,206,8,308,0,0,0,548,996
127,82,16,321,3,46,0,0,0,386,30,145,5,293,0,0,0,473,859
127,83,24,371,10,79,0,0,0,484,43,197,4,345,0,0,0,589,1073
127,84,24,343,5,77,0,0,0,449,38,167,1,352,0,0,0,558,1007
127,85,13,276,2,76,0,0,0,367,55,130,4,338,0,0,0,527,894
127,86,20,231,2,81,0,0,0,334,30,92,4,327,0,0,0,453,787
127,87,12,183,2,73,0,0,0,270,31,92,1,292,0,0,0,416,686
127,88,11,152,3,89,0,0,0,255,34,70,5,281,0,0,0,390,645
127,89,11,138,3,56,0,0,0,208,20,56,2,262,0,0,0,340,548
127,90,5,121,1,61,0,0,0,188,26,36,3,276,0,0,0,341,529
127,91,4,82,0,48,0,0,0,134,21,30,1,207,0,0,0,259,393
127,92,3,54,2,39,0,0,0,98,21,19,2,178,0,0,0,220,318
127,93,1,44,0,44,0,0,0,89,19,20,0,149,0,0,0,188,277
127,94,6,22,0,16,0,0,0,44,14,10,5,93,0,0,0,122,166
127,95,1,14,0,24,0,0,0,39,12,4,0,90,0,0,0,106,145
127,96,3,15,0,14,0,0,0,32,6,2,0,53,0,0,0,61,93
127,97,2,7,0,14,0,0,0,23,7,0,1,35,0,0,0,43,66
127,98,0,5,0,6,0,0,0,11,4,4,0,30,0,0,0,38,49
127,99,1,5,0,4,0,0,0,10,3,4,0,14,0,0,0,21,31
127,100,1,6,0,10,0,0,0,17,10,3,1,44,0,0,0,58,75
127,999,35324,36327,984,1882,5,0,0,74522,28860,36526,1235,9342,1,0,0,75964,150486
128,0,404,0,0,0,0,0,0,404,356,0,0,0,0,0,0,356,760
128,1,387,0,0,0,0,0,0,387,392,0,0,0,0,0,0,392,779
128,2,473,0,0,0,0,0,0,473,432,0,0,0,0,0,0,432,905
128,3,450,0,0,0,0,0,0,450,445,0,0,0,0,0,0,445,895
128,4,432,0,0,0,0,0,0,432,401,0,0,0,0,0,0,401,833
128,5,466,0,0,0,0,0,0,466,465,0,0,0,0,0,0,465,931
128,6,475,0,0,0,0,0,0,475,480,0,0,0,0,0,0,480,955
128,7,538,0,0,0,0,0,0,538,503,0,0,0,0,0,0,503,1041
128,8,545,0,0,0,0,0,0,545,556,0,0,0,0,0,0,556,1101
128,9,606,0,0,0,0,0,0,606,560,0,0,0,0,0,0,560,1166
128,10,588,0,0,0,0,0,0,588,601,0,0,0,0,0,0,601,1189
128,11,586,0,0,0,0,0,0,586,629,0,0,0,0,0,0,629,1215
128,12,655,0,0,0,0,0,0,655,615,0,0,0,0,0,0,615,1270
128,13,671,0,0,0,0,0,0,671,629,0,0,0,0,0,0,629,1300
128,14,698,0,0,0,0,0,0,698,660,0,0,0,0,0,0,660,1358
128,15,713,0,0,0,0,0,0,713,626,0,0,0,0,0,0,626,1339
128,16,647,0,0,0,0,0,0,647,644,0,0,0,0,0,0,644,1291
128,17,719,0,0,0,0,0,0,719,668,0,0,0,0,0,0,668,1387
128,18,711,0,0,0,0,0,0,711,669,1,0,0,0,0,0,670,1381
128,19,776,0,0,0,0,0,0,776,650,2,0,0,0,0,0,652,1428
128,20,749,1,0,0,0,0,0,750,669,3,0,0,0,0,0,672,1422
128,21,732,2,1,0,0,0,0,735,583,6,2,0,0,0,0,591,1326
128,22,766,1,2,0,0,0,0,769,661,17,0,0,0,0,0,678,1447
128,23,746,5,0,0,0,0,0,751,704,23,1,0,0,0,0,728,1479
128,24,745,10,2,0,0,0,0,757,640,22,0,0,0,0,0,662,1419
128,25,797,23,0,0,0,0,0,820,677,46,0,1,0,0,0,724,1544
128,26,751,9,0,0,0,0,0,760,637,53,5,0,0,0,0,695,1455
128,27,736,36,0,0,0,0,0,772,591,84,4,0,0,0,0,679,1451
128,28,691,49,2,0,0,0,0,742,567,107,4,0,0,0,0,678,1420
128,29,691,59,3,0,0,0,0,753,541,164,5,1,0,0,0,711,1464
128,30,706,73,6,0,1,0,0,786,501,142,11,0,0,0,0,654,1440
128,31,624,100,0,0,3,0,0,727,467,193,9,3,1,0,0,673,1400
128,32,625,117,3,2,1,0,0,748,502,245,11,1,0,0,0,759,1507
128,33,583,172,7,1,0,0,0,763,426,266,19,2,2,0,0,715,1478
128,34,513,186,12,0,1,0,0,712,412,276,16,3,1,0,0,708,1420
128,35,544,238,12,0,1,0,0,795,369,334,17,4,0,0,0,724,1519
128,36,494,231,8,0,0,0,0,733,339,332,24,2,0,0,0,697,1430
128,37,469,253,16,0,1,1,0,740,336,350,28,7,5,1,0,727,1467
128,38,472,303,22,0,0,0,0,797,309,386,37,4,0,0,0,736,1533
128,39,430,327,24,0,2,0,0,783,330,385,41,4,2,0,0,762,1545
128,40,430,350,30,1,0,0,0,811,283,416,32,5,2,0,0,738,1549
128,41,449,379,25,0,0,0,0,853,306,449,39,4,1,0,0,799,1652
128,42,407,421,29,1,0,0,0,858,286,438,61,12,0,0,0,797,1655
128,43,414,409,40,2,1,0,0,866,315,505,55,6,0,0,0,881,1747
128,44,425,433,44,1,3,0,0,906,245,542,69,12,1,0,0,869,1775
128,45,433,474,52,2,2,0,0,963,271,591,100,13,2,0,0,977,1940
128,46,456,468,64,3,0,0,0,991,317,618,93,13,1,0,0,1042,2033
128,47,416,566,70,3,0,0,0,1055,289,693,115,13,0,0,0,1110,2165
128,48,451,628,77,1,1,0,0,1158,303,759,116,19,4,0,0,1201,2359
128,49,455,667,72,5,1,0,0,1200,343,752,128,27,1,0,0,1251,2451
128,50,462,727,95,2,0,0,0,1286,306,796,127,23,1,0,0,1253,2539
128,51,403,709,107,8,0,0,0,1227,296,825,160,24,0,0,0,1305,2532
128,52,369,800,132,5,1,0,0,1307,270,846,187,44,0,0,0,1347,2654
128,53,394,783,132,10,3,0,0,1322,264,842,152,39,0,0,0,1297,2619
128,54,394,835,112,8,1,0,0,1350,244,935,156,57,2,0,0,1394,2744
128,55,355,853,133,16,0,0,0,1357,234,964,180,52,0,0,0,1430,2787
128,56,320,828,133,17,2,0,0,1300,210,930,178,61,2,0,0,1381,2681
128,57,326,897,159,13,3,0,0,1398,234,954,167,69,2,0,0,1426,2824
128,58,345,908,145,11,2,0,0,1411,205,908,178,74,0,0,0,1365,2776
128,59,292,934,160,14,2,0,0,1402,200,950,157,94,0,0,1,1402,2804
128,60,263,900,137,20,3,0,0,1323,171,897,170,92,0,0,0,1330,2653
128,61,262,845,143,20,1,0,0,1271,128,900,165,105,2,0,0,1300,2571
128,62,212,804,137,29,3,0,0,1185,142,844,143,115,1,0,0,1245,2430
128,63,181,838,110,24,0,0,0,1153,126,801,141,141,0,0,0,1209,2362
128,64,172,791,103,29,0,0,0,1095,117,756,126,138,0,0,0,1137,2232
128,65,142,766,117,36,2,0,0,1063,97,793,121,158,0,0,0,1169,2232
128,66,164,790,105,30,0,0,0,1089,105,736,102,165,0,0,0,1108,2197
128,67,121,767,84,36,1,0,0,1009,86,712,98,163,0,0,0,1059,2068
128,68,124,739,81,33,1,0,0,978,107,700,99,172,0,0,0,1078,2056
128,69,108,714,80,38,1,0,0,941,70,742,81,216,0,0,0,1109,2050
128,70,117,770,74,62,1,0,0,1024,78,704,74,204,0,0,0,1060,2084
128,71,95,708,66,40,0,0,0,909,71,636,84,225,0,0,0,1016,1925
128,72,87,677,58,63,0,0,0,885,73,584,69,268,0,0,0,994,1879
128,73,102,736,64,75,0,0,1,978,58,612,69,288,0,0,0,1027,2005
128,74,76,715,54,65,0,0,0,910,59,593,64,282,0,0,0,998,1908
128,75,85,740,50,64,0,0,0,939,69,652,59,309,0,0,1,1090,2029
128,76,77,694,43,69,1,0,0,884,48,582,43,392,0,0,0,1065,1949
128,77,78,659,50,88,0,0,0,875,65,525,46,373,0,0,0,1009,1884
128,78,54,460,26,63,1,0,0,604,37,347,36,305,0,0,0,725,1329
128,79,47,495,18,67,0,0,0,627,45,387,29,403,1,0,0,865,1492
128,80,44,433,19,91,0,0,0,587,51,331,28,395,0,0,0,805,1392
128,81,34,448,18,82,0,0,0,582,43,336,29,395,0,0,0,803,1385
128,82,40,470,30,96,1,0,0,637,43,306,30,466,0,0,0,845,1482
128,83,49,436,27,127,0,0,0,639,60,279,18,481,0,0,1,839,1478
128,84,35,376,16,120,0,0,0,547,35,228,27,533,1,0,0,824,1371
128,85,32,327,8,107,1,0,0,475,50,207,15,471,0,0,0,743,1218
128,86,25,292,8,93,0,0,0,418,36,151,12,477,0,0,0,676,1094
128,87,17,219,10,77,0,0,0,323,23,98,10,393,0,0,0,524,847
128,88,18,189,6,87,0,0,0,300,29,91,12,398,0,0,0,530,830
128,89,19,134,4,76,0,0,0,233,25,71,11,373,0,0,0,480,713
128,90,5,93,4,51,0,0,0,153,35,45,12,319,0,0,0,411,564
128,91,12,71,2,39,0,0,0,124,30,34,4,282,0,0,0,350,474
128,92,6,60,2,53,0,0,0,121,19,24,5,232,0,0,0,280,401
128,93,6,45,3,33,0,0,0,87,12,16,1,225,0,0,0,254,341
128,94,7,40,0,31,0,0,0,78,14,6,4,156,0,0,0,180,258
128,95,3,18,0,25,0,0,0,46,16,4,2,118,0,0,0,140,186
128,96,1,12,0,18,0,0,0,31,11,1,3,93,0,0,0,108,139
128,97,1,6,0,9,0,0,0,16,7,4,0,73,0,0,0,84,100
128,98,1,6,0,9,0,0,0,16,5,1,0,37,0,0,0,43,59
128,99,1,3,0,7,0,0,0,11,2,1,0,37,0,0,0,40,51
128,100,1,2,0,6,0,0,0,9,12,0,2,45,0,0,0,59,68
128,999,35324,33552,3688,2314,49,1,1,74929,28973,33887,4728,11206,35,1,3,78833,153762
129,0,2973,0,0,0,0,0,0,2973,2860,0,0,0,0,0,0,2860,5833
129,1,3156,0,0,0,0,0,0,3156,2999,0,0,0,0,0,0,2999,6155
129,2,3318,0,0,0,0,0,0,3318,2974,0,0,0,0,0,0,2974,6292
129,3,3269,0,0,0,0,0,0,3269,3094,0,0,0,0,0,0,3094,6363
129,4,3385,0,0,0,0,0,0,3385,3307,0,0,0,0,0,0,3307,6692
129,5,3638,0,0,0,0,0,0,3638,3326,0,0,0,0,0,0,3326,6964
129,6,3848,0,0,0,0,0,0,3848,3538,0,0,0,0,0,0,3538,7386
129,7,3855,0,0,0,0,0,0,3855,3643,0,0,0,0,0,0,3643,7498
129,8,3983,0,0,0,0,0,0,3983,3830,0,0,0,0,0,0,3830,7813
129,9,4108,0,0,0,0,0,0,4108,3933,0,0,0,0,0,0,3933,8041
129,10,4303,0,0,0,0,0,0,4303,3863,0,0,0,0,0,0,3863,8166
129,11,4394,0,0,0,0,0,0,4394,4190,0,0,0,0,0,0,4190,8584
129,12,4316,0,0,0,0,0,0,4316,4237,0,0,0,0,0,0,4237,8553
129,13,4482,0,0,0,0,0,0,4482,4301,0,0,0,0,0,0,4301,8783
129,14,4618,0,0,0,0,0,0,4618,4305,0,0,0,0,0,0,4305,8923
129,15,4619,0,0,0,0,0,0,4619,4385,0,0,0,0,0,0,4385,9004
129,16,4610,0,0,0,0,0,0,4610,4286,1,0,0,0,0,0,4287,8897
129,17,4723,0,1,0,0,0,0,4724,4284,0,0,0,0,0,0,4284,9008
129,18,4540,0,0,0,0,0,0,4540,4167,0,0,0,0,0,0,4167,8707
129,19,4589,4,0,0,0,0,0,4593,4166,4,0,0,0,0,0,4170,8763
129,20,4467,0,0,0,0,0,0,4467,4183,15,0,0,0,0,0,4198,8665
129,21,4491,6,0,0,0,0,0,4497,4017,35,0,0,0,0,0,4052,8549
129,22,4359,11,2,0,2,0,0,4374,4026,52,6,0,0,0,0,4084,8458
129,23,4572,20,5,0,0,0,0,4597,4075,121,9,0,0,0,0,4205,8802
129,24,4410,37,4,0,0,0,0,4451,3882,167,1,0,0,0,0,4050,8501
129,25,4582,90,6,0,2,0,0,4680,3803,258,12,1,0,0,0,4074,8754
129,26,4375,100,7,0,0,0,0,4482,3844,318,9,0,0,0,0,4171,8653
129,27,4281,178,8,0,2,0,0,4469,3751,509,7,0,6,0,0,4273,8742
129,28,4228,264,8,0,1,0,0,4501,3517,677,12,1,3,0,0,4210,8711
129,29,4138,397,16,1,1,1,0,4554,3438,873,19,3,3,0,0,4336,8890
129,30,3816,570,14,0,5,1,0,4406,3279,1108,28,4,10,0,0,4429,8835
129,31,3902,800,11,0,4,1,0,4718,3114,1352,30,3,5,1,0,4505,9223
129,32,3722,1005,20,4,9,0,0,4760,3035,1663,48,3,9,2,0,4760,9520
129,33,3630,1161,30,4,6,1,0,4832,2688,1910,57,14,7,1,0,4677,9509
129,34,3279,1460,35,4,10,0,0,4788,2625,2170,92,11,6,0,0,4904,9692
129,35,3190,1710,44,7,10,1,0,4962,2414,2426,91,11,18,1,0,4961,9923
129,36,2930,1822,68,2,12,1,0,4835,2288,2569,113,19,12,0,0,5001,9836
129,37,2732,2054,87,6,8,0,0,4887,2081,2584,156,18,9,0,0,4848,9735
129,38,2732,2224,105,5,11,0,0,5077,1997,2768,181,16,7,0,0,4969,10046
129,39,2523,2431,123,6,8,0,0,5091,1851,3000,217,28,5,2,0,5103,10194
129,40,2458,2643,107,8,3,1,0,5220,1870,3103,226,24,5,0,0,5228,10448
129,41,2476,2857,124,3,11,0,0,5471,1824,3357,263,25,6,0,0,5475,10946
129,42,2401,2872,174,20,14,0,0,5481,1649,3381,311,47,9,1,0,5398,10879
129,43,2269,3173,172,26,6,1,0,5647,1655,3608,341,48,13,0,0,5665,11312
129,44,2295,3370,197,25,15,0,0,5902,1597,3714,380,60,12,1,0,5764,11666
129,45,2302,3543,270,31,11,0,0,6157,1632,3937,418,55,7,0,0,6049,12206
129,46,2288,3710,296,28,11,0,0,6333,1539,4124,483,64,8,1,0,6219,12552
129,47,2317,3964,370,15,8,0,0,6674,1639,4325,535,74,5,1,0,6579,13253
129,48,2459,4311,388,30,10,0,0,7198,1618,4786,613,97,8,2,0,7124,14322
129,49,2347,4421,491,29,13,0,0,7301,1600,4984,664,119,9,1,0,7377,14678
129,50,2159,4540,478,28,9,0,1,7215,1481,4933,681,121,9,0,0,7225,14440
129,51,2059,4657,511,47,11,1,0,7286,1387,5065,670,129,4,0,0,7255,14541
129,52,1963,4941,531,54,16,1,1,7507,1265,5096,727,163,7,0,0,7258,14765
129,53,1792,4810,545,47,12,0,0,7206,1246,5159,743,180,6,0,0,7334,14540
129,54,1713,5111,580,53,7,0,0,7464,1226,5180,798,209,7,1,0,7421,14885
129,55,1708,5102,570,50,10,0,1,7441,1090,5333,805,234,3,0,0,7465,14906
129,56,1645,5040,628,57,8,0,0,7378,1000,5229,772,259,4,0,0,7264,14642
129,57,1420,5318,615,90,9,0,0,7452,963,5397,769,323,5,0,0,7457,14909
129,58,1308,5208,673,81,11,0,0,7281,956,5384,740,332,3,1,0,7416,14697
129,59,1196,5421,629,99,9,1,0,7355,851,5388,761,348,5,0,0,7353,14708
129,60,1078,5095,539,107,7,0,0,6826,751,4981,663,370,2,0,1,6768,13594
129,61,923,4695,520,116,4,0,0,6258,728,4687,612,418,1,0,0,6446,12704
129,62,780,4703,456,117,12,0,1,6069,666,4471,539,475,3,0,0,6154,12223
129,63,712,4487,406,123,2,0,0,5730,577,4469,525,481,1,0,0,6053,11783
129,64,621,4320,364,137,1,0,0,5443,556,4300,483,583,1,0,0,5923,11366
129,65,540,4049,373,154,6,0,0,5122,498,4040,401,591,0,0,0,5530,10652
129,66,540,4127,343,142,5,0,0,5157,422,3964,351,676,1,0,0,5414,10571
129,67,467,3965,279,163,3,0,0,4877,367,4096,367,734,2,0,0,5566,10443
129,68,453,3791,244,175,2,0,1,4666,364,3823,328,773,0,0,0,5288,9954
129,69,406,3716,231,210,3,0,0,4566,360,3757,303,840,1,0,0,5261,9827
129,70,368,3700,221,211,1,0,1,4502,338,3470,253,902,0,0,0,4963,9465
129,71,364,3642,192,218,3,0,0,4419,337,3361,236,1004,0,0,0,4938,9357
129,72,336,3529,168,247,1,0,0,4281,288,3280,192,1116,1,0,0,4877,9158
129,73,312,3570,152,299,1,0,0,4334,267,3297,195,1232,0,0,0,4991,9325
129,74,297,3522,128,295,1,0,0,4243,284,3140,202,1352,1,0,0,4979,9222
129,75,277,3617,119,323,1,0,0,4337,319,3208,182,1547,0,0,0,5256,9593
129,76,251,3363,112,330,2,0,0,4058,250,2832,161,1559,1,0,0,4803,8861
129,77,219,3431,110,396,0,0,0,4156,236,2813,185,1779,1,0,0,5014,9170
129,78,158,2402,82,323,1,0,0,2966,220,1984,131,1456,0,0,0,3791,6757
129,79,144,2451,68,355,0,0,0,3018,206,2000,114,1604,0,0,0,3924,6942
129,80,150,2336,43,389,0,0,0,2918,197,1683,92,1719,0,0,0,3691,6609
129,81,145,2322,47,376,0,0,0,2890,190,1706,99,1855,0,0,0,3850,6740
129,82,133,2138,45,418,1,0,0,2735,222,1497,87,2059,0,0,0,3865,6600
129,83,142,2215,44,521,0,0,0,2922,210,1479,65,2241,0,0,0,3995,6917
129,84,153,2133,39,489,0,0,0,2814,239,1199,70,2306,0,0,1,3815,6629
129,85,96,1735,37,521,0,0,0,2389,229,1017,63,2249,0,0,0,3558,5947
129,86,81,1414,23,475,0,0,0,1993,202,654,36,2033,0,0,0,2925,4918
129,87,71,1163,18,452,1,0,0,1705,155,495,33,1810,0,0,0,2493,4198
129,88,52,920,9,426,0,0,0,1407,166,355,30,1872,0,0,0,2423,3830
129,89,46,661,13,334,1,0,0,1055,141,262,20,1610,0,0,0,2033,3088
129,90,34,519,7,303,0,0,0,863,130,194,12,1402,0,0,0,1738,2601
129,91,27,400,4,265,0,0,0,696,114,150,12,1238,0,0,0,1514,2210
129,92,12,285,2,252,0,0,0,551,108,93,10,978,0,0,0,1189,1740
129,93,17,219,1,171,0,0,0,408,90,64,7,900,0,0,0,1061,1469
129,94,11,140,1,124,0,0,0,276,64,30,4,705,0,0,0,803,1079
129,95,8,71,2,98,0,0,0,179,63,17,4,497,0,0,0,581,760
129,96,3,49,0,67,0,0,0,119,37,15,0,384,0,0,0,436,555
129,97,5,23,2,49,0,0,0,79,21,3,2,255,0,0,0,281,360
129,98,2,11,0,28,0,0,0,41,14,3,1,166,0,0,0,184,225
129,99,1,8,0,18,0,0,0,27,10,2,1,122,0,0,0,135,162
129,100,1,7,0,14,0,0,0,22,27,0,0,181,0,0,0,208,230
129,999,208097,196300,14387,11091,354,11,6,430246,178347,198954,19859,49117,251,16,2,446546,876792
130,0,461,0,0,0,0,0,0,461,500,0,0,0,0,0,0,500,961
130,1,483,0,0,0,0,0,0,483,507,0,0,0,0,0,0,507,990
130,2,506,0,0,0,0,0,0,506,498,0,0,0,0,0,0,498,1004
130,3,573,0,0,0,0,0,0,573,535,0,0,0,0,0,0,535,1108
130,4,571,0,0,0,0,0,0,571,516,0,0,0,0,0,0,516,1087
130,5,607,0,0,0,0,0,0,607,568,0,0,0,0,0,0,568,1175
130,6,626,0,0,0,0,0,0,626,569,0,0,0,0,0,0,569,1195
130,7,685,0,0,0,0,0,0,685,625,0,0,0,0,0,0,625,1310
130,8,707,0,0,0,0,0,0,707,655,0,0,0,0,0,0,655,1362
130,9,711,0,0,0,0,0,0,711,625,0,0,0,0,0,0,625,1336
130,10,743,0,0,0,0,0,0,743,692,0,0,0,0,0,0,692,1435
130,11,718,0,0,0,0,0,0,718,703,0,0,0,0,0,0,703,1421
130,12,786,0,0,0,0,0,0,786,721,0,0,0,0,0,0,721,1507
130,13,782,0,0,0,0,0,0,782,696,0,0,0,0,0,0,696,1478
130,14,810,0,0,0,0,0,0,810,725,0,0,0,0,0,0,725,1535
130,15,788,0,0,0,0,0,0,788,686,0,0,0,0,0,0,686,1474
130,16,823,0,0,0,0,0,0,823,775,0,0,0,0,0,0,775,1598
130,17,791,0,0,0,0,0,0,791,755,0,0,0,0,0,0,755,1546
130,18,827,0,0,0,0,0,0,827,724,1,0,0,0,0,0,725,1552
130,19,808,0,0,0,0,0,0,808,749,1,0,0,0,0,0,750,1558
130,20,790,0,0,0,0,0,0,790,714,9,0,0,0,0,0,723,1513
130,21,803,1,0,0,0,0,0,804,733,9,0,0,0,0,0,742,1546
130,22,840,5,0,0,0,0,0,845,739,20,0,0,0,0,0,759,1604
130,23,882,9,0,1,1,0,0,893,757,33,2,0,0,0,0,792,1685
130,24,885,11,1,0,0,0,0,897,736,41,3,1,0,0,0,781,1678
130,25,927,17,0,0,0,0,0,944,733,63,1,0,0,0,0,797,1741
130,26,856,28,2,1,0,0,0,887,683,93,3,0,0,0,0,779,1666
130,27,895,34,1,0,0,0,0,930,679,104,5,0,0,0,0,788,1718
130,28,841,41,0,0,1,0,0,883,695,121,3,0,0,0,0,819,1702
130,29,775,59,1,0,0,1,0,836,590,146,7,0,0,0,0,743,1579
130,30,730,92,4,0,0,0,0,826,579,201,5,0,0,1,0,786,1612
130,31,773,152,4,1,0,0,0,930,572,239,6,0,0,0,0,817,1747
130,32,732,170,1,0,0,0,0,903,528,272,10,1,0,0,0,811,1714
130,33,664,157,7,1,0,0,0,829,534,322,12,0,3,0,0,871,1700
130,34,645,227,5,1,0,0,0,878,455,339,12,0,2,0,0,808,1686
130,35,681,241,3,2,0,0,0,927,467,400,15,0,2,0,0,884,1811
130,36,569,281,9,1,0,0,0,860,436,439,15,1,1,0,0,892,1752
130,37,572,370,15,0,0,0,0,957,394,474,28,3,1,0,0,900,1857
130,38,562,376,19,1,1,0,0,959,439,495,30,5,0,0,0,969,1928
130,39,510,441,14,3,0,0,0,968,375,527,27,7,1,0,0,937,1905
130,40,503,435,19,2,0,0,0,959,372,552,43,10,1,0,0,978,1937
130,41,541,446,22,2,0,0,0,1011,335,569,59,7,1,0,0,971,1982
130,42,480,489,30,7,1,0,0,1007,330,635,55,12,0,0,0,1032,2039
130,43,460,543,37,2,3,0,0,1045,306,633,69,12,3,0,0,1023,2068
130,44,483,595,38,3,1,0,0,1120,328,762,64,18,1,0,0,1173,2293
130,45,456,650,44,5,0,0,0,1155,303,752,81,14,1,0,0,1151,2306
130,46,439,664,59,3,0,0,0,1165,327,772,75,18,1,0,0,1193,2358
130,47,489,737,58,5,1,0,0,1290,281,759,75,22,1,0,0,1138,2428
130,48,423,707,60,4,0,0,0,1194,305,876,89,30,1,1,0,1302,2496
130,49,418,740,72,5,0,0,0,1235,278,867,118,31,0,0,0,1294,2529
130,50,387,775,69,4,0,0,0,1235,302,879,106,27,0,0,0,1314,2549
130,51,376,759,65,1,1,0,0,1202,263,895,107,27,0,0,0,1292,2494
130,52,363,827,85,9,1,0,0,1285,241,991,131,40,0,0,0,1403,2688
130,53,386,840,85,6,1,0,0,1318,220,931,99,45,1,0,0,1296,2614
130,54,340,877,89,11,1,0,0,1318,208,1029,113,55,0,0,0,1405,2723
130,55,322,864,89,7,0,0,0,1282,198,966,103,57,0,0,0,1324,2606
130,56,274,947,88,12,0,0,0,1321,163,1049,125,53,1,0,0,1391,2712
130,57,279,937,110,17,1,0,0,1344,183,1026,104,73,0,0,0,1386,2730
130,58,223,972,101,14,1,0,0,1311,145,1001,125,67,0,0,0,1338,2649
130,59,238,1024,99,19,0,0,0,1380,145,1034,116,66,0,0,0,1361,2741
130,60,206,946,88,22,1,0,0,1263,119,1043,114,68,2,0,0,1346,2609
130,61,182,947,80,20,1,0,0,1230,116,979,87,100,0,0,0,1282,2512
130,62,191,1001,95,28,0,0,0,1315,107,1001,114,106,0,0,0,1328,2643
130,63,168,997,69,27,0,0,0,1261,109,969,95,107,0,0,0,1280,2541
130,64,135,937,76,25,1,0,0,1174,92,949,93,100,0,0,0,1234,2408
130,65,113,947,80,20,0,0,0,1160,83,908,67,147,0,0,0,1205,2365
130,66,135,885,76,35,1,0,0,1132,84,846,80,162,1,0,0,1173,2305
130,67,137,893,48,25,0,0,0,1103,85,948,65,212,0,0,0,1310,2413
130,68,102,880,57,51,0,0,0,1090,78,886,52,184,0,0,0,1200,2290
130,69,90,861,49,45,0,0,0,1045,61,822,49,186,1,0,0,1119,2164
130,70,79,807,54,60,0,0,0,1000,61,755,50,188,0,0,0,1054,2054
130,71,85,788,41,57,0,0,0,971,61,666,42,234,0,0,0,1003,1974
130,72,73,774,32,57,2,0,0,938,52,704,40,271,0,0,0,1067,2005
130,73,67,778,41,55,0,0,0,941,52,635,39,285,0,0,0,1011,1952
130,74,55,763,31,72,0,0,0,921,47,661,25,279,0,0,0,1012,1933
130,75,81,788,23,60,0,0,0,952,42,622,23,324,0,0,0,1011,1963
130,76,45,718,28,63,0,0,0,854,48,597,34,341,0,0,0,1020,1874
130,77,42,657,17,70,1,0,0,787,33,561,32,342,0,0,0,968,1755
130,78,42,562,22,77,1,0,0,704,40,374,25,335,0,0,0,774,1478
130,79,32,481,14,63,0,0,0,590,21,397,13,330,0,0,0,761,1351
130,80,34,479,11,78,0,0,0,602,30,356,12,367,0,0,0,765,1367
130,81,32,417,10,77,0,0,1,537,31,273,8,380,0,0,0,692,1229
130,82,26,440,5,76,0,0,0,547,19,261,9,401,0,0,0,690,1237
130,83,35,473,6,93,0,0,0,607,25,273,7,530,0,0,0,835,1442
130,84,34,458,7,126,0,0,0,625,23,265,9,579,0,0,0,876,1501
130,85,33,453,7,111,0,0,0,604,24,206,6,578,0,0,0,814,1418
130,86,24,379,3,114,0,0,0,520,11,158,6,498,0,0,0,673,1193
130,87,20,307,3,86,0,0,0,416,22,102,3,445,0,0,0,572,988
130,88,13,245,3,101,0,0,0,362,18,95,5,504,0,0,0,622,984
130,89,17,192,1,88,0,0,0,298,21,62,4,387,0,0,0,474,772
130,90,7,148,3,66,0,0,0,224,14,58,4,400,0,0,0,476,700
130,91,5,93,0,57,0,0,0,155,14,30,3,301,0,0,0,348,503
130,92,5,90,0,65,0,0,0,160,17,23,2,255,0,0,0,297,457
130,93,3,57,0,45,0,0,0,105,7,8,1,225,0,0,0,241,346
130,94,5,37,0,35,0,0,0,77,8,12,0,173,0,0,0,193,270
130,95,3,37,0,38,0,0,0,78,8,8,2,121,0,0,0,139,217
130,96,1,15,0,15,0,0,0,31,5,5,0,95,0,0,0,105,136
130,97,1,13,0,11,0,0,0,25,7,1,0,73,0,0,0,81,106
130,98,1,4,0,11,0,0,0,16,4,1,0,55,0,0,0,60,76
130,99,0,2,0,2,0,0,0,4,3,0,0,29,0,0,0,32,36
130,100,0,3,0,10,0,0,0,13,5,0,1,41,0,0,0,47,60
130,999,38977,38292,2485,2387,23,1,1,82166,31602,38847,3262,11440,26,2,0,85179,167345
131,0,1360,0,0,0,0,0,0,1360,1305,0,0,0,0,0,0,1305,2665
131,1,1391,0,0,0,0,0,0,1391,1321,0,0,0,0,0,0,1321,2712
131,2,1494,0,0,0,0,0,0,1494,1368,0,0,0,0,0,0,1368,2862
131,3,1400,0,0,0,0,0,0,1400,1400,0,0,0,0,0,0,1400,2800
131,4,1488,0,0,0,0,0,0,1488,1418,0,0,0,0,0,0,1418,2906
131,5,1639,0,0,0,0,0,0,1639,1407,0,0,0,0,0,0,1407,3046
131,6,1621,0,0,0,0,0,0,1621,1521,0,0,0,0,0,0,1521,3142
131,7,1687,0,0,0,0,0,0,1687,1584,0,0,0,0,0,0,1584,3271
131,8,1654,0,0,0,0,0,0,1654,1488,0,0,0,0,0,0,1488,3142
131,9,1704,0,0,0,0,0,0,1704,1616,0,0,0,0,0,0,1616,3320
131,10,1704,0,0,0,0,0,0,1704,1693,0,0,0,0,0,0,1693,3397
131,11,1814,0,0,0,0,0,0,1814,1727,0,0,0,0,0,0,1727,3541
131,12,1905,0,0,0,0,0,0,1905,1753,0,0,0,0,0,0,1753,3658
131,13,1982,0,0,0,0,0,0,1982,1897,0,0,0,0,0,0,1897,3879
131,14,2017,0,0,0,0,0,0,2017,1929,0,0,0,0,0,0,1929,3946
131,15,2042,0,0,0,0,0,0,2042,1915,0,0,0,0,0,0,1915,3957
131,16,2119,0,0,0,0,0,0,2119,1987,0,0,0,0,0,0,1987,4106
131,17,2165,0,0,0,0,0,0,2165,2016,0,0,0,0,0,0,2016,4181
131,18,2185,0,0,0,0,0,0,2185,2008,2,0,0,0,0,0,2010,4195
131,19,2296,0,0,0,0,0,0,2296,2076,2,0,0,0,0,0,2078,4374
131,20,2273,0,0,0,0,0,0,2273,2071,3,0,0,0,0,0,2074,4347
131,21,2261,2,0,0,0,0,0,2263,2200,10,0,0,0,0,0,2210,4473
131,22,2229,3,0,0,0,0,0,2232,2154,25,1,0,0,0,0,2180,4412
131,23,2278,13,0,0,0,0,0,2291,2242,43,0,0,0,0,0,2285,4576
131,24,2337,15,1,0,0,0,0,2353,2060,79,0,0,0,0,0,2139,4492
131,25,2172,31,1,0,1,0,0,2205,1919,119,0,0,0,0,0,2038,4243
131,26,2145,74,2,0,0,0,0,2221,1930,198,2,0,0,0,0,2130,4351
131,27,2063,124,2,0,0,0,0,2189,1651,313,2,1,1,0,0,1968,4157
131,28,1939,161,0,0,0,0,0,2100,1574,438,5,1,0,0,0,2018,4118
131,29,1896,288,1,0,0,0,0,2185,1437,625,11,1,1,0,0,2075,4260
131,30,1724,354,5,0,0,0,0,2083,1264,757,7,2,0,0,0,2030,4113
131,31,1691,543,8,0,2,0,0,2244,1164,900,12,2,5,0,0,2083,4327
131,32,1495,669,8,0,2,0,0,2174,1012,1055,18,4,0,0,0,2089,4263
131,33,1381,839,10,0,2,0,0,2232,963,1123,23,5,1,0,0,2115,4347
131,34,1259,927,14,0,2,0,0,2202,834,1324,28,4,0,0,0,2190,4392
131,35,1127,1012,20,0,1,0,0,2160,758,1340,35,4,0,0,0,2137,4297
131,36,1075,1116,18,1,3,0,1,2214,709,1419,37,5,1,0,0,2171,4385
131,37,993,1182,23,4,1,0,0,2203,599,1485,56,10,1,0,0,2151,4354
131,38,828,1227,27,3,1,0,0,2086,521,1460,62,5,1,0,0,2049,4135
131,39,825,1332,31,4,1,0,0,2193,509,1668,69,6,2,0,0,2254,4447
131,40,843,1388,40,5,2,0,0,2278,506,1678,63,7,1,0,0,2255,4533
131,41,733,1492,40,1,2,0,0,2268,508,1778,102,11,1,0,0,2400,4668
131,42,733,1514,63,6,2,0,0,2318,461,1816,92,23,0,0,0,2392,4710
131,43,743,1639,56,9,1,0,0,2448,431,1933,114,26,1,0,0,2505,4953
131,44,704,1749,64,4,2,0,0,2523,406,2031,114,32,1,0,0,2584,5107
131,45,725,1876,92,9,0,0,0,2702,426,2110,130,32,0,0,0,2698,5400
131,46,707,2006,105,7,2,0,0,2827,392,2278,154,27,2,0,0,2853,5680
131,47,657,2051,113,14,0,0,0,2835,381,2321,157,41,1,0,0,2901,5736
131,48,629,2159,120,11,0,0,0,2919,356,2374,147,44,0,0,0,2921,5840
131,49,629,2273,105,12,3,0,0,3022,384,2540,171,53,1,0,0,3149,6171
131,50,581,2182,127,25,1,0,0,2916,357,2444,170,60,1,0,0,3032,5948
131,51,519,2272,130,21,1,0,0,2943,335,2418,169,68,0,0,0,2990,5933
131,52,515,2452,139,15,1,0,0,3122,333,2492,175,85,0,0,0,3085,6207
131,53,470,2445,124,30,0,0,0,3069,282,2530,162,100,0,0,0,3074,6143
131,54,441,2432,131,22,1,0,0,3027,305,2705,157,127,1,0,0,3295,6322
131,55,399,2520,153,30,2,0,0,3104,288,2455,147,135,0,0,0,3025,6129
131,56,379,2555,143,34,1,0,0,3112,267,2458,139,139,1,0,0,3004,6116
131,57,333,2475,134,44,3,0,0,2989,262,2671,155,155,1,0,0,3244,6233
131,58,289,2462,109,32,0,0,0,2892,264,2480,155,143,0,0,0,3042,5934
131,59,259,2531,127,50,1,0,0,2968,261,2596,121,185,0,0,0,3163,6131
131,60,245,2448,114,62,0,0,0,2869,198,2382,129,174,0,0,0,2883,5752
131,61,209,2360,103,50,0,0,0,2722,232,2291,110,209,0,0,0,2842,5564
131,62,203,2292,97,73,0,0,0,2665,215,2166,97,235,1,0,0,2714,5379
131,63,173,2193,85,64,1,0,0,2516,201,2022,86,245,0,0,0,2554,5070
131,64,155,2150,90,60,2,0,0,2457,209,1994,99,272,1,0,0,2575,5032
131,65,142,1940,72,76,0,0,0,2230,165,1907,81,302,0,0,0,2455,4685
131,66,139,2039,84,75,2,0,0,2339,169,1891,72,321,1,0,0,2454,4793
131,67,125,1848,62,70,0,0,0,2105,177,1683,62,327,0,0,0,2249,4354
131,68,110,1851,44,84,0,0,0,2089,134,1654,65,386,0,0,0,2239,4328
131,69,105,1733,45,92,0,0,0,1975,143,1670,68,391,0,0,0,2272,4247
131,70,86,1651,46,105,0,0,0,1888,148,1454,66,411,0,0,0,2079,3967
131,71,81,1597,38,100,0,0,0,1816,133,1350,61,440,0,0,0,1984,3800
131,72,78,1609,31,111,0,0,0,1829,129,1430,43,469,0,0,0,2071,3900
131,73,80,1619,39,108,0,0,0,1846,140,1344,41,502,0,0,0,2027,3873
131,74,58,1610,31,129,1,0,0,1829,129,1273,46,579,0,0,0,2027,3856
131,75,76,1695,25,163,0,0,0,1959,140,1325,40,650,0,0,0,2155,4114
131,76,53,1500,27,163,0,0,0,1743,136,1183,31,656,0,0,0,2006,3749
131,77,61,1510,25,156,0,0,0,1752,120,1107,36,714,0,0,0,1977,3729
131,78,41,1122,21,149,0,0,0,1333,108,785,18,641,0,0,0,1552,2885
131,79,41,996,14,158,0,0,0,1209,91,680,29,635,0,0,0,1435,2644
131,80,43,950,12,185,0,0,0,1190,91,602,16,641,0,0,0,1350,2540
131,81,41,883,11,194,0,0,0,1129,98,574,14,691,0,0,0,1377,2506
131,82,25,811,11,174,0,0,0,1021,81,463,12,694,0,0,0,1250,2271
131,83,28,828,13,217,0,0,0,1086,80,458,18,767,0,0,0,1323,2409
131,84,24,673,11,200,0,0,0,908,64,360,12,756,0,0,0,1192,2100
131,85,24,536,4,185,0,0,0,749,76,266,14,697,0,0,0,1053,1802
131,86,20,514,8,178,0,0,0,720,69,240,6,671,0,0,0,986,1706
131,87,8,353,8,171,0,0,0,540,53,138,9,617,0,0,0,817,1357
131,88,9,329,4,177,0,0,0,519,52,129,4,593,0,0,0,778,1297
131,89,11,247,1,138,0,0,0,397,56,99,3,485,0,0,0,643,1040
131,90,6,171,6,135,0,0,0,318,42,55,4,445,0,0,0,546,864
131,91,4,149,2,113,0,0,0,268,35,40,5,379,0,0,0,459,727
131,92,4,120,0,105,0,0,0,229,28,29,1,309,0,0,0,367,596
131,93,1,69,0,73,0,0,0,143,27,17,1,273,0,0,0,318,461
131,94,4,34,0,55,0,0,0,93,19,6,3,200,0,0,0,228,321
131,95,0,32,0,50,0,0,0,82,21,7,1,142,0,0,0,171,253
131,96,2,18,0,27,0,0,0,47,15,3,0,95,0,0,0,113,160
131,97,0,12,1,15,0,0,0,28,3,5,1,80,0,0,0,89,117
131,98,0,6,0,9,0,0,0,15,7,2,0,56,0,0,0,65,80
131,99,0,2,0,11,0,0,0,13,3,1,0,32,0,0,0,36,49
131,100,0,2,0,13,0,0,0,15,1,1,0,52,0,0,0,54,69
131,999,83461,94887,3471,4866,47,0,1,186733,72243,95582,4566,18777,28,0,0,191196,377929
132,0,725,0,0,0,0,0,0,725,691,0,0,0,0,0,0,691,1416
132,1,791,0,0,0,0,0,0,791,711,0,0,0,0,0,0,711,1502
132,2,873,0,0,0,0,0,0,873,776,0,0,0,0,0,0,776,1649
132,3,968,0,0,0,0,0,0,968,783,0,0,0,0,0,0,783,1751
132,4,908,0,0,0,0,0,0,908,841,0,0,0,0,0,0,841,1749
132,5,1023,0,0,0,0,0,0,1023,914,0,0,0,0,0,0,914,1937
132,6,984,0,0,0,0,0,0,984,972,0,0,0,0,0,0,972,1956
132,7,1059,0,0,0,0,0,0,1059,1025,0,0,0,0,0,0,1025,2084
132,8,1168,0,0,0,0,0,0,1168,1063,0,0,0,0,0,0,1063,2231
132,9,1192,0,0,0,0,0,0,1192,1127,0,0,0,0,0,0,1127,2319
132,10,1242,0,0,0,0,0,0,1242,1191,0,0,0,0,0,0,1191,2433
132,11,1239,0,0,0,0,0,0,1239,1180,0,0,0,0,0,0,1180,2419
132,12,1376,0,0,0,0,0,0,1376,1261,0,0,0,0,0,0,1261,2637
132,13,1389,0,0,0,0,0,0,1389,1265,0,0,0,0,0,0,1265,2654
132,14,1362,0,0,0,0,0,0,1362,1350,0,0,0,0,0,0,1350,2712
132,15,1383,0,0,0,0,0,0,1383,1301,0,0,0,0,0,0,1301,2684
132,16,1388,0,0,0,0,0,0,1388,1299,0,0,0,0,0,0,1299,2687
132,17,1373,0,0,0,0,0,0,1373,1341,0,0,0,0,0,0,1341,2714
132,18,1480,0,0,0,0,0,0,1480,1243,0,1,0,0,0,0,1244,2724
132,19,1472,4,0,0,0,0,0,1476,1244,1,0,0,0,0,0,1245,2721
132,20,1403,3,0,0,0,0,0,1406,1268,3,0,0,0,0,0,1271,2677
132,21,1510,2,0,0,0,0,0,1512,1330,5,0,0,0,0,0,1335,2847
132,22,1449,1,0,0,0,0,0,1450,1318,13,0,0,0,0,0,1331,2781
132,23,1558,5,0,2,0,0,0,1565,1454,16,1,0,0,0,0,1471,3036
132,24,1486,11,0,0,0,0,0,1497,1263,17,0,0,0,0,0,1280,2777
132,25,1476,9,0,0,0,0,0,1485,1204,22,0,0,0,0,0,1226,2711
132,26,1476,21,1,0,0,0,0,1498,1214,45,0,0,1,0,0,1260,2758
132,27,1529,24,0,0,0,0,0,1553,1194,72,3,0,0,0,0,1269,2822
132,28,1453,38,1,1,0,0,0,1493,1207,103,1,0,1,0,0,1312,2805
132,29,1421,78,1,1,0,0,0,1501,1168,148,3,2,0,0,0,1321,2822
132,30,1418,82,3,0,1,0,0,1504,1240,180,7,0,1,0,0,1428,2932
132,31,1471,111,3,0,0,0,0,1585,1259,234,11,1,3,0,0,1508,3093
132,32,1496,166,5,0,3,0,0,1670,1184,316,16,2,0,0,0,1518,3188
132,33,1429,194,8,0,0,0,0,1631,1160,428,19,1,0,0,0,1608,3239
132,34,1513,264,11,0,1,0,0,1789,1122,468,18,1,1,0,0,1610,3399
132,35,1378,302,10,1,2,0,0,1693,1046,498,27,2,2,0,0,1575,3268
132,36,1380,379,8,0,0,0,0,1767,1015,590,34,3,1,0,0,1643,3410
132,37,1375,412,23,2,0,0,0,1812,978,611,31,6,0,0,0,1626,3438
132,38,1353,523,21,0,0,0,0,1897,993,750,55,11,2,0,0,1811,3708
132,39,1354,613,48,1,3,0,0,2019,946,847,83,9,1,1,0,1887,3906
132,40,1354,603,32,1,1,0,0,1991,945,940,62,10,3,0,0,1960,3951
132,41,1333,793,34,3,2,0,0,2165,905,1025,96,7,1,0,0,2034,4199
132,42,1280,848,58,3,2,0,0,2191,852,1107,75,12,2,0,0,2048,4239
132,43,1268,907,61,4,0,0,0,2240,836,1171,95,15,0,0,0,2117,4357
132,44,1160,976,90,1,1,0,0,2228,769,1251,133,20,1,0,0,2174,4402
132,45,1308,1136,89,3,1,0,0,2537,774,1347,142,28,0,0,0,2291,4828
132,46,1168,1258,99,4,3,0,0,2532,740,1428,164,29,2,0,0,2363,4895
132,47,1164,1267,117,5,1,0,0,2554,757,1551,160,32,0,0,0,2500,5054
132,48,1175,1327,132,10,4,0,0,2648,700,1623,188,51,0,0,0,2562,5210
132,49,1144,1538,138,12,3,0,0,2835,679,1793,170,49,0,0,0,2691,5526
132,50,1114,1523,155,10,0,0,0,2802,659,1743,193,42,1,0,0,2638,5440
132,51,1079,1569,160,23,1,0,0,2832,559,1829,164,61,0,0,0,2613,5445
132,52,946,1531,203,10,0,0,0,2690,545,1809,227,77,0,0,0,2658,5348
132,53,905,1587,184,17,0,0,0,2693,504,1817,193,88,2,0,0,2604,5297
132,54,836,1693,192,24,1,0,0,2746,521,1963,233,98,0,0,0,2815,5561
132,55,774,1642,194,20,0,0,0,2630,445,1926,226,119,1,0,0,2717,5347
132,56,738,1878,189,38,0,0,0,2843,464,2023,179,125,0,0,0,2791,5634
132,57,682,1943,212,26,4,0,0,2867,432,2064,190,144,0,0,0,2830,5697
132,58,600,1972,180,33,1,0,0,2786,411,2007,184,161,0,0,0,2763,5549
132,59,675,2028,181,37,0,0,1,2922,359,2093,190,196,0,0,0,2838,5760
132,60,534,2015,183,42,1,0,0,2775,353,2141,156,206,1,0,0,2857,5632
132,61,515,1940,171,40,0,0,0,2666,363,2162,172,221,1,0,0,2919,5585
132,62,487,1995,164,53,1,0,0,2700,311,2121,140,271,0,0,0,2843,5543
132,63,469,1977,166,66,0,0,0,2678,299,1989,138,283,1,0,0,2710,5388
132,64,404,1985,136,76,0,0,0,2601,286,1954,112,274,0,0,0,2626,5227
132,65,443,1955,129,79,0,0,0,2606,266,1909,130,346,0,0,0,2651,5257
132,66,389,2020,129,74,0,0,0,2612,275,1935,107,390,1,0,0,2708,5320
132,67,321,1949,126,74,2,0,0,2472,263,1867,95,429,0,0,0,2654,5126
132,68,303,1897,126,105,0,0,0,2431,229,1775,80,456,1,0,0,2541,4972
132,69,297,1946,122,120,0,0,0,2485,245,1722,80,480,1,0,0,2528,5013
132,70,273,1921,105,115,0,0,0,2414,249,1620,91,526,0,0,0,2486,4900
132,71,263,1869,74,112,0,0,0,2318,224,1635,72,528,0,0,0,2459,4777
132,72,252,1827,91,120,0,0,0,2290,204,1544,61,611,0,0,0,2420,4710
132,73,233,1766,82,122,0,0,0,2203,213,1485,75,575,0,0,0,2348,4551
132,74,223,1690,70,140,0,0,0,2123,223,1318,55,687,0,0,0,2283,4406
132,75,224,1727,62,160,0,0,0,2173,214,1327,53,680,0,0,0,2274,4447
132,76,191,1588,59,156,0,0,0,1994,195,1156,54,738,0,0,0,2143,4137
132,77,158,1407,53,141,0,0,0,1759,184,983,39,715,0,0,0,1921,3680
132,78,152,1196,33,148,0,0,0,1529,190,810,36,719,0,0,0,1755,3284
132,79,127,1087,32,173,0,0,0,1419,174,758,30,733,0,0,0,1695,3114
132,80,126,1069,26,151,0,0,0,1372,161,731,33,752,0,0,0,1677,3049
132,81,116,1014,24,170,0,0,0,1324,155,616,24,840,0,0,0,1635,2959
132,82,101,835,15,156,0,0,0,1107,157,515,25,850,0,0,0,1547,2654
132,83,121,858,22,200,0,0,0,1201,165,494,22,973,0,0,0,1654,2855
132,84,97,812,14,182,0,0,0,1105,164,424,11,907,0,0,0,1506,2611
132,85,79,616,12,180,0,0,0,887,139,312,14,865,0,0,0,1330,2217
132,86,61,513,13,155,0,0,0,742,145,250,9,754,0,0,0,1158,1900
132,87,59,424,6,125,0,0,0,614,103,176,12,751,0,0,0,1042,1656
132,88,41,354,1,146,0,0,0,542,105,124,5,697,0,0,0,931,1473
132,89,48,326,3,147,0,0,0,524,90,119,4,690,0,0,0,903,1427
132,90,46,255,4,126,0,0,0,431,90,81,11,656,0,0,0,838,1269
132,91,22,185,4,117,0,0,0,328,75,61,4,574,0,0,0,714,1042
132,92,17,154,0,115,0,0,0,286,56,26,5,434,0,0,0,521,807
132,93,22,110,0,83,0,0,0,215,66,29,1,407,0,0,0,503,718
132,94,17,63,1,66,0,0,0,147,40,14,1,348,0,0,0,403,550
132,95,9,48,0,45,0,0,0,102,35,14,3,249,0,0,0,301,403
132,96,5,31,0,31,0,0,0,67,23,4,1,184,0,0,0,212,279
132,97,5,12,0,23,0,0,0,40,21,6,0,120,0,0,0,147,187
132,98,4,8,0,14,0,0,0,26,12,2,0,86,0,0,0,100,126
132,99,1,9,0,12,0,0,0,22,9,1,0,67,0,0,0,77,99
132,100,4,7,0,21,0,0,0,32,8,2,0,90,0,0,0,100,132
132,999,80285,74721,5101,4673,39,0,1,164820,64776,74089,5535,22564,32,1,0,166997,331817
400,0,6731,0,0,0,0,0,0,6731,6276,0,0,0,0,0,0,6276,13007
400,1,6979,0,0,0,0,0,0,6979,6661,0,0,0,0,0,0,6661,13640
400,2,7290,0,0,0,0,0,0,7290,6921,0,0,0,0,0,0,6921,14211
400,3,7481,0,0,0,0,0,0,7481,7104,0,0,0,0,0,0,7104,14585
400,4,7690,0,0,0,0,0,0,7690,7308,0,0,0,0,0,0,7308,14998
400,5,7870,0,0,0,0,0,0,7870,7623,0,0,0,0,0,0,7623,15493
400,6,8392,0,0,0,0,0,0,8392,7972,0,0,0,0,0,0,7972,16364
400,7,8787,0,0,0,0,0,0,8787,8296,0,0,0,0,0,0,8296,17083
400,8,9195,0,0,0,0,0,0,9195,8391,0,0,0,0,0,0,8391,17586
400,9,9233,0,0,0,0,0,0,9233,8990,0,0,0,0,0,0,8990,18223
400,10,9750,0,0,0,0,0,0,9750,9076,0,0,0,0,0,0,9076,18826
400,11,9954,0,0,0,0,0,0,9954,9436,0,0,0,0,0,0,9436,19390
400,12,10247,0,0,0,0,0,0,10247,9399,0,0,0,0,0,0,9399,19646
400,13,10391,0,0,0,0,0,0,10391,9814,0,0,0,0,0,0,9814,20205
400,14,10742,0,0,0,0,0,0,10742,9946,0,0,0,0,0,0,9946,20688
400,15,10822,0,0,0,0,0,0,10822,10103,0,0,0,0,0,0,10103,20925
400,16,10662,0,0,0,0,0,0,10662,9982,0,1,0,0,0,0,9983,20645
400,17,10725,0,0,0,0,0,0,10725,9732,0,0,0,0,0,0,9732,20457
400,18,10670,0,0,0,0,0,0,10670,9923,2,0,0,0,0,0,9925,20595
400,19,10887,3,0,0,0,0,0,10890,9799,21,0,0,0,0,0,9820,20710
400,20,10898,5,0,0,0,0,0,10903,9887,58,1,0,1,0,0,9947,20850
400,21,10630,9,1,0,1,0,0,10641,9781,100,2,0,1,0,0,9884,20525
400,22,10621,39,1,0,2,0,0,10663,9744,177,9,0,0,0,0,9930,20593
400,23,11402,64,3,1,1,0,0,11471,9878,292,5,1,2,0,0,10178,21649
400,24,11294,115,9,0,1,0,0,11419,9476,441,6,2,2,1,0,9928,21347
400,25,11542,208,6,0,7,0,0,11763,9596,592,11,0,4,0,0,10203,21966
400,26,11277,288,7,0,4,0,0,11576,9581,831,21,1,4,1,0,10439,22015
400,27,11310,422,13,0,9,1,0,11755,9437,1083,37,2,10,0,0,10569,22324
400,28,10993,702,14,0,11,0,0,11720,8991,1399,32,7,6,0,0,10435,22155
400,29,10905,940,18,1,10,2,0,11876,8623,1902,65,12,21,0,0,10623,22499
400,30,10306,1318,42,0,19,2,0,11687,8534,2389,74,3,23,2,0,11025,22712
400,31,10336,1778,53,1,18,2,0,12188,8031,3099,99,6,21,4,0,11260,23448
400,32,9764,2245,71,2,18,0,0,12100,7743,3655,127,12,26,0,0,11563,23663
400,33,9599,2932,82,1,17,0,0,12631,7272,4206,218,13,33,4,0,11746,24377
400,34,8667,3266,111,11,25,1,0,12081,6806,4542,222,13,24,4,0,11611,23692
400,35,8326,3895,161,12,46,3,0,12443,6410,5100,270,28,27,2,0,11837,24280
400,36,7537,4154,173,7,37,2,0,11910,5839,5469,324,34,39,0,0,11705,23615
400,37,7277,4556,225,11,29,2,0,12100,5447,5782,402,42,22,1,0,11696,23796
400,38,6980,4940,258,10,30,1,0,12219,5328,6322,486,63,31,1,0,12231,24450
400,39,6619,5253,288,13,26,1,0,12200,5122,6456,587,52,31,4,0,12252,24452
400,40,6371,5698,353,12,33,0,0,12467,4882,6970,596,67,34,1,0,12550,25017
400,41,6246,6284,409,8,22,2,0,12971,4836,7404,710,65,22,2,0,13039,26010
400,42,5915,6393,495,38,25,0,0,12866,4635,7512,791,116,25,0,0,13079,25945
400,43,5765,6724,528,25,30,2,0,13074,4505,7793,897,131,21,1,0,13348,26422
400,44,5816,7143,554,41,28,1,1,13584,4294,8276,1012,135,18,1,0,13736,27320
400,45,5922,7556,680,56,26,1,1,14242,4543,8855,1144,148,26,1,0,14717,28959
400,46,5952,8172,773,47,31,1,0,14976,4516,9565,1267,172,24,1,0,15545,30521
400,47,5981,8629,905,47,24,1,0,15587,4409,9998,1550,206,19,3,0,16185,31772
400,48,5990,9464,1129,55,44,0,1,16683,4495,10714,1658,256,31,1,0,17155,33838
400,49,6110,10231,1218,63,44,3,0,17669,4357,11393,1886,271,22,3,0,17932,35601
400,50,5758,10375,1337,68,50,2,1,17591,4193,11400,1925,301,27,0,0,17846,35437
400,51,5437,10941,1383,116,32,1,1,17911,3831,11777,2162,328,14,0,0,18112,36023
400,52,5213,10964,1492,99,39,2,1,17810,3615,12300,2164,447,21,2,0,18549,36359
400,53,4872,11251,1509,101,35,0,0,17768,3506,12195,2281,496,24,0,0,18502,36270
400,54,4680,11549,1634,146,39,1,0,18049,3245,12823,2337,546,15,0,0,18966,37015
400,55,4316,11869,1714,139,37,1,0,18076,2965,12503,2480,644,22,1,0,18615,36691
400,56,3970,11876,1733,161,34,0,1,17775,2876,12506,2489,734,24,0,0,18629,36404
400,57,3784,11993,1851,219,33,1,2,17883,2581,12678,2407,780,12,0,0,18458,36341
400,58,3433,11867,1839,201,43,0,2,17385,2444,12458,2450,905,14,0,0,18271,35656
400,59,3234,12222,1871,218,37,0,1,17583,2334,12723,2485,977,14,0,0,18533,36116
400,60,2765,11508,1735,267,36,1,2,16314,2070,12133,2223,1045,12,0,0,17483,33797
400,61,2372,11077,1563,301,28,0,2,15343,1845,11608,2164,1168,10,0,1,16796,32139
400,62,2223,11137,1529,295,29,0,1,15214,1634,11571,2032,1350,6,0,0,16593,31807
400,63,1932,10802,1515,306,19,0,3,14577,1437,11060,1979,1465,8,0,0,15949,30526
400,64,1802,10738,1434,382,31,0,2,14389,1361,10872,1813,1464,3,0,0,15513,29902
400,65,1666,10426,1295,382,21,0,1,13791,1273,10538,1710,1685,11,0,0,15217,29008
400,66,1565,10458,1241,407,19,0,0,13690,1190,10373,1540,1886,10,0,0,14999,28689
400,67,1357,10343,1137,498,22,0,1,13358,1094,10052,1530,2071,9,0,0,14756,28114
400,68,1311,10064,1002,527,15,0,1,12920,1001,9733,1376,2287,3,0,0,14400,27320
400,69,1243,9875,970,572,10,0,0,12670,956,9476,1262,2459,2,0,0,14155,26825
400,70,1091,9433,860,598,13,0,1,11996,829,9094,1207,2598,5,0,1,13734,25730
400,71,929,9383,802,671,11,0,0,11796,820,8862,1093,2788,9,0,0,13572,25368
400,72,918,9043,687,702,10,0,1,11361,735,8655,991,3110,6,0,0,13497,24858
400,73,915,9368,689,745,8,1,2,11728,717,8784,958,3475,1,0,0,13935,25663
400,74,805,9590,636,885,8,0,1,11925,721,8634,860,3851,1,0,0,14067,25992
400,75,840,9895,599,1043,9,0,3,12389,762,8803,906,4412,3,0,0,14886,27275
400,76,723,9790,550,1063,7,0,1,12134,676,8295,797,4622,3,0,0,14393,26527
400,77,693,9222,510,1180,7,0,0,11612,662,7627,800,4985,0,0,0,14074,25686
400,78,494,6944,334,925,10,0,0,8707,473,5584,497,4191,3,0,0,10748,19455
400,79,467,6989,326,1141,7,0,0,8930,544,5573,527,4635,0,0,0,11279,20209
400,80,467,6528,268,1117,5,0,1,8386,523,5045,498,5069,0,0,0,11135,19521
400,81,495,6280,224,1286,7,0,0,8292,536,4563,486,5302,2,0,0,10889,19181
400,82,440,5929,228,1227,4,0,0,7828,530,4120,379,5713,0,0,0,10742,18570
400,83,416,6092,232,1552,3,0,1,8296,541,4036,370,6524,1,0,1,11473,19769
400,84,375,5530,170,1552,4,0,1,7632,546,3441,334,6636,1,0,1,10959,18591
400,85,323,4971,157,1473,3,0,0,6927,484,2916,311,6388,1,0,0,10100,17027
400,86,274,3950,121,1441,1,0,0,5787,472,2209,244,5894,0,0,0,8819,14606
400,87,196,3121,82,1288,1,0,0,4688,413,1571,190,5403,0,0,0,7577,12265
400,88,175,2606,73,1252,1,0,0,4107,368,1267,173,5191,0,0,0,6999,11106
400,89,135,2109,52,1067,2,0,0,3365,305,913,129,4800,0,0,0,6147,9512
400,90,94,1566,40,954,1,0,0,2655,265,650,108,4087,0,0,0,5110,7765
400,91,84,1161,26,828,0,0,0,2099,277,498,75,3601,0,0,0,4451,6550
400,92,67,872,16,723,0,0,0,1678,213,304,68,3201,0,0,0,3786,5464
400,93,46,642,9,582,0,0,0,1279,208,228,55,2724,0,0,0,3215,4494
400,94,34,409,5,405,0,0,0,853,163,127,41,2005,0,0,0,2336,3189
400,95,21,261,7,284,0,0,0,573,119,86,21,1487,0,0,0,1713,2286
400,96,17,149,1,200,0,0,0,367,93,56,19,1071,0,0,0,1239,1606
400,97,10,83,1,145,0,0,0,239,59,20,9,778,0,0,0,866,1105
400,98,5,41,0,83,0,0,0,129,51,16,11,517,0,0,0,595,724
400,99,7,23,0,59,1,0,0,90,29,6,7,378,0,0,0,420,510
400,100,9,23,2,77,0,0,0,111,57,10,7,519,0,0,0,593,704
400,999,515347,476764,46071,32415,1350,38,37,1072022,438392,485170,67490,140851,867,41,4,1132815,2204837
521,0,480,0,0,0,0,0,0,480,468,0,0,0,0,0,0,468,948
521,1,475,0,0,0,0,0,0,475,520,0,0,0,0,0,0,520,995
521,2,539,0,0,0,0,0,0,539,495,0,0,0,0,0,0,495,1034
521,3,520,0,0,0,0,0,0,520,517,0,0,0,0,0,0,517,1037
521,4,573,0,0,0,0,0,0,573,482,0,0,0,0,0,0,482,1055
521,5,560,0,0,0,0,0,0,560,580,0,0,0,0,0,0,580,1140
521,6,583,0,0,0,0,0,0,583,594,0,0,0,0,0,0,594,1177
521,7,638,0,0,0,0,0,0,638,566,0,0,0,0,0,0,566,1204
521,8,657,0,0,0,0,0,0,657,618,0,0,0,0,0,0,618,1275
521,9,685,0,0,0,0,0,0,685,613,0,0,0,0,0,0,613,1298
521,10,643,0,0,0,0,0,0,643,667,0,0,0,0,0,0,667,1310
521,11,721,0,0,0,0,0,0,721,701,0,0,0,0,0,0,701,1422
521,12,701,0,0,0,0,0,0,701,629,0,0,0,0,0,0,629,1330
521,13,738,0,0,0,0,0,0,738,648,0,0,0,0,0,0,648,1386
521,14,770,0,0,0,0,0,0,770,710,0,0,0,0,0,0,710,1480
521,15,724,0,0,0,0,0,0,724,706,0,0,0,0,0,0,706,1430
521,16,774,0,0,0,0,0,0,774,741,0,0,0,0,0,0,741,1515
521,17,756,0,0,0,0,0,0,756,707,0,0,0,0,0,0,707,1463
521,18,740,0,0,0,0,0,0,740,706,1,0,0,0,0,0,707,1447
521,19,758,0,0,0,0,0,0,758,676,2,0,0,0,0,0,678,1436
521,20,809,0,0,0,0,0,0,809,677,10,0,0,0,0,0,687,1496
521,21,771,3,0,0,0,0,0,774,691,16,0,0,0,0,0,707,1481
521,22,770,8,1,0,1,0,0,780,671,14,0,0,0,0,0,685,1465
521,23,840,9,0,0,0,0,0,849,690,24,2,0,0,0,0,716,1565
521,24,826,11,2,0,0,0,0,839,694,40,2,0,0,0,0,736,1575
521,25,838,9,4,0,0,0,0,851,680,53,2,0,0,0,0,735,1586
521,26,839,24,1,0,1,0,0,865,668,73,1,0,0,0,0,742,1607
521,27,803,41,1,1,1,0,0,847,656,97,7,1,0,0,0,761,1608
521,28,818,62,6,0,2,0,0,888,602,128,1,0,1,1,0,733,1621
521,29,774,70,5,0,0,1,0,850,563,143,3,1,0,0,0,710,1560
521,30,730,95,3,0,1,0,0,829,552,220,3,0,0,0,0,775,1604
521,31,750,155,4,1,0,0,0,910,537,230,18,0,0,0,0,785,1695
521,32,698,178,6,0,0,0,0,882,519,273,7,1,0,1,0,801,1683
521,33,685,213,11,2,2,1,0,914,469,325,22,2,0,1,0,819,1733
521,34,583,237,8,2,2,0,0,832,425,334,20,1,1,0,0,781,1613
521,35,562,281,21,1,0,0,0,865,433,377,18,2,3,0,0,833,1698
521,36,564,278,14,0,1,0,0,857,383,383,25,1,1,0,0,793,1650
521,37,535,294,26,4,3,0,0,862,337,479,33,1,0,0,0,850,1712
521,38,531,376,21,1,2,0,0,931,360,467,42,3,1,0,0,873,1804
521,39,512,373,34,3,1,0,0,923,356,475,28,4,0,0,0,863,1786
521,40,469,370,26,1,1,0,0,867,329,533,56,9,0,0,0,927,1794
521,41,497,467,27,1,1,0,0,993,311,549,54,4,0,0,0,918,1911
521,42,478,471,32,1,1,0,0,983,319,525,54,4,0,0,0,902,1885
521,43,403,493,40,4,1,0,0,941,290,594,64,11,0,0,0,959,1900
521,44,427,563,52,5,0,0,0,1047,265,587,71,9,0,0,0,932,1979
521,45,452,545,62,4,0,0,0,1063,308,652,87,14,1,0,0,1062,2125
521,46,458,574,61,5,0,0,0,1098,305,749,97,19,2,0,0,1172,2270
521,47,425,664,68,5,1,0,0,1163,296,727,106,20,0,1,0,1150,2313
521,48,455,683,85,5,2,0,0,1230,260,785,131,22,0,0,0,1198,2428
521,49,462,692,77,7,0,0,0,1238,253,744,120,25,2,0,0,1144,2382
521,50,412,716,113,4,1,0,0,1246,257,887,125,22,2,0,0,1293,2539
521,51,440,763,108,11,0,0,0,1322,291,839,137,42,5,0,0,1314,2636
521,52,416,815,111,5,1,0,0,1348,261,890,158,32,1,0,0,1342,2690
521,53,398,780,111,9,2,0,0,1300,199,864,175,51,0,0,0,1289,2589
521,54,350,881,135,11,2,0,0,1379,228,948,171,41,1,0,0,1389,2768
521,55,358,853,137,11,3,0,0,1362,214,907,172,54,1,0,0,1348,2710
521,56,308,898,143,9,1,0,0,1359,188,917,160,79,0,0,0,1344,2703
521,57,301,927,127,13,1,0,0,1369,170,955,214,83,0,0,0,1422,2791
521,58,296,995,155,17,2,0,0,1465,199,1028,156,85,0,0,0,1468,2933
521,59,277,954,148,24,0,0,0,1403,185,1031,163,85,0,0,0,1464,2867
521,60,245,982,132,17,2,0,0,1378,157,983,150,90,0,0,0,1380,2758
521,61,256,958,129,25,2,0,0,1370,139,934,156,127,1,0,0,1357,2727
521,62,206,935,131,21,2,0,0,1295,141,942,132,161,0,0,0,1376,2671
521,63,203,898,124,37,2,0,0,1264,107,944,128,162,0,0,0,1341,2605
521,64,182,858,107,35,2,0,0,1184,95,867,117,138,0,0,0,1217,2401
521,65,157,893,89,31,0,0,0,1170,100,876,123,183,0,0,0,1282,2452
521,66,137,830,100,34,3,0,0,1104,78,849,131,157,0,0,0,1215,2319
521,67,129,805,85,50,2,0,0,1071,66,790,108,224,0,0,0,1188,2259
521,68,136,837,93,58,0,0,0,1124,66,784,84,201,0,0,0,1135,2259
521,69,114,781,96,45,0,0,0,1036,75,755,97,213,0,0,0,1140,2176
521,70,99,782,72,47,1,0,0,1001,74,710,70,241,0,0,0,1095,2096
521,71,103,816,67,49,0,0,0,1035,52,684,73,263,0,0,0,1072,2107
521,72,87,778,62,70,0,0,0,997,37,687,69,256,0,0,0,1049,2046
521,73,97,785,54,72,0,0,0,1008,57,645,64,343,0,0,0,1109,2117
521,74,88,740,56,75,0,0,0,959,44,675,61,356,0,0,0,1136,2095
521,75,84,793,47,99,0,0,0,1023,45,668,77,377,0,0,0,1167,2190
521,76,73,720,52,86,1,0,0,932,52,579,65,401,0,0,0,1097,2029
521,77,78,666,37,103,1,0,0,885,48,533,52,436,0,0,0,1069,1954
521,78,55,465,22,68,0,0,0,610,30,346,27,350,0,0,0,753,1363
521,79,46,499,22,89,0,0,0,656,41,356,41,390,0,0,0,828,1484
521,80,46,416,27,83,1,0,0,573,37,352,23,435,0,0,0,847,1420
521,81,42,443,20,80,0,0,0,585,39,297,28,419,0,0,0,783,1368
521,82,47,402,16,99,0,0,0,564,43,327,21,430,0,0,0,821,1385
521,83,40,466,18,117,0,0,0,641,52,273,24,543,0,0,0,892,1533
521,84,34,417,12,135,0,0,0,598,49,253,29,607,0,0,0,938,1536
521,85,39,335,12,112,0,0,0,498,37,205,23,566,0,0,0,831,1329
521,86,37,286,5,109,0,0,0,437,41,135,16,536,0,0,0,728,1165
521,87,31,219,6,114,0,0,0,370,31,114,14,458,0,0,0,617,987
521,88,28,195,5,92,0,0,0,320,31,74,8,502,0,0,0,615,935
521,89,13,164,5,95,0,0,0,277,28,58,6,421,0,0,0,513,790
521,90,11,107,1,66,0,0,0,185,29,33,8,363,0,0,0,433,618
521,91,6,82,2,75,0,0,0,165,25,19,4,365,0,0,0,413,578
521,92,5,73,0,49,0,0,0,127,17,29,3,289,0,0,0,338,465
521,93,6,51,0,45,0,0,0,102,27,14,3,257,0,0,0,301,403
521,94,4,22,0,35,0,0,0,61,15,12,3,200,0,0,0,230,291
521,95,4,12,0,23,0,0,0,39,9,2,3,145,0,0,0,159,198
521,96,4,9,0,19,0,0,0,32,9,4,0,119,0,0,0,132,164
521,97,2,5,0,13,0,0,0,20,6,0,3,67,0,0,0,76,96
521,98,2,7,0,11,0,0,0,20,4,2,0,46,0,0,0,52,72
521,99,0,2,0,8,0,0,0,10,4,0,0,35,0,0,0,39,49
521,100,2,4,0,13,0,0,0,19,6,0,1,51,0,0,0,58,77
521,999,38333,36359,3692,2671,56,2,0,81113,30478,36685,4750,12651,23,4,0,84591,165704
583,0,1102,0,0,0,0,0,0,1102,1149,0,0,0,0,0,0,1149,2251
583,1,1221,0,0,0,0,0,0,1221,1150,0,0,0,0,0,0,1150,2371
583,2,1269,0,0,0,0,0,0,1269,1194,0,0,0,0,0,0,1194,2463
583,3,1307,0,0,0,0,0,0,1307,1188,0,0,0,0,0,0,1188,2495
583,4,1373,0,0,0,0,0,0,1373,1285,0,0,0,0,0,0,1285,2658
583,5,1377,0,0,0,0,0,0,1377,1371,0,0,0,0,0,0,1371,2748
583,6,1444,0,0,0,0,0,0,1444,1382,0,0,0,0,0,0,1382,2826
583,7,1527,0,0,0,0,0,0,1527,1444,0,0,0,0,0,0,1444,2971
583,8,1536,0,0,0,0,0,0,1536,1480,0,0,0,0,0,0,1480,3016
583,9,1602,0,0,0,0,0,0,1602,1520,0,0,0,0,0,0,1520,3122
583,10,1615,0,0,0,0,0,0,1615,1600,0,0,0,0,0,0,1600,3215
583,11,1706,0,0,0,0,0,0,1706,1630,0,0,0,0,0,0,1630,3336
583,12,1740,0,0,0,0,0,0,1740,1632,0,0,0,0,0,0,1632,3372
583,13,1721,0,0,0,0,0,0,1721,1616,0,0,0,0,0,0,1616,3337
583,14,1757,0,0,0,0,0,0,1757,1709,0,0,0,0,0,0,1709,3466
583,15,1742,0,0,0,0,0,0,1742,1695,0,0,0,0,0,0,1695,3437
583,16,1831,0,0,0,0,0,0,1831,1818,0,0,0,0,0,0,1818,3649
583,17,1737,0,0,0,0,0,0,1737,1728,1,0,0,0,0,0,1729,3466
583,18,1817,0,0,0,0,0,0,1817,1676,1,0,0,0,0,0,1677,3494
583,19,1855,0,0,0,0,0,0,1855,1658,4,0,0,0,0,0,1662,3517
583,20,1824,0,0,0,1,0,0,1825,1602,12,0,0,0,0,0,1614,3439
583,21,1810,3,0,0,1,0,0,1814,1605,21,0,0,1,0,0,1627,3441
583,22,1829,11,4,0,0,0,0,1844,1517,46,1,0,0,0,0,1564,3408
583,23,1892,16,4,0,0,0,0,1912,1632,68,2,0,0,0,0,1702,3614
583,24,1903,29,1,0,0,0,0,1933,1570,103,5,0,1,0,0,1679,3612
583,25,1887,41,3,0,1,0,0,1932,1544,147,1,0,0,0,0,1692,3624
583,26,1886,50,1,0,0,0,0,1937,1551,153,4,0,1,0,0,1709,3646
583,27,1798,90,5,0,0,0,0,1893,1436,212,8,0,1,0,0,1657,3550
583,28,1783,100,7,1,0,0,0,1891,1414,304,7,1,0,1,0,1727,3618
583,29,1649,182,11,0,1,0,0,1843,1400,430,17,0,5,0,0,1852,3695
583,30,1653,254,8,0,1,0,0,1916,1209,510,17,1,1,2,0,1740,3656
583,31,1637,330,11,0,5,0,0,1983,1278,627,21,3,2,0,0,1931,3914
583,32,1531,392,18,1,2,0,0,1944,1149,658,35,2,4,1,0,1849,3793
583,33,1470,474,18,3,5,0,0,1970,965,774,20,2,3,0,0,1764,3734
583,34,1365,589,20,1,8,0,0,1983,984,873,38,5,4,0,0,1904,3887
583,35,1354,659,26,4,2,0,0,2045,903,931,46,5,4,0,0,1889,3934
583,36,1209,728,32,1,1,0,0,1971,815,1063,51,10,1,0,0,1940,3911
583,37,1128,778,45,1,4,1,0,1957,813,1102,68,8,1,0,0,1992,3949
583,38,1059,875,49,1,4,0,0,1988,735,1129,96,7,3,0,0,1970,3958
583,39,1032,968,45,2,3,1,0,2051,750,1153,83,10,0,0,0,1996,4047
583,40,1046,1077,65,4,3,0,0,2195,734,1325,112,14,3,1,0,2189,4384
583,41,1007,1117,64,6,3,2,0,2199,733,1329,132,19,3,0,0,2216,4415
583,42,1042,1209,85,7,2,0,0,2345,687,1386,153,21,1,0,0,2248,4593
583,43,1000,1270,91,4,2,0,0,2367,662,1350,153,24,5,0,0,2194,4561
583,44,959,1288,129,14,5,0,0,2395,663,1457,171,20,1,0,0,2312,4707
583,45,982,1409,120,9,1,1,0,2522,641,1576,180,35,2,0,0,2434,4956
583,46,980,1495,131,7,3,0,0,2616,671,1677,204,38,1,0,0,2591,5207
583,47,995,1528,156,6,9,0,0,2694,658,1802,243,48,0,0,0,2751,5445
583,48,1036,1628,177,15,4,0,0,2860,653,1883,270,53,1,0,0,2860,5720
583,49,948,1754,214,15,7,0,0,2938,626,1951,298,50,4,0,0,2929,5867
583,50,937,1789,227,16,11,0,1,2981,588,1933,321,64,1,1,0,2908,5889
583,51,819,1864,225,18,3,1,0,2930,584,2032,292,58,2,0,0,2968,5898
583,52,889,1945,225,23,4,1,0,3087,533,1959,311,68,2,0,0,2873,5960
583,53,722,1885,218,24,10,0,0,2859,491,2006,344,91,2,0,0,2934,5793
583,54,733,2077,282,23,4,0,0,3119,473,2088,357,116,0,1,0,3035,6154
583,55,713,1957,253,20,9,1,0,2953,437,2133,326,103,3,0,0,3002,5955
583,56,622,2068,282,33,6,0,0,3011,390,2098,335,146,2,0,0,2971,5982
583,57,632,2138,300,37,2,0,0,3109,438,2170,344,134,2,0,0,3088,6197
583,58,516,2060,301,37,5,1,0,2920,382,2242,367,165,1,0,0,3157,6077
583,59,502,2169,292,61,2,0,0,3026,344,2312,358,180,0,1,0,3195,6221
583,60,451,2130,251,50,3,1,0,2886,311,2114,301,207,1,0,0,2934,5820
583,61,407,2023,254,47,5,0,0,2736,303,1935,283,245,0,0,0,2766,5502
583,62,373,2052,247,48,3,0,0,2723,267,2009,297,229,1,0,0,2803,5526
583,63,316,1949,225,45,1,0,0,2536,243,1968,257,317,0,0,0,2785,5321
583,64,293,1938,187,56,3,0,0,2477,243,1858,223,320,0,0,0,2644,5121
583,65,271,1829,168,73,5,0,0,2346,171,1704,226,321,2,1,0,2425,4771
583,66,245,1727,174,82,2,0,0,2230,193,1773,215,308,2,0,0,2491,4721
583,67,224,1677,153,77,0,0,0,2131,145,1659,197,326,0,0,0,2327,4458
583,68,210,1726,143,102,0,0,1,2182,138,1680,175,385,1,0,0,2379,4561
583,69,201,1656,128,108,1,0,0,2094,155,1578,164,428,1,0,0,2326,4420
583,70,162,1678,113,123,2,1,0,2079,122,1418,145,439,1,0,0,2125,4204
583,71,168,1594,116,111,0,1,0,1990,118,1449,132,469,0,0,0,2168,4158
583,72,145,1571,93,107,0,0,0,1916,115,1374,130,460,1,0,0,2080,3996
583,73,149,1617,70,139,0,0,0,1975,120,1359,119,608,0,0,0,2206,4181
583,74,135,1534,72,144,0,0,0,1885,98,1348,127,656,1,0,0,2230,4115
583,75,134,1515,84,161,0,0,0,1894,93,1287,106,759,1,0,0,2246,4140
583,76,111,1467,73,160,0,0,0,1811,118,1187,113,804,0,0,0,2222,4033
583,77,94,1412,75,186,3,0,0,1770,84,1049,98,787,1,0,0,2019,3789
583,78,65,977,45,144,0,0,0,1231,76,793,70,663,0,0,0,1602,2833
583,79,75,994,45,155,1,0,0,1270,72,748,61,725,0,0,0,1606,2876
583,80,80,892,32,158,0,0,0,1162,79,680,64,787,0,0,0,1610,2772
583,81,63,842,43,184,0,0,0,1132,89,592,54,834,0,0,0,1569,2701
583,82,65,800,31,191,0,0,0,1087,101,605,46,970,0,0,0,1722,2809
583,83,60,803,32,211,0,0,0,1106,85,577,41,1065,1,0,0,1769,2875
583,84,63,766,32,216,0,0,0,1077,109,471,43,1036,0,0,0,1659,2736
583,85,50,726,18,221,0,0,0,1015,90,372,31,1092,0,0,0,1585,2600
583,86,42,569,14,209,0,0,0,834,82,320,19,1016,0,0,0,1437,2271
583,87,20,456,11,199,1,0,0,687,66,200,21,925,0,0,0,1212,1899
583,88,20,398,10,154,0,0,0,582,66,168,13,823,0,0,0,1070,1652
583,89,25,284,11,147,0,0,0,467,41,119,13,780,0,0,0,953,1420
583,90,29,241,4,138,0,0,0,412,57,81,12,690,0,0,0,840,1252
583,91,13,161,2,123,0,0,0,299,57,60,10,605,0,0,0,732,1031
583,92,17,120,3,103,0,0,0,243,46,38,7,537,0,0,0,628,871
583,93,7,90,0,75,0,0,0,172,43,26,2,448,0,0,0,519,691
583,94,7,58,1,61,0,0,0,127,25,13,2,349,0,0,0,389,516
583,95,2,38,1,57,0,0,0,98,20,10,4,260,0,0,0,294,392
583,96,1,16,1,30,0,0,0,48,11,5,1,213,0,0,0,230,278
583,97,1,12,1,19,0,0,0,33,16,0,0,135,0,0,0,151,184
583,98,2,6,0,17,0,0,0,25,11,2,0,86,0,0,0,99,124
583,99,2,3,3,7,0,0,0,15,11,1,0,69,0,0,0,81,96
583,100,0,0,0,18,0,0,0,18,9,1,0,117,0,0,0,127,145
583,999,84856,80643,7111,5050,164,12,2,177838,70484,81662,9613,23794,82,9,0,185644,363482
689,0,2057,0,0,0,0,0,0,2057,1914,0,0,0,0,0,0,1914,3971
689,1,2050,0,0,0,0,0,0,2050,1967,0,0,0,0,0,0,1967,4017
689,2,2137,0,0,0,0,0,0,2137,2151,0,0,0,0,0,0,2151,4288
689,3,2225,0,0,0,0,0,0,2225,2099,0,0,0,0,0,0,2099,4324
689,4,2210,0,0,0,0,0,0,2210,2235,0,0,0,0,0,0,2235,4445
689,5,2375,0,0,0,0,0,0,2375,2227,0,0,0,0,0,0,2227,4602
689,6,2412,0,0,0,0,0,0,2412,2421,0,0,0,0,0,0,2421,4833
689,7,2562,0,0,0,0,0,0,2562,2427,0,0,0,0,0,0,2427,4989
689,8,2640,0,0,0,0,0,0,2640,2381,0,0,0,0,0,0,2381,5021
689,9,2669,0,0,0,0,0,0,2669,2573,0,0,0,0,0,0,2573,5242
689,10,2732,0,0,0,0,0,0,2732,2586,0,0,0,0,0,0,2586,5318
689,11,2812,0,0,0,0,0,0,2812,2609,0,0,0,0,0,0,2609,5421
689,12,2886,0,0,0,0,0,0,2886,2527,0,0,0,0,0,0,2527,5413
689,13,2881,0,0,0,0,0,0,2881,2634,0,0,0,0,0,0,2634,5515
689,14,2854,0,0,0,0,0,0,2854,2806,0,0,0,0,0,0,2806,5660
689,15,2905,0,0,0,0,0,0,2905,2712,0,0,0,0,0,0,2712,5617
689,16,2903,0,0,1,0,0,0,2904,2749,0,0,0,0,0,0,2749,5653
689,17,2848,0,0,0,0,0,0,2848,2700,0,0,0,0,0,0,2700,5548
689,18,2918,0,0,0,0,0,0,2918,2635,1,1,0,0,0,0,2637,5555
689,19,2987,3,0,0,0,0,0,2990,2652,13,0,0,0,0,0,2665,5655
689,20,2931,5,1,0,0,0,0,2937,2654,25,0,0,0,0,0,2679,5616
689,21,2900,7,0,0,0,0,0,2907,2617,57,0,0,0,0,0,2674,5581
689,22,3030,22,0,0,0,0,0,3052,2676,108,3,0,0,0,0,2787,5839
689,23,3235,22,0,0,0,0,0,3257,2754,154,4,0,0,0,0,2912,6169
689,24,3165,60,0,0,2,0,0,3227,2617,218,7,2,3,0,0,2847,6074
689,25,3279,92,4,0,0,0,0,3375,2539,285,6,0,1,0,0,2831,6206
689,26,3148,124,5,0,2,0,0,3279,2484,407,9,0,3,0,0,2903,6182
689,27,3184,217,5,0,0,0,0,3406,2305,555,8,0,0,1,0,2869,6275
689,28,2959,275,10,0,0,0,0,3244,2203,644,23,1,3,0,0,2874,6118
689,29,2764,397,11,1,3,0,0,3176,2087,895,23,0,3,0,0,3008,6184
689,30,2638,547,10,0,2,0,0,3197,1902,991,33,2,1,0,0,2929,6126
689,31,2613,728,17,0,2,1,0,3361,1871,1233,31,0,1,0,0,3136,6497
689,32,2421,946,20,1,2,0,0,3390,1595,1357,43,3,2,0,0,3000,6390
689,33,2295,1057,36,2,2,1,0,3393,1584,1451,62,3,1,0,0,3101,6494
689,34,2166,1171,39,7,8,2,0,3393,1396,1576,76,4,4,0,0,3056,6449
689,35,2053,1282,59,2,10,0,0,3406,1340,1712,83,6,4,0,0,3145,6551
689,36,1782,1364,42,1,5,0,0,3194,1196,1792,110,5,6,0,0,3109,6303
689,37,1779,1457,69,0,5,2,0,3312,1147,1864,136,11,3,0,0,3161,6473
689,38,1773,1561,78,2,3,2,0,3419,1101,1855,135,12,4,1,0,3108,6527
689,39,1629,1641,85,2,7,0,0,3364,1077,1964,129,11,6,0,0,3187,6551
689,40,1560,1788,120,8,5,0,0,3481,1088,1969,171,24,7,0,1,3260,6741
689,41,1487,1919,114,5,5,1,0,3531,1041,2126,206,22,2,0,0,3397,6928
689,42,1450,1898,141,10,4,0,0,3503,959,2172,209,25,4,0,0,3369,6872
689,43,1467,2035,144,8,7,0,0,3661,947,2335,263,35,5,0,0,3585,7246
689,44,1357,2094,138,9,3,0,0,3601,907,2333,255,35,3,0,0,3533,7134
689,45,1448,2190,192,14,5,0,0,3849,896,2438,279,41,1,0,0,3655,7504
689,46,1389,2309,193,9,3,0,0,3903,911,2493,325,53,11,0,0,3793,7696
689,47,1416,2483,237,15,2,0,0,4153,859,2757,347,51,4,0,0,4018,8171
689,48,1384,2635,267,21,4,0,0,4311,902,2850,410,76,9,0,0,4247,8558
689,49,1357,2808,312,13,5,0,0,4495,894,3108,431,70,3,0,0,4506,9001
689,50,1401,2818,342,12,6,0,0,4579,847,3005,465,96,4,0,0,4417,8996
689,51,1240,2949,343,18,4,0,0,4554,845,3090,465,102,3,0,0,4505,9059
689,52,1196,2954,408,24,2,0,0,4584,747,3226,474,138,2,0,0,4587,9171
689,53,1094,2987,363,40,2,0,0,4486,729,3183,460,107,5,0,0,4484,8970
689,54,1093,3147,395,29,7,1,0,4672,686,3284,512,129,1,0,0,4612,9284
689,55,1007,3243,415,55,7,2,0,4729,653,3356,515,159,3,0,0,4686,9415
689,56,1013,3183,429,46,3,0,0,4674,644,3288,515,187,3,0,0,4637,9311
689,57,955,3209,415,56,5,0,0,4640,633,3371,518,194,3,0,0,4719,9359
689,58,871,3412,427,66,9,0,0,4785,578,3353,480,252,2,0,1,4666,9451
689,59,784,3452,436,78,6,0,0,4756,554,3538,509,251,1,0,0,4853,9609
689,60,760,3197,384,70,4,0,0,4415,473,3119,476,290,2,0,1,4361,8776
689,61,648,3119,384,78,5,0,0,4234,442,3142,425,336,2,0,0,4347,8581
689,62,640,3010,379,55,3,0,1,4088,418,3033,395,351,0,0,0,4197,8285
689,63,553,3029,336,111,5,0,0,4034,404,2882,370,400,0,0,0,4056,8090
689,64,575,2938,314,103,2,0,0,3932,328,2786,369,482,0,0,0,3965,7897
689,65,513,2983,271,96,1,0,0,3864,315,2604,306,418,1,0,0,3644,7508
689,66,489,2847,266,120,4,0,0,3726,271,2715,325,506,0,0,0,3817,7543
689,67,446,2682,247,124,4,0,0,3503,262,2588,293,553,1,0,0,3697,7200
689,68,398,2738,239,145,1,0,0,3521,255,2463,244,644,0,0,0,3606,7127
689,69,379,2531,221,161,1,0,0,3293,208,2467,237,663,0,0,0,3575,6868
689,70,377,2543,190,169,4,0,0,3283,233,2303,232,676,0,0,0,3444,6727
689,71,384,2528,215,189,0,0,0,3316,218,2216,221,760,1,0,0,3416,6732
689,72,350,2458,176,155,1,0,0,3140,195,2269,196,752,1,0,0,3413,6553
689,73,362,2514,151,206,1,0,0,3234,187,2206,184,894,1,0,0,3472,6706
689,74,346,2511,144,235,1,0,0,3237,194,2115,173,992,1,0,0,3475,6712
689,75,317,2518,135,275,1,0,0,3246,186,2068,153,1152,1,0,0,3560,6806
689,76,280,2344,149,272,1,0,0,3046,194,1882,123,1174,0,0,0,3373,6419
689,77,279,2094,130,262,0,0,0,2765,161,1673,105,1215,0,0,0,3154,5919
689,78,237,1600,75,220,0,0,0,2132,123,1214,88,1024,0,0,0,2449,4581
689,79,226,1629,74,285,1,0,1,2216,129,1264,88,1140,1,0,0,2622,4838
689,80,217,1630,44,272,0,0,0,2163,147,1102,83,1269,0,0,0,2601,4764
689,81,222,1512,54,277,0,0,0,2065,161,1045,76,1348,0,0,0,2630,4695
689,82,234,1378,50,291,0,0,0,1953,175,944,61,1493,0,0,0,2673,4626
689,83,233,1353,41,334,0,0,0,1961,142,851,44,1633,0,0,0,2670,4631
689,84,198,1286,40,324,0,0,0,1848,162,721,53,1619,1,0,0,2556,4404
689,85,186,1138,32,367,1,0,0,1724,135,614,54,1686,0,0,0,2489,4213
689,86,153,927,27,316,0,0,0,1423,128,458,42,1493,0,0,0,2121,3544
689,87,100,725,14,298,0,0,0,1137,113,311,31,1339,0,0,0,1794,2931
689,88,106,613,17,298,0,0,0,1034,143,228,16,1325,0,0,0,1712,2746
689,89,90,488,5,259,0,0,0,842,111,175,16,1239,0,0,0,1541,2383
689,90,62,313,4,206,0,0,0,585,92,119,14,1073,0,0,0,1298,1883
689,91,43,268,7,176,0,0,0,494,71,70,10,930,0,0,0,1081,1575
689,92,36,198,5,158,0,0,0,397,77,56,11,787,0,0,0,931,1328
689,93,28,139,4,132,0,0,0,303,58,41,7,687,0,0,0,793,1096
689,94,13,107,2,110,0,0,0,232,82,21,6,502,0,0,0,611,843
689,95,10,64,3,61,0,0,0,138,45,8,2,424,0,0,0,479,617
689,96,10,41,1,49,0,0,0,101,35,9,5,284,0,0,0,333,434
689,97,7,19,1,40,0,0,0,67,18,6,5,229,0,0,0,258,325
689,98,1,9,1,20,0,0,0,31,23,0,3,153,0,0,0,179,210
689,99,3,7,0,19,0,0,0,29,19,0,0,105,0,0,0,124,153
689,100,4,5,1,24,0,0,0,34,21,1,1,137,0,0,0,160,194
689,999,139291,130524,11155,7917,188,12,2,289089,111624,130221,14274,36284,134,2,3,292542,581631
821,0,3835,0,0,0,0,0,0,3835,3549,0,0,0,0,0,0,3549,7384
821,1,3955,0,0,0,0,0,0,3955,3671,0,0,0,0,0,0,3671,7626
821,2,4141,0,0,0,0,0,0,4141,3755,0,0,0,0,0,0,3755,7896
821,3,4129,0,0,0,0,0,0,4129,3852,0,0,0,0,0,0,3852,7981
821,4,4297,0,0,0,0,0,0,4297,4276,0,0,0,0,0,0,4276,8573
821,5,4558,0,0,0,0,0,0,4558,4307,0,0,0,0,0,0,4307,8865
821,6,4840,0,0,0,0,0,0,4840,4614,0,0,0,0,0,0,4614,9454
821,7,5019,0,0,0,0,0,0,5019,4700,0,0,0,0,0,0,4700,9719
821,8,5104,0,0,0,0,0,0,5104,4764,0,0,0,0,0,0,4764,9868
821,9,5331,0,0,0,0,0,0,5331,5099,0,0,0,0,0,0,5099,10430
821,10,5594,0,0,0,0,0,0,5594,4978,0,0,0,0,0,0,4978,10572
821,11,5707,0,0,0,0,0,0,5707,5324,0,0,0,0,0,0,5324,11031
821,12,5851,0,0,0,0,0,0,5851,5595,0,0,0,0,0,0,5595,11446
821,13,5991,0,0,0,0,0,0,5991,5672,0,0,0,0,0,0,5672,11663
821,14,6104,0,0,0,0,0,0,6104,5920,0,0,0,0,0,0,5920,12024
821,15,6128,0,0,0,0,0,0,6128,5779,0,0,0,0,0,0,5779,11907
821,16,6049,0,0,0,0,0,0,6049,5798,0,0,0,0,0,0,5798,11847
821,17,6222,0,0,0,0,0,0,6222,5657,1,0,0,0,0,0,5658,11880
821,18,6098,0,1,0,0,0,0,6099,5608,2,0,0,0,0,0,5610,11709
821,19,6082,2,0,0,0,0,0,6084,5673,10,0,0,0,0,0,5683,11767
821,20,6109,4,0,0,0,0,0,6113,5698,36,2,0,1,0,0,5737,11850
821,21,6170,15,1,0,0,0,0,6186,5493,78,1,0,1,0,0,5573,11759
821,22,6289,23,1,0,0,0,0,6313,5436,144,3,0,1,0,0,5584,11897
821,23,6265,41,0,0,2,0,0,6308,5596,217,10,0,1,0,0,5824,12132
821,24,6018,74,7,0,0,0,0,6099,5347,306,11,0,1,0,0,5665,11764
821,25,6166,124,14,0,0,0,0,6304,5179,419,12,0,1,1,0,5612,11916
821,26,6118,174,12,0,3,0,0,6307,4983,585,11,0,3,3,0,5585,11892
821,27,5599,274,7,0,3,0,0,5883,4751,803,17,0,3,1,0,5575,11458
821,28,5532,442,11,0,4,1,0,5990,4502,1115,22,0,1,1,0,5641,11631
821,29,5276,583,13,0,1,0,0,5873,4122,1326,29,2,4,0,0,5483,11356
821,30,5141,819,18,0,8,0,0,5986,3852,1645,43,2,5,2,0,5549,11535
821,31,5106,1083,32,1,5,0,0,6227,3680,2027,43,2,6,0,0,5758,11985
821,32,4609,1373,34,4,5,1,0,6026,3491,2348,65,7,16,0,0,5927,11953
821,33,4608,1550,50,3,8,1,0,6220,3227,2672,86,8,15,0,0,6008,12228
821,34,4153,1830,49,10,14,1,0,6057,3016,2746,117,15,10,2,0,5906,11963
821,35,4089,2255,76,9,13,0,0,6442,2878,3176,144,18,6,0,0,6222,12664
821,36,3843,2393,68,5,15,0,0,6324,2517,3382,188,19,8,1,0,6115,12439
821,37,3419,2616,90,11,7,2,1,6146,2350,3419,210,23,12,1,0,6015,12161
821,38,3377,2866,124,6,10,0,0,6383,2336,3753,252,29,10,2,0,6382,12765
821,39,3395,3095,137,9,8,0,0,6644,2236,3994,281,27,11,0,0,6549,13193
821,40,3140,3365,172,16,10,1,0,6704,2096,4216,326,44,8,0,0,6690,13394
821,41,3157,3588,188,5,12,0,0,6950,1975,4346,339,44,5,2,0,6711,13661
821,42,3100,3795,231,31,11,2,2,7172,1917,4442,370,66,7,1,0,6803,13975
821,43,2962,4049,232,28,18,0,0,7289,1880,4676,422,81,7,0,0,7066,14355
821,44,2792,4171,308,23,18,0,0,7312,1849,4830,518,72,5,0,0,7274,14586
821,45,3023,4596,356,21,8,1,0,8005,1886,5181,582,101,4,0,0,7754,15759
821,46,2915,4818,376,28,15,0,0,8152,1828,5330,635,107,9,0,0,7909,16061
821,47,2895,5110,491,36,13,0,0,8545,1719,5569,625,132,6,1,0,8052,16597
821,48,3025,5556,497,44,22,0,0,9144,1794,6053,728,146,9,0,0,8730,17874
821,49,2914,5756,591,44,23,1,0,9329,1729,6083,777,140,9,1,1,8740,18069
821,50,2693,5774,649,59,14,0,0,9189,1629,6244,849,161,13,0,0,8896,18085
821,51,2655,6081,633,63,11,0,0,9443,1548,6162,822,189,7,0,0,8728,18171
821,52,2334,6110,661,64,21,1,0,9191,1404,6253,798,225,8,0,0,8688,17879
821,53,2327,6255,724,55,15,1,0,9377,1327,6338,854,237,6,0,0,8762,18139
821,54,2239,6347,705,58,17,0,0,9366,1320,6354,881,298,6,0,0,8859,18225
821,55,2104,6432,682,80,18,0,0,9316,1181,6500,896,316,3,1,0,8897,18213
821,56,1923,6409,726,81,16,0,0,9155,1258,6636,795,387,3,0,0,9079,18234
821,57,1917,6849,754,120,23,0,0,9663,1149,6781,828,410,9,0,0,9177,18840
821,58,1785,6779,750,133,10,1,0,9458,1146,6693,785,505,7,1,0,9137,18595
821,59,1613,6996,756,135,15,0,1,9516,1061,6722,850,550,2,0,0,9185,18701
821,60,1375,6409,678,143,10,0,0,8615,951,6336,793,547,2,0,1,8630,17245
821,61,1178,6175,637,139,23,1,0,8153,851,6040,692,623,6,0,0,8212,16365
821,62,1072,5903,585,154,4,1,0,7719,777,5722,624,687,5,0,0,7815,15534
821,63,1034,5892,567,190,6,0,0,7689,710,5586,584,773,3,0,0,7656,15345
821,64,854,5776,531,192,10,0,0,7363,713,5388,534,787,4,0,0,7426,14789
821,65,876,5472,446,212,7,0,0,7013,589,5156,501,900,2,0,0,7148,14161
821,66,728,5231,405,227,5,0,0,6596,546,4833,437,928,1,0,0,6745,13341
821,67,635,5114,352,264,6,0,0,6371,528,4796,455,1011,1,0,0,6791,13162
821,68,661,4947,321,257,2,0,0,6188,464,4604,352,1128,0,0,0,6548,12736
821,69,578,4927,305,268,4,1,0,6083,426,4308,375,1213,1,0,0,6323,12406
821,70,561,4711,273,311,3,0,0,5859,404,4169,316,1269,1,0,0,6159,12018
821,71,537,4569,237,320,0,0,0,5663,420,3948,308,1366,0,0,0,6042,11705
821,72,511,4381,214,331,5,0,1,5443,380,3965,294,1464,1,0,0,6104,11547
821,73,559,4635,205,418,6,0,0,5823,399,3971,250,1659,1,0,0,6280,12103
821,74,469,4574,180,431,3,0,0,5657,355,3777,225,1840,0,0,0,6197,11854
821,75,444,4427,194,447,0,0,0,5512,378,3649,206,2036,3,0,0,6272,11784
821,76,346,4057,176,425,2,0,0,5006,332,3223,198,1958,0,0,0,5711,10717
821,77,345,4065,128,519,1,0,1,5059,335,3022,172,2207,0,0,0,5736,10795
821,78,269,2875,84,410,0,0,0,3638,276,2079,94,1925,0,0,0,4374,8012
821,79,271,2893,83,450,3,0,1,3701,253,2113,90,2142,0,0,0,4598,8299
821,80,253,2636,68,465,2,0,0,3424,281,1932,110,2166,0,0,0,4489,7913
821,81,244,2543,84,522,0,0,0,3393,246,1795,89,2341,0,0,0,4471,7864
821,82,227,2350,52,509,0,0,0,3138,291,1483,86,2446,0,0,0,4306,7444
821,83,200,2424,50,629,0,0,0,3303,310,1471,69,2807,0,0,0,4657,7960
821,84,198,2045,50,623,0,0,0,2916,320,1130,67,2641,0,0,0,4158,7074
821,85,150,1797,34,585,0,0,0,2566,266,929,54,2591,0,0,0,3840,6406
821,86,127,1444,37,504,0,0,0,2112,230,712,47,2305,0,0,0,3294,5406
821,87,96,1022,14,467,0,0,0,1599,228,481,27,2057,0,0,0,2793,4392
821,88,85,934,25,430,1,0,0,1475,249,382,31,2042,0,0,0,2704,4179
821,89,59,689,6,377,0,0,0,1131,202,269,18,1808,0,0,0,2297,3428
821,90,51,524,4,332,0,0,0,911,168,176,11,1586,0,0,0,1941,2852
821,91,45,361,5,305,0,0,0,716,167,118,12,1412,0,0,0,1709,2425
821,92,33,253,2,214,0,0,0,502,146,101,11,1236,0,0,0,1494,1996
821,93,26,218,4,200,0,0,0,448,150,41,7,1043,0,0,0,1241,1689
821,94,13,126,4,126,0,0,0,269,112,20,2,766,0,0,0,900,1169
821,95,11,84,1,88,0,0,0,184,78,25,2,597,1,0,0,703,887
821,96,6,49,0,69,0,0,0,124,55,10,4,426,0,0,0,495,619
821,97,6,25,0,55,0,0,0,86,46,4,0,307,0,0,0,357,443
821,98,2,12,0,30,0,0,0,44,31,6,2,209,0,0,0,248,292
821,99,5,5,2,20,0,0,0,32,14,5,1,158,0,0,0,178,210
821,100,4,6,0,23,0,0,0,33,32,1,1,198,0,0,0,232,265
821,999,272974,247052,18270,13863,519,17,7,552702,224686,247389,23378,61968,281,21,2,557725,1110427
900,0,1367,0,0,0,0,0,0,1367,1245,0,0,0,0,0,0,1245,2612
900,1,1411,0,0,0,0,0,0,1411,1251,0,0,0,0,0,0,1251,2662
900,2,1412,0,0,0,0,0,0,1412,1362,0,0,0,0,0,0,1362,2774
900,3,1470,0,0,0,0,0,0,1470,1391,0,0,0,0,0,0,1391,2861
900,4,1542,0,0,0,0,0,0,1542,1535,0,0,0,0,0,0,1535,3077
900,5,1613,0,0,0,0,0,0,1613,1565,0,0,0,0,0,0,1565,3178
900,6,1692,0,0,0,0,0,0,1692,1555,0,0,0,0,0,0,1555,3247
900,7,1708,0,0,0,0,0,0,1708,1657,0,0,0,0,0,0,1657,3365
900,8,1853,0,0,0,0,0,0,1853,1646,0,0,0,0,0,0,1646,3499
900,9,1867,0,0,0,0,0,0,1867,1765,0,0,0,0,0,0,1765,3632
900,10,1856,0,0,0,0,0,0,1856,1776,0,0,0,0,0,0,1776,3632
900,11,1959,0,0,0,0,0,0,1959,1794,0,0,0,0,0,0,1794,3753
900,12,2051,0,0,0,0,0,0,2051,1871,0,0,0,0,0,0,1871,3922
900,13,2142,0,0,0,0,0,0,2142,1925,0,0,0,0,0,0,1925,4067
900,14,2056,0,0,0,0,0,0,2056,1984,0,0,0,0,0,0,1984,4040
900,15,2115,0,0,0,0,0,0,2115,1901,0,0,0,0,0,0,1901,4016
900,16,2071,0,0,0,0,0,0,2071,1963,1,0,0,0,0,0,1964,4035
900,17,2090,0,0,0,0,0,0,2090,1878,0,0,0,0,0,0,1878,3968
900,18,2037,0,0,0,0,0,0,2037,1848,3,0,0,0,0,0,1851,3888
900,19,1963,1,0,0,0,0,0,1964,1933,8,0,0,0,0,0,1941,3905
900,20,1967,3,0,0,0,1,0,1971,1674,30,1,0,0,0,0,1705,3676
900,21,2035,7,1,0,0,0,0,2043,1694,47,0,0,0,0,0,1741,3784
900,22,2008,11,4,0,0,0,0,2023,1716,81,0,0,0,0,0,1797,3820
900,23,2098,16,4,0,1,0,0,2119,1710,122,2,0,0,0,0,1834,3953
900,24,2158,54,2,0,0,0,0,2214,1728,153,3,0,1,0,0,1885,4099
900,25,2111,72,4,0,2,0,0,2189,1686,231,2,0,0,0,0,1919,4108
900,26,2004,110,3,0,1,0,0,2118,1560,265,7,0,0,0,0,1832,3950
900,27,1952,144,9,0,0,0,0,2105,1506,417,10,2,0,0,0,1935,4040
900,28,1804,198,8,0,1,0,0,2011,1402,438,10,0,3,0,0,1853,3864
900,29,1893,274,12,0,0,1,0,2180,1397,542,11,1,2,0,0,1953,4133
900,30,1770,338,17,1,1,0,0,2127,1283,660,17,0,2,0,0,1962,4089
900,31,1741,422,8,1,4,0,0,2176,1217,808,31,0,3,0,0,2059,4235
900,32,1614,500,12,2,4,1,0,2133,1074,905,32,2,7,1,0,2021,4154
900,33,1603,610,21,2,2,0,0,2238,1056,983,39,6,1,0,0,2085,4323
900,34,1463,739,21,3,2,0,0,2228,1008,1054,47,1,3,1,0,2114,4342
900,35,1444,855,40,0,2,1,0,2342,976,1173,47,11,1,0,0,2208,4550
900,36,1321,972,24,1,4,1,0,2323,873,1234,55,5,5,0,0,2172,4495
900,37,1274,1011,44,2,6,2,0,2339,827,1289,89,8,4,0,0,2217,4556
900,38,1213,1041,63,3,4,0,0,2324,890,1302,74,8,2,0,0,2276,4600
900,39,1253,1128,45,2,2,0,0,2430,812,1398,72,22,2,1,0,2307,4737
900,40,1181,1213,68,5,4,0,0,2471,753,1330,130,11,4,0,0,2228,4699
900,41,1180,1312,67,2,2,0,0,2563,749,1476,131,24,3,0,0,2383,4946
900,42,1169,1386,105,11,3,0,0,2674,765,1583,156,24,2,0,0,2530,5204
900,43,1173,1470,94,13,4,0,1,2755,824,1740,166,29,3,0,0,2762,5517
900,44,1095,1588,100,6,5,1,0,2795,764,1731,185,35,3,0,0,2718,5513
900,45,1199,1674,148,23,1,0,0,3045,796,1842,228,30,1,0,0,2897,5942
900,46,1220,1777,173,19,4,0,0,3193,813,1930,250,43,2,0,0,3038,6231
900,47,1205,1831,189,17,0,0,0,3242,785,1906,256,41,2,0,0,2990,6232
900,48,1219,1967,218,13,5,0,0,3422,774,2113,261,56,1,0,0,3205,6627
900,49,1180,2048,214,17,6,0,0,3465,763,2170,309,57,0,0,0,3299,6764
900,50,1116,2106,231,13,2,0,0,3468,768,2161,351,69,2,1,0,3352,6820
900,51,1070,2163,254,20,4,0,0,3511,695,2248,317,80,5,0,0,3345,6856
900,52,948,2111,246,27,4,0,0,3336,669,2302,340,83,3,0,0,3397,6733
900,53,947,2164,277,28,3,0,0,3419,586,2172,337,94,0,0,0,3189,6608
900,54,882,2270,307,26,0,0,0,3485,554,2251,385,100,3,0,0,3293,6778
900,55,808,2287,283,31,4,0,0,3413,578,2293,364,132,2,0,0,3369,6782
900,56,774,2234,305,30,5,0,0,3348,493,2299,374,123,2,0,0,3291,6639
900,57,670,2290,313,42,6,0,0,3321,480,2290,309,140,2,0,0,3221,6542
900,58,686,2427,313,45,3,0,1,3475,439,2284,359,167,2,0,0,3251,6726
900,59,595,2390,313,47,3,0,1,3349,391,2278,400,192,2,0,0,3263,6612
900,60,513,2231,281,56,4,0,0,3085,396,2156,312,187,2,0,0,3053,6138
900,61,452,2120,275,56,1,0,0,2904,348,2106,324,235,2,0,0,3015,5919
900,62,446,2202,270,78,2,0,0,2998,292,2123,298,265,1,0,0,2979,5977
900,63,385,2066,247,66,3,0,2,2769,320,1992,269,285,2,0,0,2868,5637
900,64,333,2041,232,66,4,0,0,2676,263,1934,254,304,4,0,0,2759,5435
900,65,288,1835,191,91,3,0,0,2408,224,1812,227,350,1,0,0,2614,5022
900,66,284,1917,211,80,3,0,0,2495,222,1833,214,352,0,0,0,2621,5116
900,67,246,1891,183,77,5,0,0,2402,184,1769,184,416,0,0,0,2553,4955
900,68,218,1792,159,99,5,0,0,2273,219,1786,173,378,1,0,0,2557,4830
900,69,229,1793,131,121,2,0,0,2276,201,1662,175,467,0,0,0,2505,4781
900,70,177,1674,106,119,1,0,0,2077,137,1584,145,473,1,0,0,2340,4417
900,71,190,1618,130,142,2,0,0,2082,161,1560,143,541,0,0,0,2405,4487
900,72,161,1604,112,157,2,0,0,2036,138,1484,135,523,0,0,0,2280,4316
900,73,166,1705,96,144,0,0,1,2112,127,1529,112,617,1,0,0,2386,4498
900,74,161,1720,83,156,0,0,1,2121,127,1465,112,668,0,0,0,2372,4493
900,75,155,1742,78,178,1,0,0,2154,138,1449,126,809,0,0,0,2522,4676
900,76,162,1747,72,193,1,0,1,2176,127,1449,94,884,1,0,0,2555,4731
900,77,186,1668,62,242,0,0,0,2158,124,1341,96,908,0,0,0,2469,4627
900,78,81,1006,36,148,0,0,0,1271,78,780,65,707,0,0,0,1630,2901
900,79,109,1152,38,174,1,0,1,1475,95,846,44,884,0,0,0,1869,3344
900,80,103,1017,27,174,1,0,0,1322,96,843,55,879,0,0,0,1873,3195
900,81,90,983,40,180,1,0,0,1294,107,697,41,909,0,0,0,1754,3048
900,82,104,910,17,181,2,0,0,1214,80,660,44,1006,0,0,0,1790,3004
900,83,106,982,26,253,0,0,0,1367,115,612,24,1123,0,0,0,1874,3241
900,84,94,865,17,228,1,0,0,1205,83,510,34,1130,0,0,0,1757,2962
900,85,60,800,12,234,0,0,0,1106,69,474,26,1197,0,0,0,1766,2872
900,86,77,674,7,205,0,0,0,963,81,305,21,1038,0,0,0,1445,2408
900,87,46,454,9,196,0,0,0,705,71,217,15,934,0,0,0,1237,1942
900,88,46,423,7,200,0,0,0,676,61,190,9,962,0,0,0,1222,1898
900,89,29,338,5,216,0,0,0,588,76,124,13,868,0,0,0,1081,1669
900,90,26,259,4,148,0,0,0,437,44,96,5,757,0,0,0,902,1339
900,91,21,188,3,128,0,0,0,340,41,52,4,687,0,0,0,784,1124
900,92,16,144,0,105,0,0,0,265,33,31,3,575,0,0,0,642,907
900,93,10,92,2,83,0,0,0,187,30,27,5,489,0,0,0,551,738
900,94,4,59,1,55,0,0,0,119,28,10,1,385,0,0,0,424,543
900,95,2,33,0,36,0,0,0,71,24,12,2,319,0,0,0,357,428
900,96,3,20,0,36,0,0,0,59,14,8,3,222,0,0,0,247,306
900,97,4,14,0,21,0,0,0,39,9,2,0,184,0,0,0,195,234
900,98,3,13,0,11,0,0,0,27,10,2,0,118,0,0,0,130,157
900,99,1,5,0,11,0,0,0,17,12,0,2,75,0,0,0,89,106
900,100,5,6,0,14,0,0,0,25,12,2,0,130,0,0,0,144,169
900,999,97110,91017,7730,5610,149,8,9,201633,78390,91077,9966,25836,96,4,0,205369,407002
1019,0,1154,0,0,0,0,0,0,1154,1026,0,0,0,0,0,0,1026,2180
1019,1,1170,0,0,0,0,0,0,1170,1103,0,0,0,0,0,0,1103,2273
1019,2,1228,0,0,0,0,0,0,1228,1220,0,0,0,0,0,0,1220,2448
1019,3,1196,0,0,0,0,0,0,1196,1162,0,0,0,0,0,0,1162,2358
1019,4,1256,0,0,0,0,0,0,1256,1229,0,0,0,0,0,0,1229,2485
1019,5,1313,0,0,0,0,0,0,1313,1305,0,0,0,0,0,0,1305,2618
1019,6,1440,0,0,0,0,0,0,1440,1358,0,0,0,0,0,0,1358,2798
1019,7,1468,0,0,0,0,0,0,1468,1454,0,0,0,0,0,0,1454,2922
1019,8,1530,0,0,0,0,0,0,1530,1452,0,0,0,0,0,0,1452,2982
1019,9,1556,0,0,0,0,0,0,1556,1440,0,0,0,0,0,0,1440,2996
1019,10,1590,0,0,0,0,0,0,1590,1456,0,0,0,0,0,0,1456,3046
1019,11,1706,0,0,0,0,0,0,1706,1552,0,0,0,0,0,0,1552,3258
1019,12,1685,0,0,0,0,0,0,1685,1592,0,0,0,0,0,0,1592,3277
1019,13,1777,0,0,0,0,0,0,1777,1679,0,0,0,0,0,0,1679,3456
1019,14,1795,0,0,0,0,0,0,1795,1610,0,0,0,0,0,0,1610,3405
1019,15,1741,0,0,0,0,0,0,1741,1710,0,0,0,0,0,0,1710,3451
1019,16,1733,0,0,0,0,0,0,1733,1721,0,0,0,0,0,0,1721,3454
1019,17,1774,0,0,0,0,0,0,1774,1639,0,0,0,0,0,0,1639,3413
1019,18,1796,0,0,0,0,0,0,1796,1619,1,0,0,0,0,0,1620,3416
1019,19,1763,3,0,0,0,0,0,1766,1620,3,0,0,0,0,0,1623,3389
1019,20,1827,2,0,0,0,0,0,1829,1642,12,0,0,0,0,0,1654,3483
1019,21,1811,2,0,0,0,0,0,1813,1601,14,1,0,0,0,0,1616,3429
1019,22,1818,2,0,0,0,0,0,1820,1662,32,2,0,0,0,0,1696,3516
1019,23,1936,8,1,0,0,0,0,1945,1624,48,0,0,1,0,0,1673,3618
1019,24,1869,24,0,0,0,0,0,1893,1690,67,1,1,0,0,0,1759,3652
1019,25,1854,28,2,0,0,0,0,1884,1655,83,0,0,1,0,0,1739,3623
1019,26,1908,40,1,0,0,0,0,1949,1580,133,0,0,0,0,0,1713,3662
1019,27,1896,84,1,0,0,0,0,1981,1565,176,4,1,1,0,0,1747,3728
1019,28,1802,102,1,0,0,0,0,1905,1426,252,4,0,0,0,0,1682,3587
1019,29,1694,153,4,0,1,0,0,1852,1377,322,6,0,0,0,0,1705,3557
1019,30,1740,194,2,0,0,0,0,1936,1383,425,5,0,3,0,0,1816,3752
1019,31,1669,315,3,1,0,0,0,1988,1302,526,8,2,1,0,0,1839,3827
1019,32,1606,374,4,0,1,1,0,1986,1114,648,21,0,3,1,0,1787,3773
1019,33,1582,433,6,1,1,0,0,2023,1195,751,21,4,0,0,0,1971,3994
1019,34,1462,549,14,0,2,0,0,2027,1097,902,27,1,2,0,0,2029,4056
1019,35,1407,647,21,1,1,0,0,2077,962,988,40,3,1,0,0,1994,4071
1019,36,1248,737,16,6,1,0,0,2008,854,1016,41,4,0,0,0,1915,3923
1019,37,1222,835,19,2,1,0,0,2079,835,1117,48,6,3,1,0,2010,4089
1019,38,1151,965,37,3,1,0,0,2157,883,1228,75,10,3,1,0,2200,4357
1019,39,1117,1063,37,2,1,0,0,2220,750,1267,71,11,1,0,0,2100,4320
1019,40,1087,1081,51,1,2,0,0,2222,709,1347,90,9,3,0,0,2158,4380
1019,41,1089,1221,68,5,2,0,0,2385,688,1495,108,10,6,0,0,2307,4692
1019,42,1049,1203,62,5,1,0,0,2320,682,1446,96,15,1,0,0,2240,4560
1019,43,1004,1341,55,3,0,0,0,2403,646,1573,136,26,1,0,0,2382,4785
1019,44,997,1455,78,10,3,0,0,2543,572,1702,118,25,3,0,0,2420,4963
1019,45,937,1567,93,2,4,0,0,2603,591,1759,143,26,1,0,0,2520,5123
1019,46,972,1581,105,7,3,0,0,2668,573,1813,140,29,2,0,0,2557,5225
1019,47,885,1677,125,4,2,0,0,2693,610,1961,171,46,0,0,0,2788,5481
1019,48,886,1743,122,14,1,0,0,2766,546,2087,207,42,0,0,0,2882,5648
1019,49,859,1876,143,10,2,0,0,2890,501,2098,200,53,2,0,0,2854,5744
1019,50,788,1917,159,18,2,0,0,2884,466,2155,192,54,1,0,0,2868,5752
1019,51,722,1962,154,22,2,0,0,2862,489,2141,214,79,1,0,0,2924,5786
1019,52,682,2070,157,14,2,1,0,2926,438,2375,216,96,1,0,0,3126,6052
1019,53,656,1978,153,12,0,0,0,2799,387,2285,229,92,1,0,0,2994,5793
1019,54,605,2161,194,18,3,0,0,2981,403,2356,226,77,0,0,0,3062,6043
1019,55,546,2221,171,25,0,0,0,2963,329,2389,240,118,0,0,0,3076,6039
1019,56,477,2287,191,26,2,0,0,2983,357,2470,248,135,1,0,0,3211,6194
1019,57,450,2302,208,37,1,0,0,2998,340,2365,232,158,0,0,0,3095,6093
1019,58,446,2341,184,48,2,0,0,3021,276,2488,197,189,1,0,0,3151,6172
1019,59,438,2288,183,51,1,0,0,2961,289,2392,222,183,0,0,0,3086,6047
1019,60,360,2139,173,41,2,0,0,2715,239,2229,182,196,0,0,0,2846,5561
1019,61,330,2086,156,47,1,0,0,2620,205,2170,182,254,1,0,0,2812,5432
1019,62,311,2027,176,51,1,1,0,2567,256,2228,165,273,0,0,0,2922,5489
1019,63,290,2051,155,47,2,0,0,2545,221,2166,179,282,1,0,0,2849,5394
1019,64,250,2022,129,52,0,0,0,2453,184,2065,149,333,1,0,0,2732,5185
1019,65,260,1957,124,79,0,0,0,2420,193,2021,141,321,0,0,0,2676,5096
1019,66,219,1938,119,67,1,0,0,2344,184,1945,131,369,0,0,0,2629,4973
1019,67,197,1979,127,76,0,0,0,2379,144,1907,110,399,0,0,0,2560,4939
1019,68,204,1907,115,87,0,0,0,2313,142,1957,114,445,0,0,0,2658,4971
1019,69,203,1861,87,90,0,0,0,2241,119,1800,98,492,1,0,0,2510,4751
1019,70,161,1826,99,79,3,0,0,2168,139,1653,89,512,0,0,0,2393,4561
1019,71,167,1816,81,110,1,0,0,2175,109,1645,85,604,0,0,0,2443,4618
1019,72,129,1789,63,112,0,0,0,2093,117,1594,71,641,0,0,0,2423,4516
1019,73,144,1950,71,106,0,0,0,2271,103,1581,73,681,1,0,0,2439,4710
1019,74,148,2031,64,144,0,0,0,2387,117,1528,55,794,0,0,0,2494,4881
1019,75,121,1807,50,124,0,0,0,2102,106,1533,72,875,0,0,0,2586,4688
1019,76,100,1733,57,160,1,0,0,2051,86,1239,49,910,0,0,0,2284,4335
1019,77,103,1709,41,154,0,0,0,2007,84,1146,48,987,0,0,0,2265,4272
1019,78,73,1159,32,106,1,0,0,1371,64,805,30,733,0,0,0,1632,3003
1019,79,69,1233,20,161,0,0,0,1483,72,754,41,891,0,0,0,1758,3241
1019,80,52,1028,24,138,1,0,0,1243,76,686,28,845,0,0,0,1635,2878
1019,81,55,985,24,161,0,0,0,1225,63,567,24,853,0,0,0,1507,2732
1019,82,54,962,15,164,0,0,0,1195,47,538,26,923,0,0,0,1534,2729
1019,83,64,1024,10,217,0,0,0,1315,73,537,19,1032,0,0,0,1661,2976
1019,84,59,970,27,203,0,0,0,1259,60,459,17,1178,0,0,0,1714,2973
1019,85,40,779,13,188,0,0,0,1020,60,351,12,981,0,0,0,1404,2424
1019,86,29,690,11,191,0,0,0,921,44,304,14,993,0,0,0,1355,2276
1019,87,32,548,7,159,0,0,0,746,50,232,12,937,0,0,0,1231,1977
1019,88,27,485,13,177,0,0,0,702,58,160,7,892,0,0,0,1117,1819
1019,89,16,374,3,168,0,0,0,561,35,127,5,834,0,0,0,1001,1562
1019,90,12,311,3,167,0,0,0,493,42,108,7,763,0,0,0,920,1413
1019,91,15,231,4,107,0,0,0,357,34,71,7,572,0,0,0,684,1041
1019,92,10,170,5,115,0,0,0,300,39,42,7,508,0,0,0,596,896
1019,93,10,120,1,108,0,0,0,239,22,35,6,515,0,0,0,578,817
1019,94,1,75,0,58,0,0,0,134,27,21,4,328,0,0,0,380,514
1019,95,1,40,0,52,0,0,0,93,24,21,3,273,0,0,0,321,414
1019,96,2,35,0,47,0,0,0,84,13,6,1,206,0,0,0,226,310
1019,97,3,20,0,29,0,0,0,52,8,7,0,135,0,0,0,150,202
1019,98,1,8,0,20,0,0,0,29,8,10,0,103,0,0,0,121,150
1019,99,0,9,0,14,0,0,0,23,9,0,0,67,0,0,0,76,99
1019,100,0,11,0,15,0,0,0,26,7,12,2,140,0,0,0,161,187
1019,999,83187,88727,4924,4739,59,3,0,181639,68719,88968,6265,25575,50,3,0,189580,371219
1109,0,603,0,0,0,0,0,0,603,581,0,0,0,0,0,0,581,1184
1109,1,627,0,0,0,0,0,0,627,614,0,0,0,0,0,0,614,1241
1109,2,691,0,0,0,0,0,0,691,632,0,0,0,0,0,0,632,1323
1109,3,706,0,0,0,0,0,0,706,625,0,0,0,0,0,0,625,1331
1109,4,741,0,0,0,0,0,0,741,650,0,0,0,0,0,0,650,1391
1109,5,693,0,0,0,0,0,0,693,699,0,0,0,0,0,0,699,1392
1109,6,778,0,0,0,0,0,0,778,776,0,0,0,0,0,0,776,1554
1109,7,819,0,0,0,0,0,0,819,807,0,0,0,0,0,0,807,1626
1109,8,856,0,0,0,0,0,0,856,781,0,0,0,0,0,0,781,1637
1109,9,840,0,0,0,0,0,0,840,829,0,0,0,0,0,0,829,1669
1109,10,882,0,0,0,0,0,0,882,863,0,0,0,0,0,0,863,1745
1109,11,956,0,0,0,0,0,0,956,872,0,0,0,0,0,0,872,1828
1109,12,945,0,0,0,0,0,0,945,846,0,0,0,0,0,0,846,1791
1109,13,925,0,0,0,0,0,0,925,871,0,0,0,0,0,0,871,1796
1109,14,976,0,0,0,0,0,0,976,916,0,0,0,0,0,0,916,1892
1109,15,1003,0,0,0,0,0,0,1003,925,0,0,0,0,0,0,925,1928
1109,16,1044,0,0,0,0,0,0,1044,873,0,0,0,0,0,0,873,1917
1109,17,942,0,0,0,0,0,0,942,963,0,0,0,0,0,0,963,1905
1109,18,1032,0,0,0,0,0,0,1032,950,0,0,0,0,0,0,950,1982
1109,19,1016,1,0,0,0,0,0,1017,922,4,0,0,0,0,0,926,1943
1109,20,1033,3,2,0,0,0,0,1038,905,14,0,0,1,0,0,920,1958
1109,21,1019,2,0,0,0,0,0,1021,960,12,0,0,0,0,0,972,1993
1109,22,998,9,0,0,0,0,0,1007,911,25,0,0,0,0,0,936,1943
1109,23,1059,13,0,0,0,0,0,1072,873,47,0,1,1,0,0,922,1994
1109,24,1049,21,2,0,0,0,0,1072,859,70,1,0,0,0,0,930,2002
1109,25,1145,31,2,0,0,0,0,1178,853,81,0,1,0,0,0,935,2113
1109,26,995,33,4,0,0,0,0,1032,807,124,4,0,1,0,0,936,1968
1109,27,1042,63,5,0,0,1,0,1111,755,152,8,1,1,0,0,917,2028
1109,28,998,78,3,0,1,0,0,1080,758,190,6,1,1,0,0,956,2036
1109,29,927,108,3,0,0,0,0,1038,657,250,8,0,1,0,0,916,1954
1109,30,891,185,6,0,1,0,0,1083,650,280,13,1,2,1,0,947,2030
1109,31,850,214,3,0,2,0,0,1069,623,363,14,0,3,1,0,1004,2073
1109,32,756,246,14,0,3,0,0,1019,559,369,13,6,2,0,0,949,1968
1109,33,753,264,9,0,2,0,0,1028,570,444,23,2,4,0,0,1043,2071
1109,34,705,345,14,0,1,0,0,1065,478,472,20,8,1,1,0,980,2045
1109,35,700,429,15,1,2,0,0,1147,503,518,19,6,0,0,0,1046,2193
1109,36,605,420,20,0,4,0,0,1049,404,593,38,4,2,0,0,1041,2090
1109,37,590,474,27,1,4,0,0,1096,412,548,34,11,0,0,0,1005,2101
1109,38,573,465,20,1,1,0,0,1060,423,645,57,8,1,0,0,1134,2194
1109,39,555,509,24,4,1,0,0,1093,391,589,64,7,1,1,0,1053,2146
1109,40,485,523,41,1,1,0,0,1051,377,679,54,7,5,1,0,1123,2174
1109,41,513,574,31,1,1,0,0,1120,376,710,60,12,2,0,0,1160,2280
1109,42,479,626,49,0,0,0,0,1154,361,729,85,11,0,0,0,1186,2340
1109,43,526,656,47,2,2,0,0,1233,360,735,92,14,2,0,0,1203,2436
1109,44,514,682,61,2,6,1,0,1266,341,795,85,12,0,0,0,1233,2499
1109,45,511,757,71,1,4,0,0,1344,359,852,109,19,2,1,0,1342,2686
1109,46,504,804,75,7,2,0,0,1392,391,938,106,21,3,0,0,1459,2851
1109,47,535,866,97,6,4,0,0,1508,342,934,153,23,3,0,0,1455,2963
1109,48,518,931,109,6,1,0,0,1565,359,1060,162,26,3,0,0,1610,3175
1109,49,552,971,126,6,6,0,0,1661,358,1061,165,47,5,1,0,1637,3298
1109,50,543,957,120,8,4,0,0,1632,291,1015,177,30,2,0,0,1515,3147
1109,51,490,1064,125,15,3,0,0,1697,329,1132,185,49,5,0,0,1700,3397
1109,52,444,1061,146,12,4,0,0,1667,289,1188,169,51,2,0,0,1699,3366
1109,53,430,1078,156,14,0,1,0,1679,259,1116,196,52,1,1,0,1625,3304
1109,54,446,1189,155,10,2,0,0,1802,290,1191,226,53,1,0,0,1761,3563
1109,55,383,1120,176,17,3,0,0,1699,256,1197,210,60,2,0,0,1725,3424
1109,56,394,1179,158,11,9,0,0,1751,248,1204,226,64,1,0,0,1743,3494
1109,57,372,1174,168,28,1,0,0,1743,249,1242,224,80,0,0,0,1795,3538
1109,58,318,1233,184,27,3,0,0,1765,241,1200,212,82,1,0,0,1736,3501
1109,59,333,1204,150,21,6,0,0,1714,236,1220,208,95,1,0,0,1760,3474
1109,60,268,1164,171,31,2,0,0,1636,189,1190,209,146,1,0,0,1735,3371
1109,61,244,1167,143,26,2,0,0,1582,178,1116,178,111,1,0,0,1584,3166
1109,62,232,1138,146,35,0,0,0,1551,143,1158,164,135,1,0,0,1601,3152
1109,63,218,1106,163,41,1,0,0,1529,132,1133,163,149,1,0,0,1578,3107
1109,64,200,1121,144,38,2,0,0,1505,115,1032,156,148,1,0,0,1452,2957
1109,65,200,1090,118,33,1,0,0,1442,99,991,123,181,1,0,0,1395,2837
1109,66,169,1021,133,45,0,0,0,1368,111,1055,147,198,1,0,0,1512,2880
1109,67,167,1055,109,56,0,0,0,1387,112,1009,114,218,0,0,0,1453,2840
1109,68,154,1007,96,52,3,0,0,1312,94,968,116,233,1,0,0,1412,2724
1109,69,138,1002,108,62,0,0,0,1310,65,917,118,250,2,0,0,1352,2662
1109,70,124,956,100,56,0,0,0,1236,67,922,75,272,0,0,0,1336,2572
1109,71,126,978,77,62,0,0,0,1243,62,901,79,278,0,0,0,1320,2563
1109,72,108,937,58,55,3,0,0,1161,75,802,85,313,0,0,0,1275,2436
1109,73,100,1023,80,90,3,0,0,1296,68,861,86,343,0,0,0,1358,2654
1109,74,87,946,65,77,0,0,0,1175,56,882,76,376,0,0,0,1390,2565
1109,75,107,1025,49,110,1,0,0,1292,64,880,73,457,0,0,0,1474,2766
1109,76,87,996,65,118,0,0,0,1266,65,776,65,431,1,0,0,1338,2604
1109,77,65,881,50,125,0,0,0,1121,58,717,62,487,0,0,0,1324,2445
1109,78,58,611,39,84,0,0,0,792,49,453,37,383,1,0,0,923,1715
1109,79,64,627,25,92,0,0,0,808,40,440,42,458,0,0,0,980,1788
1109,80,60,630,17,99,0,0,0,806,47,474,37,502,0,0,0,1060,1866
1109,81,42,596,24,103,0,0,0,765,29,402,35,510,0,0,0,976,1741
1109,82,64,518,12,122,0,0,0,716,40,353,24,498,0,0,0,915,1631
1109,83,47,529,18,131,0,0,0,725,38,354,21,611,0,0,0,1024,1749
1109,84,62,480,13,112,0,1,0,668,41,317,31,669,0,0,0,1058,1726
1109,85,39,476,15,136,0,0,0,666,30,243,16,662,0,0,0,951,1617
1109,86,35,369,8,134,0,0,0,546,36,189,20,592,0,0,0,837,1383
1109,87,29,282,8,128,0,0,0,447,39,110,10,548,0,0,0,707,1154
1109,88,28,242,7,115,0,0,0,392,27,110,13,557,0,0,0,707,1099
1109,89,23,203,7,122,0,0,0,355,18,78,8,477,0,0,0,581,936
1109,90,10,150,3,105,0,0,0,268,28,53,5,390,0,0,0,476,744
1109,91,11,109,1,91,0,0,0,212,20,54,5,393,0,0,0,472,684
1109,92,12,79,0,47,0,0,0,138,22,32,5,346,0,0,0,405,543
1109,93,7,62,4,55,0,0,0,128,17,15,5,328,0,0,0,365,493
1109,94,5,41,1,47,0,0,0,94,18,16,3,245,0,0,0,282,376
1109,95,7,29,0,33,0,0,0,69,18,15,2,170,0,0,0,205,274
1109,96,3,9,0,22,0,0,0,34,9,4,1,119,0,0,0,133,167
1109,97,2,12,0,17,0,0,0,31,11,3,1,86,0,0,0,101,132
1109,98,1,8,0,8,0,0,0,17,5,2,1,63,0,0,0,71,88
1109,99,2,2,0,7,0,0,0,11,3,0,0,43,0,0,0,46,57
1109,100,0,2,0,10,0,0,0,12,4,1,2,71,0,0,0,78,90
1109,999,47013,47241,4495,3134,102,4,0,101989,38000,47016,5839,14312,75,8,0,105250,207239
1224,0,1158,0,0,0,0,0,0,1158,1060,0,0,0,0,0,0,1060,2218
1224,1,1178,0,0,0,0,0,0,1178,1139,0,0,0,0,0,0,1139,2317
1224,2,1191,0,0,0,0,0,0,1191,1065,0,0,0,0,0,0,1065,2256
1224,3,1250,0,0,0,0,0,0,1250,1158,0,0,0,0,0,0,1158,2408
1224,4,1267,0,0,0,0,0,0,1267,1197,0,0,0,0,0,0,1197,2464
1224,5,1339,0,0,0,0,0,0,1339,1284,0,0,0,0,0,0,1284,2623
1224,6,1400,0,0,0,0,0,0,1400,1396,0,0,0,0,0,0,1396,2796
1224,7,1441,0,0,0,0,0,0,1441,1423,0,0,0,0,0,0,1423,2864
1224,8,1565,0,0,0,0,0,0,1565,1392,0,0,0,0,0,0,1392,2957
1224,9,1546,0,0,0,0,0,0,1546,1486,0,0,0,0,0,0,1486,3032
1224,10,1624,0,0,0,0,0,0,1624,1485,0,0,0,0,0,0,1485,3109
1224,11,1707,0,0,0,0,0,0,1707,1568,0,0,0,0,0,0,1568,3275
1224,12,1707,0,0,0,0,0,0,1707,1631,0,0,0,0,0,0,1631,3338
1224,13,1771,0,0,0,0,0,0,1771,1651,0,0,0,0,0,0,1651,3422
1224,14,1796,0,0,0,0,0,0,1796,1702,0,0,0,0,0,0,1702,3498
1224,15,1826,0,0,0,0,0,0,1826,1719,0,0,0,0,0,0,1719,3545
1224,16,1818,0,0,0,0,0,0,1818,1718,0,0,0,0,0,0,1718,3536
1224,17,1839,0,0,0,0,0,0,1839,1717,0,0,0,0,0,0,1717,3556
1224,18,1835,1,0,0,0,0,0,1836,1624,1,0,0,0,0,0,1625,3461
1224,19,1855,1,0,0,0,0,0,1856,1709,11,0,0,0,0,0,1720,3576
1224,20,1868,2,0,0,0,0,0,1870,1630,13,0,0,0,0,0,1643,3513
1224,21,1816,3,0,0,0,0,0,1819,1694,30,0,0,0,0,0,1724,3543
1224,22,1860,13,1,0,0,0,0,1874,1643,44,2,0,0,0,0,1689,3563
1224,23,1885,17,1,0,1,0,0,1904,1661,68,2,0,0,0,0,1731,3635
1224,24,2039,35,1,0,0,0,0,2075,1638,108,0,0,0,0,0,1746,3821
1224,25,1901,61,5,0,1,0,0,1968,1551,159,2,0,0,0,0,1712,3680
1224,26,1928,71,4,0,1,0,0,2004,1536,234,8,1,0,0,0,1779,3783
1224,27,1914,75,4,0,2,0,0,1995,1454,280,6,1,3,0,0,1744,3739
1224,28,1869,146,2,0,1,0,0,2018,1422,333,7,1,0,0,0,1763,3781
1224,29,1800,185,5,0,5,0,0,1995,1333,453,12,2,3,0,0,1803,3798
1224,30,1801,252,9,0,2,0,0,2064,1352,522,7,0,0,0,0,1881,3945
1224,31,1735,351,9,0,5,0,0,2100,1237,615,17,2,2,1,0,1874,3974
1224,32,1633,407,5,1,0,0,0,2046,1225,660,32,2,2,0,0,1921,3967
1224,33,1580,500,19,3,5,1,0,2108,1107,710,39,5,4,1,0,1866,3974
1224,34,1438,575,31,3,2,1,0,2050,1057,844,43,4,1,0,0,1949,3999
1224,35,1377,631,26,1,4,0,0,2039,982,981,45,3,2,0,0,2013,4052
1224,36,1254,795,35,3,2,1,0,2090,799,999,65,9,4,1,0,1877,3967
1224,37,1236,804,39,3,5,0,0,2087,850,1040,56,13,5,0,0,1964,4051
1224,38,1196,896,42,2,5,2,0,2143,824,1127,94,20,4,1,0,2070,4213
1224,39,1135,900,35,2,2,0,0,2074,773,1274,105,13,5,0,0,2170,4244
1224,40,1072,1071,67,0,3,0,0,2213,804,1215,134,14,2,0,0,2169,4382
1224,41,1106,1073,80,2,4,1,0,2266,744,1322,158,12,4,0,0,2240,4506
1224,42,1028,1167,82,7,4,0,0,2288,719,1385,148,22,2,0,0,2276,4564
1224,43,1070,1206,107,4,3,0,0,2390,705,1349,193,31,2,0,0,2280,4670
1224,44,997,1259,107,12,0,0,0,2375,702,1473,160,32,1,1,0,2369,4744
1224,45,1077,1424,115,10,7,0,0,2633,717,1649,207,40,1,0,0,2614,5247
1224,46,1129,1508,159,12,2,0,1,2811,759,1774,244,39,6,0,0,2822,5633
1224,47,1207,1586,163,17,2,0,0,2975,760,1909,243,58,4,0,0,2974,5949
1224,48,1150,1688,185,11,3,0,0,3037,766,1943,324,52,0,4,0,3089,6126
1224,49,1164,1763,232,15,5,1,0,3180,722,1960,319,57,4,1,0,3063,6243
1224,50,1106,1792,224,11,4,0,0,3137,715,2014,306,89,3,0,0,3127,6264
1224,51,1110,1905,284,14,6,0,0,3319,722,2089,362,92,0,0,0,3265,6584
1224,52,1066,1933,294,22,5,0,0,3320,671,2276,387,88,2,0,0,3424,6744
1224,53,951,2109,277,35,5,0,0,3377,563,2253,361,123,1,1,0,3302,6679
1224,54,951,2135,329,27,9,0,0,3451,665,2352,459,163,2,0,0,3641,7092
1224,55,880,2174,325,39,5,0,0,3423,539,2313,413,153,4,0,0,3422,6845
1224,56,908,2278,340,42,3,0,0,3571,503,2411,453,174,3,1,0,3545,7116
1224,57,848,2329,341,39,8,0,0,3565,484,2407,450,176,0,0,0,3517,7082
1224,58,789,2379,372,49,6,0,0,3595,478,2416,455,207,1,0,0,3557,7152
1224,59,726,2440,389,39,5,0,0,3599,467,2543,466,231,0,0,0,3707,7306
1224,60,564,2398,362,60,4,0,0,3388,399,2349,395,242,0,0,0,3385,6773
1224,61,564,2201,332,57,3,0,0,3157,366,2278,379,298,2,0,0,3323,6480
1224,62,515,2262,332,72,7,0,0,3188,355,2135,409,363,0,0,0,3262,6450
1224,63,490,2162,303,62,6,0,0,3023,305,2079,322,371,1,0,0,3078,6101
1224,64,426,2132,277,80,3,0,0,2918,278,2024,355,346,3,0,0,3006,5924
1224,65,376,2092,293,109,1,0,0,2871,247,2084,321,406,0,0,0,3058,5929
1224,66,377,2164,264,107,2,0,0,2914,246,1950,278,382,1,0,0,2857,5771
1224,67,319,2110,236,93,0,0,0,2758,186,1982,286,472,2,0,0,2928,5686
1224,68,280,2015,227,105,5,0,0,2632,191,1845,254,475,1,0,0,2766,5398
1224,69,274,1985,211,120,1,0,0,2591,167,1858,246,525,2,0,0,2798,5389
1224,70,250,1903,197,127,4,0,0,2481,192,1682,196,589,1,0,0,2660,5141
1224,71,259,1869,161,157,1,0,0,2447,174,1618,187,597,0,0,0,2576,5023
1224,72,221,1875,150,165,1,0,0,2412,182,1680,159,615,0,0,0,2636,5048
1224,73,210,1867,146,187,2,0,0,2412,160,1727,193,726,1,0,0,2807,5219
1224,74,210,1883,134,164,3,0,0,2394,140,1569,166,788,1,0,0,2664,5058
1224,75,204,1870,125,206,1,0,0,2406,153,1591,174,925,0,0,0,2843,5249
1224,76,219,1773,115,266,1,0,0,2374,140,1579,157,982,0,0,0,2858,5232
1224,77,162,1764,112,269,0,0,1,2308,137,1471,137,1038,1,0,0,2784,5092
1224,78,118,1262,80,204,2,0,0,1666,112,1029,66,808,0,0,0,2015,3681
1224,79,131,1353,62,224,0,0,0,1770,117,950,103,1027,0,0,0,2197,3967
1224,80,118,1261,49,226,0,0,0,1654,124,909,76,1080,1,0,0,2190,3844
1224,81,111,1158,52,256,0,0,0,1577,121,848,95,1143,1,0,0,2208,3785
1224,82,131,1117,48,270,0,0,0,1566,108,782,68,1216,0,0,0,2174,3740
1224,83,102,1110,49,296,0,0,0,1557,117,711,79,1355,0,0,0,2262,3819
1224,84,111,1026,46,300,0,0,0,1483,104,674,49,1402,0,0,0,2229,3712
1224,85,93,923,42,302,0,0,0,1360,93,491,60,1400,0,0,0,2044,3404
1224,86,64,736,22,277,1,0,0,1100,79,377,38,1227,0,0,0,1721,2821
1224,87,63,602,19,246,0,0,0,930,79,304,32,1114,0,0,0,1529,2459
1224,88,71,464,23,246,1,0,0,805,106,224,32,1100,0,0,0,1462,2267
1224,89,31,367,14,225,0,0,0,637,90,169,17,1018,0,0,0,1294,1931
1224,90,36,306,8,170,0,0,0,520,89,111,15,943,0,0,0,1158,1678
1224,91,25,234,6,138,0,0,0,403,76,81,7,813,0,0,0,977,1380
1224,92,26,161,3,129,0,0,0,319,55,61,11,676,0,0,0,803,1122
1224,93,16,118,5,112,0,0,0,251,56,46,6,676,0,0,0,784,1035
1224,94,9,70,2,92,0,0,0,173,33,29,5,464,0,0,0,531,704
1224,95,9,43,1,59,0,0,0,112,34,19,6,338,0,0,0,397,509
1224,96,1,27,0,44,0,0,0,72,19,15,4,260,0,0,0,298,370
1224,97,3,21,1,27,0,0,0,52,18,5,1,187,0,0,0,211,263
1224,98,4,19,1,16,0,0,0,40,11,6,1,126,0,0,0,144,184
1224,99,4,5,0,15,0,0,0,24,10,3,1,84,0,0,0,98,122
1224,100,1,9,0,26,0,0,0,36,16,4,3,145,0,0,0,168,204
1224,999,91911,90657,9255,6731,181,7,2,198744,73782,90908,12173,30671,95,12,0,207641,406385
1411,0,367,0,0,0,0,0,0,367,357,0,0,0,0,0,0,357,724
1411,1,405,0,0,0,0,0,0,405,382,0,0,0,0,0,0,382,787
1411,2,402,0,0,0,0,0,0,402,358,0,0,0,0,0,0,358,760
1411,3,386,0,0,0,0,0,0,386,405,0,0,0,0,0,0,405,791
1411,4,403,0,0,0,0,0,0,403,409,0,0,0,0,0,0,409,812
1411,5,490,0,0,0,0,0,0,490,407,0,0,0,0,0,0,407,897
1411,6,482,0,0,0,0,0,0,482,412,0,0,0,0,0,0,412,894
1411,7,512,0,0,0,0,0,0,512,448,0,0,0,0,0,0,448,960
1411,8,503,0,0,0,0,0,0,503,482,0,0,0,0,0,0,482,985
1411,9,562,0,0,0,0,0,0,562,499,0,0,0,0,0,0,499,1061
1411,10,517,0,0,0,0,0,0,517,522,0,0,0,0,0,0,522,1039
1411,11,588,0,0,0,0,0,0,588,559,0,0,0,0,0,0,559,1147
1411,12,633,0,0,0,0,0,0,633,583,0,0,0,0,0,0,583,1216
1411,13,592,0,0,0,0,0,0,592,579,0,0,0,0,0,0,579,1171
1411,14,651,0,0,0,0,0,0,651,581,0,0,0,0,0,0,581,1232
1411,15,634,0,0,0,0,0,0,634,600,0,0,0,0,0,0,600,1234
1411,16,657,1,0,0,0,0,0,658,586,0,0,0,0,0,0,586,1244
1411,17,667,0,0,0,0,0,0,667,597,0,0,0,0,0,0,597,1264
1411,18,610,0,0,0,0,0,0,610,567,0,0,0,0,0,0,567,1177
1411,19,608,0,1,0,0,0,0,609,595,0,2,0,0,0,0,597,1206
1411,20,629,0,0,0,0,0,0,629,605,4,0,0,0,0,0,609,1238
1411,21,623,0,0,0,0,0,0,623,531,7,0,0,0,0,0,538,1161
1411,22,641,2,0,0,0,0,0,643,565,9,1,0,0,0,0,575,1218
1411,23,658,1,0,0,0,0,0,659,588,22,1,0,0,0,0,611,1270
1411,24,639,6,0,0,0,0,0,645,552,27,0,0,0,0,0,579,1224
1411,25,625,12,0,0,0,0,0,637,541,34,1,0,1,0,0,577,1214
1411,26,593,13,2,0,0,0,0,608,500,61,2,0,1,0,0,564,1172
1411,27,612,28,1,0,0,0,0,641,512,68,2,0,0,0,0,582,1223
1411,28,570,44,1,0,0,0,0,615,460,99,1,0,1,0,0,561,1176
1411,29,531,60,1,0,0,0,0,592,425,113,2,0,1,0,0,541,1133
1411,30,515,85,2,0,0,0,0,602,420,144,6,1,1,0,0,572,1174
1411,31,556,96,2,0,0,0,0,654,414,196,7,0,1,0,0,618,1272
1411,32,495,123,2,0,1,0,0,621,386,169,10,0,3,0,0,568,1189
1411,33,469,135,6,0,0,0,0,610,395,248,12,1,1,0,0,657,1267
1411,34,479,172,5,1,1,0,0,658,346,220,21,1,3,0,0,591,1249
1411,35,464,197,5,0,0,0,0,666,331,278,21,1,1,0,0,632,1298
1411,36,414,196,7,0,1,0,0,618,329,296,14,3,1,0,0,643,1261
1411,37,375,227,11,1,0,0,0,614,293,337,23,5,2,0,0,660,1274
1411,38,385,232,18,1,0,0,0,636,309,310,19,3,1,0,0,642,1278
1411,39,382,278,13,2,0,0,0,675,296,323,23,1,0,0,0,643,1318
1411,40,378,329,21,1,2,0,0,731,288,356,41,4,0,0,0,689,1420
1411,41,341,332,22,0,0,0,0,695,278,389,43,5,1,1,0,717,1412
1411,42,328,309,24,1,3,0,0,665,234,383,49,7,3,0,0,676,1341
1411,43,351,379,30,2,0,0,0,762,231,411,49,8,1,0,0,700,1462
1411,44,319,365,43,0,0,0,0,727,241,420,43,18,1,0,0,723,1450
1411,45,418,420,39,3,1,0,0,881,303,469,63,5,0,0,0,840,1721
1411,46,340,453,50,2,2,0,0,847,282,466,67,10,1,1,0,827,1674
1411,47,369,437,53,1,1,0,0,861,284,549,76,15,0,0,0,924,1785
1411,48,394,445,57,1,1,0,0,898,295,571,76,19,1,0,0,962,1860
1411,49,401,505,63,2,0,0,0,971,291,567,111,11,1,0,0,981,1952
1411,50,344,572,77,4,4,0,0,1001,257,595,130,21,2,0,0,1005,2006
1411,51,359,566,66,6,3,0,0,1000,267,624,114,28,0,0,0,1033,2033
1411,52,313,587,87,6,0,0,0,993,242,660,140,32,0,0,0,1074,2067
1411,53,338,575,88,4,1,0,0,1006,235,629,156,38,0,0,0,1058,2064
1411,54,319,622,122,7,2,0,0,1072,247,698,135,28,0,0,0,1108,2180
1411,55,320,599,106,11,2,1,0,1039,210,657,164,37,2,0,0,1070,2109
1411,56,297,600,134,10,2,0,0,1043,217,662,152,60,0,0,0,1091,2134
1411,57,306,637,137,16,2,0,0,1098,191,698,150,49,1,0,0,1089,2187
1411,58,235,662,115,10,0,0,0,1022,180,671,144,57,1,0,0,1053,2075
1411,59,262,727,139,16,2,0,0,1146,202,702,162,48,1,0,0,1115,2261
1411,60,226,665,127,24,1,0,0,1043,142,663,136,61,2,0,0,1004,2047
1411,61,169,609,99,22,0,0,0,899,126,635,136,68,0,0,0,965,1864
1411,62,186,640,122,20,3,0,0,971,126,596,126,77,0,0,0,925,1896
1411,63,135,575,103,15,1,0,0,829,107,565,136,87,0,0,0,895,1724
1411,64,132,632,92,15,0,0,0,871,107,603,117,104,0,0,0,931,1802
1411,65,149,539,79,28,0,0,0,795,71,572,99,91,0,0,0,833,1628
1411,66,122,560,82,19,1,0,0,784,94,504,114,103,0,0,0,815,1599
1411,67,106,581,78,16,0,0,0,781,61,529,85,111,0,0,0,786,1567
1411,68,95,502,70,33,1,0,0,701,66,542,89,155,1,0,0,853,1554
1411,69,106,524,54,27,0,0,0,711,62,499,86,150,0,0,0,797,1508
1411,70,99,564,54,35,0,0,0,752,54,471,63,168,0,0,0,756,1508
1411,71,98,508,60,36,0,0,0,702,48,452,62,162,0,0,0,724,1426
1411,72,74,499,60,47,0,0,0,680,46,465,53,172,0,0,0,736,1416
1411,73,79,508,44,51,0,0,0,682,49,441,55,193,0,0,0,738,1420
1411,74,64,507,51,39,0,0,0,661,50,459,55,214,0,0,0,778,1439
1411,75,74,510,35,60,2,0,1,682,41,443,65,243,0,0,0,792,1474
1411,76,55,523,39,58,0,0,1,676,27,371,51,259,0,0,0,708,1384
1411,77,67,441,35,52,0,0,0,595,26,347,39,263,0,0,0,675,1270
1411,78,49,299,21,46,0,0,0,415,25,276,29,210,0,0,0,540,955
1411,79,45,356,25,65,0,0,0,491,20,226,33,248,0,0,0,527,1018
1411,80,40,363,24,63,0,0,0,490,28,249,29,258,0,0,0,564,1054
1411,81,45,332,17,68,0,0,0,462,23,205,20,314,0,0,0,562,1024
1411,82,42,300,17,73,0,0,0,432,35,204,20,318,0,0,0,577,1009
1411,83,43,281,15,75,0,0,0,414,33,179,23,347,0,0,0,582,996
1411,84,32,269,7,69,0,0,0,377,32,165,17,332,0,0,0,546,923
1411,85,13,240,4,81,0,0,0,338,33,134,13,341,0,0,0,521,859
1411,86,17,170,8,74,0,0,0,269,26,104,9,312,0,0,0,451,720
1411,87,17,142,3,55,1,0,0,218,14,62,13,290,0,0,0,379,597
1411,88,9,124,6,50,0,0,0,189,20,52,11,250,0,0,0,333,522
1411,89,14,87,6,44,0,0,0,151,21,35,6,243,0,0,0,305,456
1411,90,9,76,1,40,0,0,0,126,18,33,3,216,0,0,0,270,396
1411,91,7,48,5,41,0,0,0,101,21,19,3,179,0,0,0,222,323
1411,92,6,28,0,33,0,0,0,67,13,13,4,182,0,0,0,212,279
1411,93,5,28,1,29,0,0,0,63,12,12,3,150,0,0,0,177,240
1411,94,1,21,0,26,0,0,0,48,10,7,1,116,0,0,0,134,182
1411,95,4,16,1,8,0,0,0,29,7,6,1,95,0,0,0,109,138
1411,96,1,8,0,9,0,0,0,18,7,0,0,57,0,0,0,64,82
1411,97,0,4,0,7,0,0,0,11,8,1,1,51,0,0,0,61,72
1411,98,1,3,1,6,0,0,0,11,0,0,0,30,0,0,0,30,41
1411,99,0,1,0,4,0,0,0,5,2,0,0,16,0,0,0,18,23
1411,100,0,0,0,2,0,0,0,2,2,0,1,34,0,0,0,37,39
1411,999,30492,25112,2996,1673,41,1,2,60317,25414,25281,4040,7786,37,2,0,62560,122877
1512,0,603,0,0,0,0,0,0,603,552,0,0,0,0,0,0,552,1155
1512,1,617,0,0,0,0,0,0,617,624,0,0,0,0,0,0,624,1241
1512,2,662,0,0,0,0,0,0,662,623,0,0,0,0,0,0,623,1285
1512,3,681,0,0,0,0,0,0,681,680,0,0,0,0,0,0,680,1361
1512,4,655,0,0,0,0,0,0,655,653,0,0,0,0,0,0,653,1308
1512,5,717,0,0,0,0,0,0,717,654,0,0,0,0,0,0,654,1371
1512,6,754,0,0,0,0,0,0,754,732,0,0,0,0,0,0,732,1486
1512,7,789,0,0,0,0,0,0,789,739,0,0,0,0,0,0,739,1528
1512,8,793,0,0,0,0,0,0,793,754,0,0,0,0,0,0,754,1547
1512,9,832,0,0,0,0,0,0,832,764,0,0,0,0,0,0,764,1596
1512,10,820,0,0,0,0,0,0,820,785,0,0,0,0,0,0,785,1605
1512,11,859,0,0,0,0,0,0,859,812,0,0,0,0,0,0,812,1671
1512,12,896,0,0,0,0,0,0,896,787,0,0,0,0,0,0,787,1683
1512,13,899,0,0,0,0,0,0,899,821,0,0,0,0,0,0,821,1720
1512,14,891,0,0,0,0,0,0,891,890,0,0,0,0,0,0,890,1781
1512,15,935,0,0,0,0,0,0,935,908,0,0,0,0,0,0,908,1843
1512,16,986,0,0,0,0,0,0,986,837,0,0,0,0,0,0,837,1823
1512,17,873,0,0,0,0,0,0,873,874,0,0,0,0,0,0,874,1747
1512,18,972,0,0,0,0,0,0,972,921,0,0,0,0,0,0,921,1893
1512,19,979,0,0,0,0,0,0,979,901,4,0,0,0,0,0,905,1884
1512,20,925,3,0,0,0,0,0,928,812,10,0,0,0,0,0,822,1750
1512,21,976,2,0,0,0,0,0,978,773,23,0,0,0,0,0,796,1774
1512,22,999,7,0,0,0,0,0,1006,924,25,3,0,0,0,0,952,1958
1512,23,1027,7,1,0,0,0,0,1035,837,60,0,0,2,0,0,899,1934
1512,24,1016,10,0,0,0,0,0,1026,899,65,3,1,1,0,0,969,1995
1512,25,1119,17,3,0,0,0,0,1139,826,62,0,0,2,0,0,890,2029
1512,26,1050,41,0,0,0,0,0,1091,791,116,4,0,1,0,0,912,2003
1512,27,1079,44,1,2,2,0,0,1128,769,149,4,0,3,0,0,925,2053
1512,28,980,84,5,0,0,0,0,1069,770,175,2,1,1,0,0,949,2018
1512,29,922,99,4,0,3,0,0,1028,727,214,9,0,0,0,0,950,1978
1512,30,969,114,8,0,1,0,0,1092,656,312,6,1,2,1,0,978,2070
1512,31,956,169,6,0,0,0,0,1131,719,294,18,0,2,0,0,1033,2164
1512,32,850,217,11,1,0,0,0,1079,627,354,19,1,2,0,0,1003,2082
1512,33,824,273,8,0,1,0,0,1106,589,416,22,2,2,0,0,1031,2137
1512,34,750,320,15,3,3,0,0,1091,578,421,25,1,4,0,0,1029,2120
1512,35,739,305,14,0,3,0,0,1061,585,463,31,4,3,0,0,1086,2147
1512,36,739,378,20,1,1,1,0,1140,530,461,28,2,2,0,0,1023,2163
1512,37,695,420,27,2,3,0,0,1147,475,489,45,2,0,0,0,1011,2158
1512,38,661,413,29,2,3,0,0,1108,468,575,56,11,3,0,0,1113,2221
1512,39,582,506,32,4,0,0,0,1124,428,519,63,10,3,0,0,1023,2147
1512,40,576,530,38,2,0,0,0,1146,421,576,66,8,4,0,0,1075,2221
1512,41,566,508,38,4,2,0,0,1118,389,589,66,6,3,0,0,1053,2171
1512,42,579,552,48,5,3,0,0,1187,389,642,90,11,0,0,1,1133,2320
1512,43,561,547,55,5,2,0,0,1170,393,627,99,20,4,0,0,1143,2313
1512,44,500,592,62,8,3,0,0,1165,361,694,83,10,1,0,0,1149,2314
1512,45,552,623,69,9,0,0,0,1253,436,739,123,20,2,0,0,1320,2573
1512,46,546,649,83,6,3,0,0,1287,425,754,136,28,2,0,0,1345,2632
1512,47,542,739,89,2,2,0,0,1374,401,852,160,26,1,0,0,1440,2814
1512,48,579,771,98,5,2,0,0,1455,415,893,152,23,2,0,0,1485,2940
1512,49,547,847,127,4,2,0,0,1527,448,916,196,44,1,0,0,1605,3132
1512,50,587,844,119,9,1,0,0,1560,396,958,178,35,3,0,0,1570,3130
1512,51,609,939,155,13,1,0,1,1718,400,992,240,34,3,0,0,1669,3387
1512,52,551,942,139,11,3,0,0,1646,346,1014,228,47,2,0,0,1637,3283
1512,53,559,953,155,14,3,0,0,1684,373,1041,254,72,1,0,0,1741,3425
1512,54,505,1044,174,13,4,0,0,1740,327,1064,237,71,3,0,0,1702,3442
1512,55,491,1113,170,19,2,0,0,1795,343,1078,274,75,1,0,0,1771,3566
1512,56,444,1027,199,7,4,0,0,1681,321,1161,257,83,2,0,0,1824,3505
1512,57,490,1070,199,21,0,0,0,1780,304,1161,275,99,2,0,0,1841,3621
1512,58,405,1154,229,31,6,0,0,1825,319,1253,273,100,0,0,0,1945,3770
1512,59,402,1133,219,25,3,0,0,1782,273,1270,285,121,1,0,0,1950,3732
1512,60,347,1084,215,25,2,0,0,1673,252,1159,246,130,1,0,0,1788,3461
1512,61,332,1127,196,25,3,0,0,1683,232,1139,254,127,1,0,0,1753,3436
1512,62,304,1079,199,39,2,0,0,1623,182,1122,232,156,0,0,0,1692,3315
1512,63,223,1136,204,47,1,0,0,1611,203,1037,231,158,1,0,0,1630,3241
1512,64,250,1064,204,38,2,0,0,1558,175,1053,238,193,0,0,0,1659,3217
1512,65,204,998,165,50,3,0,0,1420,158,1016,225,193,0,0,0,1592,3012
1512,66,235,1038,182,48,2,0,1,1506,162,980,175,207,0,0,0,1524,3030
1512,67,191,964,173,57,1,0,0,1386,136,942,177,198,0,0,1,1454,2840
1512,68,165,951,144,47,2,0,0,1309,145,870,168,252,0,0,0,1435,2744
1512,69,150,940,136,61,0,0,0,1287,119,863,149,262,0,0,0,1393,2680
1512,70,145,952,118,63,3,0,0,1281,106,858,164,289,0,0,0,1417,2698
1512,71,136,869,116,65,4,0,0,1190,100,787,142,257,0,0,0,1286,2476
1512,72,105,846,97,69,1,0,0,1118,89,793,134,311,0,0,0,1327,2445
1512,73,106,866,93,89,1,0,0,1155,100,800,120,361,0,0,0,1381,2536
1512,74,92,905,85,79,0,0,0,1161,92,770,128,436,1,0,0,1427,2588
1512,75,118,875,111,112,1,0,0,1217,93,816,116,452,1,0,0,1478,2695
1512,76,95,917,85,102,0,0,0,1199,97,755,117,484,0,0,0,1453,2652
1512,77,89,867,72,107,1,0,0,1136,82,751,110,515,1,0,0,1459,2595
1512,78,72,616,57,95,1,0,0,841,58,523,73,452,0,0,0,1106,1947
1512,79,82,662,58,126,0,0,0,928,74,516,68,497,0,0,0,1155,2083
1512,80,66,590,50,119,1,0,0,826,72,462,61,484,0,0,0,1079,1905
1512,81,68,603,53,120,0,0,0,844,55,423,68,550,0,0,0,1096,1940
1512,82,52,591,32,155,0,0,0,830,60,432,62,596,0,0,0,1150,1980
1512,83,52,583,34,145,0,0,0,814,71,438,62,675,0,0,0,1246,2060
1512,84,53,496,40,127,0,0,0,716,57,325,57,681,0,0,0,1120,1836
1512,85,38,486,27,137,0,0,0,688,57,272,49,627,0,0,0,1005,1693
1512,86,45,403,21,119,0,0,0,588,45,214,50,615,0,0,0,924,1512
1512,87,31,339,15,127,0,0,0,512,50,186,32,572,0,0,0,840,1352
1512,88,30,271,22,133,0,0,0,456,50,143,27,556,0,0,0,776,1232
1512,89,19,204,10,110,0,0,0,343,35,103,32,458,0,0,0,628,971
1512,90,8,184,9,97,0,0,0,298,28,74,19,431,0,0,0,552,850
1512,91,19,114,4,85,0,0,0,222,27,57,18,416,0,0,0,518,740
1512,92,5,79,3,59,0,0,0,146,30,39,12,312,0,0,0,393,539
1512,93,11,66,3,63,0,0,0,143,29,22,6,323,0,0,0,380,523
1512,94,8,44,2,38,0,0,0,92,22,16,7,224,0,0,0,269,361
1512,95,6,34,1,39,0,0,0,80,18,13,7,182,0,0,0,220,300
1512,96,3,21,0,23,0,0,0,47,9,6,5,107,0,0,0,127,174
1512,97,2,6,1,8,0,0,0,17,9,5,1,98,0,0,0,113,130
1512,98,2,6,0,8,0,0,0,16,4,6,2,65,0,0,0,77,93
1512,99,1,3,3,10,0,0,0,17,7,4,2,42,0,0,0,55,72
1512,100,3,2,0,14,0,0,0,19,8,3,2,94,0,0,0,107,126
1512,999,48625,43887,5689,3308,97,1,2,101609,39972,44274,7858,15007,77,1,2,107191,208800
1569,0,703,0,0,0,0,0,0,703,658,0,0,0,0,0,0,658,1361
1569,1,743,0,0,0,0,0,0,743,685,0,0,0,0,0,0,685,1428
1569,2,726,0,0,0,0,0,0,726,694,0,0,0,0,0,0,694,1420
1569,3,734,0,0,0,0,0,0,734,770,0,0,0,0,0,0,770,1504
1569,4,750,0,0,0,0,0,0,750,740,0,0,0,0,0,0,740,1490
1569,5,810,0,0,0,0,0,0,810,828,0,0,0,0,0,0,828,1638
1569,6,896,0,0,0,0,0,0,896,775,0,0,0,0,0,0,775,1671
1569,7,905,0,0,0,0,0,0,905,870,0,0,0,0,0,0,870,1775
1569,8,949,0,0,0,0,0,0,949,965,0,0,0,0,0,0,965,1914
1569,9,1072,0,0,0,0,0,0,1072,921,0,0,0,0,0,0,921,1993
1569,10,1027,0,0,0,0,0,0,1027,935,0,0,0,0,0,0,935,1962
1569,11,1107,0,0,0,0,0,0,1107,1057,0,0,0,0,0,0,1057,2164
1569,12,1064,0,0,0,0,0,0,1064,1056,0,0,0,0,0,0,1056,2120
1569,13,1116,0,0,0,0,0,0,1116,1032,0,0,0,0,0,0,1032,2148
1569,14,1156,0,0,0,0,0,0,1156,1109,0,0,0,0,0,0,1109,2265
1569,15,1220,0,0,0,0,0,0,1220,1132,0,0,0,0,0,0,1132,2352
1569,16,1218,0,0,0,0,0,0,1218,1119,0,0,0,0,0,0,1119,2337
1569,17,1231,0,0,0,0,0,0,1231,1128,0,0,0,0,0,0,1128,2359
1569,18,1297,0,0,0,0,0,0,1297,1124,2,0,0,0,0,0,1126,2423
1569,19,1239,0,0,0,0,0,0,1239,1139,3,0,0,0,0,0,1142,2381
1569,20,1282,0,0,0,0,0,0,1282,1130,9,0,0,0,0,0,1139,2421
1569,21,1268,0,0,0,0,0,0,1268,1133,20,0,0,0,0,0,1153,2421
1569,22,1221,5,0,0,0,0,0,1226,1087,32,2,0,0,0,0,1121,2347
1569,23,1302,6,0,0,0,0,0,1308,1150,56,1,1,1,0,0,1209,2517
1569,24,1249,15,1,0,2,0,0,1267,1059,63,2,0,2,0,0,1126,2393
1569,25,1288,20,0,0,1,0,0,1309,1087,90,0,0,2,0,0,1179,2488
1569,26,1242,30,1,0,2,0,0,1275,1015,121,3,0,1,0,0,1140,2415
1569,27,1231,41,1,0,0,0,0,1273,955,140,5,0,0,0,0,1100,2373
1569,28,1151,81,0,0,0,0,0,1232,875,187,4,0,0,0,0,1066,2298
1569,29,1080,99,1,0,2,0,0,1182,866,246,12,0,0,0,0,1124,2306
1569,30,1044,158,5,0,2,0,0,1209,830,306,11,0,0,0,0,1147,2356
1569,31,1130,199,3,0,1,0,0,1333,812,342,9,0,0,0,0,1163,2496
1569,32,998,204,8,2,1,0,0,1213,731,425,14,1,2,0,0,1173,2386
1569,33,1020,278,13,1,2,0,0,1314,679,475,19,3,3,0,0,1179,2493
1569,34,959,312,10,1,3,0,0,1285,702,522,23,2,2,0,0,1251,2536
1569,35,860,427,23,1,1,0,0,1312,644,576,36,6,4,0,0,1266,2578
1569,36,804,436,24,2,1,0,0,1267,552,561,34,2,3,0,0,1152,2419
1569,37,760,475,16,1,1,0,0,1253,524,599,48,5,5,0,0,1181,2434
1569,38,719,495,35,2,2,0,0,1253,510,660,68,11,2,0,0,1251,2504
1569,39,705,596,44,1,0,0,0,1346,507,669,85,7,2,0,0,1270,2616
1569,40,712,609,36,2,3,0,0,1362,502,702,73,4,1,0,0,1282,2644
1569,41,675,672,56,1,2,0,0,1406,477,740,82,18,2,0,0,1319,2725
1569,42,670,622,48,8,1,0,0,1349,512,762,82,16,3,0,0,1375,2724
1569,43,608,680,43,7,2,0,0,1340,483,769,99,10,1,0,0,1362,2702
1569,44,633,744,67,17,0,0,0,1461,514,864,101,11,6,0,0,1496,2957
1569,45,657,776,72,12,1,0,0,1518,520,947,139,23,2,0,0,1631,3149
1569,46,692,871,106,7,2,0,0,1678,510,1021,151,26,4,0,0,1712,3390
1569,47,767,917,105,7,2,0,0,1798,542,1105,154,28,1,0,0,1830,3628
1569,48,745,1046,106,9,3,0,0,1909,591,1179,194,34,1,0,0,1999,3908
1569,49,772,1105,147,11,2,0,0,2037,541,1289,205,38,2,0,0,2075,4112
1569,50,793,1121,142,3,6,0,0,2065,518,1305,219,44,2,0,0,2088,4153
1569,51,784,1228,157,14,5,0,0,2188,505,1403,266,55,0,0,0,2229,4417
1569,52,740,1285,181,20,4,0,0,2230,502,1416,277,76,1,0,0,2272,4502
1569,53,670,1379,208,18,7,0,0,2282,508,1446,284,62,1,0,1,2302,4584
1569,54,678,1418,211,20,4,0,0,2331,456,1587,332,62,1,0,0,2438,4769
1569,55,633,1468,258,25,3,0,0,2387,485,1544,307,81,1,0,0,2418,4805
1569,56,631,1391,266,21,3,0,0,2312,459,1557,347,91,0,0,0,2454,4766
1569,57,542,1494,258,21,3,0,0,2318,433,1645,331,101,0,0,0,2510,4828
1569,58,564,1571,265,33,3,0,0,2436,398,1636,341,130,0,0,0,2505,4941
1569,59,523,1614,296,30,3,0,0,2466,367,1605,318,136,5,0,0,2431,4897
1569,60,428,1616,265,25,1,0,1,2336,290,1539,338,139,1,0,0,2307,4643
1569,61,399,1497,227,39,4,0,0,2166,272,1524,284,174,1,0,0,2255,4421
1569,62,368,1432,218,38,4,0,0,2060,241,1522,283,172,0,0,1,2219,4279
1569,63,307,1347,202,39,2,0,0,1897,237,1363,256,197,1,0,0,2054,3951
1569,64,276,1397,198,43,1,0,0,1915,221,1407,250,243,3,0,0,2124,4039
1569,65,264,1340,213,52,1,0,0,1870,196,1337,227,221,2,0,0,1983,3853
1569,66,240,1361,171,58,0,0,0,1830,163,1297,206,253,0,0,1,1920,3750
1569,67,221,1291,168,71,3,0,0,1754,170,1246,199,284,1,0,0,1900,3654
1569,68,188,1310,172,83,3,0,0,1756,163,1209,192,293,0,0,0,1857,3613
1569,69,207,1265,147,64,3,0,0,1686,137,1152,171,332,0,0,0,1792,3478
1569,70,164,1179,149,77,1,0,0,1570,137,1108,152,331,0,0,0,1728,3298
1569,71,156,1171,127,76,1,0,0,1531,127,1070,154,350,0,0,0,1701,3232
1569,72,117,1165,121,81,1,0,0,1485,87,1111,136,409,1,0,0,1744,3229
1569,73,116,1201,120,106,1,0,0,1544,109,1118,156,477,0,0,0,1860,3404
1569,74,143,1173,106,111,1,0,0,1534,115,1112,145,503,0,0,0,1875,3409
1569,75,134,1232,93,150,4,0,0,1613,91,1091,122,538,0,0,0,1842,3455
1569,76,123,1242,83,135,1,0,0,1584,106,1132,128,639,0,0,0,2005,3589
1569,77,105,1256,84,136,1,0,1,1583,107,1008,125,719,0,0,0,1959,3542
1569,78,94,886,68,140,0,0,1,1189,76,730,76,639,0,0,0,1521,2710
1569,79,99,938,63,168,0,0,0,1268,92,788,90,698,0,0,0,1668,2936
1569,80,86,860,50,174,0,0,1,1171,88,658,86,735,0,0,0,1567,2738
1569,81,77,826,37,159,0,0,0,1099,87,699,60,841,0,0,0,1687,2786
1569,82,65,861,41,188,1,0,0,1156,103,590,62,818,0,0,0,1573,2729
1569,83,68,857,47,202,0,0,0,1174,68,585,60,929,0,0,0,1642,2816
1569,84,71,796,35,203,0,0,0,1105,84,481,48,918,0,0,0,1531,2636
1569,85,72,654,32,222,0,0,0,980,91,411,53,972,0,0,0,1527,2507
1569,86,43,534,22,208,0,0,0,807,91,334,35,919,0,0,0,1379,2186
1569,87,34,435,23,188,0,0,0,680,54,260,29,822,0,0,0,1165,1845
1569,88,38,387,23,165,0,0,0,613,58,193,29,784,0,0,0,1064,1677
1569,89,33,328,11,136,1,0,0,509,64,128,25,726,0,0,0,943,1452
1569,90,23,239,10,151,0,0,0,423,59,93,27,638,0,0,0,817,1240
1569,91,18,191,3,131,0,0,0,343,48,75,10,583,0,0,0,716,1059
1569,92,14,130,7,115,0,0,0,266,36,54,12,516,0,0,0,618,884
1569,93,8,97,3,90,0,0,0,198,44,30,9,449,0,0,0,532,730
1569,94,8,64,2,59,0,0,0,133,22,27,2,344,0,0,0,395,528
1569,95,2,48,0,48,0,0,0,98,23,12,6,245,0,0,0,286,384
1569,96,1,29,0,39,0,0,0,69,13,6,4,189,0,0,0,212,281
1569,97,6,13,0,27,0,0,0,46,10,3,3,137,0,0,0,153,199
1569,98,1,10,0,20,0,0,0,31,7,4,0,99,0,0,0,110,141
1569,99,1,3,1,4,0,0,0,9,13,1,2,62,0,0,0,78,87
1569,100,1,2,0,8,0,0,0,11,11,2,2,102,0,0,0,117,128
1569,999,59584,58551,6555,4526,115,0,4,129335,49619,59136,8932,20523,73,0,3,138286,267621
1607,0,2368,0,0,0,0,0,0,2368,2258,0,0,0,0,0,0,2258,4626
1607,1,2490,0,0,0,0,0,0,2490,2239,0,0,0,0,0,0,2239,4729
1607,2,2527,0,0,0,0,0,0,2527,2280,0,0,0,0,0,0,2280,4807
1607,3,2565,0,0,0,0,0,0,2565,2435,0,0,0,0,0,0,2435,5000
1607,4,2637,0,0,0,0,0,0,2637,2420,0,0,0,0,0,0,2420,5057
1607,5,2643,0,0,0,0,0,0,2643,2523,0,0,0,0,0,0,2523,5166
1607,6,2882,0,0,0,0,0,0,2882,2701,0,0,0,0,0,0,2701,5583
1607,7,2892,0,0,0,0,0,0,2892,2728,0,0,0,0,0,0,2728,5620
1607,8,3018,0,0,0,0,0,0,3018,2793,0,0,0,0,0,0,2793,5811
1607,9,3208,0,0,0,0,0,0,3208,3005,0,0,0,0,0,0,3005,6213
1607,10,3237,0,0,0,0,0,0,3237,3005,0,0,0,0,0,0,3005,6242
1607,11,3385,0,0,0,0,0,0,3385,3156,0,0,0,0,0,0,3156,6541
1607,12,3292,0,0,0,0,0,0,3292,3172,0,0,0,0,0,0,3172,6464
1607,13,3478,0,0,0,0,0,0,3478,3377,0,0,0,0,0,0,3377,6855
1607,14,3614,0,0,0,0,0,0,3614,3547,0,0,0,0,0,0,3547,7161
1607,15,3703,0,0,0,0,0,0,3703,3530,0,0,0,0,0,0,3530,7233
1607,16,3689,0,0,0,0,0,0,3689,3357,0,0,0,0,0,0,3357,7046
1607,17,3734,0,0,0,0,0,0,3734,3489,0,0,0,0,0,0,3489,7223
1607,18,3799,0,0,0,0,0,0,3799,3415,3,0,0,0,0,0,3418,7217
1607,19,3802,2,1,0,0,0,0,3805,3475,10,0,0,0,0,0,3485,7290
1607,20,3820,1,0,0,0,0,0,3821,3388,21,0,0,0,0,0,3409,7230
1607,21,3873,7,0,0,0,0,0,3880,3514,28,0,0,0,0,0,3542,7422
1607,22,3939,11,4,0,0,0,0,3954,3465,54,2,0,2,0,0,3523,7477
1607,23,3972,26,3,0,0,0,0,4001,3476,135,3,0,0,0,0,3614,7615
1607,24,4085,47,4,1,2,0,0,4139,3337,145,3,0,0,0,0,3485,7624
1607,25,4062,63,2,0,1,0,0,4128,3375,211,6,0,2,0,0,3594,7722
1607,26,3953,106,1,0,1,0,0,4061,3329,272,7,0,4,0,0,3612,7673
1607,27,4136,177,12,0,1,0,0,4326,3243,432,15,1,2,0,0,3693,8019
1607,28,3845,234,5,0,4,0,0,4088,3111,519,15,0,6,0,0,3651,7739
1607,29,3781,304,6,0,2,1,0,4094,3020,744,27,3,6,0,0,3800,7894
1607,30,3638,510,7,0,4,0,0,4159,2976,903,30,3,6,0,0,3918,8077
1607,31,3584,605,20,1,6,0,0,4216,2749,1124,33,2,8,1,0,3917,8133
1607,32,3434,798,27,1,6,0,0,4266,2637,1357,49,3,10,0,0,4056,8322
1607,33,3131,1000,31,5,6,0,0,4173,2428,1447,71,3,8,1,0,3958,8131
1607,34,3002,1089,27,7,6,0,0,4131,2297,1664,91,9,10,0,0,4071,8202
1607,35,2835,1350,50,6,8,2,0,4251,2134,1820,99,11,12,0,0,4076,8327
1607,36,2731,1429,76,5,7,0,0,4248,1937,1880,112,13,10,1,0,3953,8201
1607,37,2407,1547,90,2,9,0,0,4055,1790,1887,163,19,10,0,0,3869,7924
1607,38,2384,1738,95,6,7,0,0,4230,1773,2066,167,26,10,1,0,4043,8273
1607,39,2316,1774,99,7,4,0,0,4200,1738,2153,166,22,12,0,0,4091,8291
1607,40,2157,2020,130,5,7,0,0,4319,1629,2311,231,25,8,0,0,4204,8523
1607,41,2002,2083,151,7,5,0,0,4248,1512,2328,250,30,10,0,0,4130,8378
1607,42,1984,2224,188,12,8,1,0,4417,1521,2484,296,35,9,0,0,4345,8762
1607,43,1986,2140,182,16,10,0,0,4334,1437,2577,306,55,6,0,0,4381,8715
1607,44,1903,2288,177,18,12,0,0,4398,1497,2759,355,53,11,1,0,4676,9074
1607,45,2026,2376,228,31,11,0,0,4672,1496,3036,410,66,9,0,0,5017,9689
1607,46,2052,2687,271,24,13,0,0,5047,1522,3147,483,70,5,0,0,5227,10274
1607,47,2132,2996,293,25,12,0,0,5458,1533,3328,497,100,6,0,0,5464,10922
1607,48,2218,3199,370,26,13,0,0,5826,1645,3636,590,92,4,0,0,5967,11793
1607,49,2228,3376,431,32,15,0,0,6082,1642,4020,655,109,6,0,0,6432,12514
1607,50,2156,3641,448,36,6,0,0,6287,1519,4063,697,115,7,0,0,6401,12688
1607,51,2239,3744,577,26,16,0,0,6602,1542,4263,822,138,12,0,0,6777,13379
1607,52,2147,3929,577,37,17,1,0,6708,1536,4272,823,161,7,0,0,6799,13507
1607,53,1902,4026,586,44,12,0,0,6570,1391,4381,902,208,7,1,0,6890,13460
1607,54,1878,4099,659,32,16,0,0,6684,1376,4476,905,213,7,0,0,6977,13661
1607,55,1796,4183,651,49,14,1,0,6694,1276,4546,894,269,6,1,0,6992,13686
1607,56,1680,4096,677,60,13,0,0,6526,1186,4569,925,266,9,0,0,6955,13481
1607,57,1624,4458,793,74,17,0,0,6966,1155,4724,1012,323,9,0,0,7223,14189
1607,58,1580,4558,819,89,12,1,0,7059,1070,4829,1032,371,6,0,0,7308,14367
1607,59,1474,4719,815,84,9,0,0,7101,1052,4913,1061,401,4,0,0,7431,14532
1607,60,1222,4357,781,110,17,1,0,6488,927,4818,984,457,8,0,0,7194,13682
1607,61,1146,4290,688,116,6,0,0,6246,863,4572,904,469,4,0,0,6812,13058
1607,62,1055,4132,649,113,5,0,0,5954,744,4393,863,549,5,0,0,6554,12508
1607,63,912,4212,638,122,13,0,0,5897,727,4298,801,552,3,0,0,6381,12278
1607,64,891,4142,625,125,10,0,0,5793,644,4232,778,634,4,0,0,6292,12085
1607,65,794,3962,541,142,7,0,0,5446,589,4053,726,709,1,0,0,6078,11524
1607,66,736,3989,535,165,5,0,0,5430,559,3916,715,721,4,0,0,5915,11345
1607,67,659,3897,476,169,3,0,0,5204,504,3763,681,801,2,0,0,5751,10955
1607,68,600,3645,470,200,8,0,0,4923,445,3683,589,909,0,0,0,5626,10549
1607,69,586,3809,426,202,5,0,0,5028,461,3620,552,983,1,0,0,5617,10645
1607,70,501,3594,334,254,5,0,0,4688,424,3465,486,1051,2,0,0,5428,10116
1607,71,498,3458,351,225,4,0,0,4536,382,3292,480,1068,3,0,1,5226,9762
1607,72,451,3397,329,270,2,0,0,4449,391,3220,399,1187,2,0,0,5199,9648
1607,73,469,3739,304,321,5,0,0,4838,405,3301,431,1339,2,0,0,5478,10316
1607,74,398,3580,276,316,6,0,1,4577,359,3298,411,1434,1,0,0,5503,10080
1607,75,394,3741,286,365,1,0,0,4787,407,3402,409,1698,0,0,0,5916,10703
1607,76,369,3838,264,411,3,0,0,4885,409,3286,422,1856,0,0,0,5973,10858
1607,77,342,3677,236,471,2,0,0,4728,349,3351,360,2065,1,0,0,6126,10854
1607,78,262,2492,133,395,3,0,0,3285,246,2032,245,1622,3,0,0,4148,7433
1607,79,225,2778,158,436,4,0,0,3601,258,2198,246,2015,2,0,0,4719,8320
1607,80,223,2608,129,421,1,0,0,3382,276,2064,227,2011,0,0,0,4578,7960
1607,81,217,2467,124,456,3,0,0,3267,271,1775,223,2273,1,0,0,4543,7810
1607,82,210,2327,125,551,2,0,0,3215,275,1817,203,2368,0,0,0,4663,7878
1607,83,207,2365,115,584,5,0,0,3276,284,1756,171,2725,0,0,0,4936,8212
1607,84,182,2186,88,646,2,0,0,3104,300,1462,186,2822,0,0,0,4770,7874
1607,85,173,1889,86,607,3,0,0,2758,268,1224,167,2807,0,0,0,4466,7224
1607,86,143,1630,61,562,2,0,0,2398,216,956,118,2609,0,0,0,3899,6297
1607,87,102,1279,46,513,0,0,0,1940,200,672,101,2362,0,0,0,3335,5275
1607,88,95,1077,30,480,1,0,0,1683,187,578,100,2365,0,0,0,3230,4913
1607,89,86,844,36,463,1,0,0,1430,182,431,62,2177,0,0,0,2852,4282
1607,90,77,714,18,368,0,0,0,1177,156,351,70,1881,0,0,0,2458,3635
1607,91,48,565,17,349,0,0,0,979,179,237,57,1809,0,0,0,2282,3261
1607,92,36,436,15,290,1,0,0,778,152,195,37,1480,0,0,0,1864,2642
1607,93,30,312,9,239,0,0,0,590,118,142,37,1357,0,0,0,1654,2244
1607,94,28,189,8,200,0,0,0,425,107,71,17,1033,0,0,0,1228,1653
1607,95,15,143,4,147,0,0,0,309,78,36,14,799,0,0,0,927,1236
1607,96,12,85,2,102,0,0,0,201,74,32,13,573,0,0,0,692,893
1607,97,8,46,2,72,0,0,0,128,45,18,8,445,0,0,0,516,644
1607,98,6,34,0,49,0,0,0,89,33,5,2,336,0,0,0,376,465
1607,99,6,17,2,26,0,0,0,51,22,9,3,197,0,0,0,231,282
1607,100,2,16,0,53,0,0,0,71,33,5,5,341,0,0,0,384,455
1607,999,185471,175618,19000,12874,447,8,1,393419,156708,179566,27508,60104,315,7,1,424209,817628
1664,0,663,0,0,0,0,0,0,663,570,0,0,0,0,0,0,570,1233
1664,1,631,0,0,0,0,0,0,631,589,0,0,0,0,0,0,589,1220
1664,2,629,0,0,0,0,0,0,629,682,0,0,0,0,0,0,682,1311
1664,3,700,0,0,0,0,0,0,700,651,0,0,0,0,0,0,651,1351
1664,4,711,0,0,0,0,0,0,711,674,0,0,0,0,0,0,674,1385
1664,5,772,0,0,0,0,0,0,772,660,0,0,0,0,0,0,660,1432
1664,6,827,0,0,0,0,0,0,827,754,0,0,0,0,0,0,754,1581
1664,7,862,0,0,0,0,0,0,862,720,0,0,0,0,0,0,720,1582
1664,8,812,0,0,0,0,0,0,812,757,0,0,0,0,0,0,757,1569
1664,9,822,0,0,0,0,0,0,822,786,0,0,0,0,0,0,786,1608
1664,10,904,0,0,0,0,0,0,904,820,0,0,0,0,0,0,820,1724
1664,11,886,0,0,0,0,0,0,886,876,0,0,0,0,0,0,876,1762
1664,12,927,0,0,0,0,0,0,927,835,0,0,0,0,0,0,835,1762
1664,13,861,0,0,0,0,0,0,861,922,0,0,0,0,0,0,922,1783
1664,14,931,0,0,0,0,0,0,931,904,0,0,0,0,0,0,904,1835
1664,15,919,0,0,0,0,0,0,919,964,0,0,0,0,0,0,964,1883
1664,16,991,0,0,0,0,0,0,991,842,0,0,0,0,0,0,842,1833
1664,17,989,0,0,0,0,0,0,989,958,0,0,0,0,0,0,958,1947
1664,18,959,0,0,0,0,0,0,959,832,0,0,0,0,0,0,832,1791
1664,19,1067,2,0,0,0,0,0,1069,905,2,0,0,0,0,0,907,1976
1664,20,979,0,0,0,0,0,0,979,884,4,1,0,0,0,0,889,1868
1664,21,979,3,0,0,0,0,0,982,903,10,0,0,0,0,0,913,1895
1664,22,949,2,2,0,0,0,0,953,944,12,2,0,0,0,0,958,1911
1664,23,1022,4,0,0,1,0,0,1027,888,29,1,0,1,0,0,919,1946
1664,24,1102,6,1,0,0,0,0,1109,848,33,3,0,0,0,0,884,1993
1664,25,1093,16,0,1,0,0,0,1110,834,55,0,0,0,0,0,889,1999
1664,26,1057,30,0,0,0,0,0,1087,879,66,1,0,2,0,0,948,2035
1664,27,1029,37,4,0,0,0,0,1070,905,94,3,0,1,0,0,1003,2073
1664,28,1010,42,3,0,0,0,0,1055,810,155,6,0,1,0,0,972,2027
1664,29,990,85,2,0,0,0,0,1077,748,162,10,1,2,0,0,923,2000
1664,30,972,108,6,0,0,0,0,1086,717,203,10,0,2,0,0,932,2018
1664,31,988,158,3,0,0,0,0,1149,704,274,7,0,0,0,0,985,2134
1664,32,879,185,11,3,3,0,0,1081,625,345,15,1,0,0,0,986,2067
1664,33,894,248,10,2,2,0,0,1156,641,428,21,0,1,1,0,1092,2248
1664,34,789,286,13,0,1,0,0,1089,645,406,25,1,4,0,0,1081,2170
1664,35,797,354,19,4,2,1,0,1177,577,538,29,1,0,0,0,1145,2322
1664,36,742,413,18,2,3,0,0,1178,519,496,35,0,2,0,0,1052,2230
1664,37,685,429,28,1,2,0,0,1145,544,566,41,8,5,0,0,1164,2309
1664,38,719,466,36,2,3,0,0,1226,470,580,54,7,2,0,0,1113,2339
1664,39,661,490,28,2,1,0,0,1182,464,610,61,9,1,0,0,1145,2327
1664,40,638,544,43,0,1,0,0,1226,431,607,65,7,4,0,0,1114,2340
1664,41,608,606,38,4,2,0,0,1258,445,662,79,10,3,0,0,1199,2457
1664,42,576,597,51,13,3,0,0,1240,421,718,67,12,2,1,0,1221,2461
1664,43,582,625,47,6,1,0,0,1261,366,723,95,9,0,0,0,1193,2454
1664,44,559,663,53,5,1,0,0,1281,414,750,84,18,1,1,0,1268,2549
1664,45,596,775,63,9,2,0,0,1445,429,832,105,22,3,0,0,1391,2836
1664,46,601,731,88,6,1,0,0,1427,435,908,117,15,4,0,0,1479,2906
1664,47,599,796,84,9,3,0,0,1491,433,919,129,20,5,0,0,1506,2997
1664,48,605,864,101,15,1,0,0,1586,389,968,143,25,2,0,0,1527,3113
1664,49,592,952,115,12,2,0,0,1673,404,1071,171,29,4,0,0,1679,3352
1664,50,601,995,110,9,0,0,0,1715,400,1107,171,53,4,0,0,1735,3450
1664,51,561,1031,126,9,2,1,0,1730,347,1165,187,40,0,1,0,1740,3470
1664,52,546,1059,139,8,3,0,0,1755,371,1164,206,43,1,0,0,1785,3540
1664,53,514,1031,158,16,1,0,0,1720,333,1180,207,47,4,0,0,1771,3491
1664,54,509,1100,164,9,4,0,0,1786,341,1226,237,72,2,0,0,1878,3664
1664,55,462,1176,178,11,2,0,0,1829,323,1260,212,63,1,0,0,1859,3688
1664,56,419,1181,158,17,6,1,0,1782,307,1281,243,83,1,0,0,1915,3697
1664,57,432,1311,164,20,1,0,0,1928,300,1328,228,92,2,0,0,1950,3878
1664,58,377,1242,210,23,1,0,1,1854,253,1393,247,92,3,0,0,1988,3842
1664,59,370,1381,222,26,3,0,0,2002,245,1334,244,105,3,0,0,1931,3933
1664,60,325,1240,171,20,3,0,0,1759,210,1264,235,100,2,0,0,1811,3570
1664,61,276,1175,184,35,2,0,0,1672,205,1208,228,144,0,0,0,1785,3457
1664,62,258,1236,166,29,2,0,0,1691,175,1212,214,125,0,1,0,1727,3418
1664,63,226,1138,150,40,2,0,0,1556,128,1164,186,186,2,0,0,1666,3222
1664,64,208,1104,153,31,1,0,0,1497,125,1082,183,134,0,0,0,1524,3021
1664,65,206,1067,142,50,1,0,0,1466,130,1045,151,186,0,0,0,1512,2978
1664,66,174,1031,131,44,2,0,0,1382,114,1021,155,190,1,0,0,1481,2863
1664,67,142,1077,134,30,1,0,0,1384,98,991,149,207,0,0,0,1445,2829
1664,68,138,980,94,61,0,0,0,1273,81,934,131,240,0,0,0,1386,2659
1664,69,131,969,107,45,0,0,0,1252,81,948,130,269,0,0,0,1428,2680
1664,70,93,975,69,57,0,0,0,1194,83,853,93,258,0,0,0,1287,2481
1664,71,87,884,82,69,1,0,0,1123,60,882,106,244,0,0,0,1292,2415
1664,72,94,889,79,50,0,0,0,1112,67,842,102,287,0,0,0,1298,2410
1664,73,100,940,80,68,1,0,0,1189,63,873,66,319,0,0,0,1321,2510
1664,74,98,962,68,95,1,0,0,1224,56,917,73,388,0,0,0,1434,2658
1664,75,96,1065,50,105,0,0,0,1316,67,885,63,410,0,0,0,1425,2741
1664,76,72,999,60,90,0,0,0,1221,64,882,83,498,0,0,0,1527,2748
1664,77,77,1006,49,100,1,0,0,1233,62,846,76,527,0,0,0,1511,2744
1664,78,50,627,28,106,0,0,0,811,45,545,41,392,0,0,0,1023,1834
1664,79,62,721,37,107,0,0,0,927,51,603,53,536,0,1,0,1244,2171
1664,80,56,706,29,106,0,0,0,897,28,498,49,563,0,0,0,1138,2035
1664,81,36,685,32,114,0,0,0,867,49,510,29,584,0,0,0,1172,2039
1664,82,44,663,27,141,0,0,0,875,48,492,42,622,0,0,0,1204,2079
1664,83,61,657,20,142,1,0,0,881,51,439,44,697,0,0,0,1231,2112
1664,84,39,564,16,147,0,0,0,766,41,388,36,678,0,0,0,1143,1909
1664,85,47,509,16,131,0,0,0,703,51,292,33,685,0,0,0,1061,1764
1664,86,34,396,15,121,0,0,0,566,40,225,26,628,0,0,0,919,1485
1664,87,30,313,12,134,0,0,0,489,32,170,15,607,0,0,0,824,1313
1664,88,27,257,5,112,0,0,0,401,40,110,14,542,0,0,0,706,1107
1664,89,17,244,5,84,0,0,0,350,18,101,7,531,0,0,0,657,1007
1664,90,17,166,5,85,0,0,0,273,26,68,7,445,0,0,0,546,819
1664,91,14,130,5,83,0,0,0,232,23,56,8,434,0,0,0,521,753
1664,92,17,102,4,53,0,0,0,176,31,45,6,387,0,0,0,469,645
1664,93,7,90,2,66,0,0,0,165,18,29,2,366,0,0,0,415,580
1664,94,8,56,2,50,0,0,0,116,13,10,4,291,0,0,0,318,434
1664,95,5,31,0,35,0,0,0,71,13,15,0,215,0,0,0,243,314
1664,96,3,25,0,19,0,0,0,47,19,7,1,166,0,0,0,193,240
1664,97,0,14,0,15,0,0,0,29,7,4,5,100,0,0,0,116,145
1664,98,1,8,1,13,0,0,0,23,3,0,1,74,0,0,0,78,101
1664,99,0,4,0,6,0,0,0,10,6,4,1,57,0,0,0,68,78
1664,100,2,5,1,11,0,0,0,19,10,2,2,93,0,0,0,107,126
1664,999,49324,47734,4727,3144,77,3,1,105010,40169,48126,6412,15290,78,6,0,110081,215091
1807,0,2819,0,0,0,0,0,0,2819,2698,0,0,0,0,0,0,2698,5517
1807,1,2984,0,0,0,0,0,0,2984,2839,0,0,0,0,0,0,2839,5823
1807,2,3155,0,0,0,0,0,0,3155,3034,0,0,0,0,0,0,3034,6189
1807,3,3084,0,0,0,0,0,0,3084,2943,0,0,0,0,0,0,2943,6027
1807,4,3303,0,0,0,0,0,0,3303,3256,0,0,0,0,0,0,3256,6559
1807,5,3489,0,0,0,0,0,0,3489,3328,0,0,0,0,0,0,3328,6817
1807,6,3562,0,0,0,0,0,0,3562,3358,0,0,0,0,0,0,3358,6920
1807,7,3683,0,0,0,0,0,0,3683,3555,0,0,0,0,0,0,3555,7238
1807,8,3966,0,0,0,0,0,0,3966,3744,0,0,0,0,0,0,3744,7710
1807,9,4098,0,0,0,0,0,0,4098,3836,0,0,0,0,0,0,3836,7934
1807,10,4141,0,0,0,0,0,0,4141,4008,0,0,0,0,0,0,4008,8149
1807,11,4219,0,0,0,0,0,0,4219,4007,0,0,0,0,0,0,4007,8226
1807,12,4417,0,0,0,0,0,0,4417,4128,0,0,0,0,0,0,4128,8545
1807,13,4376,0,0,0,0,0,0,4376,4121,0,0,0,0,0,0,4121,8497
1807,14,4600,0,0,0,0,0,0,4600,4337,0,0,0,0,0,0,4337,8937
1807,15,4544,0,0,0,0,0,0,4544,4213,0,0,0,0,0,0,4213,8757
1807,16,4616,0,0,0,0,0,0,4616,4076,0,0,0,0,0,0,4076,8692
1807,17,4497,0,0,0,0,0,0,4497,4327,0,0,0,0,0,0,4327,8824
1807,18,4458,0,0,0,0,0,0,4458,4089,2,0,0,0,0,0,4091,8549
1807,19,4523,1,0,0,0,0,0,4524,4206,9,0,0,0,0,0,4215,8739
1807,20,4274,4,0,0,0,0,0,4278,4028,20,0,0,0,0,0,4048,8326
1807,21,4312,3,0,0,0,0,0,4315,3975,42,0,0,0,0,0,4017,8332
1807,22,4378,14,0,0,1,0,0,4393,3915,93,2,0,1,0,0,4011,8404
1807,23,4452,27,1,0,0,0,0,4480,3990,146,2,0,1,0,0,4139,8619
1807,24,4349,63,1,0,0,0,0,4413,3929,187,4,0,2,0,0,4122,8535
1807,25,4384,93,6,0,1,0,0,4484,3955,261,6,2,1,0,0,4225,8709
1807,26,4434,133,5,1,0,0,0,4573,3733,380,8,0,2,1,0,4124,8697
1807,27,4356,188,8,0,2,0,0,4554,3545,507,7,0,2,0,0,4061,8615
1807,28,4009,307,5,0,2,0,0,4323,3479,698,14,2,2,1,0,4196,8519
1807,29,4021,407,11,0,8,0,0,4447,3239,977,24,2,3,0,0,4245,8692
1807,30,3868,621,7,0,6,2,0,4504,3183,1157,28,3,6,0,0,4377,8881
1807,31,3891,795,14,1,3,1,0,4705,3052,1468,38,3,5,0,0,4566,9271
1807,32,3740,1000,21,1,11,0,0,4773,2769,1668,49,7,9,0,0,4502,9275
1807,33,3431,1274,40,3,7,0,0,4755,2699,1972,82,4,8,0,0,4765,9520
1807,34,3184,1467,43,5,11,0,0,4710,2415,2161,88,6,6,0,0,4676,9386
1807,35,3244,1634,56,2,12,0,0,4948,2321,2346,118,13,10,1,0,4809,9757
1807,36,2936,1809,88,4,6,0,0,4843,2091,2421,139,8,9,0,0,4668,9511
1807,37,2622,1989,73,4,8,0,1,4697,1890,2618,180,17,16,1,0,4722,9419
1807,38,2667,2271,94,1,6,1,0,5040,1969,2818,195,23,8,0,0,5013,10053
1807,39,2547,2421,124,4,7,2,0,5105,1789,2856,227,24,9,1,0,4906,10011
1807,40,2442,2578,126,1,5,0,0,5152,1770,3098,232,32,8,1,0,5141,10293
1807,41,2436,2706,172,8,5,1,0,5328,1724,3282,266,30,8,1,0,5311,10639
1807,42,2287,2887,190,13,6,0,0,5383,1639,3287,331,41,10,1,0,5309,10692
1807,43,2271,2955,212,19,11,0,0,5468,1630,3411,374,43,5,0,0,5463,10931
1807,44,2239,3163,256,20,11,0,0,5689,1527,3688,409,61,9,0,0,5694,11383
1807,45,2266,3481,293,18,15,1,0,6074,1599,3883,475,77,7,1,0,6042,12116
1807,46,2270,3711,348,18,12,0,0,6359,1591,4171,518,68,8,0,0,6356,12715
1807,47,2284,3891,394,33,11,0,0,6613,1583,4326,536,96,7,0,0,6548,13161
1807,48,2383,4255,433,21,16,1,0,7109,1624,4655,604,115,13,0,0,7011,14120
1807,49,2318,4380,487,37,13,0,1,7236,1546,4683,663,113,9,0,0,7014,14250
1807,50,2251,4378,517,30,11,0,0,7187,1506,4678,729,106,5,1,0,7025,14212
1807,51,2079,4613,523,46,8,0,0,7269,1414,5007,745,166,5,1,0,7338,14607
1807,52,2010,4630,575,40,8,0,0,7263,1287,4934,780,186,6,0,0,7193,14456
1807,53,1808,4657,601,39,15,1,0,7121,1181,4967,797,198,7,1,0,7151,14272
1807,54,1707,4829,680,55,6,1,0,7278,1171,5233,818,216,5,1,1,7445,14723
1807,55,1697,5098,633,62,9,0,0,7499,1081,5125,868,225,4,0,0,7303,14802
1807,56,1529,5018,682,70,9,0,0,7308,1050,5130,867,267,4,0,0,7318,14626
1807,57,1365,5204,709,77,10,0,0,7365,937,5348,877,313,0,1,0,7476,14841
1807,58,1251,5353,747,83,15,0,0,7449,958,5441,876,395,3,0,0,7673,15122
1807,59,1169,5375,662,99,10,0,1,7316,866,5348,792,395,4,0,0,7405,14721
1807,60,1028,5056,660,99,11,0,0,6854,754,5014,781,405,1,0,0,6955,13809
1807,61,900,4722,558,94,6,0,0,6280,675,4781,659,480,5,0,0,6600,12880
1807,62,765,4536,576,130,5,0,0,6012,639,4650,612,495,4,0,0,6400,12412
1807,63,698,4494,480,143,10,0,1,5826,596,4285,609,556,3,0,0,6049,11875
1807,64,615,4317,448,143,4,0,1,5528,527,4456,573,652,2,0,0,6210,11738
1807,65,519,4159,421,138,3,0,2,5242,533,3991,535,631,2,0,0,5692,10934
1807,66,568,4025,414,167,6,0,0,5180,467,3912,443,731,2,0,0,5555,10735
1807,67,449,3987,366,171,2,0,0,4975,451,3871,419,755,0,0,0,5496,10471
1807,68,429,3962,337,183,1,0,0,4912,425,3811,424,858,0,0,0,5518,10430
1807,69,428,3814,293,209,3,0,0,4747,383,3656,371,976,0,0,0,5386,10133
1807,70,399,3733,263,250,1,0,1,4647,355,3563,333,993,0,0,0,5244,9891
1807,71,351,3670,257,269,2,0,0,4549,338,3488,280,1102,0,0,0,5208,9757
1807,72,336,3694,221,238,2,0,0,4491,313,3362,266,1191,0,0,0,5132,9623
1807,73,352,3709,198,274,1,0,0,4534,307,3402,241,1287,0,0,0,5237,9771
1807,74,302,3698,181,350,0,0,0,4531,272,3405,256,1485,2,0,0,5420,9951
1807,75,296,3724,189,353,1,0,0,4563,297,3284,239,1644,0,0,0,5464,10027
1807,76,277,3474,162,391,1,0,1,4306,288,2996,235,1722,0,0,0,5241,9547
1807,77,247,3647,128,426,2,0,0,4450,282,2947,252,2004,0,0,0,5485,9935
1807,78,199,2606,99,332,1,0,0,3237,215,2099,152,1558,0,0,0,4024,7261
1807,79,204,2550,73,374,0,0,0,3201,230,2022,134,1722,0,0,0,4108,7309
1807,80,158,2503,65,436,0,0,0,3162,200,1801,122,1815,0,0,0,3938,7100
1807,81,148,2366,64,411,0,0,0,2989,210,1738,113,2068,0,0,0,4129,7118
1807,82,161,2343,61,477,0,0,0,3042,248,1625,118,2159,0,0,0,4150,7192
1807,83,158,2262,58,498,0,0,0,2976,252,1488,130,2395,2,0,0,4267,7243
1807,84,122,2104,47,518,0,0,0,2791,235,1263,92,2523,0,0,0,4113,6904
1807,85,116,1846,44,507,1,0,0,2514,230,1042,70,2358,0,0,0,3700,6214
1807,86,99,1406,33,463,0,0,0,2001,225,795,62,2209,0,0,0,3291,5292
1807,87,69,1191,22,390,0,0,0,1672,171,544,57,2004,0,0,0,2776,4448
1807,88,67,963,13,416,0,0,0,1459,178,462,39,1907,0,0,0,2586,4045
1807,89,53,763,13,374,0,0,0,1203,172,301,31,1778,0,0,0,2282,3485
1807,90,28,579,16,307,0,0,0,930,141,248,31,1507,0,0,0,1927,2857
1807,91,32,412,5,274,0,0,0,723,122,162,19,1389,0,0,0,1692,2415
1807,92,27,339,5,222,0,0,0,593,112,92,17,1202,0,0,0,1423,2016
1807,93,19,232,1,168,0,0,0,420,98,55,6,982,0,0,0,1141,1561
1807,94,9,147,1,136,0,0,0,293,65,34,14,785,0,0,0,898,1191
1807,95,11,99,0,93,0,0,0,203,51,26,6,574,0,0,0,657,860
1807,96,6,57,1,76,0,0,0,140,44,15,7,455,0,0,0,521,661
1807,97,3,33,1,56,0,0,0,93,38,10,3,335,0,0,0,386,479
1807,98,1,22,0,47,0,0,0,70,23,3,0,237,0,0,0,263,333
1807,99,0,7,0,17,0,0,0,24,13,2,0,147,0,0,0,162,186
1807,100,2,15,0,41,0,0,0,58,26,4,1,216,0,0,0,247,305
1807,999,204346,196949,16611,11476,360,11,9,429762,174954,199207,22520,53549,250,14,1,450495,880257
1864,0,1910,0,0,0,0,0,0,1910,1871,0,0,0,0,0,0,1871,3781
1864,1,2019,0,0,0,0,0,0,2019,1837,0,0,0,0,0,0,1837,3856
1864,2,1955,0,0,0,0,0,0,1955,2064,0,0,0,0,0,0,2064,4019
1864,3,2163,0,0,0,0,0,0,2163,2013,0,0,0,0,0,0,2013,4176
1864,4,2252,0,0,0,0,0,0,2252,2133,0,0,0,0,0,0,2133,4385
1864,5,2306,0,0,0,0,0,0,2306,2186,0,0,0,0,0,0,2186,4492
1864,6,2436,0,0,0,0,0,0,2436,2301,0,0,0,0,0,0,2301,4737
1864,7,2556,0,0,0,0,0,0,2556,2507,0,0,0,0,0,0,2507,5063
1864,8,2651,0,0,0,0,0,0,2651,2525,0,0,0,0,0,0,2525,5176
1864,9,2694,0,0,0,0,0,0,2694,2515,0,0,0,0,0,0,2515,5209
1864,10,2808,0,0,0,0,0,0,2808,2557,0,0,0,0,0,0,2557,5365
1864,11,2903,0,0,0,0,0,0,2903,2697,0,0,0,0,0,0,2697,5600
1864,12,2878,0,0,0,0,0,0,2878,2732,0,0,0,0,0,0,2732,5610
1864,13,2934,0,0,0,0,0,0,2934,2804,0,0,0,0,0,0,2804,5738
1864,14,3132,0,0,0,0,0,0,3132,2802,0,0,0,0,0,0,2802,5934
1864,15,3039,0,0,0,0,0,0,3039,2901,0,0,0,0,0,0,2901,5940
1864,16,2976,0,0,0,0,0,0,2976,2859,0,0,0,0,0,0,2859,5835
1864,17,3005,2,1,0,0,0,0,3008,2833,1,0,0,0,0,0,2834,5842
1864,18,3052,0,0,0,0,0,0,3052,2796,1,0,0,0,0,0,2797,5849
1864,19,3082,2,0,0,0,0,0,3084,2839,2,0,0,0,0,0,2841,5925
1864,20,2992,5,0,0,0,0,0,2997,2711,16,0,0,1,0,0,2728,5725
1864,21,2857,7,0,0,0,0,0,2864,2640,28,0,0,0,0,0,2668,5532
1864,22,3036,8,2,0,0,0,0,3046,2684,42,1,0,0,0,0,2727,5773
1864,23,3179,17,2,0,0,0,0,3198,2727,77,1,0,0,0,0,2805,6003
1864,24,3105,29,4,0,0,0,0,3138,2761,127,6,0,0,0,0,2894,6032
1864,25,3185,63,0,0,1,0,0,3249,2617,163,4,0,2,0,0,2786,6035
1864,26,3104,77,1,0,1,0,0,3183,2617,256,5,0,1,0,0,2879,6062
1864,27,3031,137,2,0,1,0,0,3171,2542,339,4,1,1,0,0,2887,6058
1864,28,2978,178,5,0,2,0,0,3163,2426,455,16,0,2,0,0,2899,6062
1864,29,2905,283,8,0,1,0,0,3197,2360,610,11,0,2,1,0,2984,6181
1864,30,2830,403,16,1,5,0,0,3255,2167,805,27,0,2,0,0,3001,6256
1864,31,2725,528,13,0,1,0,0,3267,2070,970,27,3,8,0,0,3078,6345
1864,32,2633,691,16,4,5,0,0,3349,2025,1186,28,0,4,0,0,3243,6592
1864,33,2534,823,19,2,3,0,0,3381,1844,1301,60,2,3,0,0,3210,6591
1864,34,2360,982,28,0,4,0,0,3374,1730,1373,59,7,8,0,0,3177,6551
1864,35,2242,1141,25,1,6,1,0,3416,1564,1555,64,5,8,0,0,3196,6612
1864,36,1988,1214,48,1,5,0,0,3256,1423,1704,75,3,8,0,0,3213,6469
1864,37,1970,1343,48,3,3,0,0,3367,1402,1783,117,10,2,0,0,3314,6681
1864,38,1887,1491,77,5,3,0,1,3464,1337,1843,139,16,2,1,0,3338,6802
1864,39,1719,1654,75,4,7,0,0,3459,1268,2065,146,9,8,1,0,3497,6956
1864,40,1750,1766,93,4,7,0,0,3620,1227,2184,172,20,3,0,0,3606,7226
1864,41,1740,1872,108,2,6,0,0,3728,1269,2200,160,21,7,0,0,3657,7385
1864,42,1613,1864,133,13,7,0,0,3630,1134,2319,195,19,2,1,1,3671,7301
1864,43,1658,2026,135,7,3,0,0,3829,1111,2313,222,27,10,0,0,3683,7512
1864,44,1521,2181,168,12,11,0,0,3893,1062,2488,246,40,2,0,0,3838,7731
1864,45,1561,2485,193,10,8,0,0,4257,1022,2702,306,48,4,0,0,4082,8339
1864,46,1646,2511,230,12,7,0,0,4406,1132,2840,315,49,7,0,0,4343,8749
1864,47,1659,2682,247,17,5,1,0,4611,1101,3018,345,58,3,0,0,4525,9136
1864,48,1684,2938,285,19,12,0,0,4938,1127,3172,392,76,8,0,0,4775,9713
1864,49,1690,3067,300,20,5,0,0,5082,996,3317,460,76,1,1,0,4851,9933
1864,50,1512,3045,359,33,6,0,0,4955,1018,3369,454,85,3,0,0,4929,9884
1864,51,1473,3262,351,27,11,0,0,5124,941,3410,484,94,6,0,0,4935,10059
1864,52,1407,3338,373,21,7,0,1,5147,869,3356,473,108,3,0,0,4809,9956
1864,53,1228,3181,367,29,4,0,1,4810,826,3354,505,132,5,0,0,4822,9632
1864,54,1253,3420,407,23,6,0,0,5109,839,3647,490,153,4,0,0,5133,10242
1864,55,1176,3377,417,46,12,0,0,5028,815,3474,507,177,0,0,0,4973,10001
1864,56,1081,3623,441,36,13,0,0,5194,696,3542,529,168,6,0,0,4941,10135
1864,57,1010,3819,404,47,8,0,0,5288,706,3681,502,194,4,0,0,5087,10375
1864,58,947,3600,475,54,10,0,0,5086,684,3621,481,220,1,0,0,5007,10093
1864,59,857,3703,421,66,7,0,0,5054,648,3609,490,283,1,0,0,5031,10085
1864,60,744,3295,404,62,6,0,0,4511,546,3406,480,297,4,0,0,4733,9244
1864,61,712,3257,353,76,3,0,0,4401,512,3167,426,283,1,0,0,4389,8790
1864,62,545,3214,336,80,3,0,0,4178,488,3119,455,333,2,0,0,4397,8575
1864,63,509,3027,341,78,3,0,0,3958,430,3066,366,361,4,0,0,4227,8185
1864,64,513,3033,283,97,6,0,0,3932,399,2903,372,377,1,0,0,4052,7984
1864,65,418,2792,267,89,1,0,0,3567,339,2729,306,446,1,0,0,3821,7388
1864,66,400,2770,231,105,2,1,0,3509,306,2697,308,494,3,0,0,3808,7317
1864,67,321,2686,283,140,5,0,0,3435,328,2619,279,531,0,0,0,3757,7192
1864,68,329,2558,196,126,4,1,0,3214,292,2570,211,551,0,0,0,3624,6838
1864,69,312,2528,163,148,4,0,0,3155,271,2427,219,610,0,0,0,3527,6682
1864,70,283,2509,183,172,1,0,0,3148,230,2376,202,648,2,0,0,3458,6606
1864,71,283,2540,180,161,2,0,0,3166,264,2389,180,703,0,0,0,3536,6702
1864,72,271,2488,156,172,1,0,0,3088,221,2207,193,791,0,0,0,3412,6500
1864,73,245,2488,126,190,2,0,0,3051,251,2330,179,836,1,0,1,3598,6649
1864,74,239,2655,132,214,0,0,2,3242,253,2203,182,926,0,0,0,3564,6806
1864,75,251,2542,122,235,0,0,0,3150,249,2075,167,1061,0,0,0,3552,6702
1864,76,208,2473,99,263,2,0,0,3045,230,1952,140,1146,1,0,0,3469,6514
1864,77,212,2260,116,258,3,0,0,2849,248,1924,142,1261,0,0,0,3575,6424
1864,78,133,1750,59,239,1,0,0,2182,163,1242,87,981,0,0,0,2473,4655
1864,79,129,1696,70,255,0,0,0,2150,163,1271,105,1121,0,0,0,2660,4810
1864,80,125,1547,39,260,0,0,0,1971,180,1112,66,1251,0,0,0,2609,4580
1864,81,139,1485,53,271,1,0,0,1949,172,1019,62,1252,1,0,0,2506,4455
1864,82,122,1464,29,314,1,0,0,1930,136,965,60,1416,1,0,0,2578,4508
1864,83,96,1513,33,358,0,0,0,2000,184,881,67,1551,0,0,0,2683,4683
1864,84,94,1322,28,342,1,0,0,1787,173,797,55,1620,0,0,0,2645,4432
1864,85,100,1104,24,345,0,0,0,1573,160,652,40,1532,0,0,0,2384,3957
1864,86,61,883,16,300,0,0,0,1260,167,446,38,1380,1,0,0,2032,3292
1864,87,61,698,16,273,0,0,0,1048,147,381,32,1215,0,0,0,1775,2823
1864,88,54,634,14,241,0,0,0,943,122,272,24,1253,0,0,0,1671,2614
1864,89,35,460,7,225,0,0,0,727,138,227,20,1190,0,0,0,1575,2302
1864,90,30,350,7,188,0,0,0,575,88,124,9,1048,0,0,0,1269,1844
1864,91,22,259,3,175,0,0,0,459,102,78,14,923,0,0,0,1117,1576
1864,92,13,218,4,139,0,0,0,374,80,68,15,762,0,0,0,925,1299
1864,93,8,162,2,130,0,0,0,302,83,42,5,683,0,0,0,813,1115
1864,94,7,83,0,76,0,0,0,166,55,25,9,556,0,0,0,645,811
1864,95,9,62,1,68,0,0,0,140,49,15,1,346,0,0,0,411,551
1864,96,2,23,1,45,0,0,0,71,33,11,2,291,0,0,0,337,408
1864,97,1,14,0,29,0,0,0,44,22,3,1,213,0,0,0,239,283
1864,98,0,6,1,19,0,0,0,26,18,3,3,135,0,0,0,159,185
1864,99,1,2,1,10,0,0,0,14,8,3,2,94,0,0,0,107,121
1864,100,2,2,0,16,0,0,0,20,21,6,4,159,0,0,0,190,210
1864,999,142516,133690,10676,7503,255,4,5,294649,120231,134120,14046,34731,165,5,2,303300,597949
2050,0,1711,0,0,0,0,0,0,1711,1580,0,0,0,0,0,0,1580,3291
2050,1,1745,0,0,0,0,0,0,1745,1737,0,0,0,0,0,0,1737,3482
2050,2,1793,0,0,0,0,0,0,1793,1701,0,0,0,0,0,0,1701,3494
2050,3,1828,0,0,0,0,0,0,1828,1767,0,0,0,0,0,0,1767,3595
2050,4,1915,0,0,0,0,0,0,1915,1900,0,0,0,0,0,0,1900,3815
2050,5,2087,0,0,0,0,0,0,2087,1911,0,0,0,0,0,0,1911,3998
2050,6,2132,0,0,0,0,0,0,2132,1939,0,0,0,0,0,0,1939,4071
2050,7,2192,0,0,0,0,0,0,2192,2080,0,0,0,0,0,0,2080,4272
2050,8,2291,0,0,0,0,0,0,2291,2187,0,0,0,0,0,0,2187,4478
2050,9,2321,0,0,0,0,0,0,2321,2080,0,0,0,0,0,0,2080,4401
2050,10,2331,0,0,0,0,0,0,2331,2194,0,0,0,0,0,0,2194,4525
2050,11,2335,0,0,0,0,0,0,2335,2334,0,0,0,0,0,0,2334,4669
2050,12,2409,0,0,0,0,0,0,2409,2298,0,0,0,0,0,0,2298,4707
2050,13,2492,0,0,0,0,0,0,2492,2361,0,0,0,0,0,0,2361,4853
2050,14,2662,0,0,0,0,0,0,2662,2412,0,0,0,0,0,0,2412,5074
2050,15,2560,0,0,0,0,0,0,2560,2529,0,0,0,0,0,0,2529,5089
2050,16,2516,0,0,0,0,0,0,2516,2391,0,0,0,0,0,0,2391,4907
2050,17,2580,0,0,0,0,0,0,2580,2353,0,0,0,0,0,0,2353,4933
2050,18,2611,2,0,0,0,0,0,2613,2370,1,0,0,0,0,0,2371,4984
2050,19,2623,0,0,0,0,0,0,2623,2305,9,0,0,0,0,0,2314,4937
2050,20,2602,5,0,0,0,0,0,2607,2182,23,0,0,0,0,0,2205,4812
2050,21,2510,4,0,1,0,0,0,2515,2305,38,1,0,0,0,0,2344,4859
2050,22,2597,8,2,0,0,0,0,2607,2372,62,1,0,0,1,0,2436,5043
2050,23,2723,25,3,0,0,0,0,2751,2290,107,1,0,0,0,0,2398,5149
2050,24,2665,46,0,0,0,0,0,2711,2303,176,4,0,0,0,0,2483,5194
2050,25,2790,76,1,0,1,0,0,2868,2329,200,2,0,1,0,0,2532,5400
2050,26,2715,101,2,0,1,0,0,2819,2234,307,5,0,1,0,0,2547,5366
2050,27,2695,118,2,0,2,0,0,2817,2122,380,11,1,4,0,0,2518,5335
2050,28,2597,194,3,1,2,0,0,2797,2098,433,7,1,2,0,0,2541,5338
2050,29,2472,276,5,0,0,0,0,2753,1983,597,19,1,6,0,0,2606,5359
2050,30,2428,394,6,1,1,0,0,2830,1941,723,17,1,8,0,0,2690,5520
2050,31,2441,472,15,2,4,2,0,2936,1818,885,24,2,5,0,0,2734,5670
2050,32,2340,558,19,4,2,0,0,2923,1704,1009,29,6,5,0,0,2753,5676
2050,33,2318,789,25,2,5,0,1,3140,1669,1132,52,10,6,0,0,2869,6009
2050,34,2096,860,25,3,5,0,0,2989,1479,1265,52,2,8,0,0,2806,5795
2050,35,1951,1053,29,3,3,1,0,3040,1389,1433,76,14,9,1,0,2922,5962
2050,36,1905,1081,49,6,4,0,0,3045,1287,1539,88,9,3,1,0,2927,5972
2050,37,1750,1243,46,2,2,0,0,3043,1200,1570,105,9,5,0,0,2889,5932
2050,38,1608,1271,67,3,6,0,0,2955,1192,1663,120,14,8,0,0,2997,5952
2050,39,1559,1447,82,1,4,0,0,3093,1140,1704,144,17,3,0,0,3008,6101
2050,40,1564,1509,62,3,5,0,0,3143,1113,1859,152,20,8,0,0,3152,6295
2050,41,1556,1656,114,7,3,0,0,3336,1057,1892,187,18,4,1,0,3159,6495
2050,42,1498,1653,112,6,3,1,0,3273,1082,1944,208,40,3,1,0,3278,6551
2050,43,1474,1754,127,8,2,0,0,3365,962,2104,228,25,8,0,0,3327,6692
2050,44,1503,1941,151,6,9,0,0,3610,1051,2158,256,43,1,0,0,3509,7119
2050,45,1558,2017,201,7,3,0,0,3786,1024,2294,265,44,4,0,0,3631,7417
2050,46,1524,2236,219,12,6,1,1,3999,1054,2290,296,45,6,0,0,3691,7690
2050,47,1570,2368,228,16,12,0,0,4194,975,2604,354,58,2,0,0,3993,8187
2050,48,1616,2381,258,19,10,0,0,4284,1058,2675,396,64,8,0,1,4202,8486
2050,49,1523,2696,317,21,5,0,0,4562,1014,2845,448,90,2,0,0,4399,8961
2050,50,1435,2698,353,30,8,0,0,4524,1004,2960,460,91,5,0,0,4520,9044
2050,51,1425,2751,371,18,5,2,1,4573,882,2961,476,106,9,0,0,4434,9007
2050,52,1408,2783,393,25,5,0,0,4614,816,2894,495,103,3,0,0,4311,8925
2050,53,1306,2866,342,24,12,0,2,4552,788,2924,493,139,3,0,0,4347,8899
2050,54,1147,2972,414,51,7,0,1,4592,784,3085,575,153,3,0,0,4600,9192
2050,55,1186,2957,419,42,13,0,0,4617,707,3081,485,181,4,0,0,4458,9075
2050,56,1109,3115,456,48,4,0,0,4732,719,3054,571,198,2,0,0,4544,9276
2050,57,1077,3179,438,63,8,0,0,4765,693,3192,517,226,1,0,0,4629,9394
2050,58,966,3103,485,54,7,0,0,4615,619,3029,518,247,1,0,0,4414,9029
2050,59,811,3143,476,65,2,0,0,4497,567,3256,467,262,1,0,0,4553,9050
2050,60,802,3007,422,77,6,0,1,4315,521,3090,463,288,1,0,0,4363,8678
2050,61,719,3004,385,58,6,0,0,4172,469,2952,437,332,3,0,0,4193,8365
2050,62,620,2884,348,85,6,0,0,3943,458,2788,409,384,1,0,0,4040,7983
2050,63,554,2696,335,85,6,0,0,3676,449,2734,383,391,0,0,0,3957,7633
2050,64,534,2756,331,105,3,0,1,3730,364,2650,346,424,2,0,0,3786,7516
2050,65,473,2620,294,112,1,0,0,3500,336,2518,321,458,2,0,1,3636,7136
2050,66,405,2597,291,112,1,0,0,3406,364,2465,288,521,1,0,0,3639,7045
2050,67,410,2586,275,116,0,0,0,3387,294,2389,278,553,0,0,0,3514,6901
2050,68,350,2445,237,137,5,0,0,3174,306,2264,275,587,0,0,0,3432,6606
2050,69,328,2292,248,149,1,0,0,3018,255,2219,233,657,1,0,0,3365,6383
2050,70,331,2340,205,146,2,0,1,3025,211,2030,231,682,0,0,1,3155,6180
2050,71,304,2216,161,173,2,0,0,2856,223,1969,206,706,1,0,0,3105,5961
2050,72,267,2260,180,167,4,0,0,2878,187,1973,188,819,0,0,0,3167,6045
2050,73,296,2282,169,221,3,0,0,2971,213,2038,192,891,0,0,0,3334,6305
2050,74,261,2197,136,210,2,0,0,2806,182,1877,167,982,0,0,0,3208,6014
2050,75,263,2233,130,241,3,0,0,2870,208,1893,166,1118,0,0,0,3385,6255
2050,76,214,2186,110,257,2,0,0,2769,182,1747,168,1136,0,0,0,3233,6002
2050,77,199,1964,103,282,1,0,0,2549,181,1580,150,1256,0,0,0,3167,5716
2050,78,142,1383,70,202,0,0,1,1798,122,1048,97,1012,0,0,0,2279,4077
2050,79,138,1471,56,229,0,0,1,1895,115,1083,84,1165,0,0,0,2447,4342
2050,80,137,1391,60,253,0,0,0,1841,137,969,92,1227,0,0,0,2425,4266
2050,81,132,1319,50,270,0,0,0,1771,140,966,73,1241,0,0,0,2420,4191
2050,82,120,1227,48,295,0,0,0,1690,120,863,62,1365,0,0,0,2410,4100
2050,83,149,1317,50,344,0,0,0,1860,161,801,67,1607,0,0,0,2636,4496
2050,84,136,1142,29,340,0,0,0,1647,125,708,50,1559,1,0,0,2443,4090
2050,85,112,994,34,344,0,0,0,1484,139,570,60,1636,0,0,0,2405,3889
2050,86,81,777,23,308,1,0,0,1190,109,388,38,1507,0,0,0,2042,3232
2050,87,81,585,22,274,0,0,0,962,95,300,35,1374,0,0,0,1804,2766
2050,88,69,519,17,301,0,0,0,906,90,267,34,1348,0,0,0,1739,2645
2050,89,53,416,13,244,0,0,0,726,71,204,17,1238,0,0,0,1530,2256
2050,90,35,327,5,205,0,0,0,572,76,132,24,1106,0,0,0,1338,1910
2050,91,39,233,7,185,0,0,0,464,79,85,18,991,0,0,0,1173,1637
2050,92,25,170,2,148,0,0,0,345,61,76,11,904,0,0,0,1052,1397
2050,93,14,122,5,133,1,0,0,275,65,42,7,734,0,0,0,848,1123
2050,94,10,77,4,83,0,0,0,174,50,28,6,501,0,0,0,585,759
2050,95,12,50,3,65,0,0,0,130,27,22,3,415,0,0,0,467,597
2050,96,5,33,0,56,0,0,0,94,31,11,0,295,0,0,0,337,431
2050,97,2,17,1,41,0,0,0,61,13,7,4,236,0,0,0,260,321
2050,98,0,12,0,16,0,0,0,28,14,4,3,147,0,0,0,168,196
2050,99,2,2,0,14,0,0,0,18,13,3,2,128,0,0,0,146,164
2050,100,2,4,0,25,0,0,0,31,11,3,0,175,0,0,0,189,220
2050,999,127978,117954,11176,7662,227,7,11,265015,104702,118113,14293,36336,165,5,3,273617,538632
2146,0,3800,0,0,0,0,0,0,3800,3640,0,0,0,0,0,0,3640,7440
2146,1,3953,0,0,0,0,0,0,3953,3745,0,0,0,0,0,0,3745,7698
2146,2,3662,0,0,0,0,0,0,3662,3590,0,0,0,0,0,0,3590,7252
2146,3,4019,0,0,0,0,0,0,4019,3731,0,0,0,0,0,0,3731,7750
2146,4,3958,0,0,0,0,0,0,3958,3753,0,0,0,0,0,0,3753,7711
2146,5,4163,0,0,0,0,0,0,4163,4025,0,0,0,0,0,0,4025,8188
2146,6,4222,0,0,0,0,0,0,4222,4098,0,0,0,0,0,0,4098,8320
2146,7,4362,0,0,0,0,0,0,4362,4127,0,0,0,0,0,0,4127,8489
2146,8,4396,0,0,0,0,0,0,4396,4212,0,0,0,0,0,0,4212,8608
2146,9,4447,0,0,0,0,0,0,4447,4140,0,0,0,0,0,0,4140,8587
2146,10,4473,0,0,0,0,0,0,4473,4337,0,0,0,0,0,0,4337,8810
2146,11,4680,0,0,0,0,0,0,4680,4345,0,0,0,0,0,0,4345,9025
2146,12,4889,0,0,0,0,0,0,4889,4500,0,0,0,0,0,0,4500,9389
2146,13,4998,0,0,0,0,0,0,4998,4946,0,0,0,0,0,0,4946,9944
2146,14,5117,0,0,0,0,0,0,5117,4846,0,0,0,0,0,0,4846,9963
2146,15,5129,0,0,0,0,0,0,5129,4934,0,0,0,0,0,0,4934,10063
2146,16,5265,0,0,0,0,0,0,5265,4931,0,0,0,0,0,0,4931,10196
2146,17,5293,0,0,1,0,0,0,5294,5042,0,0,0,0,0,0,5042,10336
2146,18,5447,0,0,0,0,0,0,5447,4971,3,0,0,0,0,0,4974,10421
2146,19,5667,3,0,0,0,0,0,5670,5250,10,0,0,0,0,0,5260,10930
2146,20,5546,1,0,1,0,0,0,5548,5170,27,0,0,0,0,0,5197,10745
2146,21,5356,7,0,0,0,0,0,5363,5091,44,0,0,1,0,0,5136,10499
2146,22,5430,14,1,0,0,0,0,5445,5124,76,0,0,0,0,0,5200,10645
2146,23,5236,33,0,0,0,0,0,5269,4978,143,3,1,0,0,0,5125,10394
2146,24,5293,51,0,0,1,0,0,5345,4852,213,0,0,0,0,0,5065,10410
2146,25,5316,111,1,0,0,0,0,5428,4591,358,3,0,1,0,0,4953,10381
2146,26,5154,191,0,0,1,0,0,5346,4503,518,5,0,0,0,0,5026,10372
2146,27,5017,261,1,0,0,0,0,5279,4163,757,3,5,1,0,0,4929,10208
2146,28,4679,442,4,1,1,0,0,5127,3934,1168,11,1,2,0,0,5116,10243
2146,29,4680,680,5,1,0,0,0,5366,3740,1490,12,2,1,0,0,5245,10611
2146,30,4306,965,5,1,1,0,0,5278,3273,1950,17,4,2,0,0,5246,10524
2146,31,4143,1327,3,1,2,0,0,5476,3125,2422,19,6,1,0,0,5573,11049
2146,32,3890,1707,15,3,3,0,0,5618,2881,2787,34,9,3,0,0,5714,11332
2146,33,3643,1983,14,3,2,1,0,5646,2543,2995,40,4,3,0,0,5585,11231
2146,34,3391,2199,13,4,4,0,0,5611,2175,3478,57,12,0,0,0,5722,11333
2146,35,3158,2564,29,1,2,0,0,5754,2070,3563,62,16,2,0,0,5713,11467
2146,36,2815,2810,38,4,6,0,0,5673,1796,3749,90,24,2,0,0,5661,11334
2146,37,2588,3076,48,4,3,0,0,5719,1663,3956,116,22,7,1,0,5765,11484
2146,38,2459,3239,59,6,9,1,0,5773,1515,4207,103,22,4,0,0,5851,11624
2146,39,2329,3545,60,8,4,0,0,5946,1468,4387,125,43,6,0,0,6029,11975
2146,40,2273,3848,86,8,3,0,0,6218,1283,4683,123,31,4,0,0,6124,12342
2146,41,2055,4099,72,9,4,0,0,6239,1217,4799,148,38,0,0,0,6202,12441
2146,42,1950,4198,99,13,6,0,0,6266,1171,4700,160,61,1,0,0,6093,12359
2146,43,1879,4277,109,13,2,0,0,6280,1089,4883,194,72,4,0,0,6242,12522
2146,44,1864,4435,124,21,6,0,0,6450,1095,5057,211,70,0,0,0,6433,12883
2146,45,1764,4710,138,18,2,0,0,6632,1039,5221,246,83,1,0,0,6590,13222
2146,46,1647,4737,151,22,6,0,0,6563,998,5199,244,112,1,0,0,6554,13117
2146,47,1674,5000,145,22,5,0,0,6846,965,5545,257,136,1,0,0,6904,13750
2146,48,1591,5206,178,31,3,0,0,7009,958,5573,259,146,1,0,0,6937,13946
2146,49,1517,5378,201,41,3,0,0,7140,988,5849,263,159,0,0,0,7259,14399
2146,50,1350,5346,191,42,5,0,0,6934,949,5806,270,195,1,0,0,7221,14155
2146,51,1227,5224,183,62,4,0,0,6700,933,5718,307,228,0,0,0,7186,13886
2146,52,1232,5392,205,53,5,0,1,6888,872,5773,296,278,2,0,0,7221,14109
2146,53,1126,5461,193,64,5,0,0,6849,887,5609,301,256,1,0,0,7054,13903
2146,54,1012,5697,192,67,3,0,0,6971,822,5706,291,343,0,0,0,7162,14133
2146,55,980,5750,209,66,1,0,0,7006,858,5786,288,380,0,0,0,7312,14318
2146,56,912,5816,199,99,1,0,0,7027,797,5784,279,372,1,0,0,7233,14260
2146,57,801,5765,222,116,0,0,0,6904,828,5692,299,458,1,0,0,7278,14182
2146,58,794,5881,206,125,5,0,0,7011,778,5656,278,506,0,0,0,7218,14229
2146,59,697,6019,213,132,1,0,0,7062,772,5730,283,579,1,0,0,7365,14427
2146,60,625,5481,205,120,5,0,0,6436,703,5282,247,586,0,0,0,6818,13254
2146,61,521,5301,170,142,1,0,1,6136,676,4893,245,686,2,0,0,6502,12638
2146,62,502,5095,155,171,2,0,0,5925,620,4970,204,738,0,0,0,6532,12457
2146,63,459,4958,139,156,3,0,0,5715,583,4518,194,778,0,0,0,6073,11788
2146,64,366,4909,133,170,1,0,0,5579,584,4336,179,835,1,0,0,5935,11514
2146,65,383,4557,129,180,1,0,0,5250,558,4029,175,866,0,0,0,5628,10878
2146,66,339,4434,119,203,1,0,0,5096,438,3809,151,878,0,0,0,5276,10372
2146,67,273,4182,121,222,0,0,0,4798,409,3726,152,982,0,0,0,5269,10067
2146,68,288,4259,103,231,0,0,0,4881,428,3622,154,1082,1,0,0,5287,10168
2146,69,232,4190,94,232,3,0,0,4751,437,3605,141,1262,0,0,0,5445,10196
2146,70,209,3700,69,219,1,0,0,4198,352,3032,131,1114,0,0,0,4629,8827
2146,71,188,3528,67,279,0,0,0,4062,355,2766,113,1183,0,0,0,4417,8479
2146,72,165,3536,68,274,0,0,0,4043,313,2679,117,1331,0,0,0,4440,8483
2146,73,134,3526,75,286,1,0,0,4022,319,2731,97,1512,0,0,0,4659,8681
2146,74,158,3327,58,329,1,0,0,3873,311,2641,82,1601,0,0,0,4635,8508
2146,75,120,3246,56,395,0,0,0,3817,307,2518,93,1626,1,0,0,4545,8362
2146,76,128,3067,44,396,0,0,0,3635,274,2160,84,1788,0,0,0,4306,7941
2146,77,108,2947,47,386,0,0,0,3488,250,2055,72,1959,0,0,0,4336,7824
2146,78,77,2242,34,350,2,0,0,2705,207,1518,44,1586,0,0,0,3355,6060
2146,79,93,1858,24,321,0,0,0,2296,199,1155,30,1445,0,0,0,2829,5125
2146,80,76,1791,24,345,0,0,1,2237,216,1243,31,1640,0,0,0,3130,5367
2146,81,57,1658,14,345,0,0,0,2074,177,1010,29,1568,0,0,0,2784,4858
2146,82,52,1402,24,366,0,0,0,1844,198,871,30,1669,0,0,0,2768,4612
2146,83,63,1440,12,435,0,0,0,1950,198,833,31,1828,0,0,0,2890,4840
2146,84,39,1253,11,434,0,0,0,1737,194,670,25,1713,0,0,0,2602,4339
2146,85,26,989,11,412,0,0,0,1438,164,541,20,1557,0,0,0,2282,3720
2146,86,31,833,5,358,0,0,0,1227,121,406,17,1393,0,0,0,1937,3164
2146,87,26,645,7,337,0,0,0,1015,124,331,10,1374,0,0,0,1839,2854
2146,88,21,559,4,304,1,0,0,889,125,228,10,1243,0,0,0,1606,2495
2146,89,15,380,3,238,0,0,0,636,90,159,13,1086,0,0,0,1348,1984
2146,90,18,289,1,244,0,0,0,552,85,129,12,836,0,0,0,1062,1614
2146,91,11,244,1,201,0,0,0,457,55,108,2,775,0,0,0,940,1397
2146,92,8,158,2,177,0,0,0,345,63,66,2,652,0,0,0,783,1128
2146,93,11,129,0,141,0,0,0,281,51,44,4,535,0,0,0,634,915
2146,94,6,64,0,104,0,0,0,174,31,17,3,387,0,0,0,438,612
2146,95,5,48,1,66,0,0,0,120,29,20,1,294,0,0,0,344,464
2146,96,4,23,0,43,0,0,0,70,23,7,1,206,0,0,0,237,307
2146,97,1,15,0,37,0,0,0,53,16,8,0,148,0,0,0,172,225
2146,98,0,10,0,22,0,0,0,32,10,9,1,112,0,0,0,132,164
2146,99,0,3,0,11,0,0,0,14,6,3,1,83,0,0,0,93,107
2146,100,3,12,0,18,0,0,0,33,16,5,1,115,0,0,0,137,170
2146,999,210555,217736,5642,10763,132,2,3,444833,185432,219823,8646,47726,61,1,0,461689,906522
2185,0,1300,0,0,0,0,0,0,1300,1216,0,0,0,0,0,0,1216,2516
2185,1,1416,0,0,0,0,0,0,1416,1280,0,0,0,0,0,0,1280,2696
2185,2,1388,0,0,0,0,0,0,1388,1387,0,0,0,0,0,0,1387,2775
2185,3,1407,0,0,0,0,0,0,1407,1298,0,0,0,0,0,0,1298,2705
2185,4,1427,0,0,0,0,0,0,1427,1291,0,0,0,0,0,0,1291,2718
2185,5,1445,0,0,0,0,0,0,1445,1404,0,0,0,0,0,0,1404,2849
2185,6,1504,0,0,0,0,0,0,1504,1461,0,0,0,0,0,0,1461,2965
2185,7,1541,0,0,0,0,0,0,1541,1425,0,0,0,0,0,0,1425,2966
2185,8,1503,0,0,0,0,0,0,1503,1465,0,0,0,0,0,0,1465,2968
2185,9,1523,0,0,0,0,0,0,1523,1425,0,0,0,0,0,0,1425,2948
2185,10,1543,0,0,0,0,0,0,1543,1427,0,0,0,0,0,0,1427,2970
2185,11,1549,0,0,0,0,0,0,1549,1524,0,0,0,0,0,0,1524,3073
2185,12,1672,0,0,0,0,0,0,1672,1503,0,0,0,0,0,0,1503,3175
2185,13,1642,0,0,0,0,0,0,1642,1536,0,0,0,0,0,0,1536,3178
2185,14,1680,0,0,0,0,0,0,1680,1650,0,0,0,0,0,0,1650,3330
2185,15,1710,0,0,0,0,0,0,1710,1624,0,0,0,0,0,0,1624,3334
2185,16,1641,1,0,0,0,0,0,1642,1548,0,0,0,0,0,0,1548,3190
2185,17,1801,0,0,0,0,0,0,1801,1572,0,0,0,0,0,0,1572,3373
2185,18,1862,0,0,0,0,0,0,1862,1552,6,0,0,0,0,0,1558,3420
2185,19,1863,1,0,0,0,0,0,1864,1603,11,0,0,0,0,0,1614,3478
2185,20,1872,0,0,0,0,0,0,1872,1589,30,0,0,0,0,0,1619,3491
2185,21,1812,7,0,0,0,0,0,1819,1571,43,0,0,0,0,0,1614,3433
2185,22,1828,19,0,1,0,0,0,1848,1583,76,0,0,0,0,0,1659,3507
2185,23,2001,24,1,0,0,0,0,2026,1527,106,0,0,0,0,0,1633,3659
2185,24,2052,52,0,0,0,0,0,2104,1477,160,0,0,0,0,0,1637,3741
2185,25,1882,53,0,0,0,0,0,1935,1433,196,1,0,0,0,0,1630,3565
2185,26,1890,101,0,0,1,0,0,1992,1366,362,3,0,1,0,0,1732,3724
2185,27,1741,160,3,0,0,0,0,1904,1299,425,0,0,0,0,0,1724,3628
2185,28,1749,185,4,0,0,0,0,1938,1220,556,14,0,5,0,0,1795,3733
2185,29,1682,310,3,1,1,0,0,1997,1112,549,6,0,1,0,0,1668,3665
2185,30,1630,381,5,0,1,0,0,2017,1112,750,13,1,0,0,0,1876,3893
2185,31,1541,517,8,0,0,0,0,2066,990,807,15,0,0,0,0,1812,3878
2185,32,1367,580,12,1,0,0,0,1960,883,937,26,1,1,0,0,1848,3808
2185,33,1359,741,10,0,1,0,0,2111,815,1008,29,2,1,0,0,1855,3966
2185,34,1272,773,15,1,1,0,0,2062,722,1086,30,4,4,0,0,1846,3908
2185,35,1212,971,23,0,3,0,0,2209,733,1131,27,6,1,0,0,1898,4107
2185,36,1119,1000,23,3,0,0,0,2145,708,1252,46,6,2,0,0,2014,4159
2185,37,1095,1036,25,2,5,0,0,2163,607,1290,45,8,1,0,0,1951,4114
2185,38,915,1161,27,1,0,0,0,2104,540,1317,66,13,2,0,0,1938,4042
2185,39,875,1178,34,1,3,0,0,2091,550,1361,64,13,1,0,0,1989,4080
2185,40,837,1221,43,3,2,0,0,2106,494,1433,71,10,0,0,0,2008,4114
2185,41,877,1353,42,3,6,0,0,2281,478,1490,80,12,1,0,0,2061,4342
2185,42,819,1369,53,6,2,0,0,2249,390,1561,72,19,1,0,0,2043,4292
2185,43,712,1491,62,4,0,0,0,2269,408,1579,87,19,1,0,0,2094,4363
2185,44,696,1397,78,2,1,0,0,2174,399,1513,108,33,2,0,0,2055,4229
2185,45,698,1506,73,7,1,0,0,2285,399,1662,118,22,0,0,0,2201,4486
2185,46,641,1554,82,3,2,0,0,2282,375,1679,101,24,0,0,0,2179,4461
2185,47,660,1670,75,6,1,0,0,2412,348,1832,130,31,0,0,0,2341,4753
2185,48,613,1748,89,11,3,0,0,2464,371,1802,142,45,0,0,0,2360,4824
2185,49,587,1815,101,6,1,0,0,2510,351,1901,155,50,0,0,0,2457,4967
2185,50,537,1772,116,13,2,0,0,2440,343,1817,148,57,2,0,0,2367,4807
2185,51,501,1735,108,15,0,0,0,2359,310,1785,143,54,1,0,0,2293,4652
2185,52,469,1759,122,17,1,0,0,2368,313,1926,142,57,0,0,0,2438,4806
2185,53,357,1850,118,21,1,0,0,2347,278,1826,149,74,0,0,0,2327,4674
2185,54,392,1924,117,26,0,0,0,2459,258,1871,160,85,0,0,0,2374,4833
2185,55,342,1845,121,27,3,0,0,2338,245,1967,163,102,0,0,0,2477,4815
2185,56,315,1888,124,29,4,0,0,2360,254,1934,143,119,0,0,0,2450,4810
2185,57,324,1899,115,29,1,0,0,2368,223,1862,148,132,0,0,0,2365,4733
2185,58,309,1931,95,21,1,0,0,2357,214,1845,109,135,0,0,0,2303,4660
2185,59,264,1898,106,36,0,0,0,2304,209,1778,126,147,0,0,0,2260,4564
2185,60,235,1805,93,29,0,0,0,2162,203,1793,120,180,1,0,0,2297,4459
2185,61,239,1817,130,36,2,0,0,2224,210,1734,116,176,0,0,0,2236,4460
2185,62,204,1782,103,44,1,0,0,2134,194,1716,116,185,0,0,0,2211,4345
2185,63,166,1763,81,50,0,0,0,2060,191,1718,107,246,0,0,0,2262,4322
2185,64,171,1672,92,59,0,0,0,1994,158,1617,99,254,0,0,0,2128,4122
2185,65,143,1540,79,55,0,0,0,1817,150,1457,95,287,0,0,0,1989,3806
2185,66,125,1576,56,58,2,0,0,1817,147,1396,86,280,0,0,0,1909,3726
2185,67,111,1540,62,62,2,0,0,1777,141,1451,59,321,0,0,0,1972,3749
2185,68,110,1497,52,62,2,0,0,1723,114,1329,67,337,0,0,0,1847,3570
2185,69,92,1504,58,76,0,0,0,1730,123,1403,71,365,0,0,0,1962,3692
2185,70,85,1331,53,64,0,0,0,1533,105,1145,63,423,0,0,0,1736,3269
2185,71,82,1259,44,58,1,0,0,1444,127,1115,51,413,0,0,0,1706,3150
2185,72,93,1210,35,94,0,0,0,1432,99,1069,44,467,0,0,0,1679,3111
2185,73,68,1267,34,93,0,0,0,1462,92,1034,42,492,0,0,0,1660,3122
2185,74,72,1373,39,100,0,0,0,1584,114,1029,47,613,0,0,0,1803,3387
2185,75,54,1251,36,124,2,0,0,1467,115,1020,44,653,0,0,0,1832,3299
2185,76,69,1272,35,118,0,0,0,1494,117,957,42,735,0,0,0,1851,3345
2185,77,48,1036,29,113,0,0,0,1226,100,780,41,645,0,0,0,1566,2792
2185,78,34,924,18,97,0,0,0,1073,78,563,32,559,0,0,0,1232,2305
2185,79,33,808,19,103,0,0,0,963,74,497,22,570,0,0,0,1163,2126
2185,80,28,754,17,102,0,0,0,901,68,400,26,661,0,0,0,1155,2056
2185,81,29,677,13,102,0,0,0,821,72,383,19,648,0,0,0,1122,1943
2185,82,28,679,17,108,0,0,0,832,78,334,16,730,0,0,0,1158,1990
2185,83,29,761,21,148,0,0,0,959,87,315,18,843,0,0,0,1263,2222
2185,84,30,654,7,138,0,0,0,829,99,235,17,837,0,0,0,1188,2017
2185,85,15,524,10,136,0,0,0,685,59,202,8,763,0,0,0,1032,1717
2185,86,13,435,6,95,0,0,0,549,56,136,6,631,0,0,0,829,1378
2185,87,13,380,5,127,0,0,0,525,55,112,12,621,0,0,0,800,1325
2185,88,9,330,2,107,0,0,0,448,46,83,8,536,0,0,0,673,1121
2185,89,11,247,2,102,0,0,0,362,39,58,5,493,0,0,0,595,957
2185,90,8,171,4,101,0,0,0,284,36,29,8,432,0,0,0,505,789
2185,91,5,128,2,81,0,0,0,216,35,20,3,404,0,0,0,462,678
2185,92,5,106,0,70,0,0,0,181,32,20,3,318,0,0,0,373,554
2185,93,3,61,0,71,0,0,0,135,21,6,2,240,0,0,0,269,404
2185,94,4,43,1,43,0,0,0,91,14,9,3,179,0,0,0,205,296
2185,95,3,35,0,34,0,0,0,72,13,4,6,133,0,0,0,156,228
2185,96,2,19,0,25,0,0,0,46,12,0,2,93,0,0,0,107,153
2185,97,2,11,1,20,0,0,0,34,10,5,0,74,0,0,0,89,123
2185,98,2,4,0,10,0,0,0,16,11,0,1,56,0,0,0,68,84
2185,99,0,3,0,5,0,0,0,8,3,1,0,43,0,0,0,47,55
2185,100,0,4,0,9,0,0,0,13,3,3,0,57,0,0,0,63,76
2185,999,75734,77129,3289,3425,60,0,0,159637,61189,75700,4407,18274,29,0,0,159599,319236
2205,0,1368,0,0,0,0,0,0,1368,1245,0,0,0,0,0,0,1245,2613
2205,1,1511,0,0,0,0,0,0,1511,1309,0,0,0,0,0,0,1309,2820
2205,2,1490,0,0,0,0,0,0,1490,1475,0,0,0,0,0,0,1475,2965
2205,3,1525,0,0,0,0,0,0,1525,1441,0,0,0,0,0,0,1441,2966
2205,4,1605,0,0,0,0,0,0,1605,1444,0,0,0,0,0,0,1444,3049
2205,5,1598,0,0,0,0,0,0,1598,1533,0,0,0,0,0,0,1533,3131
2205,6,1682,0,0,0,0,0,0,1682,1484,0,0,0,0,0,0,1484,3166
2205,7,1660,0,0,0,0,0,0,1660,1618,0,0,0,0,0,0,1618,3278
2205,8,1729,0,0,0,0,0,0,1729,1588,0,0,0,0,0,0,1588,3317
2205,9,1765,0,0,0,0,0,0,1765,1682,0,0,0,0,0,0,1682,3447
2205,10,1751,0,0,0,0,0,0,1751,1658,0,0,0,0,0,0,1658,3409
2205,11,1926,0,0,0,0,0,0,1926,1729,0,0,0,0,0,0,1729,3655
2205,12,1918,0,0,0,0,0,0,1918,1708,0,0,0,0,0,0,1708,3626
2205,13,1868,0,0,0,0,0,0,1868,1852,0,0,0,0,0,0,1852,3720
2205,14,1995,0,0,0,0,0,0,1995,1790,0,0,0,0,0,0,1790,3785
2205,15,1977,0,0,0,0,0,0,1977,1907,0,0,0,0,0,0,1907,3884
2205,16,2022,0,0,0,0,0,0,2022,1757,0,0,0,0,0,0,1757,3779
2205,17,2099,0,0,0,0,0,0,2099,1843,0,0,0,0,0,0,1843,3942
2205,18,2087,0,0,0,0,0,0,2087,1917,3,0,0,0,0,0,1920,4007
2205,19,2165,1,0,0,0,0,0,2166,1912,11,0,0,1,0,0,1924,4090
2205,20,2145,3,0,0,0,0,0,2148,1907,17,1,0,0,0,0,1925,4073
2205,21,2062,6,0,0,0,0,0,2068,1850,19,0,0,1,0,0,1870,3938
2205,22,2102,11,0,0,0,0,0,2113,1812,55,0,0,1,0,0,1868,3981
2205,23,2096,17,1,0,0,0,0,2114,1845,65,0,1,0,0,0,1911,4025
2205,24,2030,39,0,0,0,0,0,2069,1829,97,4,1,1,0,0,1932,4001
2205,25,2008,54,2,0,0,0,0,2064,1735,195,2,0,1,0,0,1933,3997
2205,26,1908,79,2,0,0,0,0,1989,1684,209,1,0,0,0,0,1894,3883
2205,27,1865,110,2,0,0,0,0,1977,1641,270,5,1,2,0,0,1919,3896
2205,28,1910,168,0,0,0,0,0,2078,1560,358,2,0,2,0,0,1922,4000
2205,29,1823,221,2,0,3,0,0,2049,1336,493,6,2,2,0,0,1839,3888
2205,30,1821,290,1,0,2,0,0,2114,1439,604,16,1,3,0,0,2063,4177
2205,31,1808,413,5,0,3,0,0,2229,1369,736,13,1,2,0,0,2121,4350
2205,32,1625,522,12,0,1,0,0,2160,1256,847,19,4,2,0,0,2128,4288
2205,33,1606,591,16,0,1,0,0,2214,1164,975,26,3,6,1,0,2175,4389
2205,34,1464,700,11,0,2,0,0,2177,1063,1127,31,2,3,0,0,2226,4403
2205,35,1486,808,13,1,5,0,0,2313,999,1155,22,7,2,0,0,2185,4498
2205,36,1365,930,22,3,2,0,0,2322,892,1195,50,4,3,0,0,2144,4466
2205,37,1251,1035,32,3,3,0,1,2325,865,1319,50,5,5,0,1,2245,4570
2205,38,1235,1079,35,2,4,0,0,2355,758,1448,68,5,4,0,0,2283,4638
2205,39,1116,1238,39,2,3,0,0,2398,764,1494,70,13,1,0,0,2342,4740
2205,40,1055,1306,59,1,1,0,0,2422,691,1584,73,14,2,0,0,2364,4786
2205,41,1051,1428,61,3,3,0,0,2546,643,1682,92,21,2,0,1,2441,4987
2205,42,989,1453,63,3,1,0,0,2509,609,1691,92,25,6,0,0,2423,4932
2205,43,914,1595,73,10,3,0,0,2595,548,1807,137,25,0,0,0,2517,5112
2205,44,931,1550,91,7,2,0,0,2581,553,1879,141,22,3,0,0,2598,5179
2205,45,917,1668,90,14,2,0,0,2691,557,1989,164,38,2,0,0,2750,5441
2205,46,812,1808,110,7,2,1,0,2740,507,2056,160,31,4,0,0,2758,5498
2205,47,900,1936,131,10,2,0,0,2979,489,2083,176,40,2,0,0,2790,5769
2205,48,809,1967,125,14,4,0,0,2919,470,2178,210,53,3,0,0,2914,5833
2205,49,797,2067,153,15,4,0,0,3036,490,2389,205,73,3,0,0,3160,6196
2205,50,741,2155,147,16,4,0,0,3063,414,2289,223,60,4,0,0,2990,6053
2205,51,721,2040,187,21,3,0,0,2972,410,2337,221,88,0,0,0,3056,6028
2205,52,650,2183,163,20,2,0,0,3018,389,2384,222,99,1,0,0,3095,6113
2205,53,567,2162,187,23,3,0,0,2942,370,2399,230,122,0,0,0,3121,6063
2205,54,553,2315,211,33,2,0,0,3114,337,2335,264,119,0,0,0,3055,6169
2205,55,510,2190,184,42,0,0,0,2926,324,2275,224,111,0,0,0,2934,5860
2205,56,447,2289,180,39,1,0,0,2956,313,2432,196,132,2,0,0,3075,6031
2205,57,432,2254,183,45,3,0,0,2917,254,2380,222,171,0,0,0,3027,5944
2205,58,383,2300,174,50,1,0,0,2908,260,2263,204,174,0,0,0,2901,5809
2205,59,399,2412,144,49,0,0,0,3004,251,2313,199,212,1,0,0,2976,5980
2205,60,330,2306,173,44,0,0,0,2853,261,2351,182,226,0,0,0,3020,5873
2205,61,275,2281,165,53,3,0,0,2777,244,2271,175,262,0,0,0,2952,5729
2205,62,297,2168,145,56,0,0,0,2666,211,2238,158,288,0,0,0,2895,5561
2205,63,246,2185,140,63,1,1,0,2636,203,2119,178,298,0,0,0,2798,5434
2205,64,242,2143,149,87,2,0,0,2623,192,2040,122,357,0,0,0,2711,5334
2205,65,213,2037,99,78,0,0,0,2427,159,1962,103,388,0,0,0,2612,5039
2205,66,214,2005,107,75,4,1,0,2406,177,1866,120,445,0,0,0,2608,5014
2205,67,167,1889,103,88,1,0,0,2248,146,1703,89,424,0,0,0,2362,4610
2205,68,181,1944,89,110,0,0,0,2324,156,1800,103,503,2,0,0,2564,4888
2205,69,152,1871,54,122,2,0,0,2201,152,1776,92,488,0,0,0,2508,4709
2205,70,120,1704,71,105,0,0,0,2000,138,1510,70,556,0,0,0,2274,4274
2205,71,129,1709,50,115,1,0,0,2004,122,1438,72,564,0,0,0,2196,4200
2205,72,122,1645,69,129,0,0,0,1965,124,1395,55,601,0,0,0,2175,4140
2205,73,105,1676,61,148,0,0,0,1990,143,1414,75,721,0,0,0,2353,4343
2205,74,73,1704,48,117,0,0,0,1942,113,1348,55,755,0,0,0,2271,4213
2205,75,111,1768,42,163,0,0,0,2084,124,1321,69,888,1,0,0,2403,4487
2205,76,85,1858,52,175,0,0,0,2170,128,1296,45,972,0,0,0,2441,4611
2205,77,81,1512,31,181,0,0,0,1805,118,1082,39,934,0,0,0,2173,3978
2205,78,55,1303,17,174,0,0,0,1549,113,884,46,837,0,0,0,1880,3429
2205,79,47,1130,22,145,0,0,0,1344,71,683,28,867,1,0,0,1650,2994
2205,80,56,982,16,155,0,0,0,1209,77,612,18,820,1,0,0,1528,2737
2205,81,39,875,19,159,0,0,0,1092,99,504,22,869,0,0,0,1494,2586
2205,82,34,829,16,179,0,0,0,1058,85,465,28,865,0,0,0,1443,2501
2205,83,41,878,18,195,0,0,0,1132,82,436,14,1046,0,0,0,1578,2710
2205,84,36,731,16,184,1,0,0,968,68,346,19,946,0,0,0,1379,2347
2205,85,25,635,13,179,0,0,0,852,63,246,14,957,0,0,0,1280,2132
2205,86,17,441,8,182,0,0,0,648,63,160,6,695,0,0,0,924,1572
2205,87,17,422,7,150,0,0,0,596,40,118,11,669,0,0,0,838,1434
2205,88,14,352,3,175,0,0,0,544,48,128,7,654,0,0,0,837,1381
2205,89,13,255,4,148,0,0,0,420,42,60,5,573,0,0,0,680,1100
2205,90,9,214,2,116,0,0,0,341,29,49,6,481,0,0,0,565,906
2205,91,6,162,2,86,0,0,0,256,26,32,5,420,0,0,0,483,739
2205,92,4,92,1,97,0,0,0,194,33,25,1,370,0,0,0,429,623
2205,93,4,74,1,72,0,0,0,151,23,14,4,319,0,0,0,360,511
2205,94,4,46,0,56,0,0,0,106,10,11,0,200,0,0,0,221,327
2205,95,3,26,0,36,0,0,0,65,13,8,0,135,0,0,0,156,221
2205,96,3,16,0,25,0,0,0,44,10,1,1,105,0,0,0,117,161
2205,97,0,14,0,16,0,0,0,30,9,1,2,91,0,0,0,103,133
2205,98,0,1,0,11,0,0,0,12,5,1,0,56,0,0,0,62,74
2205,99,1,6,1,10,0,0,0,18,5,1,0,42,0,0,0,48,66
2205,100,1,7,0,16,0,0,0,24,8,5,1,66,0,0,0,80,104
2205,999,88617,91289,4725,4908,87,3,1,189630,73472,91157,6081,23433,82,1,2,194228,383858
2262,0,582,0,0,0,0,0,0,582,560,0,0,0,0,0,0,560,1142
2262,1,609,0,0,0,0,0,0,609,595,0,0,0,0,0,0,595,1204
2262,2,608,0,0,0,0,0,0,608,614,0,0,0,0,0,0,614,1222
2262,3,622,0,0,0,0,0,0,622,604,0,0,0,0,0,0,604,1226
2262,4,694,0,0,0,0,0,0,694,649,0,0,0,0,0,0,649,1343
2262,5,718,0,0,0,0,0,0,718,673,0,0,0,0,0,0,673,1391
2262,6,747,0,0,0,0,0,0,747,720,0,0,0,0,0,0,720,1467
2262,7,800,0,0,0,0,0,0,800,694,0,0,0,0,0,0,694,1494
2262,8,746,0,0,0,0,0,0,746,736,0,0,0,0,0,0,736,1482
2262,9,825,0,0,0,0,0,0,825,741,0,0,0,0,0,0,741,1566
2262,10,804,0,0,0,0,0,0,804,731,0,0,0,0,0,0,731,1535
2262,11,862,0,0,0,0,0,0,862,769,0,0,0,0,0,0,769,1631
2262,12,868,0,0,0,0,0,0,868,795,0,0,0,0,0,0,795,1663
2262,13,901,0,0,0,0,0,0,901,773,0,0,0,0,0,0,773,1674
2262,14,800,0,0,0,0,0,0,800,772,0,0,0,0,0,0,772,1572
2262,15,925,0,0,0,0,0,0,925,801,0,0,0,0,0,0,801,1726
2262,16,836,0,0,0,0,0,0,836,804,0,0,0,0,0,0,804,1640
2262,17,910,0,0,0,0,0,0,910,845,0,0,0,0,0,0,845,1755
2262,18,855,1,0,0,0,0,0,856,831,2,0,0,0,0,0,833,1689
2262,19,879,1,0,0,0,0,0,880,831,3,0,0,0,0,0,834,1714
2262,20,903,0,0,0,1,0,0,904,865,4,0,0,0,0,0,869,1773
2262,21,933,0,0,0,0,0,0,933,802,11,0,0,0,0,0,813,1746
2262,22,894,3,0,0,1,0,0,898,807,24,0,0,0,0,0,831,1729
2262,23,967,5,0,0,0,0,0,972,872,27,1,0,1,0,0,901,1873
2262,24,979,13,0,0,1,0,0,993,830,35,0,0,0,0,0,865,1858
2262,25,965,38,2,0,0,0,0,1005,807,64,0,0,0,0,0,871,1876
2262,26,974,30,0,0,0,0,0,1004,786,107,3,0,0,0,0,896,1900
2262,27,973,45,1,0,0,0,0,1019,797,149,2,1,0,0,0,949,1968
2262,28,907,103,3,0,0,0,0,1013,660,164,3,0,0,0,0,827,1840
2262,29,834,97,2,0,1,0,0,934,650,194,6,0,0,1,0,851,1785
2262,30,826,137,0,0,1,0,0,964,631,260,5,1,0,0,0,897,1861
2262,31,804,186,6,0,0,0,0,996,551,323,7,1,1,0,0,883,1879
2262,32,806,188,3,1,0,0,0,998,513,312,12,2,0,0,0,839,1837
2262,33,745,263,7,0,0,0,0,1015,542,363,12,0,2,0,0,919,1934
2262,34,655,306,9,0,2,1,0,973,455,397,17,1,1,0,0,871,1844
2262,35,606,313,9,1,0,0,0,929,431,442,22,3,1,1,0,900,1829
2262,36,572,340,11,0,2,0,0,925,400,478,17,3,2,0,0,900,1825
2262,37,547,411,21,0,0,0,0,979,370,529,24,1,1,0,0,925,1904
2262,38,551,371,18,0,1,0,0,941,372,527,36,3,0,0,0,938,1879
2262,39,527,444,22,2,0,0,0,995,355,569,48,4,1,0,0,977,1972
2262,40,547,480,29,2,2,0,0,1060,350,542,51,6,1,0,0,950,2010
2262,41,512,496,27,1,0,0,0,1036,344,633,44,5,2,0,0,1028,2064
2262,42,483,547,28,1,4,0,0,1063,340,600,61,8,1,0,0,1010,2073
2262,43,480,582,44,5,2,0,0,1113,302,656,67,9,2,0,0,1036,2149
2262,44,456,546,42,1,1,0,0,1046,287,690,76,18,1,0,0,1072,2118
2262,45,465,654,54,4,0,0,0,1177,281,737,81,15,1,0,0,1115,2292
2262,46,492,629,59,3,2,0,0,1185,297,765,82,11,0,1,0,1156,2341
2262,47,480,731,52,9,2,0,0,1274,279,845,96,25,1,0,0,1246,2520
2262,48,476,754,77,5,1,0,0,1313,324,913,128,27,1,0,0,1393,2706
2262,49,471,792,102,7,0,0,0,1372,310,849,138,24,1,0,0,1322,2694
2262,50,482,821,79,4,2,0,0,1388,267,978,125,39,0,0,0,1409,2797
2262,51,451,866,95,5,3,0,0,1420,289,955,118,34,1,0,1,1398,2818
2262,52,422,891,108,9,1,0,0,1431,262,1013,135,39,2,0,0,1451,2882
2262,53,377,927,104,12,0,0,0,1420,257,982,122,38,2,0,0,1401,2821
2262,54,393,915,122,11,1,0,0,1442,269,1028,145,54,0,0,0,1496,2938
2262,55,405,988,109,10,1,0,0,1513,231,1033,149,59,2,0,0,1474,2987
2262,56,363,1007,122,12,0,0,0,1504,226,1056,154,67,2,0,0,1505,3009
2262,57,355,1028,133,28,2,0,0,1546,235,1115,129,80,1,0,0,1560,3106
2262,58,342,1026,143,19,0,0,0,1530,201,1061,159,83,2,0,0,1506,3036
2262,59,305,1075,128,20,0,0,0,1528,213,1069,152,107,0,0,0,1541,3069
2262,60,260,1063,136,17,1,0,0,1477,184,1059,127,111,2,0,0,1483,2960
2262,61,222,989,118,17,2,0,0,1348,165,1037,110,115,0,0,0,1427,2775
2262,62,239,965,128,22,0,0,0,1354,173,1025,127,132,1,0,0,1458,2812
2262,63,219,950,105,33,0,0,0,1307,157,957,136,140,1,0,0,1391,2698
2262,64,214,966,101,34,0,0,0,1315,127,974,86,184,0,0,0,1371,2686
2262,65,175,939,112,44,0,0,0,1270,133,874,90,187,1,0,0,1285,2555
2262,66,147,914,78,39,1,0,0,1179,115,848,79,194,0,0,0,1236,2415
2262,67,182,869,92,39,0,0,0,1182,118,801,76,188,0,0,0,1183,2365
2262,68,140,824,67,45,1,0,0,1077,108,790,76,214,0,0,0,1188,2265
2262,69,139,834,72,46,2,0,0,1093,98,754,84,226,0,0,0,1162,2255
2262,70,115,819,53,54,0,0,0,1041,104,728,57,235,0,0,0,1124,2165
2262,71,120,787,53,51,1,0,0,1012,80,667,66,246,0,0,0,1059,2071
2262,72,112,809,51,74,0,0,0,1046,83,677,48,284,0,0,0,1092,2138
2262,73,107,824,46,60,0,0,0,1037,71,646,51,332,0,0,0,1100,2137
2262,74,97,806,41,77,0,0,0,1021,69,590,30,306,0,0,0,995,2016
2262,75,81,726,32,66,0,0,0,905,66,617,43,375,0,0,0,1101,2006
2262,76,91,658,25,96,0,0,0,870,80,525,31,370,0,0,0,1006,1876
2262,77,85,633,33,107,0,0,0,858,84,534,32,423,0,0,0,1073,1931
2262,78,58,492,20,66,0,0,0,636,32,339,23,361,0,0,0,755,1391
2262,79,56,501,21,66,0,0,0,644,45,336,24,401,0,0,0,806,1450
2262,80,65,461,21,82,0,0,0,629,59,306,21,400,0,0,0,786,1415
2262,81,49,479,11,74,0,0,0,613,57,274,16,447,0,0,0,794,1407
2262,82,57,406,16,99,0,0,0,578,39,283,19,450,0,0,0,791,1369
2262,83,54,405,8,89,0,0,0,556,42,225,17,512,0,0,0,796,1352
2262,84,47,362,10,89,0,0,0,508,52,212,9,503,0,0,0,776,1284
2262,85,46,311,8,101,0,0,0,466,40,186,13,470,0,0,0,709,1175
2262,86,31,255,7,84,0,0,0,377,33,124,12,448,0,0,0,617,994
2262,87,25,213,4,87,0,0,0,329,39,91,12,411,0,0,0,553,882
2262,88,27,187,4,77,0,0,0,295,27,82,7,425,0,0,0,541,836
2262,89,22,137,4,80,0,0,0,243,30,60,5,362,0,0,0,457,700
2262,90,9,115,3,58,0,0,0,185,40,34,8,345,0,0,0,427,612
2262,91,11,84,2,60,0,0,0,157,33,34,3,295,0,0,0,365,522
2262,92,10,67,1,36,0,0,0,114,23,20,5,275,0,0,0,323,437
2262,93,5,28,1,41,0,0,0,75,18,15,4,242,0,0,0,279,354
2262,94,4,33,2,24,0,0,0,63,14,9,1,165,0,0,0,189,252
2262,95,2,19,0,23,0,0,0,44,10,2,1,145,0,0,0,158,202
2262,96,1,8,0,16,0,0,0,25,12,2,0,111,0,0,0,125,150
2262,97,2,4,0,14,0,0,0,20,7,2,0,75,0,0,0,84,104
2262,98,1,3,0,6,0,0,0,10,8,1,0,43,0,0,0,52,62
2262,99,0,2,0,4,0,0,0,6,1,1,1,40,0,0,0,43,49
2262,100,1,2,0,4,0,0,0,7,8,1,0,54,0,0,0,63,70
2262,999,43644,38999,3257,2373,42,1,0,88316,35282,39246,3977,12010,38,3,1,90557,178873
2351,0,11398,0,0,0,0,0,0,11398,10452,0,0,0,0,0,0,10452,21850
2351,1,11716,0,0,0,0,0,0,11716,11008,0,0,0,0,0,0,11008,22724
2351,2,11985,0,0,0,0,0,0,11985,11290,0,0,0,0,0,0,11290,23275
2351,3,11845,0,0,0,0,0,0,11845,11370,0,0,0,0,0,0,11370,23215
2351,4,12574,0,0,0,0,0,0,12574,11870,0,0,0,0,0,0,11870,24444
2351,5,13154,0,0,0,0,0,0,13154,12564,0,0,0,0,0,0,12564,25718
2351,6,13596,0,0,0,0,0,0,13596,12841,0,0,0,0,0,0,12841,26437
2351,7,14108,0,0,0,0,0,0,14108,13274,0,0,0,0,0,0,13274,27382
2351,8,14667,0,0,0,0,0,0,14667,13541,0,0,0,0,0,0,13541,28208
2351,9,14688,0,0,0,0,0,0,14688,14052,0,0,0,0,0,0,14052,28740
2351,10,14876,0,0,0,0,0,0,14876,13981,0,0,0,0,0,0,13981,28857
2351,11,15455,0,0,0,0,0,0,15455,14431,0,0,0,0,0,0,14431,29886
2351,12,15604,0,0,0,0,0,0,15604,14527,0,0,0,0,0,0,14527,30131
2351,13,16147,0,0,0,0,0,0,16147,14792,0,0,0,0,0,0,14792,30939
2351,14,16189,0,0,0,0,0,0,16189,15412,0,0,0,0,0,0,15412,31601
2351,15,16424,0,0,0,0,0,0,16424,15541,0,0,0,0,0,0,15541,31965
2351,16,16231,0,0,0,0,0,0,16231,15203,0,0,0,0,0,0,15203,31434
2351,17,16583,0,0,0,0,0,0,16583,15297,3,0,0,0,0,0,15300,31883
2351,18,16447,0,0,1,0,0,0,16448,14939,4,1,0,0,0,0,14944,31392
2351,19,17058,1,1,0,0,0,0,17060,15407,15,0,0,0,0,0,15422,32482
2351,20,16906,8,0,0,0,0,0,16914,14582,61,0,0,0,0,0,14643,31557
2351,21,16674,14,0,0,1,0,0,16689,14540,123,1,0,0,0,0,14664,31353
2351,22,16748,47,10,0,2,0,0,16807,14744,246,10,0,0,0,0,15000,31807
2351,23,17300,63,10,0,0,0,0,17373,14770,415,12,0,1,0,0,15198,32571
2351,24,17443,163,21,0,1,0,0,17628,14557,604,17,2,2,0,0,15182,32810
2351,25,17727,263,18,1,4,0,0,18013,14871,859,13,0,1,0,0,15744,33757
2351,26,17761,390,16,0,10,0,0,18177,15024,1219,21,1,7,2,0,16274,34451
2351,27,17873,577,31,0,17,2,0,18500,15130,1707,38,3,14,0,0,16892,35392
2351,28,17476,963,25,0,22,1,0,18487,14805,2324,47,2,12,2,0,17192,35679
2351,29,17516,1387,28,0,29,2,0,18962,14589,3167,72,9,13,1,0,17851,36813
2351,30,17196,1984,35,1,31,3,0,19250,14539,3844,90,7,27,1,0,18508,37758
2351,31,17121,2724,57,1,38,1,0,19942,14053,4944,130,9,27,0,0,19163,39105
2351,32,16362,3524,69,14,54,0,0,20023,13156,5863,175,30,26,3,0,19253,39276
2351,33,15850,4407,102,12,63,2,0,20436,12585,6810,237,21,34,0,0,19687,40123
2351,34,14910,5297,145,17,57,5,0,20431,12059,7636,252,28,37,6,0,20018,40449
2351,35,14571,6177,146,21,87,6,1,21009,10977,8550,343,41,50,3,0,19964,40973
2351,36,13042,6893,208,11,90,4,0,20248,9831,9095,420,36,39,6,0,19427,39675
2351,37,12109,7712,266,25,88,4,2,20206,9137,9561,539,85,51,5,0,19378,39584
2351,38,11708,8295,339,24,86,3,0,20455,8526,10327,692,98,53,3,0,19699,40154
2351,39,11110,9142,382,20,71,3,0,20728,8348,10680,705,103,51,6,1,19894,40622
2351,40,10617,9839,472,25,85,4,1,21043,8199,11153,814,136,42,2,0,20346,41389
2351,41,10283,10611,524,32,87,4,0,21541,7940,12149,915,144,46,3,0,21197,42738
2351,42,9746,10767,655,76,86,9,1,21340,7615,11963,1046,224,36,5,1,20890,42230
2351,43,9582,11046,648,101,65,3,0,21445,7134,12203,1154,203,40,4,1,20739,42184
2351,44,9152,11588,761,99,89,4,0,21693,7075,12654,1205,228,40,2,0,21204,42897
2351,45,9246,12319,827,92,73,1,1,22559,7056,13151,1406,256,39,4,1,21913,44472
2351,46,9225,12989,894,90,89,1,1,23289,7301,14004,1559,302,43,2,0,23211,46500
2351,47,9291,13344,1143,107,70,2,2,23959,7218,14734,1737,362,43,5,1,24100,48059
2351,48,9421,14390,1272,107,89,1,2,25282,7320,15674,2073,403,29,2,0,25501,50783
2351,49,9460,15298,1447,142,106,2,2,26457,7323,16599,2089,433,35,2,0,26481,52938
2351,50,8992,15865,1487,152,97,1,1,26595,7152,16858,2288,468,30,2,0,26798,53393
2351,51,8500,16077,1629,147,109,2,1,26465,6658,17266,2563,489,32,3,0,27011,53476
2351,52,8181,16630,1789,155,96,2,2,26855,6236,17453,2594,633,41,2,0,26959,53814
2351,53,7520,16751,1863,171,100,0,5,26410,5940,17488,2746,679,38,3,0,26894,53304
2351,54,7121,17254,2062,181,89,2,0,26709,5717,17923,2792,780,22,1,0,27235,53944
2351,55,6652,17283,2046,194,99,2,2,26278,5234,17813,2854,861,32,2,0,26796,53074
2351,56,6252,17203,2045,221,72,1,4,25798,5085,17774,2900,938,30,0,0,26727,52525
2351,57,6096,17558,2172,316,85,5,2,26234,4757,18232,3021,1082,17,2,0,27111,53345
2351,58,5577,17739,2260,308,88,1,2,25975,4533,18071,3007,1192,26,0,0,26829,52804
2351,59,4959,17915,2243,339,69,1,3,25529,4339,17899,2952,1261,26,1,0,26478,52007
2351,60,4194,16697,2026,346,75,2,3,23343,3682,16732,2809,1405,15,0,1,24644,47987
2351,61,3625,15739,1902,398,80,0,1,21745,3369,15993,2607,1534,21,0,1,23525,45270
2351,62,3335,15287,1813,419,81,0,5,20940,3020,15406,2378,1635,15,0,0,22454,43394
2351,63,2920,14917,1584,479,44,0,2,19946,2755,14657,2269,1837,24,0,0,21542,41488
2351,64,2618,14109,1482,442,47,0,3,18701,2513,14221,2145,2027,12,0,1,20919,39620
2351,65,2398,13579,1335,506,62,1,1,17882,2370,13400,1894,2074,9,0,2,19749,37631
2351,66,2109,13413,1240,514,36,1,0,17313,2217,13131,1888,2307,13,0,1,19557,36870
2351,67,1998,13028,1219,628,25,0,5,16903,1985,12469,1754,2480,8,0,0,18696,35599
2351,68,1605,12631,1064,584,28,1,0,15913,1742,12426,1679,2775,14,0,0,18636,34549
2351,69,1604,12299,1028,702,26,1,2,15662,1689,11812,1499,2874,8,0,0,17882,33544
2351,70,1454,11601,890,679,25,0,3,14652,1474,11222,1412,3085,5,0,0,17198,31850
2351,71,1349,11471,804,716,28,1,1,14370,1452,11109,1374,3321,7,0,1,17264,31634
2351,72,1220,10975,773,824,16,0,2,13810,1314,10895,1281,3682,8,0,2,17182,30992
2351,73,1187,11450,701,933,17,0,0,14288,1297,11048,1223,4075,6,0,0,17649,31937
2351,74,1131,11547,618,1020,24,0,1,14341,1315,10803,1214,4592,6,0,0,17930,32271
2351,75,1071,12201,658,1230,28,0,1,15189,1284,10935,1269,5335,5,0,0,18828,34017
2351,76,1037,11722,565,1316,24,0,2,14666,1236,10442,1157,5823,3,0,0,18661,33327
2351,77,968,12094,577,1483,14,0,2,15138,1192,10324,1133,6521,3,0,0,19173,34311
2351,78,670,8663,421,1179,3,0,2,10938,933,7137,759,5324,0,0,0,14153,25091
2351,79,680,8894,383,1302,14,0,1,11274,934,7316,764,5986,3,0,0,15003,26277
2351,80,585,8235,358,1372,8,1,2,10561,935,6749,714,6206,1,0,0,14605,25166
2351,81,615,7996,297,1420,10,0,0,10338,889,6099,718,6920,1,0,0,14627,24965
2351,82,520,7611,274,1630,9,0,1,10045,905,5674,632,7475,0,0,0,14686,24731
2351,83,511,7958,258,1826,6,0,1,10560,968,5485,592,8500,1,0,0,15546,26106
2351,84,446,7156,217,1849,9,0,0,9677,897,4781,481,8382,1,0,0,14542,24219
2351,85,349,6426,168,1849,4,0,0,8796,887,3807,470,8278,0,0,0,13442,22238
2351,86,286,5041,134,1733,5,0,1,7200,715,2918,325,7788,0,0,0,11746,18946
2351,87,215,4051,105,1510,2,0,0,5883,603,2157,316,6906,1,0,0,9983,15866
2351,88,198,3471,96,1443,1,0,0,5209,631,1732,248,6868,0,0,0,9479,14688
2351,89,200,2721,63,1291,2,0,0,4277,565,1261,209,6239,0,0,0,8274,12551
2351,90,132,2064,50,1089,3,0,0,3338,460,917,156,5352,1,0,0,6886,10224
2351,91,108,1549,29,963,2,0,0,2651,434,615,137,4799,0,0,0,5985,8636
2351,92,69,1220,24,819,3,0,0,2135,376,416,88,4097,0,0,0,4977,7112
2351,93,41,844,17,672,1,0,1,1576,332,276,99,3430,0,0,0,4137,5713
2351,94,37,558,13,512,0,0,0,1120,264,199,56,2740,0,0,0,3259,4379
2351,95,25,347,1,370,1,0,0,744,200,93,43,2028,0,0,0,2364,3108
2351,96,20,204,7,284,0,0,0,515,136,60,36,1502,0,0,0,1734,2249
2351,97,15,111,0,205,0,0,0,331,83,30,26,1141,0,0,0,1280,1611
2351,98,5,69,4,131,0,0,0,209,62,24,10,828,0,0,0,924,1133
2351,99,4,22,1,61,0,0,0,88,47,12,10,509,0,0,0,578,666
2351,100,10,43,1,101,0,0,0,155,82,20,7,881,0,0,0,990,1145
2351,999,815585,672511,53348,40033,3257,92,78,1584904,710691,683921,83411,181110,1323,85,14,1660555,3245459
2648,0,4359,0,0,0,0,0,0,4359,4263,0,0,0,0,0,0,4263,8622
2648,1,4605,0,0,0,0,0,0,4605,4210,0,0,0,0,0,0,4210,8815
2648,2,4594,0,0,0,0,0,0,4594,4443,0,0,0,0,0,0,4443,9037
2648,3,4871,0,0,0,0,0,0,4871,4504,0,0,0,0,0,0,4504,9375
2648,4,4993,0,0,0,0,0,0,4993,4703,0,0,0,0,0,0,4703,9696
2648,5,5240,0,0,0,0,0,0,5240,4916,0,0,0,0,0,0,4916,10156
2648,6,5428,0,0,0,0,0,0,5428,5115,0,0,0,0,0,0,5115,10543
2648,7,5560,0,0,0,0,0,0,5560,5442,0,0,0,0,0,0,5442,11002
2648,8,5800,0,0,0,0,0,0,5800,5516,0,0,0,0,0,0,5516,11316
2648,9,5866,0,0,0,0,0,0,5866,5613,0,0,0,0,0,0,5613,11479
2648,10,6031,0,0,0,0,0,0,6031,5730,0,0,0,0,0,0,5730,11761
2648,11,6084,0,0,0,0,0,0,6084,5980,0,0,0,0,0,0,5980,12064
2648,12,6505,0,0,0,0,0,0,6505,6055,0,0,0,0,0,0,6055,12560
2648,13,6878,0,0,0,0,0,0,6878,6316,0,0,0,0,0,0,6316,13194
2648,14,6810,0,0,0,0,0,0,6810,6478,0,0,0,0,0,0,6478,13288
2648,15,6925,0,0,0,0,0,0,6925,6440,0,0,0,0,0,0,6440,13365
2648,16,6904,0,0,0,0,0,0,6904,6429,0,0,0,0,0,0,6429,13333
2648,17,6872,0,0,0,0,0,0,6872,6415,0,0,0,0,0,0,6415,13287
2648,18,6570,2,0,0,0,0,0,6572,6156,7,0,0,0,0,0,6163,12735
2648,19,6801,0,0,0,0,0,0,6801,6247,18,0,0,0,0,0,6265,13066
2648,20,6763,2,0,0,0,0,0,6765,6045,76,0,0,0,0,0,6121,12886
2648,21,6801,7,0,0,0,0,0,6808,5862,100,1,0,0,0,0,5963,12771
2648,22,6974,45,6,0,0,0,0,7025,6016,217,6,1,0,0,0,6240,13265
2648,23,6976,65,3,0,0,0,0,7044,5887,310,7,0,0,0,0,6204,13248
2648,24,6894,110,5,0,2,0,0,7011,5773,444,5,1,0,2,0,6225,13236
2648,25,6843,187,13,0,4,0,0,7047,5535,628,9,1,2,1,0,6176,13223
2648,26,6618,315,8,0,2,1,0,6944,5454,814,17,0,2,0,0,6287,13231
2648,27,6424,412,10,0,8,0,0,6854,5203,999,20,1,7,0,0,6230,13084
2648,28,6262,565,14,0,6,0,0,6847,4871,1374,31,2,7,0,0,6285,13132
2648,29,5965,750,19,0,9,1,0,6744,4597,1713,37,5,8,1,0,6361,13105
2648,30,5844,1065,23,0,8,0,0,6940,4376,2035,54,3,12,1,0,6481,13421
2648,31,5688,1339,25,0,12,0,0,7064,4165,2351,68,6,6,1,0,6597,13661
2648,32,5026,1684,43,3,13,0,0,6769,3830,2722,81,11,9,2,0,6655,13424
2648,33,4987,2002,56,2,6,1,0,7054,3651,3123,104,10,11,1,0,6900,13954
2648,34,4828,2172,61,6,7,2,0,7076,3321,3298,138,12,13,0,0,6782,13858
2648,35,4642,2717,83,3,12,0,0,7457,3185,3666,159,16,5,1,0,7032,14489
2648,36,4165,2791,85,11,13,3,0,7068,2865,3841,183,19,9,1,0,6918,13986
2648,37,3962,3007,113,8,20,1,0,7111,2681,4078,237,29,6,0,0,7031,14142
2648,38,3994,3341,149,6,23,0,0,7513,2598,4229,299,40,14,1,0,7181,14694
2648,39,3742,3722,189,9,8,0,0,7670,2430,4557,326,35,19,0,0,7367,15037
2648,40,3658,3974,221,10,16,2,0,7881,2507,4669,426,49,13,0,0,7664,15545
2648,41,3588,4279,248,11,19,0,0,8145,2373,4971,426,64,12,0,0,7846,15991
2648,42,3513,4337,294,18,14,0,0,8176,2301,5063,519,95,14,0,0,7992,16168
2648,43,3327,4625,325,22,15,5,0,8319,2251,5326,595,79,13,1,0,8265,16584
2648,44,3240,4761,369,26,19,1,0,8416,2137,5372,595,95,20,2,0,8221,16637
2648,45,3201,5310,445,29,19,1,1,9006,2174,5803,687,99,10,0,0,8773,17779
2648,46,3511,5476,465,28,28,2,0,9510,2054,6012,832,121,12,0,0,9031,18541
2648,47,3338,5640,568,35,24,1,1,9607,2140,6276,861,150,8,0,0,9435,19042
2648,48,3430,6381,639,53,19,0,0,10522,2122,6761,967,184,17,0,0,10051,20573
2648,49,3369,6566,749,47,25,0,0,10756,2067,7012,1018,183,10,0,0,10290,21046
2648,50,3031,6556,769,50,28,1,0,10435,1868,6889,1027,188,8,1,0,9981,20416
2648,51,2900,6786,853,56,20,1,0,10616,1783,6960,1017,259,10,0,0,10029,20645
2648,52,2733,6838,934,59,12,1,0,10577,1690,6898,1071,260,11,1,0,9931,20508
2648,53,2525,7055,869,67,17,0,0,10533,1578,6982,1096,264,11,0,0,9931,20464
2648,54,2415,7225,931,69,29,1,0,10670,1552,7135,1136,325,6,0,0,10154,20824
2648,55,2259,7313,909,81,24,2,1,10589,1424,7295,1081,370,7,0,1,10178,20767
2648,56,2124,7389,934,97,15,0,0,10559,1480,7212,1133,425,7,1,1,10259,20818
2648,57,2011,7392,1017,125,20,0,0,10565,1379,7270,1123,469,5,0,0,10246,20811
2648,58,1851,7264,928,112,19,1,2,10177,1280,7322,1102,494,7,0,1,10206,20383
2648,59,1680,7639,909,136,26,0,0,10390,1257,7289,1089,571,7,0,0,10213,20603
2648,60,1499,6974,841,151,16,0,0,9481,1073,6965,1002,637,8,0,0,9685,19166
2648,61,1347,6781,824,169,12,0,0,9133,998,6579,878,664,5,1,0,9125,18258
2648,62,1232,6734,739,175,16,0,0,8896,975,6417,838,772,10,1,0,9013,17909
2648,63,1094,6452,677,195,19,0,0,8437,894,6070,784,848,5,0,0,8601,17038
2648,64,992,6093,626,219,11,0,1,7942,787,5927,674,855,7,0,0,8250,16192
2648,65,917,5954,559,200,6,0,0,7636,705,5506,623,1024,4,0,0,7862,15498
2648,66,847,5757,540,237,3,0,1,7385,670,5493,606,1009,5,0,0,7783,15168
2648,67,825,5748,475,267,6,0,2,7323,658,5241,561,1147,2,0,0,7609,14932
2648,68,715,5407,456,252,8,0,0,6838,564,5007,525,1184,3,0,1,7284,14122
2648,69,678,5352,402,276,8,1,0,6717,539,4861,486,1181,3,0,0,7070,13787
2648,70,605,5176,334,316,5,0,0,6436,469,4688,431,1280,1,0,0,6869,13305
2648,71,613,4893,335,338,10,0,0,6189,491,4556,356,1484,1,0,1,6889,13078
2648,72,579,4856,300,356,7,0,0,6098,433,4433,346,1629,0,0,0,6841,12939
2648,73,529,5127,280,386,6,0,0,6328,448,4427,319,1785,0,0,1,6980,13308
2648,74,546,4971,251,486,5,1,0,6260,437,4283,310,1949,0,0,0,6979,13239
2648,75,520,5158,239,505,5,0,0,6427,434,4199,286,2230,1,0,0,7150,13577
2648,76,414,4738,222,521,3,0,0,5898,421,3786,276,2282,3,0,0,6768,12666
2648,77,447,4730,187,523,3,0,0,5890,400,3686,270,2547,0,0,0,6903,12793
2648,78,303,3179,121,445,2,0,0,4050,284,2429,171,2018,1,0,0,4903,8953
2648,79,342,3436,107,521,0,0,0,4406,337,2479,180,2401,1,0,0,5398,9804
2648,80,283,3174,97,577,4,0,0,4135,288,2352,128,2554,0,0,0,5322,9457
2648,81,319,3083,69,599,2,0,1,4073,314,2184,132,2608,0,0,0,5238,9311
2648,82,321,2892,71,597,2,0,0,3883,320,1945,127,2877,0,0,0,5269,9152
2648,83,278,2824,62,681,0,0,0,3845,349,1794,118,3183,0,0,0,5444,9289
2648,84,249,2617,55,665,1,0,0,3587,346,1455,95,3218,0,0,0,5114,8701
2648,85,220,2204,51,675,0,0,0,3150,309,1200,74,3154,0,0,0,4737,7887
2648,86,145,1749,29,551,1,0,0,2475,283,853,66,2710,0,0,0,3912,6387
2648,87,120,1270,13,495,1,0,0,1899,244,635,39,2460,0,0,0,3378,5277
2648,88,103,1054,21,513,0,0,0,1691,218,538,37,2492,0,0,0,3285,4976
2648,89,94,776,11,450,0,0,0,1331,205,308,28,2127,0,0,0,2668,3999
2648,90,74,623,6,375,1,0,0,1079,187,229,21,2033,0,0,0,2470,3549
2648,91,61,522,9,322,0,0,0,914,146,189,18,1749,0,0,0,2102,3016
2648,92,33,322,4,253,0,0,0,612,147,109,10,1503,0,0,1,1770,2382
2648,93,31,235,1,237,0,0,0,504,131,78,20,1329,0,0,0,1558,2062
2648,94,22,156,1,164,0,0,0,343,114,51,5,1056,0,0,0,1226,1569
2648,95,11,100,0,123,0,0,0,234,88,31,7,781,0,0,0,907,1141
2648,96,6,72,1,78,0,0,0,157,59,9,7,588,0,0,0,663,820
2648,97,6,26,1,52,0,0,0,85,49,5,4,392,0,0,0,450,535
2648,98,1,20,0,43,0,0,0,64,33,14,2,283,0,0,0,332,396
2648,99,2,9,1,25,0,0,0,37,21,4,0,183,0,0,0,208,245
2648,100,3,9,0,32,0,0,0,44,37,4,4,297,0,0,0,342,386
2648,999,306224,280359,23299,15224,724,30,10,625870,252638,280136,30447,71439,398,20,7,635085,1260955
2938,0,1191,0,0,0,0,0,0,1191,1063,0,0,0,0,0,0,1063,2254
2938,1,1207,0,0,0,0,0,0,1207,1089,0,0,0,0,0,0,1089,2296
2938,2,1255,0,0,0,0,0,0,1255,1227,0,0,0,0,0,0,1227,2482
2938,3,1286,0,0,0,0,0,0,1286,1174,0,0,0,0,0,0,1174,2460
2938,4,1387,0,0,0,0,0,0,1387,1269,0,0,0,0,0,0,1269,2656
2938,5,1361,0,0,0,0,0,0,1361,1229,0,0,0,0,0,0,1229,2590
2938,6,1454,0,0,0,0,0,0,1454,1362,0,0,0,0,0,0,1362,2816
2938,7,1401,0,0,0,0,0,0,1401,1399,0,0,0,0,0,0,1399,2800
2938,8,1546,0,0,0,0,0,0,1546,1372,0,0,0,0,0,0,1372,2918
2938,9,1557,0,0,0,0,0,0,1557,1479,0,0,0,0,0,0,1479,3036
2938,10,1590,0,0,0,0,0,0,1590,1481,0,0,0,0,0,0,1481,3071
2938,11,1650,0,0,0,0,0,0,1650,1520,0,0,0,0,0,0,1520,3170
2938,12,1646,0,0,0,0,0,0,1646,1492,0,0,0,0,0,0,1492,3138
2938,13,1775,0,0,0,0,0,0,1775,1584,0,0,0,0,0,0,1584,3359
2938,14,1746,0,0,0,0,0,0,1746,1595,0,0,0,0,0,0,1595,3341
2938,15,1818,0,0,0,0,0,0,1818,1677,0,0,0,0,0,0,1677,3495
2938,16,1751,0,0,0,0,0,0,1751,1592,0,0,0,0,0,0,1592,3343
2938,17,1747,0,0,0,0,0,0,1747,1576,0,0,0,0,0,0,1576,3323
2938,18,1773,0,0,0,0,0,0,1773,1592,3,0,0,0,0,0,1595,3368
2938,19,1747,0,0,0,0,0,0,1747,1558,3,0,0,0,0,0,1561,3308
2938,20,1777,2,0,0,0,0,0,1779,1506,13,0,0,0,0,0,1519,3298
2938,21,1759,2,0,0,0,0,0,1761,1498,21,0,0,0,0,0,1519,3280
2938,22,1742,8,0,0,0,0,0,1750,1612,53,1,0,0,0,0,1666,3416
2938,23,1846,15,0,0,0,0,0,1861,1589,82,4,0,1,0,0,1676,3537
2938,24,1803,26,2,0,0,0,0,1831,1508,119,4,0,0,0,0,1631,3462
2938,25,1851,36,4,0,0,0,0,1891,1553,145,4,0,0,0,0,1702,3593
2938,26,1827,84,3,0,1,0,0,1915,1431,194,4,0,1,0,0,1630,3545
2938,27,1741,107,2,0,1,0,0,1851,1441,221,4,1,1,0,0,1668,3519
2938,28,1761,137,5,0,1,0,0,1904,1333,337,11,1,2,0,0,1684,3588
2938,29,1654,212,7,0,2,0,0,1875,1288,403,12,2,0,0,0,1705,3580
2938,30,1582,260,6,0,0,0,0,1848,1203,549,16,1,3,0,0,1772,3620
2938,31,1544,349,9,0,2,0,0,1904,1133,694,20,1,4,0,0,1852,3756
2938,32,1466,473,11,0,0,0,0,1950,1054,721,24,1,3,0,0,1803,3753
2938,33,1352,503,13,3,3,0,0,1874,993,823,42,5,3,0,0,1866,3740
2938,34,1318,615,15,4,2,1,0,1955,966,930,35,5,5,0,0,1941,3896
2938,35,1256,697,21,1,3,0,0,1978,788,983,43,0,1,0,0,1815,3793
2938,36,1150,745,26,1,1,0,0,1923,736,1087,48,8,5,0,0,1884,3807
2938,37,1116,782,21,2,3,1,0,1925,713,1145,51,6,3,0,0,1918,3843
2938,38,1078,905,48,3,4,0,0,2038,753,1085,75,8,5,0,0,1926,3964
2938,39,1043,1000,59,3,4,0,0,2109,672,1179,93,16,1,0,0,1961,4070
2938,40,963,1042,56,1,3,0,1,2066,632,1247,89,9,4,0,0,1981,4047
2938,41,1017,1143,67,2,6,0,1,2236,641,1353,99,14,3,0,0,2110,4346
2938,42,937,1203,68,6,5,2,0,2221,630,1377,107,16,2,0,0,2132,4353
2938,43,894,1250,81,5,4,1,0,2235,617,1448,105,24,4,0,0,2198,4433
2938,44,923,1344,94,10,0,0,0,2371,615,1460,118,25,4,0,0,2222,4593
2938,45,957,1384,101,11,7,0,0,2460,570,1607,193,31,3,0,0,2404,4864
2938,46,986,1468,121,15,6,0,0,2596,612,1655,186,25,1,1,0,2480,5076
2938,47,967,1558,137,13,4,0,0,2679,638,1748,193,49,1,0,0,2629,5308
2938,48,996,1695,155,16,2,0,0,2864,579,1852,248,41,2,0,0,2722,5586
2938,49,949,1704,181,10,5,0,0,2849,557,1860,244,43,5,0,0,2709,5558
2938,50,838,1712,189,19,4,0,1,2763,535,1878,285,58,3,0,0,2759,5522
2938,51,864,1855,189,15,5,0,1,2929,542,1845,220,52,2,0,0,2661,5590
2938,52,846,1858,211,19,4,0,1,2939,493,1939,275,73,2,0,0,2782,5721
2938,53,736,1791,226,24,3,0,0,2780,415,1960,299,92,1,1,0,2768,5548
2938,54,744,1989,247,22,5,0,0,3007,466,2012,262,112,3,0,0,2855,5862
2938,55,724,2006,257,28,6,0,0,3021,425,2046,274,118,3,0,0,2866,5887
2938,56,650,1978,222,24,7,0,0,2881,401,2008,261,131,0,0,0,2801,5682
2938,57,645,2134,256,24,6,0,0,3065,399,2073,281,131,3,0,0,2887,5952
2938,58,588,2098,242,45,5,0,0,2978,402,2086,285,149,1,0,0,2923,5901
2938,59,586,2007,245,46,1,0,1,2886,343,2041,268,191,1,0,0,2844,5730
2938,60,500,2008,221,43,3,0,0,2775,340,2062,224,204,1,0,0,2831,5606
2938,61,433,1888,207,43,8,0,0,2579,303,1925,226,188,1,0,0,2643,5222
2938,62,396,1894,197,53,3,0,0,2543,268,1849,186,263,0,0,0,2566,5109
2938,63,371,1853,155,63,5,0,0,2447,241,1868,192,250,1,0,0,2552,4999
2938,64,348,1816,176,67,3,0,0,2410,224,1771,184,277,0,0,0,2456,4866
2938,65,335,1766,151,87,1,0,0,2340,257,1702,183,290,0,0,1,2433,4773
2938,66,306,1651,151,59,1,0,0,2168,199,1624,192,297,1,0,0,2313,4481
2938,67,270,1680,101,89,4,0,1,2145,157,1587,142,361,0,0,0,2247,4392
2938,68,271,1628,120,80,1,0,0,2100,167,1636,152,386,0,0,0,2341,4441
2938,69,243,1605,104,115,2,0,0,2069,144,1458,104,428,0,0,0,2134,4203
2938,70,223,1517,96,105,4,0,0,1945,153,1418,134,428,0,0,0,2133,4078
2938,71,218,1535,96,108,3,0,0,1960,144,1358,99,488,1,0,0,2090,4050
2938,72,218,1538,73,97,1,0,0,1927,133,1301,103,500,0,0,0,2037,3964
2938,73,223,1605,76,154,3,0,0,2061,129,1377,87,535,0,0,0,2128,4189
2938,74,215,1533,76,163,2,0,0,1989,147,1284,92,686,0,0,0,2209,4198
2938,75,218,1575,67,145,1,0,0,2006,120,1323,84,737,0,0,0,2264,4270
2938,76,178,1485,68,169,0,0,0,1900,115,1158,62,754,0,0,1,2090,3990
2938,77,153,1447,50,176,1,0,0,1827,143,1121,65,810,1,0,0,2140,3967
2938,78,115,923,27,141,1,0,0,1207,111,668,47,602,0,0,1,1429,2636
2938,79,115,917,26,176,0,0,0,1234,109,714,43,754,0,0,0,1620,2854
2938,80,122,879,26,181,1,0,0,1209,98,663,39,782,0,0,0,1582,2791
2938,81,123,888,18,201,0,0,0,1230,114,607,41,876,0,0,0,1638,2868
2938,82,118,841,21,184,0,0,0,1164,111,566,35,918,0,0,0,1630,2794
2938,83,131,795,23,236,0,0,0,1185,105,501,39,1003,0,0,0,1648,2833
2938,84,95,785,12,270,0,0,0,1162,91,454,25,1033,0,0,0,1603,2765
2938,85,97,657,7,210,0,0,0,971,109,390,24,1051,1,0,0,1575,2546
2938,86,78,538,9,182,0,0,0,807,92,227,19,924,0,0,0,1262,2069
2938,87,57,425,9,160,0,0,0,651,85,213,9,860,0,0,0,1167,1818
2938,88,53,350,5,174,0,0,0,582,74,153,20,823,0,0,0,1070,1652
2938,89,40,276,5,140,0,0,0,461,60,123,6,739,0,0,0,928,1389
2938,90,27,192,4,118,0,0,0,341,73,71,4,669,0,0,0,817,1158
2938,91,26,145,1,118,0,0,0,290,43,47,10,614,0,0,0,714,1004
2938,92,20,102,0,74,0,0,0,196,57,37,2,493,0,0,0,589,785
2938,93,9,68,0,85,0,0,0,162,44,26,2,439,0,0,0,511,673
2938,94,7,52,1,47,0,0,0,107,50,21,3,313,0,0,0,387,494
2938,95,6,33,0,37,0,0,0,76,21,11,2,250,0,0,0,284,360
2938,96,1,24,0,34,0,0,0,59,15,4,2,174,0,0,0,195,254
2938,97,0,9,0,25,0,0,0,34,15,7,0,159,0,0,0,181,215
2938,98,4,7,0,15,0,0,0,26,14,0,1,101,0,0,0,116,142
2938,99,0,5,0,6,0,0,0,11,12,0,0,67,0,0,0,79,90
2938,100,3,3,0,17,0,0,0,23,6,4,0,101,0,0,0,111,134
2938,999,84730,79115,5976,5019,163,5,7,175015,67505,79614,7667,23066,93,2,3,177950,352965
3018,0,2423,0,0,0,0,0,0,2423,2273,0,0,0,0,0,0,2273,4696
3018,1,2475,0,0,0,0,0,0,2475,2488,0,0,0,0,0,0,2488,4963
3018,2,2678,0,0,0,0,0,0,2678,2551,0,0,0,0,0,0,2551,5229
3018,3,2656,0,0,0,0,0,0,2656,2577,0,0,0,0,0,0,2577,5233
3018,4,2775,0,0,0,0,0,0,2775,2577,0,0,0,0,0,0,2577,5352
3018,5,2832,0,0,0,0,0,0,2832,2611,0,0,0,0,0,0,2611,5443
3018,6,2828,0,0,0,0,0,0,2828,2687,0,0,0,0,0,0,2687,5515
3018,7,2825,0,0,0,0,0,0,2825,2764,0,0,0,0,0,0,2764,5589
3018,8,2850,0,0,0,0,0,0,2850,2758,0,0,0,0,0,0,2758,5608
3018,9,2925,0,0,0,0,0,0,2925,2805,0,0,0,0,0,0,2805,5730
3018,10,2884,0,0,0,0,0,0,2884,2617,0,0,0,0,0,0,2617,5501
3018,11,2953,0,0,0,0,0,0,2953,2761,0,0,0,0,0,0,2761,5714
3018,12,2896,0,0,0,0,0,0,2896,2747,0,0,0,0,0,0,2747,5643
3018,13,2922,0,0,0,0,0,0,2922,2680,0,0,0,0,0,0,2680,5602
3018,14,2926,0,0,0,0,0,0,2926,2711,0,0,0,0,0,0,2711,5637
3018,15,2984,0,0,0,0,0,0,2984,2808,0,0,0,0,0,0,2808,5792
3018,16,3098,0,0,0,0,0,0,3098,2734,0,0,0,0,0,0,2734,5832
3018,17,2985,1,0,0,0,0,0,2986,2826,0,0,0,0,0,0,2826,5812
3018,18,3120,0,0,0,0,0,0,3120,2820,3,0,0,0,0,0,2823,5943
3018,19,3114,1,0,0,0,0,0,3115,2837,18,0,0,0,0,0,2855,5970
3018,20,3085,2,0,0,0,0,0,3087,2776,43,0,0,0,0,0,2819,5906
3018,21,3001,8,0,0,0,0,0,3009,2716,52,1,0,0,0,0,2769,5778
3018,22,3163,19,5,0,0,0,0,3187,2796,86,4,0,0,0,0,2886,6073
3018,23,3133,39,1,0,0,0,0,3173,2784,130,4,0,1,0,0,2919,6092
3018,24,3136,55,3,0,0,0,0,3194,2766,193,4,0,2,0,0,2965,6159
3018,25,3100,123,2,0,0,0,0,3225,2684,287,9,0,0,0,0,2980,6205
3018,26,3144,169,8,0,2,0,0,3323,2572,384,3,0,2,0,0,2961,6284
3018,27,2964,244,3,0,3,0,0,3214,2418,530,12,4,0,0,0,2964,6178
3018,28,2788,305,6,0,2,0,0,3101,2145,598,13,1,5,0,0,2762,5863
3018,29,2713,417,17,1,2,0,0,3150,2142,779,14,0,4,0,0,2939,6089
3018,30,2545,516,15,0,2,0,0,3078,1948,914,30,0,3,0,0,2895,5973
3018,31,2507,685,13,0,5,0,0,3210,1817,1108,35,2,8,1,0,2971,6181
3018,32,2397,813,26,3,2,0,0,3241,1810,1240,36,8,3,0,0,3097,6338
3018,33,2326,959,26,3,5,0,0,3319,1642,1327,40,1,9,0,0,3019,6338
3018,34,2133,1117,23,2,1,0,0,3276,1577,1424,63,6,8,0,0,3078,6354
3018,35,2005,1189,43,5,2,2,0,3246,1533,1486,59,3,8,1,0,3090,6336
3018,36,1859,1210,38,4,6,0,0,3117,1409,1523,68,6,5,0,0,3011,6128
3018,37,1765,1341,52,3,5,0,0,3166,1287,1623,85,18,7,1,0,3021,6187
3018,38,1683,1484,51,3,2,2,0,3225,1264,1730,102,17,8,0,0,3121,6346
3018,39,1648,1484,48,3,7,0,0,3190,1238,1698,113,18,5,1,0,3073,6263
3018,40,1582,1612,51,3,5,1,0,3254,1248,1870,117,16,4,0,0,3255,6509
3018,41,1587,1746,71,2,4,0,0,3410,1264,2022,132,17,4,1,0,3440,6850
3018,42,1573,1792,83,13,1,0,0,3462,1200,2031,151,39,5,0,0,3426,6888
3018,43,1531,1842,83,14,3,1,0,3474,1109,2093,161,49,4,0,0,3416,6890
3018,44,1425,1754,77,7,6,0,0,3269,1157,2057,165,36,3,0,0,3418,6687
3018,45,1420,1876,109,7,4,0,0,3416,1114,2145,180,36,4,0,0,3479,6895
3018,46,1384,1878,138,12,1,0,0,3413,1086,2096,227,46,2,1,0,3458,6871
3018,47,1315,1985,144,9,8,0,0,3461,1188,2136,254,39,3,0,0,3620,7081
3018,48,1402,2181,170,14,2,0,0,3769,1129,2302,296,48,4,1,0,3780,7549
3018,49,1489,2268,189,17,15,0,0,3978,1177,2401,311,81,4,0,0,3974,7952
3018,50,1417,2225,267,20,8,0,0,3937,1162,2517,340,70,5,1,0,4095,8032
3018,51,1450,2434,251,21,4,1,0,4161,1178,2619,356,66,4,1,0,4224,8385
3018,52,1456,2525,270,26,7,0,0,4284,1084,2674,404,97,5,0,0,4264,8548
3018,53,1355,2511,278,29,5,0,0,4178,979,2690,488,104,2,0,0,4263,8441
3018,54,1458,2744,337,29,8,0,0,4576,960,2798,452,134,3,0,0,4347,8923
3018,55,1277,2721,325,34,8,1,1,4367,953,2834,475,124,3,1,0,4390,8757
3018,56,1172,2685,354,38,3,0,0,4252,879,2791,467,180,4,0,0,4321,8573
3018,57,1182,2826,347,29,7,0,0,4391,812,2873,473,178,2,0,0,4338,8729
3018,58,1069,2969,376,41,8,0,0,4463,853,2750,509,168,3,0,0,4283,8746
3018,59,988,2941,398,57,4,0,0,4388,674,2885,459,231,3,1,0,4253,8641
3018,60,835,2812,363,63,4,0,0,4077,649,2773,400,211,0,0,0,4033,8110
3018,61,734,2706,319,53,2,0,0,3814,594,2639,429,248,0,0,0,3910,7724
3018,62,694,2514,350,68,3,0,0,3629,571,2557,379,271,1,0,0,3779,7408
3018,63,629,2527,343,68,5,0,0,3572,486,2414,357,289,1,0,0,3547,7119
3018,64,517,2540,305,76,1,0,0,3439,457,2274,323,283,2,0,0,3339,6778
3018,65,484,2282,256,79,3,0,0,3104,429,2101,291,353,2,0,0,3176,6280
3018,66,446,2105,221,82,2,0,0,2856,424,2159,270,370,0,0,0,3223,6079
3018,67,415,2091,204,75,4,0,0,2789,331,1955,247,400,1,0,0,2934,5723
3018,68,360,2017,199,76,1,0,0,2653,321,1833,202,429,1,0,0,2786,5439
3018,69,325,1885,187,84,1,0,0,2482,282,1752,215,419,2,0,0,2670,5152
3018,70,301,1838,148,106,2,0,0,2395,265,1710,205,478,0,0,0,2658,5053
3018,71,301,1723,143,101,1,0,0,2269,256,1669,152,511,0,0,0,2588,4857
3018,72,242,1762,136,112,0,0,0,2252,207,1505,166,545,0,0,0,2423,4675
3018,73,262,1650,143,125,1,0,0,2181,252,1491,168,588,1,0,0,2500,4681
3018,74,225,1647,109,150,1,0,0,2132,216,1436,142,650,0,0,0,2444,4576
3018,75,215,1708,105,136,1,0,1,2166,219,1441,126,736,0,0,0,2522,4688
3018,76,200,1534,87,181,0,0,0,2002,191,1356,137,766,0,0,0,2450,4452
3018,77,203,1621,81,210,0,0,0,2115,249,1368,138,873,0,0,0,2628,4743
3018,78,133,1213,47,138,2,0,1,1534,155,906,101,716,0,0,0,1878,3412
3018,79,161,1341,66,189,0,0,0,1757,188,1092,89,899,0,0,0,2268,4025
3018,80,144,1479,49,231,1,0,0,1904,182,1079,104,962,0,0,0,2327,4231
3018,81,146,1349,79,197,0,0,0,1771,186,942,88,1098,0,0,0,2314,4085
3018,82,145,1301,57,231,0,0,0,1734,168,881,78,1119,0,0,0,2246,3980
3018,83,127,1067,41,218,0,0,0,1453,161,688,65,1069,0,0,0,1983,3436
3018,84,117,1021,25,227,0,0,0,1390,149,584,58,1155,0,0,0,1946,3336
3018,85,78,834,24,238,0,0,0,1174,148,467,38,1020,0,0,0,1673,2847
3018,86,73,722,20,204,0,0,0,1019,139,337,34,953,0,0,0,1463,2482
3018,87,68,549,14,170,0,0,0,801,139,270,25,912,0,0,0,1346,2147
3018,88,55,425,11,177,0,0,0,668,99,224,16,846,0,0,0,1185,1853
3018,89,43,413,6,171,0,0,0,633,113,164,14,805,0,0,0,1096,1729
3018,90,40,345,9,143,0,0,0,537,105,110,10,732,0,0,0,957,1494
3018,91,16,249,4,169,0,0,0,438,84,79,11,641,0,0,0,815,1253
3018,92,20,199,4,114,0,0,0,337,75,62,6,549,0,0,0,692,1029
3018,93,21,139,4,102,0,0,0,266,71,42,11,453,0,0,0,577,843
3018,94,7,68,0,79,0,0,0,154,53,30,4,348,0,0,0,435,589
3018,95,7,69,1,55,0,0,0,132,36,21,4,245,0,0,0,306,438
3018,96,7,36,0,47,0,0,0,90,34,9,4,197,0,0,0,244,334
3018,97,1,17,1,23,0,0,0,42,27,4,1,133,0,0,0,165,207
3018,98,0,13,0,25,0,0,0,38,20,3,2,96,0,0,0,121,159
3018,99,1,3,0,16,0,0,0,20,16,1,0,72,0,0,0,89,109
3018,100,2,3,0,17,0,0,0,22,17,1,0,116,0,0,0,134,156
3018,999,144576,107513,8859,5475,192,8,3,266626,124926,108189,12222,25399,160,11,0,270907,537533
3234,0,1984,0,0,0,0,0,0,1984,1817,0,0,0,0,0,0,1817,3801
3234,1,2158,0,0,0,0,0,0,2158,1880,0,0,0,0,0,0,1880,4038
3234,2,2174,0,0,0,0,0,0,2174,2070,0,0,0,0,0,0,2070,4244
3234,3,2164,0,0,0,0,0,0,2164,1992,0,0,0,0,0,0,1992,4156
3234,4,2289,0,0,0,0,0,0,2289,2047,0,0,0,0,0,0,2047,4336
3234,5,2242,0,0,0,0,0,0,2242,2197,0,0,0,0,0,0,2197,4439
3234,6,2400,0,0,0,0,0,0,2400,2259,0,0,0,0,0,0,2259,4659
3234,7,2479,0,0,0,0,0,0,2479,2356,0,0,0,0,0,0,2356,4835
3234,8,2541,0,0,0,0,0,0,2541,2371,0,0,0,0,0,0,2371,4912
3234,9,2603,0,0,0,0,0,0,2603,2432,0,0,0,0,0,0,2432,5035
3234,10,2713,0,0,0,0,0,0,2713,2554,0,0,0,0,0,0,2554,5267
3234,11,2778,0,0,0,0,0,0,2778,2590,0,0,0,0,0,0,2590,5368
3234,12,2774,0,0,0,0,0,0,2774,2683,0,0,0,0,0,0,2683,5457
3234,13,2916,0,0,0,0,0,0,2916,2738,0,0,0,0,0,0,2738,5654
3234,14,2894,0,0,0,0,0,0,2894,2727,0,0,0,0,0,0,2727,5621
3234,15,2908,0,0,0,0,0,0,2908,2768,0,0,0,0,0,0,2768,5676
3234,16,2819,0,0,0,0,0,0,2819,2700,0,0,0,0,0,0,2700,5519
3234,17,2926,0,0,0,0,0,0,2926,2669,0,0,0,0,0,0,2669,5595
3234,18,3025,0,0,0,0,0,0,3025,2669,2,0,0,0,0,0,2671,5696
3234,19,3045,0,0,0,0,0,0,3045,2789,7,0,0,0,0,0,2796,5841
3234,20,2942,1,0,0,0,0,0,2943,2685,12,0,0,0,0,0,2697,5640
3234,21,2959,6,0,0,0,0,0,2965,2656,27,0,0,0,0,0,2683,5648
3234,22,3030,14,1,0,0,0,0,3045,2636,63,0,0,0,0,0,2699,5744
3234,23,3047,21,3,0,0,0,0,3071,2764,114,4,0,1,0,0,2883,5954
3234,24,3025,38,2,0,0,0,0,3065,2667,134,1,0,0,0,0,2802,5867
3234,25,3077,56,2,0,0,0,0,3135,2687,210,9,0,0,0,0,2906,6041
3234,26,2980,100,2,0,0,0,0,3082,2526,272,7,0,0,0,0,2805,5887
3234,27,2970,182,2,0,3,0,0,3157,2448,369,7,0,0,0,0,2824,5981
3234,28,2832,253,2,0,1,0,0,3088,2334,516,15,0,1,0,0,2866,5954
3234,29,2796,286,12,0,5,0,0,3099,2193,635,12,0,1,0,0,2841,5940
3234,30,2719,429,10,1,3,0,0,3162,2112,773,16,2,3,0,0,2906,6068
3234,31,2683,541,11,0,2,0,0,3237,2037,940,30,1,7,0,0,3015,6252
3234,32,2494,656,21,1,6,0,0,3178,1838,1040,37,4,4,1,0,2924,6102
3234,33,2456,726,18,2,6,0,0,3208,1722,1187,51,6,6,0,0,2972,6180
3234,34,2132,853,46,1,5,0,0,3037,1610,1287,47,3,5,1,0,2953,5990
3234,35,2101,1004,31,2,8,0,1,3147,1543,1427,67,5,6,0,0,3048,6195
3234,36,1870,1141,31,3,5,1,0,3051,1455,1452,79,9,5,0,0,3000,6051
3234,37,1784,1199,56,0,9,0,0,3048,1284,1549,100,15,7,0,0,2955,6003
3234,38,1814,1222,57,2,8,0,0,3103,1268,1647,121,11,4,1,0,3052,6155
3234,39,1671,1425,66,3,6,0,0,3171,1157,1749,135,11,4,1,0,3057,6228
3234,40,1607,1508,92,3,7,0,0,3217,1174,1807,137,15,2,0,0,3135,6352
3234,41,1499,1667,84,5,5,1,0,3261,1067,1919,163,19,1,0,0,3169,6430
3234,42,1388,1700,100,10,5,0,0,3203,1020,1873,181,17,2,0,0,3093,6296
3234,43,1378,1715,116,8,5,1,0,3223,982,2051,199,27,5,1,0,3265,6488
3234,44,1352,1795,114,6,5,0,0,3272,898,2181,241,28,1,0,0,3349,6621
3234,45,1423,1991,139,8,4,0,0,3565,1017,2319,251,43,2,0,0,3632,7197
3234,46,1357,2118,189,6,6,0,0,3676,961,2362,287,51,3,0,0,3664,7340
3234,47,1335,2225,193,16,4,1,0,3774,958,2551,330,46,1,1,0,3887,7661
3234,48,1338,2296,203,9,7,1,0,3854,932,2765,340,60,2,0,0,4099,7953
3234,49,1376,2567,258,13,12,0,0,4226,913,2853,351,73,2,0,0,4192,8418
3234,50,1240,2538,307,20,7,0,0,4112,831,2896,418,80,4,1,0,4230,8342
3234,51,1173,2629,278,22,7,0,0,4109,784,2866,397,77,1,0,0,4125,8234
3234,52,1196,2690,314,25,5,0,0,4230,746,3040,455,120,1,1,0,4363,8593
3234,53,1016,2701,344,20,7,0,0,4088,765,2875,433,104,2,0,0,4179,8267
3234,54,1068,2937,338,34,5,0,0,4382,801,2961,475,125,2,1,0,4365,8747
3234,55,1023,2961,335,30,12,0,0,4361,664,2988,497,134,2,0,0,4285,8646
3234,56,962,2911,406,33,3,0,1,4316,687,3124,493,144,5,0,0,4453,8769
3234,57,988,2994,376,19,4,0,0,4381,634,3164,492,173,1,0,0,4464,8845
3234,58,918,3133,422,43,3,0,0,4519,625,3152,474,197,1,0,0,4449,8968
3234,59,804,3147,411,65,8,0,1,4436,553,3204,514,237,1,0,0,4509,8945
3234,60,721,3000,393,56,7,0,0,4177,523,3008,427,254,2,0,0,4214,8391
3234,61,623,2798,367,69,6,0,0,3863,468,2845,400,281,0,0,0,3994,7857
3234,62,595,2899,341,85,3,0,0,3923,481,2839,438,315,3,0,0,4076,7999
3234,63,580,2778,351,72,4,0,1,3786,419,2756,356,317,3,0,0,3851,7637
3234,64,494,2788,300,69,3,0,0,3654,365,2728,316,359,1,0,0,3769,7423
3234,65,468,2555,269,88,1,0,0,3381,376,2489,292,408,1,0,0,3566,6947
3234,66,423,2570,248,88,1,0,0,3330,324,2491,309,410,3,0,0,3537,6867
3234,67,437,2574,233,106,3,0,0,3353,289,2367,264,479,0,0,1,3400,6753
3234,68,397,2443,221,100,2,0,0,3163,312,2315,247,428,2,0,0,3304,6467
3234,69,374,2383,193,112,2,0,0,3064,266,2154,226,546,1,0,0,3193,6257
3234,70,367,2318,186,109,1,0,0,2981,291,2065,210,544,0,0,0,3110,6091
3234,71,297,2306,176,141,0,0,0,2920,240,1981,180,654,0,0,0,3055,5975
3234,72,324,2208,156,130,2,0,0,2820,225,1894,176,666,0,0,0,2961,5781
3234,73,298,2279,147,140,2,0,0,2866,225,1953,169,763,1,0,0,3111,5977
3234,74,275,2149,126,190,1,0,0,2741,207,1721,160,764,0,0,0,2852,5593
3234,75,271,2138,123,209,0,0,0,2741,185,1712,142,850,1,0,0,2890,5631
3234,76,252,1997,109,198,2,0,0,2558,204,1652,127,926,0,0,0,2909,5467
3234,77,231,2104,82,206,0,0,0,2623,222,1705,120,1060,0,0,0,3107,5730
3234,78,134,1407,78,198,0,0,0,1817,136,1080,84,815,0,0,0,2115,3932
3234,79,144,1562,60,195,0,0,0,1961,175,1122,71,986,1,0,0,2355,4316
3234,80,186,1429,49,220,1,0,0,1885,186,1114,64,1069,0,0,0,2433,4318
3234,81,157,1408,68,227,0,0,0,1860,167,944,61,1155,0,0,0,2327,4187
3234,82,151,1253,54,241,0,0,0,1699,168,890,55,1209,0,0,0,2322,4021
3234,83,156,1177,35,255,0,0,0,1623,182,767,59,1312,0,0,0,2320,3943
3234,84,138,1076,30,251,0,0,0,1495,185,619,46,1284,0,0,0,2134,3629
3234,85,110,938,24,239,0,0,0,1311,195,531,34,1214,0,0,0,1974,3285
3234,86,84,779,21,212,0,0,0,1096,150,387,27,1133,0,0,0,1697,2793
3234,87,77,661,16,208,0,0,0,962,125,322,25,1062,0,0,0,1534,2496
3234,88,76,547,11,177,0,0,0,811,135,216,21,1094,0,0,0,1466,2277
3234,89,56,403,9,158,0,0,0,626,120,143,23,1032,0,0,0,1318,1944
3234,90,41,306,7,155,0,0,0,509,104,113,13,905,0,0,0,1135,1644
3234,91,34,253,9,144,0,0,0,440,93,93,9,779,0,0,0,974,1414
3234,92,24,205,5,117,0,0,0,351,79,60,7,695,0,0,0,841,1192
3234,93,18,153,4,97,0,0,0,272,87,51,5,649,0,0,0,792,1064
3234,94,19,99,2,70,0,0,0,190,74,26,5,493,0,0,0,598,788
3234,95,15,64,0,71,0,0,0,150,45,22,4,383,0,0,0,454,604
3234,96,11,44,0,42,0,0,0,97,46,10,5,269,0,0,0,330,427
3234,97,6,26,0,29,0,0,0,61,39,3,2,212,0,0,0,256,317
3234,98,2,11,0,14,0,0,0,27,29,2,2,143,0,0,0,176,203
3234,99,2,7,0,17,0,0,0,26,19,2,0,98,0,0,0,119,145
3234,100,3,8,0,24,0,0,0,35,25,2,1,183,0,0,0,211,246
3234,999,136726,116479,9895,5939,229,5,4,269277,115128,117557,13048,30035,114,9,1,275892,545169
3324,0,3194,0,0,0,0,0,0,3194,3039,0,0,0,0,0,0,3039,6233
3324,1,3344,0,0,0,0,0,0,3344,3193,0,0,0,0,0,0,3193,6537
3324,2,3457,0,0,0,0,0,0,3457,3355,0,0,0,0,0,0,3355,6812
3324,3,3614,0,0,0,0,0,0,3614,3382,0,0,0,0,0,0,3382,6996
3324,4,3754,0,0,0,0,0,0,3754,3485,0,0,0,0,0,0,3485,7239
3324,5,3941,0,0,0,0,0,0,3941,3698,0,0,0,0,0,0,3698,7639
3324,6,4033,0,0,0,0,0,0,4033,3816,0,0,0,0,0,0,3816,7849
3324,7,4169,0,0,0,0,0,0,4169,3895,0,0,0,0,0,0,3895,8064
3324,8,4305,0,0,0,0,0,0,4305,4027,0,0,0,0,0,0,4027,8332
3324,9,4313,0,0,0,0,0,0,4313,4086,0,0,0,0,0,0,4086,8399
3324,10,4278,0,0,0,0,0,0,4278,4082,0,0,0,0,0,0,4082,8360
3324,11,4533,0,0,0,0,0,0,4533,4194,0,0,0,0,0,0,4194,8727
3324,12,4597,0,0,0,0,0,0,4597,4302,0,0,0,0,0,0,4302,8899
3324,13,4776,0,0,0,0,0,0,4776,4478,0,0,0,0,0,0,4478,9254
3324,14,4835,0,0,0,0,0,0,4835,4464,0,0,0,0,0,0,4464,9299
3324,15,4800,0,0,0,0,0,0,4800,4633,0,0,0,0,0,0,4633,9433
3324,16,4777,0,0,0,0,0,0,4777,4488,0,0,0,0,0,0,4488,9265
3324,17,4746,0,0,0,0,0,0,4746,4496,0,0,0,0,0,0,4496,9242
3324,18,4830,1,0,0,0,0,0,4831,4476,3,0,0,0,0,0,4479,9310
3324,19,4818,1,0,0,0,0,0,4819,4476,10,0,0,0,0,0,4486,9305
3324,20,4637,1,0,0,0,0,0,4638,4336,22,0,0,0,0,0,4358,8996
3324,21,4741,9,0,0,0,0,0,4750,4249,58,1,0,0,0,0,4308,9058
3324,22,4687,11,1,0,1,0,0,4700,4268,90,5,0,0,0,0,4363,9063
3324,23,4757,36,5,0,1,0,0,4799,4363,175,6,0,1,0,0,4545,9344
3324,24,4985,56,3,0,0,0,0,5044,4330,260,8,0,0,0,0,4598,9642
3324,25,4907,104,8,0,1,0,0,5020,4215,354,7,1,0,0,0,4577,9597
3324,26,4767,150,8,0,2,0,0,4927,4131,505,13,0,1,0,0,4650,9577
3324,27,4757,272,10,1,1,0,0,5041,3856,712,22,1,4,0,0,4595,9636
3324,28,4633,429,14,0,9,1,0,5086,3722,973,20,2,2,0,0,4719,9805
3324,29,4416,544,19,1,6,0,0,4986,3622,1241,24,0,7,0,0,4894,9880
3324,30,4256,773,18,0,4,0,0,5051,3377,1479,32,2,5,0,0,4895,9946
3324,31,4221,1034,26,0,4,0,0,5285,3188,1787,55,3,7,1,0,5041,10326
3324,32,3876,1261,30,4,2,1,0,5174,2994,2054,67,7,8,0,0,5130,10304
3324,33,3795,1503,39,1,7,0,0,5345,2754,2287,79,8,8,0,0,5136,10481
3324,34,3573,1773,43,1,14,0,0,5404,2574,2441,120,8,15,1,0,5159,10563
3324,35,3477,2034,62,5,11,0,0,5589,2392,2796,132,17,11,2,0,5350,10939
3324,36,3055,2186,62,7,7,1,0,5318,2207,2914,151,15,14,2,0,5303,10621
3324,37,2892,2258,82,6,11,0,0,5249,2063,3020,188,19,6,0,0,5296,10545
3324,38,2915,2581,131,3,15,1,0,5646,1977,3270,235,25,10,1,0,5518,11164
3324,39,2682,2684,108,6,7,1,0,5488,1853,3423,260,27,6,0,0,5569,11057
3324,40,2510,2946,162,6,8,1,0,5633,1880,3369,271,35,10,0,0,5565,11198
3324,41,2559,3087,169,7,7,2,0,5831,1748,3627,331,29,9,0,0,5744,11575
3324,42,2539,3285,198,23,7,0,0,6052,1744,3714,342,63,7,0,0,5870,11922
3324,43,2355,3575,250,25,10,1,0,6216,1599,3842,387,52,8,0,0,5888,12104
3324,44,2394,3570,275,17,9,1,1,6267,1698,4041,468,62,10,3,0,6282,12549
3324,45,2445,3714,327,28,7,0,0,6521,1674,4253,497,74,6,1,0,6505,13026
3324,46,2442,3938,350,24,13,0,0,6767,1562,4372,551,92,7,1,0,6585,13352
3324,47,2408,4196,398,24,11,1,0,7038,1547,4626,624,106,5,0,0,6908,13946
3324,48,2378,4485,455,35,14,0,0,7367,1516,4921,704,120,5,1,0,7267,14634
3324,49,2428,4732,511,31,13,0,0,7715,1540,5067,747,154,8,0,0,7516,15231
3324,50,2230,4661,599,37,12,0,0,7539,1498,4934,781,142,12,0,0,7367,14906
3324,51,2169,4947,559,49,22,0,0,7746,1342,5103,844,153,8,2,0,7452,15198
3324,52,2103,4987,622,49,17,0,0,7778,1353,5115,868,195,9,0,0,7540,15318
3324,53,2006,5030,616,43,6,0,0,7701,1252,5020,870,223,1,0,0,7366,15067
3324,54,1818,5252,698,55,11,1,1,7836,1195,5361,896,258,7,0,0,7717,15553
3324,55,1681,5187,715,59,9,0,0,7651,1103,5299,821,271,1,0,1,7496,15147
3324,56,1493,5386,710,62,7,0,0,7658,1099,5233,869,298,6,0,0,7505,15163
3324,57,1461,5341,724,79,10,0,0,7615,1016,5385,898,337,5,1,0,7642,15257
3324,58,1310,5391,764,86,10,0,0,7561,977,5346,883,354,10,0,1,7571,15132
3324,59,1228,5422,782,76,4,0,0,7512,929,5335,904,444,0,1,0,7613,15125
3324,60,1199,5154,681,89,13,0,0,7136,791,5047,783,451,7,0,0,7079,14215
3324,61,986,4898,631,116,15,0,0,6646,721,4702,753,489,3,1,0,6669,13315
3324,62,862,4808,583,127,13,0,0,6393,690,4608,715,571,5,0,0,6589,12982
3324,63,859,4536,516,122,8,0,0,6041,575,4386,636,605,6,1,0,6209,12250
3324,64,746,4466,532,135,11,0,0,5890,556,4448,499,629,4,0,0,6136,12026
3324,65,648,4317,454,137,7,0,0,5563,508,4197,491,684,1,0,0,5881,11444
3324,66,633,4136,406,156,7,0,0,5338,505,4054,462,768,3,0,0,5792,11130
3324,67,578,4148,421,177,1,0,0,5325,466,3880,453,841,0,0,0,5640,10965
3324,68,497,4049,341,174,6,0,0,5067,371,3829,399,865,4,0,0,5468,10535
3324,69,472,3893,336,191,6,0,1,4899,382,3630,373,908,0,0,0,5293,10192
3324,70,425,3801,260,209,6,0,0,4701,318,3389,321,926,0,0,0,4954,9655
3324,71,406,3636,251,224,8,0,0,4525,313,3313,281,987,0,0,0,4894,9419
3324,72,340,3628,213,236,2,0,0,4419,310,3256,302,1064,1,0,0,4933,9352
3324,73,356,3710,192,253,0,0,0,4511,290,3316,277,1236,1,0,0,5120,9631
3324,74,316,3528,173,284,3,1,0,4305,296,3140,271,1362,1,0,0,5070,9375
3324,75,324,3667,171,340,1,0,1,4504,274,3232,225,1520,1,0,0,5252,9756
3324,76,315,3503,138,353,1,0,0,4310,291,2885,231,1701,0,0,0,5108,9418
3324,77,371,3704,178,398,2,0,0,4653,348,3058,224,1937,0,0,0,5567,10220
3324,78,194,2331,87,312,2,0,0,2926,218,1801,143,1332,2,0,0,3496,6422
3324,79,236,2560,106,343,3,0,0,3248,272,2015,112,1714,0,0,0,4113,7361
3324,80,239,2557,89,377,2,0,0,3264,275,1892,149,1909,0,0,0,4225,7489
3324,81,223,2309,73,398,2,0,0,3005,265,1703,138,1952,1,0,0,4059,7064
3324,82,164,2210,66,426,3,0,0,2869,269,1458,103,1999,0,0,1,3830,6699
3324,83,195,2074,62,493,2,0,0,2826,256,1345,83,2191,1,0,0,3876,6702
3324,84,163,2061,43,472,0,0,0,2739,286,1158,82,2385,0,0,0,3911,6650
3324,85,168,1703,40,431,0,0,0,2342,235,988,73,2261,0,0,0,3557,5899
3324,86,125,1449,35,443,0,0,0,2052,218,667,54,2151,0,0,0,3090,5142
3324,87,101,1157,14,397,0,0,0,1669,182,499,32,1916,0,0,0,2629,4298
3324,88,95,943,26,340,1,0,0,1405,222,382,35,1888,0,0,0,2527,3932
3324,89,76,758,13,370,0,0,0,1217,185,298,27,1733,0,0,0,2243,3460
3324,90,64,571,11,296,0,0,0,942,173,170,23,1484,0,0,0,1850,2792
3324,91,41,418,6,233,0,0,0,698,141,120,15,1428,0,0,0,1704,2402
3324,92,40,335,9,195,0,0,0,579,127,90,12,1169,0,0,0,1398,1977
3324,93,26,190,3,178,0,0,0,397,110,54,8,995,0,0,0,1167,1564
3324,94,25,153,2,133,0,0,0,313,90,37,7,755,0,0,0,889,1202
3324,95,16,103,2,93,0,0,0,214,71,18,5,565,0,0,0,659,873
3324,96,9,62,2,83,0,0,0,156,55,12,3,468,0,0,0,538,694
3324,97,5,41,0,59,0,0,0,105,33,5,4,313,0,0,0,355,460
3324,98,2,24,0,37,0,0,0,63,32,0,0,217,0,0,0,249,312
3324,99,0,13,0,22,0,0,0,35,16,7,0,163,0,0,0,186,221
3324,100,5,11,0,29,0,0,0,45,29,0,0,260,0,0,0,289,334
3324,999,221645,206448,17719,10731,435,13,4,456995,186573,206926,23785,52389,280,19,3,469975,926970
3434,0,2883,0,0,0,0,0,0,2883,2785,0,0,0,0,0,0,2785,5668
3434,1,3084,0,0,0,0,0,0,3084,2956,0,0,0,0,0,0,2956,6040
3434,2,3160,0,0,0,0,0,0,3160,3100,0,0,0,0,0,0,3100,6260
3434,3,3254,0,0,0,0,0,0,3254,2938,0,0,0,0,0,0,2938,6192
3434,4,3216,0,0,0,0,0,0,3216,3072,0,0,0,0,0,0,3072,6288
3434,5,3442,0,0,0,0,0,0,3442,3166,0,0,0,0,0,0,3166,6608
3434,6,3480,0,0,0,0,0,0,3480,3264,0,0,0,0,0,0,3264,6744
3434,7,3555,0,0,0,0,0,0,3555,3387,0,0,0,0,0,0,3387,6942
3434,8,3632,0,0,0,0,0,0,3632,3565,0,0,0,0,0,0,3565,7197
3434,9,3899,0,0,0,0,0,0,3899,3649,0,0,0,0,0,0,3649,7548
3434,10,3797,0,0,0,0,0,0,3797,3747,0,0,0,0,0,0,3747,7544
3434,11,4008,0,0,0,0,0,0,4008,3945,0,0,0,0,0,0,3945,7953
3434,12,4096,0,0,0,0,0,0,4096,3972,0,0,0,0,0,0,3972,8068
3434,13,4285,0,0,0,0,0,0,4285,4005,0,0,0,0,0,0,4005,8290
3434,14,4384,0,0,0,0,0,0,4384,4170,0,0,0,0,0,0,4170,8554
3434,15,4518,0,0,0,0,0,0,4518,4206,0,0,0,0,0,0,4206,8724
3434,16,4404,0,0,0,0,0,0,4404,4232,0,0,0,0,0,0,4232,8636
3434,17,4507,0,0,0,0,0,0,4507,4221,0,0,0,0,0,0,4221,8728
3434,18,4576,0,0,0,0,0,0,4576,4294,4,0,0,0,0,0,4298,8874
3434,19,4772,1,0,0,0,0,0,4773,4367,11,0,0,0,0,0,4378,9151
3434,20,4493,4,0,1,0,0,0,4498,4242,26,0,0,0,0,0,4268,8766
3434,21,4591,10,0,0,0,0,0,4601,4289,71,1,0,0,0,0,4361,8962
3434,22,4672,22,2,0,0,0,0,4696,4121,110,2,0,0,0,0,4233,8929
3434,23,4811,30,1,0,1,0,0,4843,4227,180,3,0,1,0,0,4411,9254
3434,24,4608,63,1,1,1,0,0,4674,4202,232,9,0,2,0,0,4445,9119
3434,25,4774,115,8,0,2,0,0,4899,3971,356,6,1,1,0,0,4335,9234
3434,26,4850,180,8,0,1,0,0,5039,3902,468,18,0,2,1,0,4391,9430
3434,27,4603,222,8,0,1,0,0,4834,3693,597,14,0,0,0,0,4304,9138
3434,28,4413,385,9,1,1,1,0,4810,3411,830,13,2,3,0,0,4259,9069
3434,29,4169,500,11,0,0,0,0,4680,3158,998,19,2,7,0,0,4184,8864
3434,30,4034,643,15,0,2,1,0,4695,3196,1184,33,4,2,0,0,4419,9114
3434,31,4030,904,15,0,5,1,0,4955,2818,1527,43,0,11,0,0,4399,9354
3434,32,3629,993,22,4,3,0,0,4651,2695,1666,46,3,8,0,0,4418,9069
3434,33,3632,1197,45,1,8,0,0,4883,2471,1836,55,5,6,0,0,4373,9256
3434,34,3266,1463,41,4,7,0,0,4781,2345,2052,94,5,5,0,0,4501,9282
3434,35,3065,1591,45,4,9,0,0,4714,2173,2320,113,11,6,2,0,4625,9339
3434,36,2779,1716,64,3,11,0,0,4573,1944,2263,104,11,8,0,0,4330,8903
3434,37,2642,1914,58,5,8,2,0,4629,1861,2461,139,19,4,0,0,4484,9113
3434,38,2596,2019,78,5,5,0,0,4703,1873,2547,173,21,8,2,0,4624,9327
3434,39,2487,2167,112,1,9,2,0,4778,1794,2729,177,15,5,0,0,4720,9498
3434,40,2401,2299,114,6,5,0,0,4825,1537,2877,197,34,4,1,0,4650,9475
3434,41,2391,2448,132,6,7,0,0,4984,1614,3037,243,27,8,0,0,4929,9913
3434,42,2261,2667,162,9,11,0,1,5111,1599,3146,260,54,4,0,0,5063,10174
3434,43,2390,2706,183,15,7,0,0,5301,1469,3218,298,42,5,0,0,5032,10333
3434,44,2126,2975,213,18,12,2,1,5347,1461,3477,323,52,8,0,0,5321,10668
3434,45,2280,3262,239,14,16,0,0,5811,1538,3706,427,52,2,1,0,5726,11537
3434,46,2379,3362,300,12,15,1,0,6069,1501,3916,442,75,0,1,0,5935,12004
3434,47,2230,3554,326,27,7,0,0,6144,1349,4131,541,89,3,0,0,6113,12257
3434,48,2333,3793,359,30,7,2,1,6525,1412,4304,576,88,3,0,0,6383,12908
3434,49,2385,4265,402,13,8,0,0,7073,1357,4710,609,113,2,0,0,6791,13864
3434,50,2202,4215,438,35,14,0,0,6904,1322,4728,664,131,2,1,0,6848,13752
3434,51,2055,4496,534,43,13,1,0,7142,1254,4846,654,163,5,0,0,6922,14064
3434,52,2018,4636,537,45,6,0,0,7242,1260,4961,733,166,3,0,1,7124,14366
3434,53,1845,4836,584,41,10,0,0,7316,1104,4959,712,185,3,0,0,6963,14279
3434,54,1757,4984,616,50,9,0,0,7416,1151,5178,721,201,2,0,0,7253,14669
3434,55,1705,4995,587,53,7,0,0,7347,1159,5157,723,241,1,0,0,7281,14628
3434,56,1575,5237,623,73,8,0,1,7517,975,5190,729,249,4,1,0,7148,14665
3434,57,1489,5326,644,82,11,1,0,7553,904,5364,732,283,2,1,0,7286,14839
3434,58,1376,5425,646,67,8,0,0,7522,834,5256,776,357,2,0,0,7225,14747
3434,59,1241,5312,680,99,5,0,0,7337,848,5349,740,358,2,0,0,7297,14634
3434,60,1056,5012,599,95,3,0,0,6765,740,5019,674,366,2,0,0,6801,13566
3434,61,945,4931,566,100,5,0,0,6547,700,4750,624,417,4,0,0,6495,13042
3434,62,906,4763,538,113,3,0,0,6323,639,4567,558,481,1,0,0,6246,12569
3434,63,768,4598,460,123,9,0,0,5958,580,4408,532,491,1,0,0,6012,11970
3434,64,722,4480,434,121,5,0,0,5762,515,4191,480,585,0,0,0,5771,11533
3434,65,625,4115,386,135,3,0,0,5264,439,3940,422,594,1,0,0,5396,10660
3434,66,572,4068,333,174,2,0,0,5149,436,3738,401,654,2,0,0,5231,10380
3434,67,530,3802,314,169,7,0,0,4822,413,3698,341,670,0,0,0,5122,9944
3434,68,503,3778,285,186,2,0,1,4755,329,3504,315,768,2,0,0,4918,9673
3434,69,486,3727,257,200,3,0,0,4673,310,3313,321,832,0,0,0,4776,9449
3434,70,402,3539,234,198,2,0,0,4375,290,3293,262,893,1,0,0,4739,9114
3434,71,389,3503,209,216,1,0,0,4318,297,3158,248,932,2,0,0,4637,8955
3434,72,399,3545,187,215,4,0,0,4350,260,3082,211,975,0,0,1,4529,8879
3434,73,364,3543,201,265,1,0,2,4376,298,3187,217,1147,1,0,0,4850,9226
3434,74,310,3466,166,260,1,0,0,4203,264,2963,178,1302,0,0,0,4707,8910
3434,75,334,3383,164,284,0,0,0,4165,321,2959,193,1384,1,0,0,4858,9023
3434,76,289,3098,114,299,1,0,0,3801,293,2646,176,1479,1,0,0,4595,8396
3434,77,301,3471,135,335,2,0,0,4244,286,2824,176,1800,1,0,0,5087,9331
3434,78,203,2252,96,246,2,0,0,2799,188,1797,116,1361,0,0,0,3462,6261
3434,79,238,2502,80,317,1,0,0,3138,228,1849,112,1721,0,0,0,3910,7048
3434,80,198,2456,72,349,1,0,0,3076,246,1852,110,1888,0,0,0,4096,7172
3434,81,211,2252,75,395,1,0,0,2934,248,1594,95,1883,0,0,0,3820,6754
3434,82,209,2020,67,419,1,0,0,2716,233,1352,76,1981,0,0,0,3642,6358
3434,83,177,2061,59,470,0,0,0,2767,245,1269,70,2222,0,0,0,3806,6573
3434,84,171,1902,34,479,0,0,0,2586,221,1029,78,2193,0,0,0,3521,6107
3434,85,146,1626,27,425,0,0,0,2224,235,843,58,2207,0,0,0,3343,5567
3434,86,93,1285,24,356,0,0,0,1758,209,619,51,1909,0,0,0,2788,4546
3434,87,93,927,14,349,0,0,0,1383,175,448,26,1798,0,0,0,2447,3830
3434,88,75,850,16,329,0,0,0,1270,185,312,22,1748,0,0,0,2267,3537
3434,89,61,698,15,292,0,0,0,1066,179,240,21,1626,0,0,0,2066,3132
3434,90,46,489,4,261,0,0,0,800,136,148,21,1331,0,0,0,1636,2436
3434,91,45,344,3,213,0,0,0,605,127,116,15,1227,0,0,0,1485,2090
3434,92,31,285,4,189,0,0,0,509,99,66,10,1086,0,0,0,1261,1770
3434,93,23,197,3,159,0,0,0,382,101,48,10,902,0,0,0,1061,1443
3434,94,18,125,1,105,0,0,0,249,72,31,6,616,0,0,0,725,974
3434,95,12,77,1,98,0,0,0,188,51,26,3,559,0,0,0,639,827
3434,96,10,59,0,68,0,0,0,137,51,9,2,409,0,0,0,471,608
3434,97,4,28,0,43,0,0,0,75,31,4,2,283,0,0,0,320,395
3434,98,0,10,0,27,0,0,0,37,32,2,0,217,0,0,0,251,288
3434,99,4,3,0,22,0,0,0,29,23,1,2,125,0,0,0,151,180
3434,100,0,13,1,24,0,0,0,38,46,4,1,200,0,0,0,251,289
3434,999,207504,190215,15040,9891,320,14,7,422991,171846,190877,19398,48321,164,11,2,430619,853610
3451,0,561,0,0,0,0,0,0,561,503,0,0,0,0,0,0,503,1064
3451,1,582,0,0,0,0,0,0,582,546,0,0,0,0,0,0,546,1128
3451,2,608,0,0,0,0,0,0,608,601,0,0,0,0,0,0,601,1209
3451,3,654,0,0,0,0,0,0,654,573,0,0,0,0,0,0,573,1227
3451,4,640,0,0,0,0,0,0,640,564,0,0,0,0,0,0,564,1204
3451,5,666,0,0,0,0,0,0,666,661,0,0,0,0,0,0,661,1327
3451,6,707,0,0,0,0,0,0,707,618,0,0,0,0,0,0,618,1325
3451,7,695,0,0,0,0,0,0,695,663,0,0,0,0,0,0,663,1358
3451,8,732,0,0,0,0,0,0,732,700,0,0,0,0,0,0,700,1432
3451,9,739,0,0,0,0,0,0,739,722,0,0,0,0,0,0,722,1461
3451,10,774,0,0,0,0,0,0,774,713,0,0,0,0,0,0,713,1487
3451,11,832,0,0,0,0,0,0,832,764,0,0,0,0,0,0,764,1596
3451,12,882,0,0,0,0,0,0,882,817,0,0,0,0,0,0,817,1699
3451,13,885,0,0,0,0,0,0,885,842,0,0,0,0,0,0,842,1727
3451,14,870,0,0,0,0,0,0,870,836,0,0,0,0,0,0,836,1706
3451,15,932,0,0,0,0,0,0,932,864,0,0,0,0,0,0,864,1796
3451,16,919,0,0,0,0,0,0,919,801,0,0,0,0,0,0,801,1720
3451,17,917,0,0,0,0,0,0,917,887,0,0,0,0,0,0,887,1804
3451,18,933,0,0,0,0,0,0,933,841,0,0,0,0,0,0,841,1774
3451,19,971,0,1,0,0,0,0,972,878,0,0,0,0,0,0,878,1850
3451,20,966,2,0,0,0,0,0,968,855,4,0,0,0,0,0,859,1827
3451,21,1004,2,0,0,0,0,0,1006,909,5,0,0,0,0,0,914,1920
3451,22,939,3,0,0,0,0,0,942,838,18,0,0,0,0,0,856,1798
3451,23,1025,13,0,0,0,0,0,1038,943,24,0,0,0,0,0,967,2005
3451,24,997,7,0,0,0,0,0,1004,869,42,0,1,0,0,0,912,1916
3451,25,1008,24,1,0,0,0,0,1033,870,80,3,0,0,0,0,953,1986
3451,26,973,30,1,0,1,0,0,1005,786,83,0,0,0,0,0,869,1874
3451,27,969,54,1,0,0,0,0,1024,808,109,4,0,1,0,0,922,1946
3451,28,892,70,4,0,0,0,0,966,715,151,6,2,0,0,0,874,1840
3451,29,908,101,3,1,1,0,0,1014,712,167,7,0,0,0,0,886,1900
3451,30,873,115,5,0,3,0,0,996,690,218,6,0,1,0,0,915,1911
3451,31,858,154,3,0,0,0,0,1015,706,241,6,0,0,0,0,953,1968
3451,32,831,170,8,2,2,0,0,1013,625,280,7,1,0,0,0,913,1926
3451,33,820,221,3,0,0,1,0,1045,599,316,15,1,0,0,0,931,1976
3451,34,785,225,6,1,2,0,0,1019,565,359,19,3,1,0,0,947,1966
3451,35,711,242,17,0,1,1,0,972,568,334,17,0,0,0,0,919,1891
3451,36,681,307,16,1,1,0,0,1006,495,388,35,2,1,0,0,921,1927
3451,37,625,329,7,1,1,0,0,963,528,429,31,2,1,0,0,991,1954
3451,38,638,352,21,2,1,0,0,1014,470,467,31,3,1,0,0,972,1986
3451,39,641,360,12,2,5,0,0,1020,476,488,27,2,0,0,0,993,2013
3451,40,684,410,26,1,1,0,0,1122,465,502,37,5,1,0,0,1010,2132
3451,41,581,412,36,0,0,0,0,1029,483,533,48,5,3,0,0,1072,2101
3451,42,616,466,24,1,2,0,0,1109,478,523,54,8,4,0,0,1067,2176
3451,43,600,452,31,0,1,1,0,1085,427,574,74,17,2,0,0,1094,2179
3451,44,607,520,32,4,1,0,0,1164,443,550,78,10,2,0,0,1083,2247
3451,45,642,548,44,2,1,0,0,1237,423,695,98,11,2,0,0,1229,2466
3451,46,605,581,62,4,1,0,0,1253,430,755,110,16,0,0,0,1311,2564
3451,47,604,671,78,3,3,0,0,1359,452,793,105,20,0,0,0,1370,2729
3451,48,609,724,81,2,2,0,0,1418,438,897,129,19,2,0,0,1485,2903
3451,49,645,786,102,8,0,0,0,1541,453,934,122,36,2,0,0,1547,3088
3451,50,666,806,112,6,1,1,0,1592,402,1039,138,27,1,0,0,1607,3199
3451,51,544,908,116,4,1,0,1,1574,419,1056,154,39,0,0,0,1668,3242
3451,52,567,940,138,6,1,0,0,1652,394,1075,170,35,1,0,0,1675,3327
3451,53,515,945,139,11,3,0,0,1613,388,1057,229,42,1,0,0,1717,3330
3451,54,496,996,143,9,0,0,0,1644,331,1129,197,55,0,0,0,1712,3356
3451,55,479,1019,157,11,2,0,0,1668,341,1128,180,73,0,0,0,1722,3390
3451,56,424,1046,150,14,3,0,0,1637,328,1185,196,66,0,0,0,1775,3412
3451,57,404,1060,153,19,0,0,0,1636,315,1177,196,74,0,0,0,1762,3398
3451,58,429,1097,179,19,2,0,0,1726,249,1172,193,81,0,0,0,1695,3421
3451,59,391,1106,169,25,1,0,0,1692,286,1204,193,94,0,0,0,1777,3469
3451,60,323,1111,164,27,1,0,0,1626,247,1138,177,99,0,0,0,1661,3287
3451,61,290,1073,169,26,2,0,0,1560,219,1111,154,109,0,0,0,1593,3153
3451,62,301,1080,120,38,2,0,0,1541,218,1086,152,145,0,0,0,1601,3142
3451,63,260,1060,125,31,1,0,0,1477,178,1048,132,155,1,0,0,1514,2991
3451,64,254,1127,116,41,4,0,0,1542,192,1034,147,161,0,0,0,1534,3076
3451,65,242,969,114,34,0,0,0,1359,167,980,101,174,0,0,0,1422,2781
3451,66,220,977,100,31,1,0,0,1329,143,960,116,197,1,0,0,1417,2746
3451,67,190,965,89,38,0,0,0,1282,129,995,99,183,0,0,0,1406,2688
3451,68,179,956,91,57,1,0,0,1284,138,976,73,211,0,0,0,1398,2682
3451,69,177,1018,76,53,0,0,0,1324,113,926,96,247,0,0,0,1382,2706
3451,70,164,1027,68,60,0,0,0,1319,111,793,73,286,0,0,0,1263,2582
3451,71,142,930,54,63,1,0,0,1190,112,841,81,298,0,0,0,1332,2522
3451,72,126,950,51,77,0,0,0,1204,94,847,61,299,0,0,0,1301,2505
3451,73,134,919,71,78,0,0,0,1202,114,918,77,362,0,0,0,1471,2673
3451,74,137,946,62,87,0,0,0,1232,86,758,63,368,0,0,0,1275,2507
3451,75,129,934,43,81,0,0,1,1188,109,759,62,452,0,0,0,1382,2570
3451,76,105,917,43,123,0,0,0,1188,106,759,55,465,0,0,0,1385,2573
3451,77,126,920,38,141,1,0,0,1226,90,719,41,529,0,0,0,1379,2605
3451,78,77,599,37,91,0,0,0,804,73,471,24,401,0,0,0,969,1773
3451,79,74,656,19,89,0,0,0,838,54,503,33,492,0,0,0,1082,1920
3451,80,62,636,22,116,0,0,0,836,66,478,27,478,0,0,0,1049,1885
3451,81,73,578,23,100,0,0,0,774,74,416,21,519,0,0,0,1030,1804
3451,82,67,565,20,130,0,0,0,782,67,336,24,577,0,0,0,1004,1786
3451,83,82,548,20,112,0,0,0,762,71,321,20,590,0,0,0,1002,1764
3451,84,53,552,12,129,0,0,0,746,68,252,14,656,0,0,0,990,1736
3451,85,49,404,13,117,0,0,0,583,65,213,11,591,0,0,0,880,1463
3451,86,41,323,4,123,0,0,0,491,67,155,8,540,0,0,0,770,1261
3451,87,29,263,3,88,0,0,0,383,57,113,7,502,0,0,0,679,1062
3451,88,20,180,4,92,0,0,0,296,47,76,7,462,0,0,0,592,888
3451,89,20,171,3,86,0,0,0,280,39,76,9,446,0,0,0,570,850
3451,90,14,124,4,62,0,0,0,204,41,38,8,388,0,0,0,475,679
3451,91,9,83,5,56,0,0,0,153,42,32,7,385,0,0,0,466,619
3451,92,10,80,2,54,0,0,0,146,26,11,2,301,0,0,0,340,486
3451,93,16,53,1,53,0,0,0,123,27,11,2,276,0,0,0,316,439
3451,94,9,39,1,29,0,0,0,78,19,5,1,192,0,0,0,217,295
3451,95,0,20,1,20,0,0,0,41,15,3,0,163,0,0,0,181,222
3451,96,3,12,0,16,0,0,0,31,7,4,0,128,0,0,0,139,170
3451,97,0,7,0,9,0,0,0,16,13,2,0,88,0,0,0,103,119
3451,98,0,2,0,10,0,0,0,12,7,0,1,63,0,0,0,71,83
3451,99,0,3,0,4,0,0,0,7,4,0,0,42,0,0,0,46,53
3451,100,0,3,0,6,0,0,0,9,7,1,1,71,0,0,0,80,89
3451,999,47958,42054,3869,2837,58,4,2,96782,39888,42346,4902,13841,29,0,0,101006,197788
3590,0,2926,0,0,0,0,0,0,2926,2822,0,0,0,0,0,0,2822,5748
3590,1,3137,0,0,0,0,0,0,3137,2904,0,0,0,0,0,0,2904,6041
3590,2,3192,0,0,0,0,0,0,3192,2961,0,0,0,0,0,0,2961,6153
3590,3,3299,0,0,0,0,0,0,3299,3044,0,0,0,0,0,0,3044,6343
3590,4,3292,0,0,0,0,0,0,3292,3095,0,0,0,0,0,0,3095,6387
3590,5,3513,0,0,0,0,0,0,3513,3242,0,0,0,0,0,0,3242,6755
3590,6,3706,0,0,0,0,0,0,3706,3450,0,0,0,0,0,0,3450,7156
3590,7,3797,0,0,0,0,0,0,3797,3557,0,0,0,0,0,0,3557,7354
3590,8,3907,0,0,0,0,0,0,3907,3654,0,0,0,0,0,0,3654,7561
3590,9,3994,0,0,0,0,0,0,3994,3909,0,0,0,0,0,0,3909,7903
3590,10,4144,0,0,0,0,0,0,4144,3971,0,0,0,0,0,0,3971,8115
3590,11,4342,0,0,0,0,0,0,4342,4123,0,0,0,0,0,0,4123,8465
3590,12,4354,0,0,0,0,0,0,4354,4131,0,0,0,0,0,0,4131,8485
3590,13,4602,0,0,0,0,0,0,4602,4182,0,0,0,0,0,0,4182,8784
3590,14,4601,0,0,0,0,0,0,4601,4303,0,0,0,0,0,0,4303,8904
3590,15,4608,0,0,0,0,0,0,4608,4568,0,0,0,0,0,0,4568,9176
3590,16,4727,0,0,0,0,0,0,4727,4463,0,0,0,0,0,0,4463,9190
3590,17,4769,0,0,0,0,0,0,4769,4501,0,0,0,0,0,0,4501,9270
3590,18,4744,0,0,0,0,0,0,4744,4457,4,0,0,0,0,0,4461,9205
3590,19,4898,2,0,0,0,0,0,4900,4308,23,0,0,0,0,0,4331,9231
3590,20,4747,0,0,0,0,0,0,4747,4393,55,0,0,0,0,0,4448,9195
3590,21,4818,10,0,0,0,0,0,4828,4203,97,0,0,1,0,0,4301,9129
3590,22,4701,24,2,0,0,0,0,4727,4036,145,2,0,0,0,0,4183,8910
3590,23,4937,53,3,0,0,0,0,4993,4280,201,9,0,0,0,0,4490,9483
3590,24,4642,76,2,0,0,0,0,4720,4020,315,7,0,0,0,0,4342,9062
3590,25,4818,141,4,1,0,0,0,4964,3894,389,7,1,2,0,0,4293,9257
3590,26,4541,207,8,1,1,0,0,4758,3784,501,7,1,0,0,0,4293,9051
3590,27,4509,295,10,1,1,0,0,4816,3631,622,13,1,2,0,0,4269,9085
3590,28,4208,421,14,0,3,0,0,4646,3189,841,12,2,0,1,0,4045,8691
3590,29,4170,539,6,0,4,0,0,4719,3237,981,31,2,4,0,0,4255,8974
3590,30,3864,713,14,0,1,0,0,4592,2937,1271,28,3,2,0,0,4241,8833
3590,31,3818,869,20,1,0,1,0,4709,2886,1496,38,6,1,0,0,4427,9136
3590,32,3530,1117,32,6,4,0,0,4689,2727,1718,51,3,1,0,0,4500,9189
3590,33,3462,1319,34,4,4,0,0,4823,2469,1887,64,4,3,0,0,4427,9250
3590,34,3101,1488,40,1,4,0,0,4634,2326,2128,88,2,10,1,0,4555,9189
3590,35,3070,1676,52,3,5,0,0,4806,2246,2308,81,8,1,2,0,4646,9452
3590,36,2670,1800,50,10,3,0,0,4533,2056,2359,100,8,3,1,0,4527,9060
3590,37,2618,1855,66,4,9,0,0,4552,1899,2512,133,21,3,0,0,4568,9120
3590,38,2594,2123,78,7,7,1,0,4810,1890,2767,141,26,6,0,1,4831,9641
3590,39,2434,2283,99,2,4,0,0,4822,1794,2764,185,23,5,0,0,4771,9593
3590,40,2411,2371,96,7,14,0,0,4899,1706,3011,208,28,3,0,0,4956,9855
3590,41,2435,2619,132,7,7,1,0,5201,1706,3188,237,32,3,0,0,5166,10367
3590,42,2265,2710,173,11,9,0,0,5168,1639,3187,290,46,2,1,0,5165,10333
3590,43,2260,2995,190,10,10,0,0,5465,1567,3345,313,39,4,0,0,5268,10733
3590,44,2301,2973,188,24,2,0,0,5488,1519,3585,326,58,3,0,0,5491,10979
3590,45,2413,3329,255,20,4,0,0,6021,1740,3819,401,70,2,1,0,6033,12054
3590,46,2310,3550,243,13,7,1,0,6124,1636,4009,455,87,2,0,0,6189,12313
3590,47,2434,3615,320,21,15,0,0,6405,1608,4238,487,95,3,0,0,6431,12836
3590,48,2338,4043,366,26,8,0,0,6781,1628,4476,555,113,11,0,0,6783,13564
3590,49,2450,4373,429,34,3,0,0,7289,1747,4849,588,140,5,0,0,7329,14618
3590,50,2290,4491,446,33,9,0,0,7269,1509,4897,601,111,6,0,0,7124,14393
3590,51,2181,4608,465,33,6,0,0,7293,1578,4774,642,141,4,0,0,7139,14432
3590,52,2186,4680,470,30,7,1,0,7374,1409,5221,705,172,4,1,0,7512,14886
3590,53,2002,4854,529,46,11,0,0,7442,1294,5212,695,183,5,0,0,7389,14831
3590,54,1823,5120,579,50,14,0,0,7586,1256,5324,738,213,5,0,0,7536,15122
3590,55,1753,4983,531,63,7,0,1,7338,1175,5251,738,200,3,0,0,7367,14705
3590,56,1611,5220,563,70,2,0,1,7467,1132,5362,752,277,1,0,0,7524,14991
3590,57,1563,5349,615,92,8,0,0,7627,1044,5358,738,288,5,0,0,7433,15060
3590,58,1378,5429,624,106,11,0,0,7548,1025,5407,733,333,1,0,0,7499,15047
3590,59,1290,5499,606,106,8,1,0,7510,947,5441,695,315,1,0,0,7399,14909
3590,60,1117,5139,562,92,5,0,0,6915,836,5123,642,390,4,0,0,6995,13910
3590,61,964,5025,528,105,8,0,0,6630,752,4837,588,435,1,0,0,6613,13243
3590,62,939,4894,502,111,4,0,0,6450,688,4850,572,489,2,0,0,6601,13051
3590,63,784,4706,485,161,5,0,0,6141,607,4551,505,531,1,1,0,6196,12337
3590,64,733,4622,433,145,5,0,0,5938,573,4600,429,566,0,0,0,6168,12106
3590,65,668,4327,380,133,7,0,0,5515,456,4410,420,543,3,0,0,5832,11347
3590,66,592,4259,350,135,5,0,0,5341,462,4006,393,643,3,0,0,5507,10848
3590,67,556,4203,293,168,5,0,0,5225,397,3887,398,743,2,0,0,5427,10652
3590,68,463,4114,306,204,2,0,0,5089,376,3871,326,805,0,1,0,5379,10468
3590,69,478,3949,264,228,2,0,0,4921,370,3706,325,809,1,0,0,5211,10132
3590,70,402,3855,240,211,4,0,0,4712,331,3623,293,856,2,0,0,5105,9817
3590,71,394,3615,190,240,3,0,0,4442,319,3372,234,981,1,0,0,4907,9349
3590,72,366,3573,217,245,4,0,0,4405,273,3236,244,991,0,0,0,4744,9149
3590,73,374,3717,175,276,2,0,0,4544,268,3342,229,1113,2,0,0,4954,9498
3590,74,322,3598,160,270,1,0,0,4351,256,3033,208,1199,0,0,0,4696,9047
3590,75,323,3595,166,345,4,0,0,4433,242,3069,198,1366,0,0,0,4875,9308
3590,76,284,3392,136,346,6,0,0,4164,258,2877,196,1515,0,0,0,4846,9010
3590,77,313,3588,135,382,2,0,0,4420,266,3053,149,1801,0,0,0,5269,9689
3590,78,196,2409,90,291,0,0,0,2986,175,1981,118,1361,0,0,0,3635,6621
3590,79,209,2711,88,366,3,0,0,3377,200,2012,115,1685,0,0,0,4012,7389
3590,80,220,2575,77,377,0,0,2,3251,186,1874,115,1862,0,0,0,4037,7288
3590,81,179,2297,61,376,1,0,0,2914,195,1662,92,1858,0,0,0,3807,6721
3590,82,200,2217,50,385,1,0,0,2853,191,1454,79,1959,0,0,0,3683,6536
3590,83,174,2181,39,467,1,0,0,2862,190,1372,84,2202,0,0,0,3848,6710
3590,84,144,1990,37,444,0,0,0,2615,192,1142,61,2182,0,0,0,3577,6192
3590,85,142,1639,35,447,1,0,0,2264,155,853,52,2160,0,0,0,3220,5484
3590,86,93,1300,21,434,0,0,0,1848,159,608,46,2090,0,0,0,2903,4751
3590,87,85,1110,21,363,0,0,0,1579,160,473,27,1855,0,0,0,2515,4094
3590,88,87,964,15,342,0,0,0,1408,123,341,31,1820,0,0,0,2315,3723
3590,89,63,748,19,310,0,0,0,1140,135,267,16,1668,0,0,0,2086,3226
3590,90,44,509,9,247,0,0,0,809,119,156,19,1427,0,0,0,1721,2530
3590,91,38,391,10,243,0,0,0,682,107,115,11,1259,0,0,0,1492,2174
3590,92,23,274,2,237,0,0,0,536,75,91,9,1114,0,0,0,1289,1825
3590,93,23,203,6,158,0,0,0,390,90,59,10,1018,0,0,0,1177,1567
3590,94,12,143,3,141,0,0,0,299,54,27,9,710,0,0,0,800,1099
3590,95,11,85,1,89,0,0,0,186,55,24,2,634,0,0,0,715,901
3590,96,5,65,3,74,0,0,0,147,47,13,2,498,0,0,0,560,707
3590,97,5,32,3,50,0,0,0,90,24,12,4,353,0,0,0,393,483
3590,98,5,19,1,33,0,0,0,58,18,6,0,244,0,0,0,268,326
3590,99,2,11,0,30,0,0,0,43,18,4,3,142,0,0,0,167,210
3590,100,0,12,1,30,0,0,0,43,25,3,1,244,0,0,0,273,316
3590,999,211530,197878,14468,10574,293,6,4,434753,176830,199333,19149,49173,139,10,1,444635,879388
3642,0,2527,0,0,0,0,0,0,2527,2393,0,0,0,0,0,0,2393,4920
3642,1,2591,0,0,0,0,0,0,2591,2498,0,0,0,0,0,0,2498,5089
3642,2,2762,0,0,0,0,0,0,2762,2612,0,0,0,0,0,0,2612,5374
3642,3,2766,0,0,0,0,0,0,2766,2602,0,0,0,0,0,0,2602,5368
3642,4,2850,0,0,0,0,0,0,2850,2654,0,0,0,0,0,0,2654,5504
3642,5,2988,0,0,0,0,0,0,2988,2848,0,0,0,0,0,0,2848,5836
3642,6,3141,0,0,0,0,0,0,3141,2949,0,0,0,0,0,0,2949,6090
3642,7,3349,0,0,0,0,0,0,3349,3043,0,0,0,0,0,0,3043,6392
3642,8,3323,0,0,0,0,0,0,3323,3111,0,0,0,0,0,0,3111,6434
3642,9,3374,0,0,0,0,0,0,3374,3152,0,0,0,0,0,0,3152,6526
3642,10,3578,0,0,0,0,0,0,3578,3268,0,0,0,0,0,0,3268,6846
3642,11,3762,0,0,0,0,0,0,3762,3495,0,0,0,0,0,0,3495,7257
3642,12,3853,0,0,0,0,0,0,3853,3690,0,0,0,0,0,0,3690,7543
3642,13,3895,0,0,0,0,0,0,3895,3672,0,0,0,0,0,0,3672,7567
3642,14,4035,0,0,0,0,0,0,4035,3686,0,0,0,0,0,0,3686,7721
3642,15,4147,0,0,0,0,0,0,4147,3830,0,0,0,0,0,0,3830,7977
3642,16,4082,0,0,0,0,0,0,4082,3867,0,0,0,0,0,0,3867,7949
3642,17,4052,0,0,0,0,0,0,4052,3775,0,0,0,0,0,0,3775,7827
3642,18,4079,1,0,0,0,0,0,4080,3661,3,0,0,0,0,0,3664,7744
3642,19,4174,4,0,0,0,0,0,4178,3881,13,0,0,0,0,0,3894,8072
3642,20,4302,1,0,0,0,0,0,4303,3769,28,0,0,0,0,0,3797,8100
3642,21,4066,6,0,0,0,0,0,4072,3635,52,2,0,0,0,0,3689,7761
3642,22,4215,15,2,0,0,0,0,4232,3645,94,2,0,0,0,0,3741,7973
3642,23,4351,38,4,0,0,0,0,4393,3739,181,1,0,0,0,0,3921,8314
3642,24,4282,56,3,0,0,0,0,4341,3640,249,3,1,3,0,0,3896,8237
3642,25,4306,112,4,0,4,0,0,4426,3692,331,5,0,3,0,0,4031,8457
3642,26,4082,157,8,0,3,0,0,4250,3556,409,7,1,0,1,0,3974,8224
3642,27,3999,214,6,0,2,0,0,4221,3315,494,10,0,2,2,0,3823,8044
3642,28,3905,338,9,0,5,0,0,4257,3045,671,23,0,5,0,0,3744,8001
3642,29,3631,378,9,0,2,0,0,4020,2894,889,18,1,3,0,0,3805,7825
3642,30,3482,513,15,0,7,0,0,4017,2874,1089,22,2,4,0,0,3991,8008
3642,31,3504,724,16,0,2,0,0,4246,2693,1252,33,3,3,2,1,3987,8233
3642,32,3267,894,19,5,2,1,0,4188,2491,1456,36,8,8,0,0,3999,8187
3642,33,3199,1080,25,4,13,2,0,4323,2471,1633,46,11,9,1,0,4171,8494
3642,34,2870,1186,28,3,8,2,0,4097,2252,1800,69,10,6,2,0,4139,8236
3642,35,2818,1456,47,4,5,2,0,4332,2093,1954,75,4,12,1,0,4139,8471
3642,36,2689,1544,58,7,6,0,0,4304,1992,1935,107,6,8,1,0,4049,8353
3642,37,2480,1611,55,7,14,0,0,4167,1870,2258,115,13,11,0,0,4267,8434
3642,38,2501,1808,60,5,8,0,0,4382,1847,2404,143,20,4,0,0,4418,8800
3642,39,2373,1960,82,4,9,1,0,4429,1754,2418,152,31,5,0,0,4360,8789
3642,40,2267,2159,90,10,9,0,0,4535,1696,2568,179,34,7,1,0,4485,9020
3642,41,2235,2298,110,10,5,0,0,4658,1719,2743,212,37,5,0,0,4716,9374
3642,42,2163,2485,139,23,7,1,0,4818,1574,2809,258,51,12,1,0,4705,9523
3642,43,2110,2577,155,15,10,0,0,4867,1531,2901,264,57,9,0,0,4762,9629
3642,44,2233,2851,195,16,9,0,0,5304,1561,3205,346,55,4,2,0,5173,10477
3642,45,2430,3013,219,14,16,1,0,5693,1671,3328,366,73,3,0,0,5441,11134
3642,46,2247,3123,221,17,13,0,0,5621,1745,3653,382,86,7,0,0,5873,11494
3642,47,2447,3406,252,25,9,0,0,6139,1652,3876,473,94,3,0,0,6098,12237
3642,48,2383,3655,316,22,16,0,0,6392,1699,4144,509,120,9,0,0,6481,12873
3642,49,2430,3977,350,31,15,0,1,6804,1797,4423,539,114,8,0,0,6881,13685
3642,50,2321,4131,413,34,5,0,0,6904,1651,4526,601,141,8,0,0,6927,13831
3642,51,2318,4251,449,54,8,0,0,7080,1612,4657,612,165,8,0,0,7054,14134
3642,52,2209,4340,446,41,8,1,1,7046,1434,4815,645,173,4,0,0,7071,14117
3642,53,1937,4471,483,57,11,1,0,6960,1408,4917,654,187,4,1,0,7171,14131
3642,54,1871,4824,609,53,11,0,1,7369,1314,5028,646,237,4,0,0,7229,14598
3642,55,1754,4722,506,41,7,0,0,7030,1234,5085,696,286,0,0,0,7301,14331
3642,56,1652,4854,557,66,12,0,0,7141,1209,5096,739,292,4,0,0,7340,14481
3642,57,1504,5045,538,80,11,0,0,7178,1133,5269,688,318,4,0,0,7412,14590
3642,58,1455,5069,588,93,8,0,0,7213,1086,5257,716,353,8,0,0,7420,14633
3642,59,1269,5286,614,100,3,0,0,7272,947,5598,744,433,2,0,0,7724,14996
3642,60,1190,4890,588,74,7,0,0,6749,873,5247,695,408,3,0,0,7226,13975
3642,61,1026,4871,543,145,9,0,0,6594,802,5089,619,481,2,0,0,6993,13587
3642,62,922,4869,489,137,8,1,0,6426,698,4970,616,532,2,0,0,6818,13244
3642,63,795,4678,417,145,11,0,1,6047,598,4627,549,613,1,0,0,6388,12435
3642,64,721,4604,427,147,8,0,0,5907,589,4605,527,657,2,0,0,6380,12287
3642,65,653,4220,378,161,9,0,0,5421,508,4366,450,675,0,0,0,5999,11420
3642,66,614,4148,360,161,9,0,0,5292,502,4213,423,740,3,0,0,5881,11173
3642,67,522,4111,303,190,7,0,0,5133,488,4021,366,826,2,0,0,5703,10836
3642,68,456,3887,259,182,8,0,0,4792,411,3782,405,820,2,0,0,5420,10212
3642,69,418,3836,285,209,2,0,0,4750,370,3776,339,907,1,0,0,5393,10143
3642,70,380,3831,247,233,4,0,0,4695,339,3468,315,940,1,0,0,5063,9758
3642,71,330,3747,214,266,3,0,0,4560,327,3441,289,1043,0,0,0,5100,9660
3642,72,320,3529,181,260,9,0,1,4300,281,3344,257,1076,3,0,0,4961,9261
3642,73,339,3600,176,269,5,0,0,4389,282,3293,266,1278,0,0,0,5119,9508
3642,74,321,3685,166,358,2,0,0,4532,266,3292,238,1375,1,0,0,5172,9704
3642,75,312,3716,161,333,3,0,0,4525,265,3218,204,1592,0,0,0,5279,9804
3642,76,270,3663,141,409,2,0,0,4485,257,2991,226,1755,0,0,0,5229,9714
3642,77,277,3739,140,469,1,0,1,4627,278,3030,195,2021,2,0,0,5526,10153
3642,78,172,2425,73,348,3,0,0,3021,181,1959,148,1489,0,0,0,3777,6798
3642,79,230,2799,91,451,0,0,0,3571,210,2160,117,1919,0,0,0,4406,7977
3642,80,195,2619,72,479,1,0,0,3366,235,2011,115,1970,0,0,0,4331,7697
3642,81,225,2459,75,480,2,0,0,3241,212,1737,126,2132,0,0,0,4207,7448
3642,82,177,2306,66,491,1,0,0,3041,206,1458,109,2231,0,0,0,4004,7045
3642,83,150,2303,48,549,0,0,0,3050,213,1513,97,2410,0,0,0,4233,7283
3642,84,167,2023,42,525,0,0,0,2757,194,1154,92,2371,0,0,0,3811,6568
3642,85,118,1611,35,547,1,0,0,2312,182,935,67,2469,0,0,0,3653,5965
3642,86,109,1399,34,481,0,0,0,2023,166,684,54,2260,0,0,0,3164,5187
3642,87,81,1025,18,413,0,0,0,1537,167,518,41,2123,0,0,0,2849,4386
3642,88,58,986,15,405,0,0,0,1464,125,395,50,1938,0,0,0,2508,3972
3642,89,66,775,17,379,0,0,0,1237,100,304,25,1797,0,0,0,2226,3463
3642,90,43,547,10,279,0,0,0,879,93,180,31,1535,0,0,0,1839,2718
3642,91,36,434,6,292,0,0,0,768,85,130,14,1356,0,0,0,1585,2353
3642,92,27,330,1,228,0,0,0,586,88,102,14,1138,0,0,0,1342,1928
3642,93,20,233,2,157,0,0,0,412,75,68,15,1009,0,0,0,1167,1579
3642,94,16,126,2,122,0,0,0,266,46,26,7,744,0,0,0,823,1089
3642,95,12,85,3,117,0,0,0,217,39,24,7,571,0,0,0,641,858
3642,96,9,50,1,89,0,0,0,149,43,14,4,467,0,0,0,528,677
3642,97,3,29,0,62,0,0,0,94,23,5,5,331,0,0,0,364,458
3642,98,1,24,0,33,0,0,0,58,25,1,2,212,0,0,0,240,298
3642,99,3,10,1,19,0,0,0,33,13,1,2,140,0,0,0,156,189
3642,100,0,7,0,23,0,0,0,30,28,2,0,270,0,0,0,300,330
3642,999,192669,188862,13787,11958,398,13,6,407693,162510,191665,19259,54038,224,15,1,427712,835405
3701,0,2947,0,0,0,0,0,0,2947,2722,0,0,0,0,0,0,2722,5669
3701,1,3165,0,0,0,0,0,0,3165,2917,0,0,0,0,0,0,2917,6082
3701,2,3227,0,0,0,0,0,0,3227,3095,0,0,0,0,0,0,3095,6322
3701,3,3264,0,0,0,0,0,0,3264,2903,0,0,0,0,0,0,2903,6167
3701,4,3353,0,0,0,0,0,0,3353,3199,0,0,0,0,0,0,3199,6552
3701,5,3491,0,0,0,0,0,0,3491,3410,0,0,0,0,0,0,3410,6901
3701,6,3663,0,0,0,0,0,0,3663,3520,0,0,0,0,0,0,3520,7183
3701,7,3806,0,0,0,0,0,0,3806,3586,0,0,0,0,0,0,3586,7392
3701,8,3901,0,0,0,0,0,0,3901,3721,0,0,0,0,0,0,3721,7622
3701,9,4031,0,0,0,0,0,0,4031,3927,0,0,0,0,0,0,3927,7958
3701,10,4345,0,0,0,0,0,0,4345,3966,0,0,0,0,0,0,3966,8311
3701,11,4377,0,0,0,0,0,0,4377,4147,0,0,0,0,0,0,4147,8524
3701,12,4410,0,0,0,0,0,0,4410,4184,0,0,0,0,0,0,4184,8594
3701,13,4527,0,0,0,0,0,0,4527,4340,0,0,0,0,0,0,4340,8867
3701,14,4631,0,0,0,0,0,0,4631,4441,0,0,0,0,0,0,4441,9072
3701,15,4736,0,0,0,0,0,0,4736,4386,0,0,0,0,0,0,4386,9122
3701,16,4612,0,0,0,0,0,0,4612,4408,0,0,0,0,0,0,4408,9020
3701,17,4644,0,0,0,0,0,0,4644,4418,0,0,0,0,0,0,4418,9062
3701,18,4668,0,0,0,0,0,0,4668,4241,2,0,0,0,0,0,4243,8911
3701,19,4739,0,0,0,0,0,0,4739,4339,12,0,0,1,0,0,4352,9091
3701,20,4734,3,1,1,0,0,0,4739,4260,36,0,0,0,0,0,4296,9035
3701,21,4554,2,0,0,1,0,0,4557,4097,45,0,0,0,0,0,4142,8699
3701,22,4638,14,4,0,0,0,0,4656,4221,86,2,0,2,0,0,4311,8967
3701,23,4860,24,0,0,0,0,0,4884,4338,133,1,0,0,0,0,4472,9356
3701,24,4914,52,3,0,2,0,0,4971,4295,219,11,0,0,0,0,4525,9496
3701,25,4905,80,2,0,0,0,0,4987,4264,282,7,0,1,0,0,4554,9541
3701,26,4902,112,2,0,0,0,0,5016,4165,420,4,1,2,0,0,4592,9608
3701,27,4755,185,5,0,0,0,0,4945,4097,506,6,1,2,0,0,4612,9557
3701,28,4633,314,6,0,6,0,0,4959,3852,661,15,2,5,1,0,4536,9495
3701,29,4537,414,10,0,0,0,0,4961,3641,873,18,2,3,1,0,4538,9499
3701,30,4303,606,9,0,8,0,0,4926,3502,1120,29,0,5,0,0,4656,9582
3701,31,4397,739,21,0,3,0,0,5160,3441,1411,32,5,6,0,0,4895,10055
3701,32,4161,971,19,4,5,0,0,5160,3215,1598,39,7,4,0,0,4863,10023
3701,33,3888,1239,28,2,6,2,0,5165,3004,1875,60,13,8,0,0,4960,10125
3701,34,3625,1387,27,4,6,0,0,5049,2784,2090,73,3,7,0,0,4957,10006
3701,35,3514,1609,47,5,10,0,0,5185,2691,2393,100,10,9,0,0,5203,10388
3701,36,3215,1799,40,6,8,1,0,5069,2291,2426,91,7,25,0,0,4840,9909
3701,37,2958,1998,74,4,13,0,0,5047,2204,2648,151,22,8,1,0,5034,10081
3701,38,3016,2196,73,6,9,0,0,5300,2224,2863,176,17,16,0,0,5296,10596
3701,39,2832,2319,84,5,8,0,0,5248,2164,3016,184,21,4,0,0,5389,10637
3701,40,2774,2586,121,5,13,0,0,5499,2054,3081,202,28,7,0,0,5372,10871
3701,41,2571,2724,115,6,6,0,0,5422,1951,3293,270,41,6,0,0,5561,10983
3701,42,2572,2787,153,23,6,1,0,5542,1869,3386,272,42,8,0,0,5577,11119
3701,43,2666,3071,210,13,2,2,0,5964,1827,3604,322,61,10,0,1,5825,11789
3701,44,2603,3229,244,15,10,1,0,6102,1926,3769,353,52,5,0,0,6105,12207
3701,45,2675,3360,246,25,13,0,1,6320,1900,3988,398,51,4,0,0,6341,12661
3701,46,2622,3631,278,15,9,0,0,6555,1926,4315,473,84,5,0,0,6803,13358
3701,47,2743,3990,337,15,8,0,0,7093,1829,4492,544,93,7,0,0,6965,14058
3701,48,2744,4223,393,17,11,1,0,7389,1833,4621,552,123,4,0,0,7133,14522
3701,49,2625,4526,426,28,8,0,0,7613,1875,5060,602,135,4,0,0,7676,15289
3701,50,2538,4657,467,32,8,0,0,7702,1759,5049,649,134,6,0,0,7597,15299
3701,51,2495,4765,463,47,8,0,0,7778,1700,5085,696,129,3,0,0,7613,15391
3701,52,2285,4881,528,34,11,1,0,7740,1686,5283,605,180,8,1,0,7763,15503
3701,53,2249,5064,529,53,8,0,0,7903,1554,5341,775,185,5,0,0,7860,15763
3701,54,2098,5287,587,55,15,1,0,8043,1426,5571,754,230,5,0,0,7986,16029
3701,55,1850,5427,576,54,10,0,0,7917,1401,5616,788,265,1,0,0,8071,15988
3701,56,1893,5380,600,54,13,0,2,7942,1337,5673,774,238,2,2,0,8026,15968
3701,57,1710,5465,637,70,10,0,0,7892,1245,5814,735,285,5,0,0,8084,15976
3701,58,1541,5656,660,105,15,0,0,7977,1160,5841,792,349,5,0,0,8147,16124
3701,59,1451,5764,626,101,9,0,0,7951,1173,5961,790,403,2,0,0,8329,16280
3701,60,1245,5612,647,100,7,0,0,7611,1010,5551,666,374,2,0,0,7603,15214
3701,61,1108,5429,535,106,9,0,0,7187,942,5434,625,463,2,0,0,7466,14653
3701,62,1044,5177,509,122,13,0,0,6865,859,5211,668,475,3,0,0,7216,14081
3701,63,843,4964,417,119,10,0,0,6353,738,4910,577,551,1,0,0,6777,13130
3701,64,814,4978,445,145,4,0,0,6386,735,4833,534,571,2,0,0,6675,13061
3701,65,730,4750,427,132,7,0,0,6046,660,4474,457,684,1,0,0,6276,12322
3701,66,663,4687,360,177,5,0,0,5892,579,4277,452,710,0,1,0,6019,11911
3701,67,582,4501,355,172,1,0,1,5612,542,4365,436,795,0,0,0,6138,11750
3701,68,509,4208,305,174,2,0,0,5198,527,4008,374,829,0,0,0,5738,10936
3701,69,529,4184,280,207,10,0,0,5210,438,3909,346,870,0,0,0,5563,10773
3701,70,443,3968,216,218,3,0,0,4848,389,3770,347,918,0,0,0,5424,10272
3701,71,431,3873,241,223,9,0,0,4777,360,3764,279,1033,0,0,0,5436,10213
3701,72,396,3887,223,256,7,0,1,4770,333,3494,288,1107,1,0,0,5223,9993
3701,73,376,3843,184,266,2,0,0,4671,333,3631,251,1233,0,0,0,5448,10119
3701,74,330,3931,189,287,6,0,1,4744,333,3339,189,1404,0,0,0,5265,10009
3701,75,348,3781,159,331,5,0,0,4624,315,3305,246,1503,0,0,0,5369,9993
3701,76,306,3628,142,340,3,0,0,4419,302,2978,194,1588,0,0,0,5062,9481
3701,77,318,3734,138,431,2,0,0,4623,300,3059,187,1848,0,0,0,5394,10017
3701,78,195,2561,95,342,0,0,0,3193,250,2103,144,1488,1,0,0,3986,7179
3701,79,218,2861,84,371,1,0,0,3535,252,2145,123,1752,0,0,0,4272,7807
3701,80,225,2761,56,441,0,0,0,3483,253,2036,125,1950,0,0,0,4364,7847
3701,81,208,2510,67,440,2,0,1,3228,266,1770,130,1975,0,0,0,4141,7369
3701,82,216,2352,43,419,1,0,0,3031,250,1572,87,2159,0,0,0,4068,7099
3701,83,201,2273,61,486,1,0,0,3022,243,1445,92,2427,0,0,0,4207,7229
3701,84,160,2156,41,464,0,0,1,2822,233,1223,70,2279,0,0,0,3805,6627
3701,85,134,1762,25,462,0,0,0,2383,260,961,75,2412,0,0,0,3708,6091
3701,86,114,1426,37,416,1,0,0,1994,202,729,49,2130,0,0,0,3110,5104
3701,87,112,1101,33,393,1,0,0,1640,191,499,43,2051,0,0,0,2784,4424
3701,88,72,1003,6,399,0,0,0,1480,159,430,30,2088,0,0,0,2707,4187
3701,89,53,850,8,337,0,0,0,1248,156,284,33,1911,0,0,0,2384,3632
3701,90,47,595,8,295,0,0,0,945,146,191,21,1512,0,0,0,1870,2815
3701,91,43,431,3,283,0,0,0,760,120,139,21,1378,0,0,0,1658,2418
3701,92,24,288,2,213,0,0,0,527,121,101,8,1181,0,0,0,1411,1938
3701,93,24,221,3,197,0,0,0,445,99,54,9,1000,0,0,0,1162,1607
3701,94,12,160,4,118,0,0,0,294,66,34,9,773,0,0,0,882,1176
3701,95,10,99,2,104,0,0,0,215,53,16,1,628,0,0,0,698,913
3701,96,5,75,1,71,0,0,0,152,53,10,2,474,0,0,0,539,691
3701,97,5,41,2,47,0,0,0,95,32,7,2,337,0,0,0,378,473
3701,98,3,14,0,30,0,0,0,47,29,6,2,250,0,0,0,287,334
3701,99,1,13,0,19,0,0,0,33,12,0,0,144,0,0,0,156,189
3701,100,2,10,0,31,0,0,0,43,28,4,1,199,0,0,0,232,275
3701,999,223682,207234,15004,10988,390,10,8,457316,191220,209629,20538,52673,223,7,1,474291,931607
3750,0,605,0,0,0,0,0,0,605,582,0,0,0,0,0,0,582,1187
3750,1,612,0,0,0,0,0,0,612,587,0,0,0,0,0,0,587,1199
3750,2,665,0,0,0,0,0,0,665,567,0,0,0,0,0,0,567,1232
3750,3,636,0,0,0,0,0,0,636,589,0,0,0,0,0,0,589,1225
3750,4,657,0,0,0,0,0,0,657,635,0,0,0,0,0,0,635,1292
3750,5,730,0,0,0,0,0,0,730,677,0,0,0,0,0,0,677,1407
3750,6,853,0,0,0,0,0,0,853,743,0,0,0,0,0,0,743,1596
3750,7,750,0,0,0,0,0,0,750,807,0,0,0,0,0,0,807,1557
3750,8,796,0,0,0,0,0,0,796,832,0,0,0,0,0,0,832,1628
3750,9,832,0,0,0,0,0,0,832,817,0,0,0,0,0,0,817,1649
3750,10,913,0,0,0,0,0,0,913,835,0,0,0,0,0,0,835,1748
3750,11,986,0,0,0,0,0,0,986,873,0,0,0,0,0,0,873,1859
3750,12,914,0,0,0,0,0,0,914,929,0,0,0,0,0,0,929,1843
3750,13,1033,0,0,0,0,0,0,1033,969,0,0,0,0,0,0,969,2002
3750,14,1016,0,0,0,0,0,0,1016,953,0,0,0,0,0,0,953,1969
3750,15,1051,0,0,0,0,0,0,1051,924,0,0,0,0,0,0,924,1975
3750,16,959,0,1,0,0,0,0,960,946,0,0,0,0,0,0,946,1906
3750,17,953,0,0,0,0,0,0,953,854,0,0,0,0,0,0,854,1807
3750,18,999,0,0,0,0,0,0,999,909,0,0,0,0,0,0,909,1908
3750,19,984,0,0,0,0,0,0,984,934,2,0,0,0,0,0,936,1920
3750,20,930,0,0,0,0,0,0,930,896,2,0,0,0,0,0,898,1828
3750,21,952,3,0,0,0,0,0,955,856,10,0,0,0,0,0,866,1821
3750,22,1027,2,0,0,0,0,0,1029,844,29,0,0,0,0,0,873,1902
3750,23,1010,10,1,0,0,0,0,1021,941,26,0,0,0,0,0,967,1988
3750,24,995,9,0,0,0,0,0,1004,903,58,1,0,0,0,0,962,1966
3750,25,1038,14,1,0,0,0,0,1053,900,76,3,0,0,0,0,979,2032
3750,26,1045,24,0,0,1,0,0,1070,871,95,3,0,1,0,0,970,2040
3750,27,1003,55,0,0,1,0,0,1059,818,126,5,0,0,0,0,949,2008
3750,28,990,56,2,0,1,0,0,1049,776,152,2,0,0,0,0,930,1979
3750,29,969,94,1,0,0,0,0,1064,717,208,5,1,0,0,0,931,1995
3750,30,896,115,5,0,0,0,0,1016,690,237,13,0,1,0,0,941,1957
3750,31,969,153,7,0,3,0,0,1132,707,264,11,0,1,0,0,983,2115
3750,32,960,163,5,1,0,0,0,1129,705,373,15,1,1,0,0,1095,2224
3750,33,924,234,10,0,2,0,0,1170,685,391,16,4,0,0,0,1096,2266
3750,34,846,279,7,0,0,0,0,1132,637,407,16,1,1,0,0,1062,2194
3750,35,816,322,13,1,3,0,0,1155,635,464,38,4,1,0,0,1142,2297
3750,36,805,363,14,1,3,0,0,1186,570,489,31,1,3,0,0,1094,2280
3750,37,769,394,23,1,6,0,0,1193,555,517,38,7,1,0,0,1118,2311
3750,38,772,401,23,0,1,0,0,1197,588,614,44,7,2,0,0,1255,2452
3750,39,727,492,23,1,3,0,0,1246,502,629,52,5,1,0,0,1189,2435
3750,40,755,557,25,1,1,0,0,1339,467,636,54,8,3,0,0,1168,2507
3750,41,675,562,44,0,2,0,0,1283,495,751,65,12,0,0,0,1323,2606
3750,42,686,622,45,8,1,0,0,1362,524,777,87,28,0,0,0,1416,2778
3750,43,732,652,53,7,2,0,0,1446,469,803,91,19,3,0,0,1385,2831
3750,44,707,700,63,6,2,0,0,1478,469,875,91,20,1,0,0,1456,2934
3750,45,747,803,72,6,2,0,0,1630,578,966,129,23,0,0,0,1696,3326
3750,46,762,894,86,8,2,0,0,1752,523,970,132,24,2,0,0,1651,3403
3750,47,782,926,104,8,2,1,0,1823,473,1029,138,27,1,0,0,1668,3491
3750,48,717,974,121,7,3,0,0,1822,461,1110,158,31,2,0,0,1762,3584
3750,49,739,1064,126,3,4,0,0,1936,468,1176,167,29,2,0,0,1842,3778
3750,50,700,1024,133,8,2,1,0,1868,442,1229,187,44,1,0,0,1903,3771
3750,51,685,1086,143,13,4,0,0,1931,393,1184,165,46,1,0,0,1789,3720
3750,52,600,1151,149,6,2,0,0,1908,345,1276,173,42,1,0,0,1837,3745
3750,53,586,1119,151,15,3,0,0,1874,301,1281,190,44,0,0,0,1816,3690
3750,54,528,1209,174,13,1,0,0,1925,347,1289,186,73,0,0,0,1895,3820
3750,55,491,1262,162,12,2,0,0,1929,277,1340,191,64,1,0,0,1873,3802
3750,56,448,1297,167,25,2,0,0,1939,294,1381,158,80,1,0,0,1914,3853
3750,57,403,1395,166,21,2,0,0,1987,292,1453,199,83,0,0,0,2027,4014
3750,58,378,1365,173,30,2,0,0,1948,268,1419,179,95,0,0,0,1961,3909
3750,59,366,1419,194,28,1,0,0,2008,257,1514,190,104,0,0,0,2065,4073
3750,60,344,1387,153,36,0,0,0,1920,215,1477,161,138,0,0,0,1991,3911
3750,61,307,1362,158,42,3,0,0,1872,207,1444,175,138,0,0,0,1964,3836
3750,62,301,1388,158,42,1,0,0,1890,189,1465,172,170,0,0,0,1996,3886
3750,63,281,1347,122,35,2,1,0,1788,142,1371,138,174,0,0,1,1826,3614
3750,64,250,1372,134,58,2,0,0,1816,137,1409,140,197,0,0,0,1883,3699
3750,65,191,1362,106,50,0,0,0,1709,127,1280,115,221,0,0,0,1743,3452
3750,66,172,1344,105,59,2,0,0,1682,116,1321,117,231,0,0,0,1785,3467
3750,67,180,1357,112,47,1,0,0,1697,130,1318,97,282,0,0,0,1827,3524
3750,68,158,1293,78,60,0,0,0,1589,124,1273,85,274,0,0,0,1756,3345
3750,69,133,1237,83,73,0,0,0,1526,102,1143,92,330,0,0,0,1667,3193
3750,70,116,1282,66,77,1,0,0,1542,93,1152,83,362,0,0,0,1690,3232
3750,71,111,1227,79,92,0,0,0,1509,95,1100,69,337,0,0,0,1601,3110
3750,72,110,1152,55,108,0,0,0,1425,84,954,59,320,0,0,0,1417,2842
3750,73,126,1203,62,99,0,0,0,1490,80,1025,54,401,0,0,0,1560,3050
3750,74,115,1121,45,119,0,0,1,1401,89,999,45,406,0,0,0,1539,2940
3750,75,100,1172,40,130,0,0,0,1442,82,919,55,510,0,0,0,1566,3008
3750,76,99,1042,37,140,0,0,0,1318,76,834,51,505,0,0,0,1466,2784
3750,77,75,1088,23,133,0,1,0,1320,60,806,40,573,0,0,0,1479,2799
3750,78,52,618,23,90,0,0,0,783,29,441,22,411,0,0,0,903,1686
3750,79,71,741,29,103,0,0,0,944,53,525,25,570,0,0,0,1173,2117
3750,80,60,681,22,121,0,0,0,884,51,456,20,534,0,0,0,1061,1945
3750,81,45,598,12,118,0,0,0,773,56,446,18,610,0,0,0,1130,1903
3750,82,62,614,20,126,0,0,0,822,52,357,21,638,0,0,0,1068,1890
3750,83,57,544,4,112,0,0,0,717,58,339,12,696,0,0,0,1105,1822
3750,84,38,492,8,141,0,0,0,679,54,278,15,686,0,0,0,1033,1712
3750,85,37,461,7,134,0,0,0,639,44,251,10,685,0,0,0,990,1629
3750,86,31,343,0,147,0,0,0,521,44,174,11,645,0,0,0,874,1395
3750,87,33,250,4,112,0,0,0,399,40,115,7,618,0,0,0,780,1179
3750,88,28,256,7,124,0,0,0,415,28,100,3,606,0,0,0,737,1152
3750,89,21,196,2,116,0,0,0,335,36,79,5,554,0,0,0,674,1009
3750,90,13,150,3,86,0,0,0,252,39,62,4,475,0,0,0,580,832
3750,91,13,103,4,81,0,0,0,201,27,38,4,388,0,0,0,457,658
3750,92,4,89,1,59,0,0,0,153,28,26,1,365,0,0,0,420,573
3750,93,10,60,0,55,0,0,0,125,23,19,2,314,0,0,0,358,483
3750,94,5,30,0,43,0,0,0,78,20,9,2,236,0,0,0,267,345
3750,95,1,28,0,32,0,0,0,61,18,6,0,174,0,0,0,198,259
3750,96,1,10,1,28,0,0,0,40,11,6,1,127,0,0,0,145,185
3750,97,0,6,0,14,0,0,0,20,7,3,0,103,0,0,0,113,133
3750,98,1,3,0,11,0,0,0,15,3,2,1,59,0,0,0,65,80
3750,99,1,1,0,9,0,0,0,11,3,1,0,43,0,0,0,47,58
3750,100,1,1,0,4,0,0,0,6,7,0,2,62,0,0,0,71,77
3750,999,51628,52275,4250,3496,78,4,1,111732,41780,52651,5157,16095,32,0,1,115716,227448
3883,0,1435,0,0,0,0,0,0,1435,1372,0,0,0,0,0,0,1372,2807
3883,1,1539,0,0,0,0,0,0,1539,1446,0,0,0,0,0,0,1446,2985
3883,2,1565,0,0,0,0,0,0,1565,1475,0,0,0,0,0,0,1475,3040
3883,3,1671,0,0,0,0,0,0,1671,1564,0,0,0,0,0,0,1564,3235
3883,4,1649,0,0,0,0,0,0,1649,1573,0,0,0,0,0,0,1573,3222
3883,5,1721,0,0,0,0,0,0,1721,1624,0,0,0,0,0,0,1624,3345
3883,6,1815,0,0,0,0,0,0,1815,1711,0,0,0,0,0,0,1711,3526
3883,7,1907,0,0,0,0,0,0,1907,1824,0,0,0,0,0,0,1824,3731
3883,8,1873,0,0,0,0,0,0,1873,1874,0,0,0,0,0,0,1874,3747
3883,9,2082,0,0,0,0,0,0,2082,1941,0,0,0,0,0,0,1941,4023
3883,10,2115,0,0,0,0,0,0,2115,2016,0,0,0,0,0,0,2016,4131
3883,11,2159,0,0,0,0,0,0,2159,2114,0,0,0,0,0,0,2114,4273
3883,12,2159,0,0,0,0,0,0,2159,2097,0,0,0,0,0,0,2097,4256
3883,13,2353,0,0,0,0,0,0,2353,2164,0,0,0,0,0,0,2164,4517
3883,14,2324,0,0,0,0,0,0,2324,2315,0,0,0,0,0,0,2315,4639
3883,15,2282,0,0,0,0,0,0,2282,2236,0,0,0,0,0,0,2236,4518
3883,16,2331,0,0,0,0,0,0,2331,2270,0,0,0,0,0,0,2270,4601
3883,17,2376,0,0,0,0,0,0,2376,2263,0,0,0,0,0,0,2263,4639
3883,18,2431,0,0,0,0,0,0,2431,2251,1,0,0,0,0,0,2252,4683
3883,19,2401,0,0,0,0,0,0,2401,2282,6,0,0,0,0,0,2288,4689
3883,20,2552,2,0,0,0,0,0,2554,2216,13,0,0,0,0,0,2229,4783
3883,21,2458,6,0,0,0,0,0,2464,2253,30,0,0,0,0,0,2283,4747
3883,22,2465,12,4,0,0,0,0,2481,2183,58,0,0,0,0,0,2241,4722
3883,23,2567,13,1,0,0,0,0,2581,2269,76,0,0,2,0,0,2347,4928
3883,24,2450,34,3,0,0,0,0,2487,2076,102,0,0,0,0,0,2178,4665
3883,25,2488,52,2,0,1,0,0,2543,2124,124,1,0,0,0,0,2249,4792
3883,26,2397,80,4,0,1,0,0,2482,2032,205,0,1,0,0,0,2238,4720
3883,27,2396,105,2,1,3,1,0,2508,1920,278,3,1,1,0,0,2203,4711
3883,28,2336,165,1,0,2,0,0,2504,1916,372,4,0,1,0,0,2293,4797
3883,29,2220,211,3,0,3,0,0,2437,1753,464,11,0,1,1,0,2230,4667
3883,30,2160,287,7,0,4,0,0,2458,1607,518,17,2,1,0,0,2145,4603
3883,31,2166,446,10,0,3,0,0,2625,1685,726,31,2,2,0,0,2446,5071
3883,32,1991,528,10,1,1,0,0,2531,1619,785,26,2,4,0,0,2436,4967
3883,33,2001,556,13,1,3,1,0,2575,1508,936,26,4,2,1,0,2477,5052
3883,34,1849,698,19,2,6,0,0,2574,1435,1051,47,0,5,0,0,2538,5112
3883,35,1747,835,39,0,3,0,0,2624,1367,1151,58,4,3,0,0,2583,5207
3883,36,1618,834,34,4,2,0,0,2492,1223,1237,53,6,5,0,0,2524,5016
3883,37,1664,879,62,2,6,0,0,2613,1210,1266,97,8,5,0,0,2586,5199
3883,38,1612,1055,42,1,0,0,0,2710,1179,1450,90,10,2,1,0,2732,5442
3883,39,1664,1175,42,2,2,1,0,2886,1209,1424,112,11,6,0,0,2762,5648
3883,40,1473,1276,56,2,2,2,0,2811,1116,1544,128,10,6,0,0,2804,5615
3883,41,1507,1367,82,4,1,0,0,2961,1050,1704,160,18,4,0,0,2936,5897
3883,42,1510,1432,91,4,1,0,0,3038,1048,1662,191,28,4,2,0,2935,5973
3883,43,1474,1509,144,3,2,0,1,3133,1036,1769,201,22,1,1,0,3030,6163
3883,44,1474,1673,125,11,4,0,0,3287,1062,1842,198,29,3,0,0,3134,6421
3883,45,1579,1776,155,4,4,0,1,3519,1140,1931,267,47,6,0,0,3391,6910
3883,46,1543,1695,189,8,3,0,0,3438,1092,2145,282,32,2,0,0,3553,6991
3883,47,1534,1914,175,9,6,1,0,3639,1130,2197,321,52,2,0,0,3702,7341
3883,48,1624,2082,228,22,12,0,0,3968,1059,2414,377,74,3,0,0,3927,7895
3883,49,1584,2294,265,13,5,0,0,4161,1114,2659,411,85,2,1,0,4272,8433
3883,50,1507,2285,303,26,2,0,0,4123,1124,2614,430,81,6,2,0,4257,8380
3883,51,1459,2412,305,15,9,0,0,4200,961,2756,436,109,1,0,0,4263,8463
3883,52,1414,2573,298,24,6,0,0,4315,913,2862,486,125,1,0,0,4387,8702
3883,53,1334,2582,377,19,6,0,0,4318,922,2952,503,123,6,0,0,4506,8824
3883,54,1321,2738,379,26,1,0,0,4465,877,2981,462,133,2,2,0,4457,8922
3883,55,1204,2780,385,27,3,0,0,4399,787,2879,513,187,1,0,0,4367,8766
3883,56,1128,2804,437,31,3,0,0,4403,763,3057,528,156,3,0,0,4507,8910
3883,57,1036,2914,412,49,6,0,0,4417,794,3009,538,206,0,0,0,4547,8964
3883,58,1097,2945,432,46,5,0,0,4525,720,3066,493,204,1,0,0,4484,9009
3883,59,998,3018,444,58,5,0,0,4523,718,3094,567,223,2,0,0,4604,9127
3883,60,862,2834,415,55,7,0,0,4173,555,3128,516,290,2,0,0,4491,8664
3883,61,813,2753,418,70,3,0,0,4057,517,2871,477,335,0,0,0,4200,8257
3883,62,686,2760,387,68,6,0,0,3907,502,2752,472,343,0,0,0,4069,7976
3883,63,637,2761,357,68,3,0,0,3826,469,2698,409,356,1,0,0,3933,7759
3883,64,578,2721,369,97,2,0,0,3767,412,2701,417,414,1,0,0,3945,7712
3883,65,518,2509,340,91,2,0,0,3460,366,2540,342,454,0,0,0,3702,7162
3883,66,471,2372,305,108,2,0,1,3259,291,2477,331,445,1,0,0,3545,6804
3883,67,445,2402,301,126,2,0,0,3276,324,2411,317,535,0,0,0,3587,6863
3883,68,446,2370,249,136,1,0,0,3202,291,2275,321,551,1,0,0,3439,6641
3883,69,352,2385,246,122,4,0,0,3109,259,2290,282,618,0,0,0,3449,6558
3883,70,329,2361,223,143,2,0,0,3058,224,2232,229,730,0,0,0,3415,6473
3883,71,314,2278,202,150,1,0,0,2945,219,2167,236,733,0,0,0,3355,6300
3883,72,326,2172,166,137,1,0,1,2803,210,2098,191,833,0,0,0,3332,6135
3883,73,321,2383,162,202,1,0,0,3069,202,2118,189,908,0,0,0,3417,6486
3883,74,299,2324,167,218,2,0,0,3010,212,2068,201,995,0,0,0,3476,6486
3883,75,307,2401,144,234,0,0,0,3086,213,2018,190,1136,1,0,0,3558,6644
3883,76,272,2383,123,269,1,0,0,3048,190,1926,177,1239,0,0,0,3532,6580
3883,77,264,2476,108,308,1,0,0,3157,180,1982,159,1458,0,0,0,3779,6936
3883,78,185,1586,75,224,0,0,0,2070,152,1246,119,1038,0,0,0,2555,4625
3883,79,189,1847,86,295,0,0,0,2417,148,1308,111,1337,0,0,0,2904,5321
3883,80,189,1685,83,294,1,0,0,2252,147,1230,109,1363,0,0,0,2849,5101
3883,81,175,1585,71,292,1,0,0,2124,153,1175,84,1491,0,0,0,2903,5027
3883,82,151,1536,61,349,2,0,0,2099,164,990,67,1543,0,0,0,2764,4863
3883,83,155,1478,53,352,0,0,0,2038,164,859,66,1663,1,0,0,2753,4791
3883,84,136,1315,44,328,0,0,0,1823,163,774,59,1599,0,0,0,2595,4418
3883,85,107,1125,28,337,0,0,0,1597,131,569,58,1618,0,0,0,2376,3973
3883,86,91,890,20,303,0,0,0,1304,122,419,54,1417,0,0,0,2012,3316
3883,87,55,710,19,264,0,0,0,1048,104,289,24,1401,0,0,0,1818,2866
3883,88,53,582,15,229,0,0,0,879,103,265,21,1322,0,0,1,1712,2591
3883,89,34,462,15,224,0,0,0,735,106,168,25,1108,0,0,0,1407,2142
3883,90,34,354,4,196,0,0,0,588,76,91,13,1033,0,0,0,1213,1801
3883,91,26,258,4,160,0,0,0,448,58,71,18,929,0,0,0,1076,1524
3883,92,14,206,3,159,0,0,0,382,61,61,10,738,0,0,0,870,1252
3883,93,21,138,3,125,0,0,0,287,63,28,10,715,0,0,0,816,1103
3883,94,13,87,2,89,0,0,0,191,36,16,8,509,0,0,0,569,760
3883,95,7,61,4,68,0,0,0,140,39,13,4,429,0,0,0,485,625
3883,96,3,44,0,55,0,0,0,102,29,10,5,351,0,0,0,395,497
3883,97,2,22,0,32,0,0,0,56,16,2,2,247,0,0,0,267,323
3883,98,1,13,0,20,0,0,0,34,13,3,3,178,0,0,0,197,231
3883,99,2,6,0,6,0,0,0,14,18,1,2,116,0,0,0,137,151
3883,100,1,6,0,25,0,0,0,32,16,2,0,194,0,0,0,212,244
3883,999,120673,112683,10852,7443,171,6,4,251832,100340,113752,14396,36707,104,11,1,265311,517143
3902,0,504,0,0,0,0,0,0,504,416,0,0,0,0,0,0,416,920
3902,1,459,0,0,0,0,0,0,459,487,0,0,0,0,0,0,487,946
3902,2,438,0,0,0,0,0,0,438,404,0,0,0,0,0,0,404,842
3902,3,451,0,0,0,0,0,0,451,480,0,0,0,0,0,0,480,931
3902,4,457,0,0,0,0,0,0,457,458,0,0,0,0,0,0,458,915
3902,5,499,0,0,0,0,0,0,499,475,0,0,0,0,0,0,475,974
3902,6,515,0,0,0,0,0,0,515,523,0,0,0,0,0,0,523,1038
3902,7,523,0,0,0,0,0,0,523,493,0,0,0,0,0,0,493,1016
3902,8,553,0,0,0,0,0,0,553,554,0,0,0,0,0,0,554,1107
3902,9,550,0,0,0,0,0,0,550,488,0,0,0,0,0,0,488,1038
3902,10,596,0,0,0,0,0,0,596,484,0,0,0,0,0,0,484,1080
3902,11,593,0,0,0,0,0,0,593,553,0,0,0,0,0,0,553,1146
3902,12,679,0,0,0,0,0,0,679,551,0,0,0,0,0,0,551,1230
3902,13,623,0,0,0,0,0,0,623,598,0,0,0,0,0,0,598,1221
3902,14,641,0,0,0,0,0,0,641,539,0,0,0,0,0,0,539,1180
3902,15,677,0,0,0,0,0,0,677,584,0,0,0,0,0,0,584,1261
3902,16,625,0,0,0,0,0,0,625,618,0,0,0,0,0,0,618,1243
3902,17,663,0,0,0,0,0,0,663,620,0,0,0,0,0,0,620,1283
3902,18,684,0,0,0,0,0,0,684,600,1,0,0,0,0,0,601,1285
3902,19,653,1,0,0,0,0,0,654,593,2,0,0,0,0,0,595,1249
3902,20,661,1,0,0,0,0,0,662,599,9,0,0,0,0,0,608,1270
3902,21,699,1,0,0,0,0,0,700,551,20,0,0,0,0,0,571,1271
3902,22,735,4,0,0,0,0,0,739,590,24,1,0,0,0,0,615,1354
3902,23,720,3,0,0,1,0,0,724,587,63,1,0,0,0,0,651,1375
3902,24,695,17,0,0,0,0,0,712,548,74,1,0,0,0,0,623,1335
3902,25,765,36,3,0,0,0,0,804,518,100,3,0,1,0,0,622,1426
3902,26,681,39,2,0,0,0,1,723,528,111,0,0,1,0,0,640,1363
3902,27,703,59,6,0,0,0,0,768,488,137,1,1,1,0,0,628,1396
3902,28,625,73,4,0,0,0,0,702,460,169,3,0,0,0,0,632,1334
3902,29,593,88,2,0,0,0,0,683,441,172,4,0,0,0,0,617,1300
3902,30,562,112,7,0,1,1,0,683,426,203,8,0,2,0,0,639,1322
3902,31,573,140,7,0,1,0,0,721,402,248,10,1,0,0,0,661,1382
3902,32,507,171,4,0,2,0,0,684,372,282,8,1,0,0,0,663,1347
3902,33,522,211,5,1,0,0,0,739,324,317,8,0,0,0,0,649,1388
3902,34,447,261,5,0,0,0,0,713,347,306,12,1,0,0,0,666,1379
3902,35,445,248,6,5,2,0,0,706,293,335,11,0,1,0,0,640,1346
3902,36,372,277,10,0,0,1,0,660,271,356,11,2,1,0,0,641,1301
3902,37,366,308,14,1,2,0,0,691,241,371,19,2,0,0,0,633,1324
3902,38,360,321,17,1,1,0,0,700,223,424,27,2,1,0,0,677,1377
3902,39,374,354,20,1,1,0,0,750,235,408,40,4,0,0,0,687,1437
3902,40,347,386,17,0,0,0,0,750,216,396,31,8,0,0,0,651,1401
3902,41,372,426,32,4,0,0,0,834,250,412,49,5,0,0,0,716,1550
3902,42,355,412,31,4,1,0,0,803,233,478,38,4,0,0,0,753,1556
3902,43,371,445,48,7,2,0,0,873,226,449,56,4,0,0,0,735,1608
3902,44,383,495,27,1,0,0,0,906,222,481,55,13,0,0,0,771,1677
3902,45,379,519,48,6,0,0,0,952,259,529,71,8,1,0,0,868,1820
3902,46,387,566,37,6,2,0,0,998,253,532,66,6,2,0,0,859,1857
3902,47,394,535,57,6,0,0,0,992,222,575,94,22,1,0,0,914,1906
3902,48,392,616,71,7,0,0,0,1086,253,613,105,13,1,0,0,985,2071
3902,49,458,651,86,7,1,0,0,1203,280,697,112,26,1,0,0,1116,2319
3902,50,400,605,98,2,1,0,0,1106,277,727,121,22,0,0,0,1147,2253
3902,51,446,683,88,9,1,0,0,1227,241,756,124,31,1,0,0,1153,2380
3902,52,406,695,79,4,2,0,0,1186,210,785,121,33,3,0,0,1152,2338
3902,53,375,698,92,6,2,0,0,1173,242,730,142,44,1,0,0,1159,2332
3902,54,358,748,127,15,1,0,0,1249,243,751,132,47,1,0,0,1174,2423
3902,55,342,718,127,15,2,0,0,1204,214,744,145,38,0,0,0,1141,2345
3902,56,342,749,138,7,0,0,0,1236,211,784,159,50,1,0,0,1205,2441
3902,57,342,740,141,17,4,0,0,1244,179,754,173,61,0,0,0,1167,2411
3902,58,296,770,126,15,1,0,0,1208,189,820,166,59,0,0,0,1234,2442
3902,59,311,802,139,20,0,0,0,1272,181,800,179,83,0,0,0,1243,2515
3902,60,239,808,115,16,1,0,0,1179,165,751,139,67,0,0,0,1122,2301
3902,61,217,768,110,23,1,0,0,1119,143,703,127,86,1,0,0,1060,2179
3902,62,191,721,119,20,2,0,0,1053,122,719,129,103,0,0,0,1073,2126
3902,63,218,738,117,20,0,0,0,1093,116,642,115,73,0,0,0,946,2039
3902,64,130,663,121,25,1,0,0,940,77,649,113,114,0,0,0,953,1893
3902,65,144,621,95,25,1,0,0,886,84,615,101,112,0,0,0,912,1798
3902,66,123,585,84,17,1,0,0,810,92,610,97,133,0,0,0,932,1742
3902,67,103,616,65,20,1,0,0,805,68,542,94,125,0,0,0,829,1634
3902,68,100,600,86,45,0,0,0,831,78,532,89,145,0,0,0,844,1675
3902,69,113,558,55,37,1,0,0,764,65,487,81,158,1,0,0,792,1556
3902,70,84,567,58,48,0,0,0,757,64,569,82,179,0,0,0,894,1651
3902,71,63,483,52,42,0,0,1,641,52,543,73,169,0,0,0,837,1478
3902,72,84,570,58,54,0,0,0,766,47,504,68,205,0,0,0,824,1590
3902,73,69,515,55,50,0,0,0,689,56,538,63,230,0,0,0,887,1576
3902,74,54,588,50,55,0,0,0,747,39,550,58,253,0,0,0,900,1647
3902,75,68,600,54,68,1,0,0,791,57,533,78,298,0,0,0,966,1757
3902,76,57,592,43,60,0,0,0,752,46,513,56,343,0,0,0,958,1710
3902,77,61,588,41,77,0,0,0,767,52,464,44,381,0,0,0,941,1708
3902,78,35,411,22,57,1,0,0,526,28,299,28,255,0,0,0,610,1136
3902,79,36,440,32,84,0,0,0,592,49,339,37,375,0,0,0,800,1392
3902,80,38,422,25,83,0,0,0,568,45,314,41,335,0,0,0,735,1303
3902,81,31,416,18,71,0,0,0,536,32,261,32,394,0,0,0,719,1255
3902,82,38,383,17,116,0,0,0,554,44,276,21,424,0,0,0,765,1319
3902,83,30,384,19,104,0,0,0,537,44,277,18,449,0,0,0,788,1325
3902,84,29,338,12,77,0,0,0,456,50,210,20,440,0,0,0,720,1176
3902,85,23,287,12,77,0,0,0,399,46,160,22,466,0,0,0,694,1093
3902,86,23,238,11,88,0,0,0,360,46,105,12,412,0,0,0,575,935
3902,87,18,221,4,76,0,0,0,319,28,96,9,396,0,0,0,529,848
3902,88,10,158,3,85,0,0,0,256,29,64,11,363,0,0,0,467,723
3902,89,14,115,2,55,0,0,0,186,30,47,9,362,0,0,0,448,634
3902,90,6,91,0,65,0,0,0,162,41,37,5,301,0,0,0,384,546
3902,91,6,79,1,46,0,0,0,132,27,21,6,235,0,0,0,289,421
3902,92,6,47,1,48,0,0,0,102,17,14,5,249,0,0,0,285,387
3902,93,4,43,0,45,0,0,0,92,23,15,3,232,0,0,0,273,365
3902,94,1,19,1,27,0,0,0,48,16,8,4,145,0,0,0,173,221
3902,95,0,21,0,25,0,0,0,46,11,4,1,110,0,0,0,126,172
3902,96,2,9,0,14,0,0,0,25,7,4,2,90,0,0,0,103,128
3902,97,1,10,0,12,0,0,0,23,10,1,0,78,0,0,0,89,112
3902,98,0,3,0,6,0,0,0,9,5,0,0,43,0,0,0,48,57
3902,99,0,1,0,7,0,0,0,8,4,0,3,34,0,0,0,41,49
3902,100,0,1,0,8,0,0,0,9,10,0,1,60,0,0,0,71,80
3902,999,32713,30302,3279,2145,42,2,2,68485,25628,29961,4204,10013,23,0,0,69829,138314
3926,0,658,0,0,0,0,0,0,658,619,0,0,0,0,0,0,619,1277
3926,1,716,0,0,0,0,0,0,716,666,0,0,0,0,0,0,666,1382
3926,2,687,0,0,0,0,0,0,687,693,0,0,0,0,0,0,693,1380
3926,3,699,0,0,0,0,0,0,699,690,0,0,0,0,0,0,690,1389
3926,4,746,0,0,0,0,0,0,746,649,0,0,0,0,0,0,649,1395
3926,5,767,0,0,0,0,0,0,767,739,0,0,0,0,0,0,739,1506
3926,6,801,0,0,0,0,0,0,801,765,0,0,0,0,0,0,765,1566
3926,7,821,0,0,0,0,0,0,821,763,0,0,0,0,0,0,763,1584
3926,8,824,0,0,0,0,0,0,824,729,0,0,0,0,0,0,729,1553
3926,9,863,0,0,0,0,0,0,863,817,0,0,0,0,0,0,817,1680
3926,10,867,0,0,0,0,0,0,867,794,0,0,0,0,0,0,794,1661
3926,11,917,0,0,0,0,0,0,917,897,0,0,0,0,0,0,897,1814
3926,12,974,0,0,0,0,0,0,974,850,0,0,0,0,0,0,850,1824
3926,13,983,0,0,0,0,0,0,983,931,0,0,0,0,0,0,931,1914
3926,14,967,0,0,0,0,0,0,967,916,0,0,0,0,0,0,916,1883
3926,15,1028,0,0,0,0,0,0,1028,898,0,0,0,0,0,0,898,1926
3926,16,1000,0,0,0,0,0,0,1000,969,0,0,0,0,0,0,969,1969
3926,17,963,0,0,0,0,0,0,963,970,0,0,0,0,0,0,970,1933
3926,18,1071,0,0,0,0,0,0,1071,876,1,0,0,0,0,0,877,1948
3926,19,1113,1,0,0,0,0,0,1114,953,2,0,0,0,0,0,955,2069
3926,20,1069,1,0,0,0,0,0,1070,918,8,0,0,0,0,0,926,1996
3926,21,1070,1,0,0,0,0,0,1071,901,16,0,0,0,0,0,917,1988
3926,22,1090,11,0,0,0,0,0,1101,931,21,0,0,0,0,0,952,2053
3926,23,1134,5,1,0,1,0,0,1141,975,27,0,0,0,0,0,1002,2143
3926,24,1114,13,0,0,0,0,0,1127,949,42,1,0,0,0,0,992,2119
3926,25,1125,28,0,0,0,0,0,1153,928,59,3,0,0,0,0,990,2143
3926,26,1215,47,1,0,0,0,0,1263,907,80,0,0,0,0,0,987,2250
3926,27,1178,56,2,0,1,0,0,1237,958,138,6,1,2,0,0,1105,2342
3926,28,1103,79,4,0,0,0,0,1186,890,135,10,0,1,0,0,1036,2222
3926,29,1072,101,4,0,1,0,0,1178,875,209,4,1,0,0,0,1089,2267
3926,30,1097,164,2,0,1,0,0,1264,832,248,8,0,1,0,0,1089,2353
3926,31,1099,199,7,0,1,0,0,1306,824,328,15,1,0,0,0,1168,2474
3926,32,1052,267,10,0,3,0,0,1332,776,371,24,2,3,0,0,1176,2508
3926,33,1002,273,12,2,4,0,0,1293,770,416,27,3,1,0,0,1217,2510
3926,34,941,346,20,0,1,0,0,1308,666,461,31,1,2,0,0,1161,2469
3926,35,913,384,23,0,4,0,0,1324,680,496,33,4,4,0,0,1217,2541
3926,36,805,412,28,2,5,0,0,1252,625,504,51,1,1,0,0,1182,2434
3926,37,785,454,23,1,1,0,0,1264,536,557,51,3,2,0,0,1149,2413
3926,38,698,508,28,4,0,0,0,1238,552,587,55,6,3,0,0,1203,2441
3926,39,702,492,43,2,4,0,0,1243,491,656,67,4,1,0,0,1219,2462
3926,40,643,531,34,2,4,0,0,1214,458,580,62,7,3,0,0,1110,2324
3926,41,624,547,40,1,3,0,0,1215,487,623,64,7,4,0,0,1185,2400
3926,42,568,562,52,7,1,0,0,1190,423,620,75,13,3,0,0,1134,2324
3926,43,591,594,43,5,6,0,0,1239,470,656,94,16,1,0,0,1237,2476
3926,44,572,566,54,4,4,0,0,1200,441,673,102,13,2,0,0,1231,2431
3926,45,645,664,71,2,0,0,0,1382,493,735,127,28,2,1,0,1386,2768
3926,46,635,730,84,2,3,0,0,1454,466,831,135,24,3,0,0,1459,2913
3926,47,639,790,98,11,7,0,0,1545,513,956,167,27,3,0,0,1666,3211
3926,48,629,833,112,9,6,0,0,1589,515,1008,180,29,1,0,0,1733,3322
3926,49,723,922,139,9,7,0,0,1800,523,1012,193,44,3,0,0,1775,3575
3926,50,620,986,138,10,0,0,0,1754,521,1079,229,36,5,0,1,1871,3625
3926,51,729,1027,164,9,3,0,0,1932,490,1119,229,37,4,0,0,1879,3811
3926,52,679,982,164,10,4,0,0,1839,474,1160,249,57,2,0,0,1942,3781
3926,53,628,1018,175,16,4,0,0,1841,474,1120,275,63,4,0,0,1936,3777
3926,54,609,998,195,8,6,0,0,1816,370,1118,276,58,6,0,0,1828,3644
3926,55,528,1069,198,15,3,0,0,1813,372,1146,290,73,1,0,0,1882,3695
3926,56,529,1038,185,25,3,0,0,1780,354,1192,329,60,1,0,0,1936,3716
3926,57,517,1157,225,14,2,0,0,1915,348,1230,322,96,0,0,0,1996,3911
3926,58,465,1180,257,20,2,0,0,1924,352,1303,340,86,1,0,0,2082,4006
3926,59,470,1204,250,34,5,0,0,1963,317,1238,310,117,3,0,0,1985,3948
3926,60,401,1173,237,36,9,0,1,1857,305,1179,281,123,2,0,0,1890,3747
3926,61,333,1105,230,26,3,0,0,1697,237,1143,293,144,2,0,0,1819,3516
3926,62,328,1179,203,32,2,0,0,1744,223,1083,291,139,1,0,0,1737,3481
3926,63,269,1091,208,36,4,0,0,1608,205,1041,260,176,2,0,0,1684,3292
3926,64,269,1065,190,33,0,0,0,1557,186,1038,259,178,1,0,0,1662,3219
3926,65,229,992,167,50,1,0,0,1439,167,1018,257,184,0,0,0,1626,3065
3926,66,211,970,156,48,3,0,0,1388,182,972,251,218,0,0,0,1623,3011
3926,67,196,1009,197,60,3,0,0,1465,117,933,230,239,0,0,0,1519,2984
3926,68,171,965,159,54,1,0,0,1350,134,944,209,252,0,0,0,1539,2889
3926,69,163,899,153,65,1,0,0,1281,111,863,202,290,2,0,0,1468,2749
3926,70,121,885,130,55,0,0,0,1191,124,902,156,280,0,0,0,1462,2653
3926,71,108,910,122,79,2,0,0,1221,101,906,165,294,1,0,0,1467,2688
3926,72,117,854,119,72,2,0,0,1164,87,827,171,363,0,0,0,1448,2612
3926,73,121,929,110,86,1,0,0,1247,108,918,175,451,0,0,0,1652,2899
3926,74,82,938,125,109,0,0,0,1254,83,838,156,454,0,0,0,1531,2785
3926,75,106,1032,98,110,0,0,0,1346,100,859,169,510,1,0,0,1639,2985
3926,76,88,1001,94,124,0,0,0,1307,92,899,166,590,0,0,0,1747,3054
3926,77,106,1010,85,131,0,0,0,1332,91,849,153,608,0,0,0,1701,3033
3926,78,63,629,76,99,1,0,0,868,53,538,103,461,0,0,0,1155,2023
3926,79,62,713,62,123,0,0,0,960,80,594,103,620,0,0,0,1397,2357
3926,80,53,745,55,138,1,0,0,992,59,574,99,617,0,0,0,1349,2341
3926,81,63,732,56,133,0,0,1,985,84,545,114,636,0,0,0,1379,2364
3926,82,51,699,49,166,1,0,0,966,78,507,99,737,0,0,0,1421,2387
3926,83,54,677,46,204,0,0,0,981,78,462,97,821,0,0,0,1458,2439
3926,84,39,592,33,167,0,0,0,831,65,406,81,791,0,0,0,1343,2174
3926,85,30,562,31,180,1,0,0,804,55,304,66,786,0,0,0,1211,2015
3926,86,33,459,25,166,1,0,0,684,41,239,49,753,0,0,0,1082,1766
3926,87,20,348,19,131,1,0,0,519,66,167,46,686,0,0,0,965,1484
3926,88,27,290,10,135,0,0,0,462,52,142,33,651,0,0,0,878,1340
3926,89,14,224,14,104,0,0,0,356,40,79,30,596,0,0,0,745,1101
3926,90,13,172,8,103,0,0,0,296,34,73,22,487,0,0,0,616,912
3926,91,3,142,6,100,0,0,0,251,40,55,25,457,0,0,0,577,828
3926,92,13,101,7,86,0,0,0,207,40,30,17,404,0,0,0,491,698
3926,93,8,86,5,55,0,0,0,154,24,23,12,366,0,0,0,425,579
3926,94,3,44,1,39,0,0,0,87,25,17,11,295,0,0,0,348,435
3926,95,5,31,0,33,0,0,0,69,20,6,5,185,0,0,0,216,285
3926,96,2,13,1,26,0,0,0,42,7,6,3,156,0,0,0,172,214
3926,97,2,12,0,20,0,0,0,34,8,4,0,143,0,0,0,155,189
3926,98,0,7,1,13,0,0,0,21,13,4,1,96,0,0,0,114,135
3926,99,1,3,0,4,0,0,0,8,2,1,0,55,0,0,0,58,66
3926,100,2,11,4,11,0,0,0,28,7,1,5,122,0,0,0,135,163
3926,999,53752,46539,6178,3666,138,0,2,110275,44653,46750,9299,17332,85,1,1,118121,228396
3955,0,1053,0,0,0,0,0,0,1053,962,0,0,0,0,0,0,962,2015
3955,1,1002,0,0,0,0,0,0,1002,981,0,0,0,0,0,0,981,1983
3955,2,959,0,0,0,0,0,0,959,926,0,0,0,0,0,0,926,1885
3955,3,1049,0,0,0,0,0,0,1049,978,0,0,0,0,0,0,978,2027
3955,4,1090,0,0,0,0,0,0,1090,1095,0,0,0,0,0,0,1095,2185
3955,5,1199,0,0,0,0,0,0,1199,1073,0,0,0,0,0,0,1073,2272
3955,6,1176,0,0,0,0,0,0,1176,1039,0,0,0,0,0,0,1039,2215
3955,7,1235,0,0,0,0,0,0,1235,1128,0,0,0,0,0,0,1128,2363
3955,8,1233,0,0,0,0,0,0,1233,1177,0,0,0,0,0,0,1177,2410
3955,9,1333,0,0,0,0,0,0,1333,1181,0,0,0,0,0,0,1181,2514
3955,10,1250,0,0,0,0,0,0,1250,1252,0,0,0,0,0,0,1252,2502
3955,11,1332,0,0,0,0,0,0,1332,1230,0,0,0,0,0,0,1230,2562
3955,12,1271,0,0,0,0,0,0,1271,1216,0,0,0,0,0,0,1216,2487
3955,13,1368,0,0,0,0,0,0,1368,1232,0,0,0,0,0,0,1232,2600
3955,14,1380,0,0,0,0,0,0,1380,1296,0,0,0,0,0,0,1296,2676
3955,15,1351,0,0,0,0,0,0,1351,1233,0,0,0,0,0,0,1233,2584
3955,16,1374,0,0,0,0,0,0,1374,1262,0,0,0,0,0,0,1262,2636
3955,17,1321,0,0,0,0,0,0,1321,1323,0,0,0,0,0,0,1323,2644
3955,18,1325,0,0,0,0,0,0,1325,1285,2,0,0,0,0,0,1287,2612
3955,19,1362,2,0,0,0,0,0,1364,1264,10,0,0,0,0,0,1274,2638
3955,20,1392,0,0,0,0,0,0,1392,1225,23,0,0,0,0,0,1248,2640
3955,21,1417,6,0,0,0,0,0,1423,1233,30,0,0,0,0,0,1263,2686
3955,22,1404,15,0,0,0,0,0,1419,1190,51,0,0,0,0,0,1241,2660
3955,23,1461,21,2,0,0,0,0,1484,1234,102,6,0,0,0,0,1342,2826
3955,24,1488,37,2,0,0,0,0,1527,1158,134,1,0,1,0,0,1294,2821
3955,25,1533,69,5,0,0,0,0,1607,1172,173,4,0,0,0,0,1349,2956
3955,26,1580,90,0,0,0,0,0,1670,1171,234,5,0,0,0,0,1410,3080
3955,27,1399,123,8,0,0,0,0,1530,1098,259,9,1,0,0,0,1367,2897
3955,28,1393,151,10,0,1,0,0,1555,1021,403,12,0,0,0,0,1436,2991
3955,29,1323,213,10,0,0,0,0,1546,992,427,15,0,1,0,0,1435,2981
3955,30,1294,266,5,0,1,0,0,1566,931,512,23,1,0,0,0,1467,3033
3955,31,1256,364,8,0,1,0,0,1629,954,601,15,1,1,0,0,1572,3201
3955,32,1201,448,10,1,3,0,0,1663,823,654,25,3,2,1,0,1508,3171
3955,33,1139,534,17,0,0,1,0,1691,780,778,28,0,5,0,0,1591,3282
3955,34,1056,568,15,2,6,0,0,1647,700,795,43,2,5,0,0,1545,3192
3955,35,1001,612,17,0,3,0,0,1633,640,817,39,7,5,0,0,1508,3141
3955,36,898,676,23,0,4,1,0,1602,642,880,56,9,3,0,0,1590,3192
3955,37,825,700,30,0,3,0,0,1558,591,906,57,9,2,0,0,1565,3123
3955,38,789,739,38,4,0,0,0,1570,539,962,60,15,2,0,0,1578,3148
3955,39,810,874,41,5,3,0,0,1733,531,978,63,9,1,0,0,1582,3315
3955,40,777,819,46,0,4,0,0,1646,504,951,66,13,6,0,0,1540,3186
3955,41,779,908,60,3,3,0,0,1753,505,978,93,11,3,0,0,1590,3343
3955,42,706,932,61,3,7,1,0,1710,476,1073,80,18,3,0,0,1650,3360
3955,43,698,949,78,7,2,0,0,1734,470,1092,115,24,0,0,0,1701,3435
3955,44,741,1013,64,6,3,0,0,1827,479,1113,125,27,3,0,0,1747,3574
3955,45,760,1088,59,7,4,0,0,1918,546,1234,123,16,1,1,0,1921,3839
3955,46,738,1063,94,15,2,1,0,1913,528,1252,141,18,1,0,0,1940,3853
3955,47,749,1287,109,15,2,0,0,2162,515,1259,160,28,0,0,0,1962,4124
3955,48,787,1282,129,13,2,0,0,2213,545,1392,172,40,2,0,0,2151,4364
3955,49,783,1432,139,12,4,0,0,2370,559,1504,193,53,0,0,0,2309,4679
3955,50,739,1344,123,14,2,0,0,2222,538,1546,211,54,1,1,0,2351,4573
3955,51,674,1419,155,12,5,0,0,2265,493,1514,185,66,4,0,0,2262,4527
3955,52,640,1475,164,7,1,0,0,2287,486,1524,230,73,1,0,0,2314,4601
3955,53,664,1429,182,17,4,0,0,2296,438,1584,212,62,0,0,0,2296,4592
3955,54,605,1543,192,11,3,0,0,2354,450,1572,215,93,0,0,0,2330,4684
3955,55,628,1529,191,19,6,0,0,2373,408,1602,236,105,2,0,0,2353,4726
3955,56,585,1637,175,21,2,0,1,2421,382,1537,245,107,1,0,0,2272,4693
3955,57,512,1633,176,25,4,0,0,2350,358,1692,237,131,0,0,0,2418,4768
3955,58,539,1598,204,23,3,0,1,2368,319,1651,220,143,1,0,0,2334,4702
3955,59,451,1644,205,32,5,0,0,2337,351,1588,223,170,0,0,0,2332,4669
3955,60,404,1591,163,25,4,0,0,2187,323,1578,224,159,0,0,0,2284,4471
3955,61,358,1495,190,23,3,0,1,2070,284,1512,221,144,0,0,0,2161,4231
3955,62,355,1526,169,50,2,0,0,2102,239,1515,183,172,2,0,1,2112,4214
3955,63,313,1484,147,52,0,0,0,1996,222,1450,202,197,1,0,0,2072,4068
3955,64,280,1409,159,53,4,0,1,1906,214,1383,149,213,2,0,0,1961,3867
3955,65,262,1442,139,61,0,0,0,1904,190,1302,174,238,0,0,0,1904,3808
3955,66,282,1355,139,57,2,0,0,1835,207,1302,149,225,0,0,0,1883,3718
3955,67,223,1373,141,63,2,0,0,1802,160,1304,141,270,1,0,0,1876,3678
3955,68,210,1271,106,74,3,0,0,1664,163,1267,127,294,1,0,0,1852,3516
3955,69,186,1220,121,89,2,0,0,1618,150,1157,110,316,0,0,0,1733,3351
3955,70,174,1142,77,68,0,0,0,1461,140,1011,107,336,1,0,0,1595,3056
3955,71,155,1127,87,77,1,0,0,1447,127,1023,95,320,0,1,0,1566,3013
3955,72,163,1071,66,87,0,0,0,1387,111,904,92,378,0,0,0,1485,2872
3955,73,161,1146,70,101,1,0,0,1479,95,1004,96,423,0,0,0,1618,3097
3955,74,162,1141,70,98,1,0,1,1473,116,955,73,495,0,0,0,1639,3112
3955,75,155,1099,54,119,0,0,0,1427,96,993,86,540,0,0,0,1715,3142
3955,76,193,1093,67,125,2,0,0,1480,103,882,83,563,0,0,0,1631,3111
3955,77,154,1109,64,144,0,0,0,1471,102,931,54,633,0,0,0,1720,3191
3955,78,104,733,44,108,0,0,0,989,73,641,46,544,0,0,0,1304,2293
3955,79,104,807,45,128,0,0,0,1084,83,623,47,614,0,0,0,1367,2451
3955,80,107,761,34,147,1,1,0,1051,86,575,51,643,0,0,0,1355,2406
3955,81,121,794,23,142,2,0,0,1082,101,522,26,718,1,0,0,1368,2450
3955,82,118,704,23,150,1,1,0,997,86,503,29,737,0,0,0,1355,2352
3955,83,106,711,17,176,0,0,0,1010,97,416,28,815,0,1,0,1357,2367
3955,84,95,603,14,191,0,0,0,903,94,378,27,844,0,0,0,1343,2246
3955,85,88,537,16,186,0,0,0,827,66,332,26,895,0,0,0,1319,2146
3955,86,77,447,12,189,0,0,0,725,67,209,19,791,0,0,0,1086,1811
3955,87,69,337,9,119,0,0,0,534,56,157,17,701,0,0,0,931,1465
3955,88,56,314,7,146,0,0,0,523,51,120,8,689,0,0,0,868,1391
3955,89,37,258,4,130,0,0,0,429,61,104,9,616,0,0,0,790,1219
3955,90,31,173,10,114,0,0,0,328,45,78,7,561,0,0,0,691,1019
3955,91,35,133,2,86,0,0,0,256,42,51,5,519,0,0,0,617,873
3955,92,21,114,3,80,0,0,0,218,38,30,6,420,0,0,0,494,712
3955,93,20,98,3,80,0,0,0,201,31,16,4,420,0,0,0,471,672
3955,94,13,59,0,59,0,0,0,131,27,11,4,283,0,0,0,325,456
3955,95,12,37,0,27,0,0,0,76,18,7,2,219,0,0,0,246,322
3955,96,3,13,0,39,0,0,0,55,20,6,0,183,0,0,0,209,264
3955,97,2,15,0,23,0,0,0,40,13,4,1,124,0,0,0,142,182
3955,98,4,6,0,10,0,0,0,20,15,0,0,84,0,0,0,99,119
3955,99,2,3,0,7,0,0,0,12,9,1,4,63,0,0,0,77,89
3955,100,3,3,0,16,0,0,0,22,13,1,0,94,0,0,0,108,130
3955,999,68295,63286,5142,3993,124,6,5,140851,55342,63647,6675,18802,66,5,1,144538,285389
3998,0,1676,0,0,0,0,0,0,1676,1526,0,0,0,0,0,0,1526,3202
3998,1,1669,0,0,0,0,0,0,1669,1567,0,0,0,0,0,0,1567,3236
3998,2,1782,0,0,0,0,0,0,1782,1633,0,0,0,0,0,0,1633,3415
3998,3,1752,0,0,0,0,0,0,1752,1661,0,0,0,0,0,0,1661,3413
3998,4,1855,0,0,0,0,0,0,1855,1743,0,0,0,0,0,0,1743,3598
3998,5,1899,0,0,0,0,0,0,1899,1724,0,0,0,0,0,0,1724,3623
3998,6,1955,0,0,0,0,0,0,1955,1807,0,0,0,0,0,0,1807,3762
3998,7,2009,0,0,0,0,0,0,2009,1917,0,0,0,0,0,0,1917,3926
3998,8,2072,0,0,0,0,0,0,2072,1917,0,0,0,0,0,0,1917,3989
3998,9,2075,0,0,0,0,0,0,2075,1972,0,0,0,0,0,0,1972,4047
3998,10,2150,0,0,0,0,0,0,2150,1920,0,0,0,0,0,0,1920,4070
3998,11,2126,0,0,0,0,0,0,2126,1990,0,0,0,0,0,0,1990,4116
3998,12,2139,0,0,0,0,0,0,2139,2054,0,0,0,0,0,0,2054,4193
3998,13,2278,0,0,0,0,0,0,2278,2122,0,0,0,0,0,0,2122,4400
3998,14,2258,0,0,0,0,0,0,2258,2183,0,0,0,0,0,0,2183,4441
3998,15,2280,0,0,0,0,0,0,2280,2053,0,0,0,0,0,0,2053,4333
3998,16,2337,0,0,0,0,0,0,2337,2071,0,0,0,0,0,0,2071,4408
3998,17,2190,0,0,0,0,0,0,2190,2021,0,0,0,0,0,0,2021,4211
3998,18,2242,0,0,0,0,0,0,2242,2058,1,0,0,0,0,0,2059,4301
3998,19,2198,1,0,0,0,0,0,2199,2004,10,0,0,0,0,0,2014,4213
3998,20,2226,3,0,0,0,0,0,2229,1904,20,0,0,0,0,0,1924,4153
3998,21,2183,4,0,0,0,0,0,2187,1938,33,0,0,0,0,0,1971,4158
3998,22,2230,10,1,0,0,0,0,2241,1969,62,3,0,0,0,0,2034,4275
3998,23,2391,11,2,0,0,0,0,2404,1967,98,3,0,0,0,0,2068,4472
3998,24,2286,34,4,0,0,0,0,2324,2096,153,7,0,0,0,0,2256,4580
3998,25,2436,60,7,0,1,0,0,2504,1964,190,6,0,0,0,0,2160,4664
3998,26,2501,100,7,0,2,0,0,2610,2023,253,8,1,0,0,0,2285,4895
3998,27,2411,137,8,0,1,0,0,2557,1859,341,9,1,1,0,0,2211,4768
3998,28,2390,222,12,0,2,0,0,2626,1862,448,11,1,0,1,0,2323,4949
3998,29,2268,267,10,0,0,0,0,2545,1763,559,10,0,2,0,0,2334,4879
3998,30,2248,392,10,0,2,0,0,2652,1711,686,14,2,4,1,0,2418,5070
3998,31,2291,496,27,0,4,0,0,2818,1706,835,23,4,3,0,0,2571,5389
3998,32,2168,601,18,2,1,0,0,2790,1603,988,38,2,4,0,0,2635,5425
3998,33,2050,660,28,3,2,0,0,2743,1575,1139,38,4,4,0,0,2760,5503
3998,34,1915,862,18,1,1,0,0,2797,1392,1181,57,4,3,1,0,2638,5435
3998,35,1736,976,40,4,5,1,0,2762,1289,1344,60,9,9,0,0,2711,5473
3998,36,1528,1084,35,3,3,0,0,2653,1229,1405,70,3,5,0,0,2712,5365
3998,37,1529,1178,41,5,3,0,0,2756,1087,1480,92,23,4,0,0,2686,5442
3998,38,1513,1249,39,3,3,0,0,2807,1078,1525,103,9,9,0,0,2724,5531
3998,39,1410,1372,71,6,1,0,0,2860,992,1579,123,20,5,0,0,2719,5579
3998,40,1386,1375,72,1,7,0,0,2841,1018,1681,132,25,9,0,0,2865,5706
3998,41,1324,1552,84,3,3,0,0,2966,1003,1745,140,20,3,0,0,2911,5877
3998,42,1177,1590,96,9,5,0,0,2877,948,1701,147,27,7,0,0,2830,5707
3998,43,1234,1633,105,11,6,0,0,2989,900,1761,178,27,4,1,0,2871,5860
3998,44,1266,1668,135,17,3,0,1,3090,920,1886,205,35,8,0,0,3054,6144
3998,45,1345,1719,137,20,7,0,0,3228,964,1973,185,37,4,1,0,3164,6392
3998,46,1271,1866,153,11,4,0,0,3305,895,2074,226,48,5,1,0,3249,6554
3998,47,1286,1985,184,17,5,0,0,3477,918,2137,254,55,2,2,0,3368,6845
3998,48,1262,2200,205,14,4,0,0,3685,929,2327,291,56,5,0,0,3608,7293
3998,49,1255,2220,200,16,11,0,0,3702,882,2390,316,75,11,0,0,3674,7376
3998,50,1157,2261,223,19,4,0,0,3664,966,2325,332,75,6,0,0,3704,7368
3998,51,1186,2277,234,21,4,0,0,3722,790,2445,383,75,1,0,0,3694,7416
3998,52,1027,2286,290,26,6,0,0,3635,807,2443,386,100,1,0,0,3737,7372
3998,53,1046,2384,259,28,11,0,0,3728,740,2381,399,117,2,0,0,3639,7367
3998,54,973,2458,291,22,3,0,0,3747,717,2485,421,108,4,0,0,3735,7482
3998,55,1005,2468,288,27,10,0,0,3798,672,2453,442,132,3,0,0,3702,7500
3998,56,836,2456,325,35,7,0,0,3659,624,2577,416,150,4,0,0,3771,7430
3998,57,811,2484,352,42,3,0,0,3692,636,2468,416,184,4,0,1,3709,7401
3998,58,753,2505,331,48,5,0,0,3642,590,2479,392,179,4,0,0,3644,7286
3998,59,682,2593,344,37,6,0,0,3662,512,2503,420,212,1,0,0,3648,7310
3998,60,589,2397,305,47,7,0,0,3345,467,2375,392,208,2,0,0,3444,6789
3998,61,472,2316,298,52,8,0,0,3146,435,2307,373,230,1,0,0,3346,6492
3998,62,495,2249,282,80,4,0,0,3110,404,2117,320,289,1,0,0,3131,6241
3998,63,422,2198,273,82,3,0,0,2978,407,2027,303,311,0,0,0,3048,6026
3998,64,401,2075,242,61,2,0,0,2781,349,2101,243,312,1,0,0,3006,5787
3998,65,336,1991,219,81,2,0,0,2629,333,1898,277,341,2,0,0,2851,5480
3998,66,348,1921,197,74,3,0,0,2543,271,1926,235,359,0,0,0,2791,5334
3998,67,298,1902,171,95,2,0,0,2468,255,1823,261,405,1,0,0,2745,5213
3998,68,276,1854,177,95,6,0,0,2408,249,1735,229,406,2,0,0,2621,5029
3998,69,213,1808,134,105,0,0,0,2260,218,1719,202,457,0,0,0,2596,4856
3998,70,228,1710,139,109,1,0,0,2187,174,1592,192,446,0,0,0,2404,4591
3998,71,192,1641,120,140,3,0,0,2096,150,1573,146,482,0,0,0,2351,4447
3998,72,201,1578,121,133,2,0,0,2035,159,1505,152,530,1,0,0,2347,4382
3998,73,184,1707,112,134,1,0,1,2139,179,1593,150,656,0,0,0,2578,4717
3998,74,187,1616,118,142,2,0,1,2066,179,1514,130,651,0,0,0,2474,4540
3998,75,192,1892,93,192,1,0,0,2370,158,1521,130,735,0,0,0,2544,4914
3998,76,196,1768,94,214,3,0,0,2275,143,1432,128,843,0,0,0,2546,4821
3998,77,181,1661,69,206,1,0,0,2118,142,1326,133,911,0,0,0,2512,4630
3998,78,138,1136,56,164,0,0,0,1494,82,999,71,735,0,0,0,1887,3381
3998,79,135,1269,52,206,0,0,0,1662,125,1002,72,845,0,0,0,2044,3706
3998,80,134,1128,40,206,0,0,0,1508,101,870,65,915,0,1,0,1952,3460
3998,81,140,1107,35,208,2,0,0,1492,105,817,67,932,0,0,0,1921,3413
3998,82,128,1043,52,235,0,0,0,1458,118,783,49,1042,0,0,0,1992,3450
3998,83,131,1081,42,236,0,0,0,1490,105,730,46,1222,0,0,0,2103,3593
3998,84,142,971,26,251,0,0,0,1390,110,609,53,1185,0,0,0,1957,3347
3998,85,96,909,25,263,0,0,0,1293,116,534,48,1193,0,0,0,1891,3184
3998,86,98,737,21,286,0,0,0,1142,103,378,38,1019,0,0,0,1538,2680
3998,87,77,533,9,198,0,0,0,817,65,292,26,985,0,0,0,1368,2185
3998,88,69,491,4,215,0,0,0,779,84,219,18,1016,0,0,0,1337,2116
3998,89,54,402,9,180,0,0,0,645,69,167,14,930,0,0,0,1180,1825
3998,90,42,279,5,164,0,0,0,490,54,127,13,789,0,0,0,983,1473
3998,91,37,240,4,122,0,0,0,403,49,83,11,737,0,0,0,880,1283
3998,92,28,169,4,110,0,0,0,311,43,57,8,621,0,0,0,729,1040
3998,93,17,123,1,113,0,0,0,254,36,42,7,517,0,0,0,602,856
3998,94,9,81,2,81,0,0,0,173,27,18,7,441,0,0,0,493,666
3998,95,10,50,0,55,0,0,0,115,20,10,2,314,0,0,0,346,461
3998,96,6,32,1,45,0,0,0,84,26,7,1,255,0,0,0,289,373
3998,97,11,15,0,20,0,0,0,46,12,8,1,175,0,0,0,196,242
3998,98,1,11,0,18,0,0,0,30,12,0,2,139,0,0,0,153,183
3998,99,3,4,0,25,0,0,0,32,8,3,0,96,0,0,0,107,139
3998,100,2,5,0,23,0,0,0,30,13,3,3,167,0,0,0,186,216
3998,999,111853,97799,8238,5917,198,1,3,224009,93536,98406,11374,26662,152,9,1,230140,454149
4045,0,1827,0,0,0,0,0,0,1827,1748,0,0,0,0,0,0,1748,3575
4045,1,1870,0,0,0,0,0,0,1870,1848,0,0,0,0,0,0,1848,3718
4045,2,1977,0,0,0,0,0,0,1977,1888,0,0,0,0,0,0,1888,3865
4045,3,2048,0,0,0,0,0,0,2048,1875,0,0,0,0,0,0,1875,3923
4045,4,2045,0,0,0,0,0,0,2045,2003,0,0,0,0,0,0,2003,4048
4045,5,2095,0,0,0,0,0,0,2095,2005,0,0,0,0,0,0,2005,4100
4045,6,2277,0,0,0,0,0,0,2277,2079,0,0,0,0,0,0,2079,4356
4045,7,2328,0,0,0,0,0,0,2328,2226,0,0,0,0,0,0,2226,4554
4045,8,2500,0,0,0,0,0,0,2500,2334,0,0,0,0,0,0,2334,4834
4045,9,2402,0,0,0,0,0,0,2402,2378,0,0,0,0,0,0,2378,4780
4045,10,2631,0,0,0,0,0,0,2631,2430,0,0,0,0,0,0,2430,5061
4045,11,2749,0,0,0,0,0,0,2749,2444,0,0,0,0,0,0,2444,5193
4045,12,2620,0,0,0,0,0,0,2620,2658,0,0,0,0,0,0,2658,5278
4045,13,2882,0,0,0,0,0,0,2882,2669,0,0,0,0,0,0,2669,5551
4045,14,2862,0,0,0,0,0,0,2862,2656,0,0,0,0,0,0,2656,5518
4045,15,2813,0,0,0,0,0,0,2813,2726,0,0,0,0,0,0,2726,5539
4045,16,2903,0,0,0,0,0,0,2903,2615,0,0,0,0,0,0,2615,5518
4045,17,2827,0,0,0,0,0,0,2827,2660,0,0,0,0,0,0,2660,5487
4045,18,2885,0,0,0,0,0,0,2885,2597,1,0,0,0,0,0,2598,5483
4045,19,2881,0,0,0,0,0,0,2881,2625,5,0,0,0,0,0,2630,5511
4045,20,2827,1,0,0,0,0,0,2828,2478,11,0,0,0,0,0,2489,5317
4045,21,2911,6,0,0,0,0,0,2917,2470,30,0,0,0,0,0,2500,5417
4045,22,2817,10,4,0,0,0,0,2831,2408,55,0,0,0,0,0,2463,5294
4045,23,2900,20,0,1,0,0,0,2921,2411,99,1,0,0,0,0,2511,5432
4045,24,2855,41,2,0,0,0,0,2898,2379,137,3,0,2,0,0,2521,5419
4045,25,2944,77,2,0,0,0,0,3023,2336,263,4,1,1,0,0,2605,5628
4045,26,2730,102,1,0,0,0,0,2833,2314,334,3,0,3,0,0,2654,5487
4045,27,2682,205,11,0,0,0,0,2898,2205,411,14,0,1,1,0,2632,5530
4045,28,2631,244,2,0,1,0,0,2878,2032,548,16,0,4,0,0,2600,5478
4045,29,2498,344,8,0,1,0,1,2852,1963,727,23,1,2,1,0,2717,5569
4045,30,2524,446,20,1,0,0,0,2991,1866,847,18,0,4,0,0,2735,5726
4045,31,2449,605,11,0,1,0,0,3066,1796,996,31,4,2,1,0,2830,5896
4045,32,2222,742,18,4,2,0,0,2988,1651,1062,34,1,6,0,0,2754,5742
4045,33,2205,854,25,1,4,1,0,3090,1605,1228,48,12,4,1,0,2898,5988
4045,34,2008,933,28,1,5,0,0,2975,1468,1315,53,6,9,0,0,2851,5826
4045,35,1959,1131,37,2,3,0,0,3132,1396,1483,55,5,9,0,0,2948,6080
4045,36,1767,1227,40,2,4,0,0,3040,1270,1517,70,10,10,0,0,2877,5917
4045,37,1758,1279,48,3,4,0,0,3092,1167,1530,106,7,7,0,0,2817,5909
4045,38,1726,1397,66,6,3,0,0,3198,1163,1704,112,30,7,1,0,3017,6215
4045,39,1628,1425,70,2,7,0,0,3132,1118,1863,141,26,6,1,0,3155,6287
4045,40,1561,1544,85,1,8,0,0,3199,1073,1901,166,33,6,1,0,3180,6379
4045,41,1501,1688,105,7,2,0,0,3303,1095,2084,150,22,9,1,0,3361,6664
4045,42,1464,1751,111,13,2,0,0,3341,1014,2080,185,17,2,1,0,3299,6640
4045,43,1533,1955,132,15,5,0,0,3640,1083,2058,175,46,4,0,0,3366,7006
4045,44,1534,1880,162,12,8,0,0,3596,1016,2216,253,37,5,0,0,3527,7123
4045,45,1559,2132,176,17,4,0,0,3888,1100,2435,289,47,8,2,0,3881,7769
4045,46,1531,2287,195,19,13,0,0,4045,1091,2559,313,44,4,4,0,4015,8060
4045,47,1526,2451,201,20,5,0,0,4203,1161,2709,341,58,11,0,0,4280,8483
4045,48,1560,2514,261,14,9,0,0,4358,1062,2782,384,76,6,0,0,4310,8668
4045,49,1543,2722,313,23,8,0,0,4609,1084,2887,369,79,7,1,0,4427,9036
4045,50,1462,2797,286,25,5,0,0,4575,1037,2859,429,75,3,0,0,4403,8978
4045,51,1397,2912,337,20,6,1,0,4673,935,2987,449,96,7,0,0,4474,9147
4045,52,1312,2929,347,24,9,0,0,4621,895,2851,456,109,7,0,0,4318,8939
4045,53,1159,2848,325,18,3,0,0,4353,842,2904,488,142,5,0,0,4381,8734
4045,54,1147,2869,356,28,8,0,0,4408,807,2977,504,122,3,0,0,4413,8821
4045,55,1030,2982,382,30,4,0,0,4428,747,2917,471,150,6,0,0,4291,8719
4045,56,992,2843,365,40,5,0,0,4245,692,2851,474,175,2,0,0,4194,8439
4045,57,909,2922,378,53,9,0,0,4271,680,2986,465,206,1,0,0,4338,8609
4045,58,794,2949,356,46,7,0,0,4152,580,2892,463,221,6,0,0,4162,8314
4045,59,705,3007,353,57,4,0,0,4126,570,2916,497,233,2,0,0,4218,8344
4045,60,675,2762,375,62,4,0,0,3878,544,2661,432,246,4,0,0,3887,7765
4045,61,610,2621,348,77,9,0,0,3665,501,2699,400,258,2,0,0,3860,7525
4045,62,501,2583,309,61,1,0,0,3455,454,2559,392,275,4,0,0,3684,7139
4045,63,468,2560,305,76,3,0,2,3414,359,2570,443,331,0,0,0,3703,7117
4045,64,423,2507,273,71,4,0,0,3278,376,2375,378,368,2,0,0,3499,6777
4045,65,354,2316,264,104,5,0,0,3043,341,2254,300,379,1,0,0,3275,6318
4045,66,367,2360,244,94,2,1,0,3068,270,2342,278,409,1,0,0,3300,6368
4045,67,301,2319,237,119,4,0,0,2980,257,2134,283,476,1,0,0,3151,6131
4045,68,294,2249,194,91,6,0,0,2834,241,2068,254,509,0,0,0,3072,5906
4045,69,261,2137,197,134,1,0,0,2730,207,2095,237,530,1,0,0,3070,5800
4045,70,246,2044,179,112,1,0,0,2582,209,1938,211,528,1,0,0,2887,5469
4045,71,217,1872,146,158,3,0,0,2396,187,1814,168,626,0,0,0,2795,5191
4045,72,181,1964,126,153,3,0,0,2427,163,1824,164,618,1,0,0,2770,5197
4045,73,191,1991,124,157,0,0,0,2463,147,1872,185,738,0,0,0,2942,5405
4045,74,176,2051,131,165,0,0,1,2524,137,1755,167,798,0,0,0,2857,5381
4045,75,202,2078,112,207,2,0,0,2601,167,1786,144,942,2,0,0,3041,5642
4045,76,182,1997,92,211,0,0,0,2482,156,1689,155,889,1,0,0,2890,5372
4045,77,138,1954,81,237,0,0,0,2410,128,1591,129,1046,0,0,0,2894,5304
4045,78,102,1315,59,174,2,0,0,1652,95,1000,95,808,0,0,0,1998,3650
4045,79,107,1413,55,218,0,0,0,1793,82,1046,85,965,0,0,0,2178,3971
4045,80,119,1355,45,216,1,0,0,1736,80,959,76,989,0,0,0,2104,3840
4045,81,119,1206,46,240,0,0,0,1611,81,914,49,1069,0,0,0,2113,3724
4045,82,115,1183,50,252,2,0,0,1602,108,838,54,1098,0,0,0,2098,3700
4045,83,111,1193,34,280,0,0,0,1618,111,765,45,1243,0,0,0,2164,3782
4045,84,113,1070,22,271,0,0,0,1476,94,647,39,1294,0,0,0,2074,3550
4045,85,91,981,24,297,0,0,0,1393,80,510,47,1256,0,0,0,1893,3286
4045,86,81,741,19,261,0,0,0,1102,78,372,26,1185,0,0,0,1661,2763
4045,87,60,580,10,235,0,0,0,885,58,299,25,1082,0,0,0,1464,2349
4045,88,70,605,10,237,0,0,0,922,67,227,23,1092,0,0,0,1409,2331
4045,89,61,433,14,218,0,0,0,726,51,136,14,1024,0,0,0,1225,1951
4045,90,42,306,2,210,0,0,0,560,50,118,14,836,0,0,0,1018,1578
4045,91,27,230,2,154,0,0,0,413,38,67,6,710,0,0,0,821,1234
4045,92,39,167,4,152,0,0,0,362,44,44,5,642,0,0,0,735,1097
4045,93,18,143,7,102,0,0,0,270,38,32,2,630,0,0,0,702,972
4045,94,9,90,1,98,0,0,0,198,25,16,3,432,0,0,0,476,674
4045,95,10,61,1,75,0,0,0,147,21,12,2,349,0,0,0,384,531
4045,96,6,28,3,53,0,0,0,90,13,9,3,272,0,0,0,297,387
4045,97,5,20,0,37,0,0,0,62,10,9,1,197,0,0,0,217,279
4045,98,1,9,0,23,0,0,0,33,10,1,2,153,0,0,0,166,199
4045,99,1,6,0,19,0,0,0,26,9,1,0,101,0,0,0,111,137
4045,100,1,3,0,23,0,0,0,27,14,0,1,122,0,0,0,137,164
4045,999,130777,114574,9764,6639,212,3,4,261973,108625,115065,13390,29606,202,16,0,266904,528877
4081,0,2452,0,0,0,0,0,0,2452,2309,0,0,0,0,0,0,2309,4761
4081,1,2694,0,0,0,0,0,0,2694,2486,0,0,0,0,0,0,2486,5180
4081,2,2690,0,0,0,0,0,0,2690,2488,0,0,0,0,0,0,2488,5178
4081,3,2708,0,0,0,0,0,0,2708,2398,0,0,0,0,0,0,2398,5106
4081,4,2633,0,0,0,0,0,0,2633,2559,0,0,0,0,0,0,2559,5192
4081,5,2885,0,0,0,0,0,0,2885,2711,0,0,0,0,0,0,2711,5596
4081,6,3013,0,0,0,0,0,0,3013,2816,0,0,0,0,0,0,2816,5829
4081,7,3157,0,0,0,0,0,0,3157,2896,0,0,0,0,0,0,2896,6053
4081,8,3127,0,0,0,0,0,0,3127,2951,0,0,0,0,0,0,2951,6078
4081,9,3177,0,0,0,0,0,0,3177,3022,0,0,0,0,0,0,3022,6199
4081,10,3308,0,0,0,0,0,0,3308,3088,0,0,0,0,0,0,3088,6396
4081,11,3512,0,0,0,0,0,0,3512,3296,0,0,0,0,0,0,3296,6808
4081,12,3597,0,0,0,0,0,0,3597,3273,0,0,0,0,0,0,3273,6870
4081,13,3633,0,0,0,0,0,0,3633,3463,0,0,0,0,0,0,3463,7096
4081,14,3624,0,0,0,0,0,0,3624,3428,0,0,0,0,0,0,3428,7052
4081,15,3753,0,0,0,0,0,0,3753,3426,0,0,0,0,0,0,3426,7179
4081,16,3629,0,0,0,0,0,0,3629,3403,0,0,0,0,0,0,3403,7032
4081,17,3561,0,0,0,0,0,0,3561,3331,0,0,0,0,0,0,3331,6892
4081,18,3579,0,0,0,0,0,0,3579,3350,3,0,0,0,0,0,3353,6932
4081,19,3623,5,0,0,0,0,0,3628,3259,9,0,0,0,0,0,3268,6896
4081,20,3510,1,0,0,0,0,0,3511,3207,32,0,0,0,0,0,3239,6750
4081,21,3616,3,0,0,0,0,0,3619,3177,49,1,0,0,0,0,3227,6846
4081,22,3645,19,4,0,0,0,0,3668,3252,88,0,0,0,0,0,3340,7008
4081,23,3748,33,2,0,0,0,0,3783,3211,172,5,0,0,0,0,3388,7171
4081,24,3706,45,5,0,1,0,0,3757,3135,214,6,0,0,0,0,3355,7112
4081,25,3835,102,4,1,1,0,0,3943,2998,294,6,0,0,0,0,3298,7241
4081,26,3754,149,2,0,0,0,0,3905,3024,429,3,0,1,0,0,3457,7362
4081,27,3685,193,10,0,1,0,0,3889,2870,533,9,2,2,0,0,3416,7305
4081,28,3599,340,5,0,1,0,0,3945,2709,690,19,3,3,0,0,3424,7369
4081,29,3584,428,8,0,1,0,0,4021,2650,879,17,0,2,0,0,3548,7569
4081,30,3459,603,15,0,1,0,0,4078,2533,1084,27,1,1,0,0,3646,7724
4081,31,3459,769,15,0,3,0,1,4247,2517,1276,23,3,3,1,0,3823,8070
4081,32,3223,877,30,3,8,0,0,4141,2347,1431,47,5,6,0,0,3836,7977
4081,33,3148,1108,21,2,10,0,0,4289,2189,1679,38,8,6,0,0,3920,8209
4081,34,2905,1196,44,6,5,1,1,4158,2102,1772,77,6,5,0,0,3962,8120
4081,35,2784,1386,38,2,5,0,0,4215,1863,1941,63,12,8,1,0,3888,8103
4081,36,2481,1528,42,0,6,0,0,4057,1845,2010,95,5,9,0,0,3964,8021
4081,37,2312,1598,68,3,8,0,0,3989,1569,2163,109,12,9,0,0,3862,7851
4081,38,2252,1745,70,4,3,0,0,4074,1696,2223,119,16,5,3,0,4062,8136
4081,39,2214,1915,92,2,2,0,0,4225,1589,2381,167,15,7,2,0,4161,8386
4081,40,2130,2101,102,4,2,0,0,4339,1442,2529,174,21,3,1,0,4170,8509
4081,41,2166,2147,106,7,5,0,0,4431,1479,2475,207,32,3,0,0,4196,8627
4081,42,2020,2219,126,9,2,0,0,4376,1456,2640,202,38,2,0,0,4338,8714
4081,43,1953,2475,148,19,6,2,0,4603,1481,2745,262,52,4,0,0,4544,9147
4081,44,1929,2528,158,19,4,0,0,4638,1457,2826,289,44,5,0,0,4621,9259
4081,45,2038,2706,213,16,8,0,0,4981,1536,2938,310,63,9,0,0,4856,9837
4081,46,2071,2865,241,22,4,0,0,5203,1552,3133,392,70,2,0,0,5149,10352
4081,47,2093,2912,256,27,5,0,0,5293,1574,3324,385,76,6,0,0,5365,10658
4081,48,2056,3335,323,26,4,0,0,5744,1573,3519,443,72,1,0,0,5608,11352
4081,49,2295,3433,314,30,2,0,0,6074,1585,3600,518,108,4,3,0,5818,11892
4081,50,2056,3571,367,28,6,1,0,6029,1479,3755,508,123,11,1,0,5877,11906
4081,51,1879,3636,402,33,9,1,0,5960,1428,3762,550,102,6,2,0,5850,11810
4081,52,1794,3667,439,34,8,0,0,5942,1390,3802,615,141,6,0,0,5954,11896
4081,53,1622,3559,463,38,13,0,0,5695,1292,3601,588,155,4,0,0,5640,11335
4081,54,1603,3688,470,39,8,0,0,5808,1210,3797,566,150,5,0,0,5728,11536
4081,55,1452,3735,483,49,5,0,0,5724,1107,3673,648,183,1,0,0,5612,11336
4081,56,1341,3725,535,47,9,0,0,5657,1052,3792,624,201,2,0,0,5671,11328
4081,57,1271,3729,500,60,7,0,0,5567,1035,3715,649,245,0,0,1,5645,11212
4081,58,1121,3834,487,66,4,1,0,5513,979,3687,617,289,2,0,0,5574,11087
4081,59,1076,3864,489,78,2,0,0,5509,874,3844,623,273,0,0,0,5614,11123
4081,60,914,3741,465,90,7,0,0,5217,880,3707,583,278,5,0,0,5453,10670
4081,61,858,3484,442,90,3,0,0,4877,798,3551,535,306,2,0,0,5192,10069
4081,62,779,3601,444,88,4,0,0,4916,762,3445,569,431,5,0,0,5212,10128
4081,63,705,3380,431,92,5,0,0,4613,677,3322,540,396,3,0,0,4938,9551
4081,64,596,3263,386,115,3,0,1,4364,703,3242,487,434,3,0,0,4869,9233
4081,65,528,3183,343,107,0,0,0,4161,592,2964,422,470,3,0,0,4451,8612
4081,66,497,3134,315,120,5,0,1,4072,548,3011,402,543,1,0,0,4505,8577
4081,67,440,3170,312,122,2,0,0,4046,481,3095,380,569,0,0,0,4525,8571
4081,68,415,3084,292,158,5,0,0,3954,452,2795,349,589,0,0,0,4185,8139
4081,69,367,2990,239,149,2,0,0,3747,423,2784,361,693,1,0,0,4262,8009
4081,70,317,2784,220,151,2,0,0,3474,365,2674,312,652,0,0,0,4003,7477
4081,71,296,2700,187,192,0,0,0,3375,331,2559,276,758,0,0,0,3924,7299
4081,72,305,2607,185,194,3,0,0,3294,290,2482,253,772,0,0,0,3797,7091
4081,73,264,2685,187,228,0,0,0,3364,251,2547,262,963,1,0,0,4024,7388
4081,74,249,2855,203,264,1,0,0,3572,255,2539,243,1075,1,0,0,4113,7685
4081,75,280,2951,165,268,1,0,0,3665,257,2517,259,1069,1,0,0,4103,7768
4081,76,216,2827,162,315,2,0,0,3522,221,2418,230,1198,0,0,0,4067,7589
4081,77,219,2798,130,333,2,0,0,3482,212,2301,181,1370,0,0,0,4064,7546
4081,78,143,1811,78,271,0,0,0,2303,129,1532,118,1103,0,0,0,2882,5185
4081,79,131,1996,86,284,0,0,1,2498,141,1624,116,1304,0,0,0,3185,5683
4081,80,155,1926,77,338,0,0,0,2496,163,1474,115,1326,0,0,0,3078,5574
4081,81,155,1733,67,323,4,0,0,2282,174,1260,97,1356,0,0,0,2887,5169
4081,82,139,1680,59,374,0,0,0,2252,137,1134,102,1469,0,0,0,2842,5094
4081,83,148,1634,61,367,0,0,0,2210,154,1142,83,1637,0,0,0,3016,5226
4081,84,122,1486,50,396,0,0,0,2054,147,1012,71,1723,0,0,0,2953,5007
4081,85,141,1397,41,364,0,0,0,1943,122,821,55,1739,0,0,0,2737,4680
4081,86,89,1088,24,403,0,0,0,1604,105,594,45,1598,0,0,0,2342,3946
4081,87,80,892,24,320,0,0,0,1316,71,440,45,1507,0,0,0,2063,3379
4081,88,80,816,22,328,0,0,0,1246,86,374,31,1524,0,0,0,2015,3261
4081,89,79,637,13,340,0,0,0,1069,78,282,24,1443,0,0,0,1827,2896
4081,90,35,491,4,273,0,0,0,803,80,171,18,1208,0,0,0,1477,2280
4081,91,49,378,9,246,0,0,0,682,64,112,10,1068,0,0,0,1254,1936
4081,92,36,265,1,200,0,0,0,502,44,85,12,903,0,0,0,1044,1546
4081,93,24,190,5,157,0,0,0,376,42,63,16,822,0,0,0,943,1319
4081,94,23,133,3,127,0,0,0,286,43,30,4,598,0,0,0,675,961
4081,95,12,71,0,91,0,0,0,174,32,14,4,491,0,0,0,541,715
4081,96,6,47,0,57,0,0,0,110,24,5,5,392,0,0,0,426,536
4081,97,2,29,0,43,0,0,0,74,9,7,2,292,0,0,0,310,384
4081,98,0,8,0,33,0,0,0,41,15,7,1,203,0,0,0,226,267
4081,99,3,8,0,20,0,0,0,31,6,3,1,129,0,0,0,139,170
4081,100,2,7,0,44,0,0,0,53,8,1,2,194,0,0,0,205,258
4081,999,175139,151732,12829,9149,220,6,5,349080,147789,152649,17622,39121,169,14,1,357365,706445
4110,0,3399,0,0,0,0,0,0,3399,3134,0,0,0,0,0,0,3134,6533
4110,1,3572,0,0,0,0,0,0,3572,3336,0,0,0,0,0,0,3336,6908
4110,2,3630,0,0,0,0,0,0,3630,3436,0,0,0,0,0,0,3436,7066
4110,3,3561,0,0,0,0,0,0,3561,3498,0,0,0,0,0,0,3498,7059
4110,4,3678,0,0,0,0,0,0,3678,3616,0,0,0,0,0,0,3616,7294
4110,5,3933,0,0,0,0,0,0,3933,3773,0,0,0,0,0,0,3773,7706
4110,6,3994,0,0,0,0,0,0,3994,3775,0,0,0,0,0,0,3775,7769
4110,7,4205,0,0,0,0,0,0,4205,3896,0,0,0,0,0,0,3896,8101
4110,8,4306,0,0,0,0,0,0,4306,4086,0,0,0,0,0,0,4086,8392
4110,9,4355,0,0,0,0,0,0,4355,4210,0,0,0,0,0,0,4210,8565
4110,10,4349,0,0,0,0,0,0,4349,4267,0,0,0,0,0,0,4267,8616
4110,11,4535,0,0,0,0,0,0,4535,4279,0,0,0,0,0,0,4279,8814
4110,12,4591,0,0,0,0,0,0,4591,4358,0,0,0,0,0,0,4358,8949
4110,13,4726,0,0,0,0,0,0,4726,4288,0,0,0,0,0,0,4288,9014
4110,14,4878,0,0,0,0,0,0,4878,4617,0,0,0,0,0,0,4617,9495
4110,15,4755,0,0,0,0,0,0,4755,4491,0,0,0,0,0,0,4491,9246
4110,16,4782,0,0,0,0,0,0,4782,4533,0,0,0,0,0,0,4533,9315
4110,17,4927,0,1,0,0,0,0,4928,4445,0,0,0,0,0,0,4445,9373
4110,18,4931,1,0,0,0,0,0,4932,4378,1,0,0,0,0,0,4379,9311
4110,19,5034,5,0,0,0,0,0,5039,4449,16,0,0,0,0,0,4465,9504
4110,20,4858,8,0,0,0,0,0,4866,4274,41,0,0,0,0,0,4315,9181
4110,21,4930,16,0,0,0,1,0,4947,4369,59,0,1,0,0,0,4429,9376
4110,22,4967,14,3,0,0,0,0,4984,4382,111,1,0,0,0,0,4494,9478
4110,23,5091,31,6,0,0,0,0,5128,4435,204,4,0,0,0,0,4643,9771
4110,24,5098,72,5,2,0,0,0,5177,4412,251,7,0,1,0,0,4671,9848
4110,25,5098,119,6,0,1,0,0,5224,4289,353,11,0,2,0,0,4655,9879
4110,26,5141,195,7,1,1,0,0,5345,4469,473,10,0,3,1,0,4956,10301
4110,27,5214,256,12,1,3,0,0,5486,4511,641,12,1,5,1,0,5171,10657
4110,28,5180,401,8,0,4,0,0,5593,4401,820,19,0,4,0,0,5244,10837
4110,29,5206,512,8,1,7,1,0,5735,4358,1058,32,2,11,0,0,5461,11196
4110,30,5198,660,12,0,3,2,0,5875,4195,1286,28,4,5,1,0,5519,11394
4110,31,5100,959,25,2,7,0,0,6093,4298,1703,54,7,8,0,0,6070,12163
4110,32,4914,1106,29,4,8,0,0,6061,3878,1788,56,8,11,1,1,5743,11804
4110,33,4801,1394,41,4,13,0,0,6253,3777,2064,69,9,16,3,0,5938,12191
4110,34,4289,1581,35,2,10,0,0,5917,3478,2246,89,4,19,3,0,5839,11756
4110,35,4098,1850,42,3,12,0,0,6005,3324,2480,118,8,13,1,1,5945,11950
4110,36,3899,2011,63,8,11,1,0,5993,3028,2671,136,17,20,1,0,5873,11866
4110,37,3555,2209,72,8,15,3,0,5862,2954,2918,155,25,16,0,0,6068,11930
4110,38,3519,2450,114,3,14,0,0,6100,2838,3032,209,27,25,1,0,6132,12232
4110,39,3443,2621,109,6,13,1,0,6193,2781,3242,230,18,27,1,0,6299,12492
4110,40,3378,2843,144,7,17,2,0,6391,2741,3271,260,39,26,1,0,6338,12729
4110,41,3195,2923,167,8,16,1,0,6310,2631,3373,270,49,23,0,0,6346,12656
4110,42,3026,3144,179,12,25,0,0,6386,2477,3446,298,47,20,2,0,6290,12676
4110,43,3107,3313,180,23,16,2,0,6641,2498,3582,389,58,13,2,0,6542,13183
4110,44,3009,3301,226,21,21,1,0,6579,2539,3928,369,72,13,1,0,6922,13501
4110,45,3068,3748,275,28,24,0,0,7143,2557,3995,406,77,19,0,0,7054,14197
4110,46,3210,3701,274,25,8,3,0,7221,2645,4119,481,93,22,3,0,7363,14584
4110,47,3285,4015,320,13,22,0,2,7657,2611,4393,545,111,23,0,0,7683,15340
4110,48,3224,4167,376,39,27,1,0,7834,2711,4718,592,101,19,1,0,8142,15976
4110,49,3297,4336,384,31,36,1,0,8085,2683,4851,608,143,14,1,1,8301,16386
4110,50,3146,4622,480,35,32,0,0,8315,2682,4950,704,135,16,0,0,8487,16802
4110,51,3017,4651,488,47,23,0,0,8226,2557,4899,786,159,15,1,0,8417,16643
4110,52,2926,4947,561,42,24,0,0,8500,2473,5206,784,152,26,0,0,8641,17141
4110,53,2660,4889,603,53,29,4,0,8238,2301,5163,865,204,12,0,0,8545,16783
4110,54,2590,4995,603,49,30,0,0,8267,2237,5230,874,226,18,0,0,8585,16852
4110,55,2418,4894,624,63,21,0,0,8020,2068,5169,920,289,18,0,1,8465,16485
4110,56,2204,4914,692,75,35,0,0,7920,2006,5190,957,277,5,0,0,8435,16355
4110,57,2166,5002,664,81,24,1,0,7938,1930,5113,957,303,9,1,0,8313,16251
4110,58,1931,5127,748,85,16,0,1,7908,1758,5252,943,369,6,0,0,8328,16236
4110,59,1864,5321,729,106,22,0,1,8043,1716,5364,994,402,10,1,0,8487,16530
4110,60,1564,4982,686,91,24,0,1,7348,1526,4819,947,378,13,0,0,7683,15031
4110,61,1396,4864,665,111,16,0,2,7054,1320,4942,908,462,5,1,0,7638,14692
4110,62,1309,4674,593,138,22,0,0,6736,1253,4887,828,487,4,0,1,7460,14196
4110,63,1090,4540,608,139,17,0,1,6395,1165,4595,884,548,3,0,0,7195,13590
4110,64,1024,4644,620,175,17,0,0,6480,1110,4455,751,655,5,0,1,6977,13457
4110,65,949,4413,554,171,16,1,2,6106,950,4455,755,632,4,0,0,6796,12902
4110,66,848,4426,550,165,13,0,0,6002,904,4262,727,675,8,0,0,6576,12578
4110,67,714,4320,504,192,10,1,0,5741,861,4148,656,760,5,0,0,6430,12171
4110,68,668,3998,478,222,8,0,0,5374,727,3964,643,814,3,0,0,6151,11525
4110,69,612,4086,372,213,9,0,0,5292,666,3929,614,909,6,0,0,6124,11416
4110,70,532,3908,354,255,6,0,0,5055,552,3720,547,948,3,0,0,5770,10825
4110,71,478,3690,361,244,13,0,0,4786,543,3651,516,1016,3,0,0,5729,10515
4110,72,464,3628,354,270,4,0,0,4720,503,3516,476,1086,2,0,0,5583,10303
4110,73,417,3794,305,314,4,0,0,4834,472,3600,463,1218,3,0,0,5756,10590
4110,74,360,3902,280,336,2,0,0,4880,427,3534,459,1402,1,0,0,5823,10703
4110,75,393,4125,289,412,6,1,0,5226,392,3761,470,1684,1,0,0,6308,11534
4110,76,364,4120,282,434,0,0,0,5200,357,3639,393,1835,0,0,0,6224,11424
4110,77,341,4135,250,509,1,0,0,5236,341,3505,437,2094,0,0,0,6377,11613
4110,78,203,2609,160,387,0,0,0,3359,216,2202,255,1511,3,0,0,4187,7546
4110,79,268,2960,135,460,1,0,0,3824,280,2417,253,1794,1,0,0,4745,8569
4110,80,219,2814,152,508,1,0,0,3694,246,2208,223,1996,0,0,0,4673,8367
4110,81,195,2632,109,505,1,0,0,3442,279,2086,223,2063,1,0,0,4652,8094
4110,82,226,2521,111,534,1,0,0,3393,257,1884,206,2316,0,0,0,4663,8056
4110,83,236,2602,96,634,1,0,0,3569,255,1882,202,2665,0,0,0,5004,8573
4110,84,212,2425,86,676,3,0,0,3402,238,1601,170,2780,0,0,0,4789,8191
4110,85,152,2127,67,651,1,0,0,2998,215,1352,150,2705,0,0,0,4422,7420
4110,86,141,1746,60,559,0,0,0,2506,171,1017,110,2464,1,0,0,3763,6269
4110,87,102,1398,35,601,1,0,0,2137,176,754,79,2275,0,0,0,3284,5421
4110,88,98,1246,26,552,1,0,0,1923,160,615,79,2368,0,0,0,3222,5145
4110,89,85,962,32,516,0,0,0,1595,131,457,57,2157,0,0,0,2802,4397
4110,90,65,809,25,478,0,0,0,1377,133,320,47,1965,0,0,0,2465,3842
4110,91,64,609,15,403,0,0,0,1091,101,209,27,1724,0,0,0,2061,3152
4110,92,45,463,11,360,0,0,0,879,112,124,35,1478,0,0,0,1749,2628
4110,93,38,325,7,294,0,0,0,664,84,107,24,1383,0,0,0,1598,2262
4110,94,18,215,1,241,0,0,0,475,65,61,15,1122,0,0,0,1263,1738
4110,95,17,115,4,173,0,0,0,309,55,35,7,797,0,0,0,894,1203
4110,96,10,105,3,145,0,0,0,263,40,25,9,646,0,0,0,720,983
4110,97,9,46,0,103,0,0,0,158,35,9,2,455,0,0,0,501,659
4110,98,7,30,1,50,0,0,0,88,33,4,9,352,0,0,0,398,486
4110,99,1,19,1,49,0,0,0,70,19,7,2,239,0,0,0,267,337
4110,100,3,15,1,55,0,0,0,74,35,3,3,380,0,0,0,421,495
4110,999,252398,208366,18558,14213,789,28,10,494362,224542,211431,27903,58675,588,29,6,523174,1017536
4167,0,933,0,0,0,0,0,0,933,886,0,0,0,0,0,0,886,1819
4167,1,959,0,0,0,0,0,0,959,935,0,0,0,0,0,0,935,1894
4167,2,1052,0,0,0,0,0,0,1052,919,0,0,0,0,0,0,919,1971
4167,3,956,0,0,0,0,0,0,956,940,0,0,0,0,0,0,940,1896
4167,4,1068,0,0,0,0,0,0,1068,1052,0,0,0,0,0,0,1052,2120
4167,5,1108,0,0,0,0,0,0,1108,1045,0,0,0,0,0,0,1045,2153
4167,6,1161,0,0,0,0,0,0,1161,1061,0,0,0,0,0,0,1061,2222
4167,7,1143,0,0,0,0,0,0,1143,1181,0,0,0,0,0,0,1181,2324
4167,8,1189,0,0,0,0,0,0,1189,1119,0,0,0,0,0,0,1119,2308
4167,9,1254,0,0,0,0,0,0,1254,1215,0,0,0,0,0,0,1215,2469
4167,10,1305,0,0,0,0,0,0,1305,1279,0,0,0,0,0,0,1279,2584
4167,11,1354,0,0,0,0,0,0,1354,1299,0,0,0,0,0,0,1299,2653
4167,12,1414,0,0,0,0,0,0,1414,1348,0,0,0,0,0,0,1348,2762
4167,13,1461,0,0,0,0,0,0,1461,1431,0,0,0,0,0,0,1431,2892
4167,14,1518,0,0,0,0,0,0,1518,1462,0,0,0,0,0,0,1462,2980
4167,15,1526,0,0,0,0,0,0,1526,1407,0,0,0,0,0,0,1407,2933
4167,16,1490,0,0,0,0,0,0,1490,1368,0,0,0,0,0,0,1368,2858
4167,17,1528,0,0,0,0,0,0,1528,1343,0,0,0,0,0,0,1343,2871
4167,18,1528,0,0,0,0,0,0,1528,1339,1,0,0,0,0,0,1340,2868
4167,19,1474,0,0,0,0,0,0,1474,1344,3,0,0,0,0,0,1347,2821
4167,20,1440,1,0,0,0,0,0,1441,1347,8,0,0,1,0,0,1356,2797
4167,21,1474,2,0,0,0,0,0,1476,1384,17,0,0,0,0,0,1401,2877
4167,22,1465,8,1,0,0,0,0,1474,1317,46,0,0,0,0,0,1363,2837
4167,23,1501,16,1,0,0,0,0,1518,1338,51,2,0,0,0,0,1391,2909
4167,24,1569,16,4,0,0,0,0,1589,1292,63,2,0,1,0,0,1358,2947
4167,25,1681,43,3,0,0,0,0,1727,1244,128,4,0,0,0,0,1376,3103
4167,26,1560,40,6,0,1,0,0,1607,1241,154,3,0,2,0,0,1400,3007
4167,27,1548,68,0,0,0,0,0,1616,1243,196,4,1,1,0,0,1445,3061
4167,28,1457,121,0,0,1,0,0,1579,1181,249,7,0,1,0,0,1438,3017
4167,29,1434,145,2,0,1,0,0,1582,1163,304,8,0,0,0,0,1475,3057
4167,30,1412,186,3,0,2,0,0,1603,1073,358,9,2,2,0,0,1444,3047
4167,31,1436,260,3,0,1,0,0,1700,1054,418,10,2,1,0,0,1485,3185
4167,32,1397,284,11,1,6,0,0,1699,1038,484,24,1,3,0,0,1550,3249
4167,33,1307,356,14,1,3,0,0,1681,1001,565,36,3,1,0,0,1606,3287
4167,34,1248,410,19,2,2,0,0,1681,899,634,32,4,2,0,0,1571,3252
4167,35,1157,482,16,1,4,0,0,1660,940,696,45,7,3,0,0,1691,3351
4167,36,1115,515,18,4,4,0,0,1656,828,713,45,4,0,1,0,1591,3247
4167,37,1099,552,28,6,3,0,0,1688,773,759,67,14,3,0,0,1616,3304
4167,38,1116,680,32,0,1,1,0,1830,741,803,58,9,3,0,0,1614,3444
4167,39,1018,718,37,3,4,0,0,1780,764,873,66,15,2,0,0,1720,3500
4167,40,1041,766,46,0,4,0,0,1857,781,953,104,16,2,1,0,1857,3714
4167,41,947,844,49,3,2,0,0,1845,756,960,110,14,2,0,0,1842,3687
4167,42,982,845,67,9,1,1,0,1905,765,991,105,16,4,0,0,1881,3786
4167,43,998,884,63,8,5,0,0,1958,749,1085,110,23,4,0,0,1971,3929
4167,44,1051,964,94,6,2,0,0,2117,792,1158,140,23,0,1,0,2114,4231
4167,45,1151,1040,89,10,3,2,0,2295,842,1266,161,24,2,0,0,2295,4590
4167,46,1151,1157,110,12,5,0,0,2435,902,1292,208,39,0,0,0,2441,4876
4167,47,1188,1249,167,10,2,0,0,2616,866,1443,223,36,3,0,0,2571,5187
4167,48,1146,1319,153,12,4,0,0,2634,887,1503,247,35,1,0,0,2673,5307
4167,49,1194,1490,154,20,1,0,0,2859,903,1622,286,45,0,0,0,2856,5715
4167,50,1130,1505,215,10,5,0,0,2865,841,1613,283,51,5,0,0,2793,5658
4167,51,1158,1549,207,9,6,0,0,2929,818,1719,305,66,6,0,0,2914,5843
4167,52,1054,1566,223,12,7,0,0,2862,783,1707,264,95,3,0,0,2852,5714
4167,53,958,1580,250,17,6,0,0,2811,712,1792,334,74,6,0,0,2918,5729
4167,54,1010,1652,240,21,5,0,0,2928,728,1780,371,116,1,0,0,2996,5924
4167,55,886,1721,244,24,2,0,0,2877,631,1897,339,100,1,0,0,2968,5845
4167,56,802,1678,282,28,4,0,0,2794,558,1798,342,145,3,0,1,2847,5641
4167,57,808,1822,300,29,4,0,0,2963,525,1856,368,130,1,0,0,2880,5843
4167,58,716,1818,281,38,6,0,0,2859,460,1925,361,155,2,0,0,2903,5762
4167,59,617,1830,304,42,7,0,0,2800,476,1953,375,180,4,0,0,2988,5788
4167,60,558,1865,297,29,4,0,0,2753,458,2017,305,165,0,0,0,2945,5698
4167,61,504,1821,263,53,3,0,1,2645,388,1893,317,198,2,0,0,2798,5443
4167,62,416,1755,276,65,6,0,0,2518,342,1920,342,219,1,0,0,2824,5342
4167,63,407,1853,244,54,1,0,0,2559,268,1872,310,286,1,0,0,2737,5296
4167,64,340,1837,247,73,1,0,0,2498,315,1888,277,259,2,0,0,2741,5239
4167,65,316,1774,226,73,3,0,0,2392,243,1677,265,318,0,0,0,2503,4895
4167,66,314,1778,210,84,2,0,0,2388,249,1816,269,321,0,0,0,2655,5043
4167,67,241,1760,207,92,1,0,0,2301,218,1798,258,352,0,0,0,2626,4927
4167,68,240,1663,185,92,2,0,0,2182,195,1640,221,367,1,0,0,2424,4606
4167,69,213,1601,177,116,2,0,0,2109,178,1601,204,437,0,0,0,2420,4529
4167,70,166,1652,138,102,0,0,0,2058,160,1538,196,433,0,0,0,2327,4385
4167,71,153,1593,126,105,1,0,0,1978,136,1526,182,499,0,0,0,2343,4321
4167,72,162,1547,101,139,1,0,0,1950,122,1429,155,521,1,0,0,2228,4178
4167,73,143,1608,138,155,0,0,0,2044,114,1494,152,608,0,0,0,2368,4412
4167,74,122,1553,106,166,0,0,0,1947,101,1434,154,646,0,0,0,2335,4282
4167,75,117,1640,118,173,0,0,0,2048,107,1509,145,726,0,0,0,2487,4535
4167,76,140,1751,88,197,0,1,0,2177,101,1397,112,847,0,0,0,2457,4634
4167,77,124,1637,78,245,2,0,0,2086,108,1372,103,940,0,0,0,2523,4609
4167,78,61,997,47,157,0,0,0,1262,65,798,70,595,0,0,0,1528,2790
4167,79,84,1200,54,213,0,0,0,1551,73,896,66,803,0,0,0,1838,3389
4167,80,78,1085,37,212,0,0,0,1412,82,827,59,868,0,0,0,1836,3248
4167,81,65,954,47,211,0,0,0,1277,95,765,48,861,0,0,0,1769,3046
4167,82,67,942,28,214,0,0,0,1251,81,615,50,949,0,0,0,1695,2946
4167,83,67,974,23,254,0,0,0,1318,83,650,61,1153,0,0,0,1947,3265
4167,84,49,848,31,281,1,0,0,1210,77,540,49,1092,0,0,0,1758,2968
4167,85,45,781,15,251,0,0,0,1092,69,478,43,1122,0,0,0,1712,2804
4167,86,46,639,10,222,0,0,0,917,57,350,32,1051,0,0,0,1490,2407
4167,87,45,464,17,232,0,0,0,758,48,259,33,917,0,0,0,1257,2015
4167,88,36,429,12,225,1,0,0,703,57,189,18,948,0,0,0,1212,1915
4167,89,32,389,7,207,0,0,0,635,48,166,19,873,0,0,0,1106,1741
4167,90,17,283,4,183,0,0,0,487,33,108,12,780,0,0,0,933,1420
4167,91,18,187,2,120,0,0,0,327,20,66,10,672,0,0,0,768,1095
4167,92,17,149,1,145,0,0,0,312,18,53,10,587,0,0,0,668,980
4167,93,9,114,4,122,0,0,0,249,19,31,3,490,0,0,0,543,792
4167,94,7,54,0,88,0,0,0,149,22,11,4,344,0,0,0,381,530
4167,95,3,39,2,50,0,0,0,94,18,11,0,265,0,0,0,294,388
4167,96,4,26,1,32,0,0,0,63,12,7,3,193,0,0,0,215,278
4167,97,1,16,0,25,0,0,0,42,10,1,2,145,0,0,0,158,200
4167,98,1,14,0,30,0,0,0,45,8,2,1,107,0,0,0,118,163
4167,99,1,2,0,15,0,0,0,18,3,1,1,88,0,0,0,93,111
4167,100,0,3,0,20,0,0,0,23,4,0,0,127,0,0,0,131,154
4167,999,78272,73459,7303,5860,145,5,1,165045,65414,74481,10019,24617,84,3,1,174619,339664
4195,0,1139,0,0,0,0,0,0,1139,1161,0,0,0,0,0,0,1161,2300
4195,1,1157,0,0,0,0,0,0,1157,1174,0,0,0,0,0,0,1174,2331
4195,2,1314,0,0,0,0,0,0,1314,1208,0,0,0,0,0,0,1208,2522
4195,3,1318,0,0,0,0,0,0,1318,1271,0,0,0,0,0,0,1271,2589
4195,4,1378,0,0,0,0,0,0,1378,1248,0,0,0,0,0,0,1248,2626
4195,5,1514,0,0,0,0,0,0,1514,1360,0,0,0,0,0,0,1360,2874
4195,6,1537,0,0,0,0,0,0,1537,1388,0,0,0,0,0,0,1388,2925
4195,7,1528,0,0,0,0,0,0,1528,1423,0,0,0,0,0,0,1423,2951
4195,8,1601,0,0,0,0,0,0,1601,1498,0,0,0,0,0,0,1498,3099
4195,9,1627,0,0,0,0,0,0,1627,1566,0,0,0,0,0,0,1566,3193
4195,10,1647,0,0,0,0,0,0,1647,1622,0,0,0,0,0,0,1622,3269
4195,11,1751,0,0,0,0,0,0,1751,1594,0,0,0,0,0,0,1594,3345
4195,12,1854,0,0,0,0,0,0,1854,1665,0,0,0,0,0,0,1665,3519
4195,13,1857,0,0,0,0,0,0,1857,1770,0,0,0,0,0,0,1770,3627
4195,14,1945,0,0,0,0,0,0,1945,1776,0,0,0,0,0,0,1776,3721
4195,15,1932,0,0,0,0,0,0,1932,1805,0,0,0,0,0,0,1805,3737
4195,16,1888,0,0,0,0,0,0,1888,1780,0,0,0,0,0,0,1780,3668
4195,17,1987,0,0,0,0,0,0,1987,1817,0,0,0,0,0,0,1817,3804
4195,18,1934,0,0,0,0,0,0,1934,1670,1,0,0,0,0,0,1671,3605
4195,19,1945,0,0,0,0,0,0,1945,1706,6,0,0,0,0,0,1712,3657
4195,20,1981,1,0,0,0,0,0,1982,1647,14,0,0,0,0,0,1661,3643
4195,21,1872,4,0,0,0,0,0,1876,1691,30,0,0,0,0,0,1721,3597
4195,22,1940,9,0,0,0,0,0,1949,1664,47,3,0,0,0,0,1714,3663
4195,23,2001,13,2,0,0,0,0,2016,1654,77,5,0,2,0,0,1738,3754
4195,24,1921,31,0,0,0,0,0,1952,1505,109,1,0,1,0,0,1616,3568
4195,25,1928,42,1,0,0,0,0,1971,1498,173,6,1,0,0,0,1678,3649
4195,26,1892,74,4,0,1,0,0,1971,1490,242,5,0,2,0,0,1739,3710
4195,27,1855,104,2,1,2,0,0,1964,1469,310,5,0,0,1,0,1785,3749
4195,28,1757,158,4,0,3,0,0,1922,1359,348,16,0,1,1,0,1725,3647
4195,29,1697,210,3,0,1,0,0,1911,1385,431,9,1,4,2,0,1832,3743
4195,30,1603,282,11,0,2,0,0,1898,1254,531,11,1,5,0,0,1802,3700
4195,31,1588,377,9,0,2,0,0,1976,1268,600,16,1,3,0,0,1888,3864
4195,32,1544,458,17,6,2,0,0,2027,1158,689,30,0,5,0,0,1882,3909
4195,33,1396,522,16,1,4,0,0,1939,1065,723,35,3,1,0,0,1827,3766
4195,34,1343,592,18,0,2,0,0,1955,1080,813,42,3,5,0,0,1943,3898
4195,35,1328,690,25,0,2,0,0,2045,966,840,50,7,4,0,0,1867,3912
4195,36,1200,716,31,2,3,1,0,1953,958,939,62,5,4,0,0,1968,3921
4195,37,1238,795,44,1,5,0,0,2083,980,1022,62,9,4,0,0,2077,4160
4195,38,1150,826,45,2,4,0,0,2027,900,1062,104,12,1,1,0,2080,4107
4195,39,1111,857,45,3,2,0,0,2018,833,1092,104,13,4,0,0,2046,4064
4195,40,1078,976,69,6,3,0,0,2132,888,1144,114,11,6,0,0,2163,4295
4195,41,1124,1033,71,4,6,0,0,2238,913,1240,149,22,7,1,0,2332,4570
4195,42,1026,1057,84,2,5,0,0,2174,823,1307,135,9,2,1,0,2277,4451
4195,43,1117,1167,98,8,4,0,0,2394,800,1411,152,23,4,0,0,2390,4784
4195,44,1152,1232,101,6,4,0,0,2495,879,1412,169,29,3,0,0,2492,4987
4195,45,1163,1335,131,5,5,1,0,2640,933,1499,205,28,4,0,0,2669,5309
4195,46,1206,1432,149,3,4,0,0,2794,981,1689,233,26,4,0,0,2933,5727
4195,47,1216,1557,149,10,5,0,0,2937,1010,1603,233,31,4,0,0,2881,5818
4195,48,1286,1673,209,15,3,0,0,3186,1015,1793,277,37,5,0,0,3127,6313
4195,49,1318,1714,209,8,4,0,0,3253,1005,1879,320,58,2,0,0,3264,6517
4195,50,1223,1726,209,8,5,1,0,3172,991,1897,353,56,4,0,0,3301,6473
4195,51,1211,1830,223,18,7,0,0,3289,943,1963,331,76,2,1,0,3316,6605
4195,52,1152,1847,260,18,6,0,0,3283,871,1940,363,77,1,0,0,3252,6535
4195,53,1067,1841,266,19,5,0,0,3198,901,1976,399,94,2,0,0,3372,6570
4195,54,1025,1888,290,20,6,0,0,3229,781,2086,407,107,3,0,0,3384,6613
4195,55,1028,1997,309,20,7,0,1,3362,779,1980,374,100,1,1,0,3235,6597
4195,56,928,1994,327,25,6,0,1,3281,711,1943,411,120,1,0,0,3186,6467
4195,57,863,2046,324,32,6,0,0,3271,735,2014,417,123,3,0,0,3292,6563
4195,58,793,1982,322,27,4,0,0,3128,595,2022,434,178,2,0,0,3231,6359
4195,59,791,2163,350,42,9,0,0,3355,617,2164,417,172,2,0,0,3372,6727
4195,60,676,1983,334,53,4,0,0,3050,503,1950,380,188,1,0,0,3022,6072
4195,61,536,2012,292,35,4,0,0,2879,477,1960,372,193,1,0,0,3003,5882
4195,62,535,1918,305,62,3,0,0,2823,434,2000,358,200,3,0,0,2995,5818
4195,63,461,1921,289,65,5,0,1,2742,394,1836,369,226,1,0,0,2826,5568
4195,64,431,1890,280,69,3,0,0,2673,375,1770,319,269,1,0,0,2734,5407
4195,65,362,1806,239,77,4,0,0,2488,343,1727,299,240,0,0,0,2609,5097
4195,66,335,1743,213,75,4,0,0,2370,301,1746,325,301,1,0,0,2674,5044
4195,67,316,1779,234,93,5,0,0,2427,281,1708,285,331,1,0,0,2606,5033
4195,68,239,1752,196,89,1,0,0,2277,238,1619,263,304,0,0,0,2424,4701
4195,69,223,1591,179,100,1,0,0,2094,199,1580,231,346,0,0,0,2356,4450
4195,70,193,1561,186,94,0,0,1,2035,213,1402,214,362,1,0,0,2192,4227
4195,71,212,1572,163,94,1,0,0,2042,196,1477,204,422,0,1,0,2300,4342
4195,72,175,1558,152,98,3,0,1,1987,178,1400,185,442,0,0,0,2205,4192
4195,73,170,1568,163,126,2,0,0,2029,148,1474,209,518,1,0,0,2350,4379
4195,74,149,1565,144,134,2,0,0,1994,153,1476,164,590,2,0,0,2385,4379
4195,75,139,1647,120,146,0,0,0,2052,151,1527,153,657,0,0,0,2488,4540
4195,76,139,1641,113,176,0,0,0,2069,125,1320,120,704,0,0,0,2269,4338
4195,77,145,1567,93,180,0,0,0,1985,121,1413,129,764,0,0,0,2427,4412
4195,78,73,1046,76,157,0,0,0,1352,95,902,103,625,0,0,0,1725,3077
4195,79,106,1178,78,168,0,0,0,1530,86,940,99,761,0,0,0,1886,3416
4195,80,96,1076,51,174,0,0,0,1397,105,832,75,834,0,0,0,1846,3243
4195,81,84,1017,54,186,1,0,0,1342,84,765,80,749,0,0,0,1678,3020
4195,82,83,1003,48,206,1,0,0,1341,86,714,87,820,0,0,0,1707,3048
4195,83,93,1019,34,215,0,0,0,1361,94,743,58,1024,0,0,0,1919,3280
4195,84,85,996,35,253,0,0,0,1369,94,681,54,1051,0,0,0,1880,3249
4195,85,84,902,42,253,0,0,0,1281,98,522,39,1082,0,0,0,1741,3022
4195,86,74,738,21,236,1,0,0,1070,86,399,38,1046,0,0,0,1569,2639
4195,87,48,567,15,211,0,0,0,841,80,303,29,973,0,0,0,1385,2226
4195,88,56,532,13,219,0,0,0,820,49,260,36,1005,0,0,0,1350,2170
4195,89,34,465,15,206,0,0,0,720,61,205,26,979,0,0,0,1271,1991
4195,90,32,347,9,205,0,0,0,593,61,118,23,802,0,0,0,1004,1597
4195,91,27,255,4,161,0,0,0,447,57,80,9,729,0,0,0,875,1322
4195,92,18,190,3,147,0,0,0,358,45,59,7,588,0,0,0,699,1057
4195,93,26,135,2,136,0,0,0,299,44,36,7,571,0,0,0,658,957
4195,94,15,86,3,82,0,0,0,186,27,24,3,406,0,0,0,460,646
4195,95,14,61,3,76,0,0,0,154,25,16,6,341,0,0,0,388,542
4195,96,3,36,1,56,0,0,0,96,9,13,4,253,0,0,0,279,375
4195,97,2,19,0,33,0,0,0,54,16,9,1,200,0,0,0,226,280
4195,98,3,18,0,31,0,0,0,52,13,3,1,134,0,0,0,151,203
4195,99,2,11,0,21,0,0,0,34,6,0,0,83,0,0,0,89,123
4195,100,1,8,0,24,0,0,0,33,10,4,0,152,0,0,0,166,199
4195,999,93460,82030,8629,5534,184,3,5,189845,79658,82074,11823,23698,121,10,0,197384,387229
4281,0,1397,0,0,0,0,0,0,1397,1333,0,0,0,0,0,0,1333,2730
4281,1,1361,0,0,0,0,0,0,1361,1323,0,0,0,0,0,0,1323,2684
4281,2,1445,0,0,0,0,0,0,1445,1456,0,0,0,0,0,0,1456,2901
4281,3,1534,0,0,0,0,0,0,1534,1475,0,0,0,0,0,0,1475,3009
4281,4,1650,0,0,0,0,0,0,1650,1459,0,0,0,0,0,0,1459,3109
4281,5,1680,0,0,0,0,0,0,1680,1554,0,0,0,0,0,0,1554,3234
4281,6,1730,0,0,0,0,0,0,1730,1624,0,0,0,0,0,0,1624,3354
4281,7,1864,0,0,0,0,0,0,1864,1729,0,0,0,0,0,0,1729,3593
4281,8,1949,0,0,0,0,0,0,1949,1827,0,0,0,0,0,0,1827,3776
4281,9,1955,0,0,0,0,0,0,1955,1873,0,0,0,0,0,0,1873,3828
4281,10,2079,0,0,0,0,0,0,2079,1892,0,0,0,0,0,0,1892,3971
4281,11,2115,0,0,0,0,0,0,2115,2000,0,0,0,0,0,0,2000,4115
4281,12,2150,0,0,0,0,0,0,2150,2088,0,0,0,0,0,0,2088,4238
4281,13,2225,0,0,0,0,0,0,2225,2175,0,0,0,0,0,0,2175,4400
4281,14,2397,0,0,0,0,0,0,2397,2178,0,0,0,0,0,0,2178,4575
4281,15,2367,0,0,0,0,0,0,2367,2257,0,0,0,0,0,0,2257,4624
4281,16,2317,0,0,0,0,0,0,2317,2176,0,0,0,0,0,0,2176,4493
4281,17,2249,0,0,0,0,0,0,2249,2116,1,0,0,0,0,0,2117,4366
4281,18,2283,0,0,0,0,0,0,2283,2086,0,0,0,0,0,0,2086,4369
4281,19,2418,0,0,0,0,0,0,2418,2102,5,0,0,0,0,0,2107,4525
4281,20,2268,1,0,0,0,0,0,2269,2061,21,0,0,0,0,0,2082,4351
4281,21,2423,1,0,0,0,0,0,2424,2085,30,0,0,0,0,0,2115,4539
4281,22,2328,2,0,0,0,0,0,2330,2025,54,3,0,0,0,0,2082,4412
4281,23,2398,25,3,0,1,0,0,2427,2001,86,3,0,1,0,0,2091,4518
4281,24,2403,44,1,0,0,0,0,2448,2041,104,5,0,0,0,0,2150,4598
4281,25,2475,46,2,0,2,0,0,2525,1948,171,5,0,1,0,0,2125,4650
4281,26,2386,77,0,0,1,0,0,2464,1972,190,7,1,0,0,0,2170,4634
4281,27,2317,118,4,0,1,0,0,2440,1790,280,7,0,1,0,0,2078,4518
4281,28,2278,156,4,0,2,0,0,2440,1793,328,6,0,2,0,0,2129,4569
4281,29,2165,192,2,0,1,0,0,2360,1697,385,9,0,3,0,0,2094,4454
4281,30,2128,231,6,0,2,0,0,2367,1655,516,12,0,3,0,0,2186,4553
4281,31,2122,332,9,0,1,0,0,2464,1578,642,18,3,2,0,0,2243,4707
4281,32,2018,453,8,1,6,0,0,2486,1439,665,25,5,3,0,0,2137,4623
4281,33,1982,550,12,2,1,0,0,2547,1445,802,35,2,3,0,0,2287,4834
4281,34,1711,620,14,0,2,0,0,2347,1357,942,37,3,1,0,0,2340,4687
4281,35,1648,697,23,2,4,0,0,2374,1213,1020,48,5,5,0,0,2291,4665
4281,36,1609,760,29,1,0,0,0,2399,1126,1125,51,9,3,0,0,2314,4713
4281,37,1544,919,36,2,2,0,0,2503,1108,1256,79,10,4,0,0,2457,4960
4281,38,1506,952,48,1,2,1,0,2510,1111,1294,98,15,2,0,1,2521,5031
4281,39,1440,1175,47,4,4,0,0,2670,1101,1417,96,12,3,0,0,2629,5299
4281,40,1332,1226,56,0,5,0,0,2619,1084,1500,96,10,4,0,0,2694,5313
4281,41,1482,1296,78,1,2,0,1,2860,998,1611,145,11,8,0,0,2773,5633
4281,42,1357,1363,94,8,4,0,0,2826,972,1612,150,21,4,0,0,2759,5585
4281,43,1415,1544,101,9,3,0,0,3072,1024,1790,159,29,2,0,0,3004,6076
4281,44,1308,1638,137,17,5,0,0,3105,934,1873,222,42,3,1,0,3075,6180
4281,45,1335,1786,150,11,10,0,0,3292,963,2013,224,48,4,0,0,3252,6544
4281,46,1417,1828,162,16,1,0,0,3424,986,2094,224,30,3,0,0,3337,6761
4281,47,1293,1888,190,14,7,1,0,3393,935,2256,247,61,3,0,0,3502,6895
4281,48,1344,2218,171,17,6,0,0,3756,944,2467,308,46,7,0,0,3772,7528
4281,49,1386,2217,219,20,5,0,0,3847,864,2440,328,53,4,0,0,3689,7536
4281,50,1222,2229,213,14,2,0,0,3680,820,2480,320,73,5,0,0,3698,7378
4281,51,1148,2275,231,21,7,0,0,3682,798,2544,338,78,2,0,0,3760,7442
4281,52,1122,2431,266,19,5,0,0,3843,757,2598,379,79,2,0,0,3815,7658
4281,53,971,2404,276,20,5,0,0,3676,654,2586,363,130,1,0,0,3734,7410
4281,54,923,2420,265,23,8,0,0,3639,678,2676,388,127,4,0,0,3873,7512
4281,55,835,2449,270,33,4,0,0,3591,614,2684,422,134,1,0,0,3855,7446
4281,56,789,2434,267,35,6,0,0,3531,585,2624,375,150,0,0,0,3734,7265
4281,57,732,2598,315,43,4,0,0,3692,547,2755,354,154,0,0,0,3810,7502
4281,58,662,2604,289,56,4,0,0,3615,527,2602,377,171,3,0,0,3680,7295
4281,59,644,2640,324,46,4,0,0,3658,472,2853,372,210,2,0,0,3909,7567
4281,60,566,2517,278,51,3,0,0,3415,436,2658,378,229,1,0,0,3702,7117
4281,61,501,2479,306,64,4,0,0,3354,383,2447,321,217,1,0,0,3369,6723
4281,62,428,2525,250,68,5,0,0,3276,354,2466,332,281,2,0,0,3435,6711
4281,63,406,2326,254,70,1,0,0,3057,354,2357,263,277,0,0,0,3251,6308
4281,64,377,2286,211,70,4,0,0,2948,289,2397,232,333,0,0,0,3251,6199
4281,65,360,2244,233,87,1,0,0,2925,283,2259,217,341,1,0,0,3101,6026
4281,66,315,2230,176,98,4,0,0,2823,239,2291,231,378,1,0,0,3140,5963
4281,67,295,2296,175,106,2,0,1,2875,236,2274,250,470,0,0,0,3230,6105
4281,68,253,2164,182,105,1,0,0,2705,195,2171,214,472,0,0,0,3052,5757
4281,69,242,2148,128,111,1,0,0,2630,196,2017,183,461,0,0,0,2857,5487
4281,70,198,1987,125,130,4,0,0,2444,171,2060,162,511,1,0,0,2905,5349
4281,71,201,2057,131,140,2,0,0,2531,149,1922,179,562,0,0,0,2812,5343
4281,72,198,2072,123,133,4,0,0,2530,167,1893,121,605,0,0,0,2786,5316
4281,73,183,2108,122,172,2,0,0,2587,155,1870,145,693,1,0,0,2864,5451
4281,74,149,1970,85,159,0,0,0,2363,141,1723,129,764,0,0,0,2757,5120
4281,75,179,2070,58,192,1,0,0,2500,135,1756,101,768,0,0,0,2760,5260
4281,76,153,1935,72,198,1,0,0,2359,126,1599,102,905,0,0,0,2732,5091
4281,77,158,1843,75,249,0,0,0,2325,133,1573,88,1031,0,0,0,2825,5150
4281,78,114,1548,55,203,1,0,0,1921,85,1160,67,868,0,0,0,2180,4101
4281,79,99,1398,46,187,0,0,0,1730,90,1098,60,931,1,0,0,2180,3910
4281,80,101,1422,39,211,0,0,0,1773,99,1074,38,1079,0,0,0,2290,4063
4281,81,114,1221,28,235,2,0,0,1600,104,904,46,1092,0,0,0,2146,3746
4281,82,95,1220,28,217,1,0,0,1561,102,773,37,1171,0,0,0,2083,3644
4281,83,79,1236,19,237,0,0,0,1571,101,823,44,1380,0,0,0,2348,3919
4281,84,80,1213,26,250,1,0,0,1570,101,675,30,1470,0,0,0,2276,3846
4281,85,88,1011,17,259,0,0,0,1375,116,545,30,1459,0,0,0,2150,3525
4281,86,66,953,18,228,0,0,0,1265,72,407,19,1374,0,0,0,1872,3137
4281,87,38,699,9,224,0,0,0,970,73,304,14,1309,0,0,0,1700,2670
4281,88,48,639,5,229,0,0,0,921,82,239,22,1258,0,0,0,1601,2522
4281,89,45,508,6,187,0,0,0,746,56,173,10,1141,0,0,0,1380,2126
4281,90,19,402,10,180,0,0,0,611,58,108,13,982,0,0,0,1161,1772
4281,91,18,290,4,157,0,0,0,469,61,72,6,812,0,0,0,951,1420
4281,92,12,224,2,130,0,0,0,368,53,64,10,820,0,0,0,947,1315
4281,93,6,178,4,110,0,0,0,298,43,33,3,663,0,0,0,742,1040
4281,94,7,106,1,94,0,0,0,208,41,18,3,514,0,0,0,576,784
4281,95,5,78,0,61,0,0,0,144,40,10,1,394,0,0,0,445,589
4281,96,2,47,0,65,0,0,0,114,25,4,1,288,0,0,0,318,432
4281,97,0,11,0,40,0,0,0,51,18,3,1,213,0,0,0,235,286
4281,98,2,16,0,22,0,0,0,40,9,5,1,159,0,0,0,174,214
4281,99,1,7,1,21,0,0,0,30,6,2,1,115,0,0,0,124,154
4281,100,0,5,0,13,0,0,0,18,17,2,3,163,0,0,0,185,203
4281,999,109232,102528,7624,6199,174,2,2,225761,91019,103621,10443,30675,108,1,1,235868,461629
4347,0,981,0,0,0,0,0,0,981,915,0,0,0,0,0,0,915,1896
4347,1,977,0,0,0,0,0,0,977,892,0,0,0,0,0,0,892,1869
4347,2,1054,0,0,0,0,0,0,1054,1002,0,0,0,0,0,0,1002,2056
4347,3,1090,0,0,0,0,0,0,1090,998,0,0,0,0,0,0,998,2088
4347,4,1094,0,0,0,0,0,0,1094,1036,0,0,0,0,0,0,1036,2130
4347,5,1148,0,0,0,0,0,0,1148,1060,0,0,0,0,0,0,1060,2208
4347,6,1214,0,0,0,0,0,0,1214,1167,0,0,0,0,0,0,1167,2381
4347,7,1226,0,0,0,0,0,0,1226,1238,0,0,0,0,0,0,1238,2464
4347,8,1244,0,0,0,0,0,0,1244,1217,0,0,0,0,0,0,1217,2461
4347,9,1299,0,0,0,0,0,0,1299,1285,0,0,0,0,0,0,1285,2584
4347,10,1337,0,0,0,0,0,0,1337,1190,0,0,0,0,0,0,1190,2527
4347,11,1354,0,0,0,0,0,0,1354,1292,0,0,0,0,0,0,1292,2646
4347,12,1385,0,0,0,0,0,0,1385,1384,0,0,0,0,0,0,1384,2769
4347,13,1524,0,0,0,0,0,0,1524,1328,0,0,0,0,0,0,1328,2852
4347,14,1484,0,0,0,0,0,0,1484,1431,0,0,0,0,0,0,1431,2915
4347,15,1472,0,0,0,0,0,0,1472,1369,0,0,0,0,0,0,1369,2841
4347,16,1479,0,0,0,0,0,0,1479,1433,0,0,0,0,0,0,1433,2912
4347,17,1413,0,0,0,0,0,0,1413,1384,1,0,0,0,0,0,1385,2798
4347,18,1408,1,0,0,0,0,0,1409,1383,4,0,0,0,0,0,1387,2796
4347,19,1500,0,0,0,0,0,0,1500,1307,2,0,0,0,0,0,1309,2809
4347,20,1551,0,0,0,0,0,0,1551,1355,11,0,0,0,0,0,1366,2917
4347,21,1511,5,0,0,0,0,0,1516,1343,13,0,0,0,0,0,1356,2872
4347,22,1445,5,2,0,0,0,0,1452,1333,27,1,0,0,0,0,1361,2813
4347,23,1540,15,0,0,0,0,0,1555,1364,52,2,0,0,0,0,1418,2973
4347,24,1536,15,0,0,1,0,0,1552,1332,69,2,0,0,0,0,1403,2955
4347,25,1530,29,2,1,0,0,0,1562,1259,102,0,0,0,1,0,1362,2924
4347,26,1596,48,3,0,0,0,0,1647,1209,165,4,0,1,0,0,1379,3026
4347,27,1434,81,3,0,0,0,0,1518,1249,187,4,1,0,0,0,1441,2959
4347,28,1415,115,3,0,1,0,0,1534,1139,241,8,0,2,0,0,1390,2924
4347,29,1440,146,1,1,0,0,0,1588,1119,301,10,0,0,0,0,1430,3018
4347,30,1428,190,4,0,0,0,0,1622,1054,395,6,0,1,0,0,1456,3078
4347,31,1353,270,9,0,2,0,0,1634,995,488,18,0,1,0,0,1502,3136
4347,32,1242,316,5,1,1,0,0,1565,983,567,22,0,1,0,0,1573,3138
4347,33,1305,386,8,1,2,0,0,1702,937,663,20,3,3,0,0,1626,3328
4347,34,1199,465,8,0,1,0,0,1673,813,660,32,3,1,0,0,1509,3182
4347,35,1108,540,14,1,1,0,0,1664,827,814,33,3,1,0,0,1678,3342
4347,36,978,638,15,0,0,0,0,1631,699,831,33,5,2,0,1,1571,3202
4347,37,1012,678,21,2,1,0,0,1714,753,831,49,10,1,0,0,1644,3358
4347,38,971,729,21,8,2,0,0,1731,699,975,52,4,1,1,0,1732,3463
4347,39,945,736,40,3,4,0,0,1728,641,992,70,6,0,0,0,1709,3437
4347,40,867,827,48,2,0,0,0,1744,593,1069,80,9,3,0,0,1754,3498
4347,41,878,962,37,1,1,0,0,1879,651,1124,65,11,0,0,0,1851,3730
4347,42,869,958,57,1,3,0,0,1888,584,1176,79,17,4,0,0,1860,3748
4347,43,840,987,61,6,1,0,0,1895,543,1228,112,17,3,0,0,1903,3798
4347,44,819,1062,56,8,2,0,0,1947,556,1335,111,25,1,0,0,2028,3975
4347,45,824,1169,85,5,4,0,0,2087,583,1291,146,24,0,0,0,2044,4131
4347,46,796,1232,105,5,2,0,0,2140,538,1463,149,17,1,0,0,2168,4308
4347,47,785,1297,117,8,0,0,0,2207,508,1493,155,36,1,0,0,2193,4400
4347,48,806,1347,101,11,1,0,0,2266,536,1574,182,32,1,0,0,2325,4591
4347,49,741,1458,125,7,4,0,0,2335,515,1615,204,43,0,0,0,2377,4712
4347,50,702,1442,121,9,2,0,0,2276,488,1589,178,53,0,0,0,2308,4584
4347,51,690,1479,168,16,0,0,0,2353,404,1611,207,52,0,0,0,2274,4627
4347,52,679,1519,136,14,0,0,0,2348,431,1765,206,63,0,0,0,2465,4813
4347,53,581,1546,138,10,1,0,0,2276,382,1610,189,72,0,0,0,2253,4529
4347,54,583,1601,201,23,0,0,0,2408,376,1780,193,82,0,0,0,2431,4839
4347,55,529,1697,158,14,0,0,0,2398,332,1705,210,99,0,0,0,2346,4744
4347,56,489,1629,163,24,0,0,0,2305,347,1787,189,106,0,0,0,2429,4734
4347,57,483,1664,182,22,1,0,0,2352,342,1756,214,104,0,0,0,2416,4768
4347,58,427,1702,192,20,1,0,0,2342,293,1833,228,124,1,0,1,2480,4822
4347,59,449,1779,211,21,0,0,0,2460,273,1862,195,135,1,0,0,2466,4926
4347,60,346,1685,171,33,1,0,0,2236,256,1773,203,142,2,0,0,2376,4612
4347,61,340,1692,170,42,0,0,0,2244,220,1634,185,147,1,0,0,2187,4431
4347,62,331,1698,149,45,2,0,0,2225,241,1679,200,180,0,0,0,2300,4525
4347,63,275,1630,151,56,0,0,0,2112,210,1683,157,222,0,0,0,2272,4384
4347,64,277,1623,136,39,0,0,0,2075,172,1667,148,237,0,0,0,2224,4299
4347,65,235,1578,115,57,1,0,0,1986,172,1539,163,216,1,0,0,2091,4077
4347,66,197,1504,123,67,1,0,0,1892,167,1547,163,290,0,0,0,2167,4059
4347,67,193,1550,95,83,1,0,0,1922,167,1452,125,271,0,0,0,2015,3937
4347,68,190,1443,104,85,2,0,0,1824,141,1408,120,368,0,0,0,2037,3861
4347,69,179,1467,83,90,1,0,0,1820,120,1378,109,333,0,0,0,1940,3760
4347,70,177,1445,85,79,0,0,0,1786,96,1291,107,367,0,0,0,1861,3647
4347,71,164,1470,90,96,1,0,0,1821,113,1279,86,426,0,0,0,1904,3725
4347,72,163,1383,70,99,0,0,0,1715,112,1341,95,443,0,0,0,1991,3706
4347,73,133,1412,65,93,0,0,0,1703,95,1244,92,498,0,0,0,1929,3632
4347,74,146,1329,59,102,0,0,0,1636,83,1077,68,514,0,0,0,1742,3378
4347,75,112,1298,57,121,1,0,0,1589,102,1155,48,616,0,0,0,1921,3510
4347,76,130,1277,48,103,2,0,0,1560,62,1006,59,642,0,0,0,1769,3329
4347,77,101,1116,36,147,1,0,0,1401,61,974,45,640,0,0,0,1720,3121
4347,78,79,928,30,114,0,0,0,1151,66,721,45,641,0,0,0,1473,2624
4347,79,93,898,29,116,0,0,0,1136,67,627,33,673,0,0,0,1400,2536
4347,80,73,881,26,122,1,0,0,1103,64,607,34,720,0,0,0,1425,2528
4347,81,74,830,18,125,1,0,0,1048,45,530,26,802,0,0,0,1403,2451
4347,82,72,716,15,121,0,0,0,924,67,519,19,779,0,0,0,1384,2308
4347,83,81,830,15,157,0,0,0,1083,53,497,30,895,0,0,0,1475,2558
4347,84,87,826,13,159,0,0,0,1085,69,457,24,975,0,0,0,1525,2610
4347,85,61,756,14,225,0,0,0,1056,60,335,15,1104,0,0,0,1514,2570
4347,86,67,612,11,161,0,0,0,851,55,279,8,919,0,0,0,1261,2112
4347,87,38,457,9,136,0,0,0,640,53,169,12,883,0,0,0,1117,1757
4347,88,42,465,6,134,0,0,0,647,47,143,7,872,0,0,0,1069,1716
4347,89,32,359,6,161,0,0,0,558,39,86,9,787,0,0,0,921,1479
4347,90,24,263,1,120,0,0,0,408,35,58,5,695,0,0,0,793,1201
4347,91,24,188,1,90,0,0,0,303,35,47,5,603,0,0,0,690,993
4347,92,18,152,4,82,0,0,0,256,22,28,2,494,0,0,0,546,802
4347,93,8,101,0,75,0,0,0,184,26,21,3,470,0,0,0,520,704
4347,94,13,60,1,65,0,0,0,139,17,3,3,319,0,0,0,342,481
4347,95,7,55,1,42,0,0,0,105,17,9,2,230,0,0,0,258,363
4347,96,0,29,0,38,0,0,0,67,15,4,2,222,0,0,0,243,310
4347,97,2,13,0,17,0,0,0,32,15,5,1,161,0,0,0,182,214
4347,98,3,5,0,15,0,0,0,23,11,1,1,87,0,0,0,100,123
4347,99,1,10,0,11,0,0,0,22,4,1,0,62,0,0,0,67,89
4347,100,0,8,0,16,0,0,0,24,12,1,0,110,0,0,0,123,147
4347,999,70647,68807,4628,3984,55,0,0,148121,58173,69332,6117,21211,35,2,2,154872,302993
4386,0,627,0,0,0,0,0,0,627,565,0,0,0,0,0,0,565,1192
4386,1,622,0,0,0,0,0,0,622,564,0,0,0,0,0,0,564,1186
4386,2,620,0,0,0,0,0,0,620,619,0,0,0,0,0,0,619,1239
4386,3,659,0,0,0,0,0,0,659,627,0,0,0,0,0,0,627,1286
4386,4,633,0,0,0,0,0,0,633,638,0,0,0,0,0,0,638,1271
4386,5,672,0,0,0,0,0,0,672,666,0,0,0,0,0,0,666,1338
4386,6,696,0,0,0,0,0,0,696,724,0,0,0,0,0,0,724,1420
4386,7,813,0,0,0,0,0,0,813,719,0,0,0,0,0,0,719,1532
4386,8,774,0,0,0,0,0,0,774,787,0,0,0,0,0,0,787,1561
4386,9,889,0,0,0,0,0,0,889,780,0,0,0,0,0,0,780,1669
4386,10,854,0,0,0,0,0,0,854,834,0,0,0,0,0,0,834,1688
4386,11,837,0,0,0,0,0,0,837,827,0,0,0,0,0,0,827,1664
4386,12,875,0,0,0,0,0,0,875,823,0,0,0,0,0,0,823,1698
4386,13,889,0,0,0,0,0,0,889,879,0,0,0,0,0,0,879,1768
4386,14,913,0,0,0,0,0,0,913,868,0,0,0,0,0,0,868,1781
4386,15,977,0,0,0,0,0,0,977,894,0,0,0,0,0,0,894,1871
4386,16,940,0,0,0,0,0,0,940,840,0,0,0,0,0,0,840,1780
4386,17,952,0,0,0,0,0,0,952,855,0,0,0,0,0,0,855,1807
4386,18,924,0,0,0,0,0,0,924,894,0,0,0,0,0,0,894,1818
4386,19,1014,0,0,0,0,0,0,1014,927,1,0,0,0,0,0,928,1942
4386,20,975,2,0,0,0,0,0,977,833,4,0,0,0,0,0,837,1814
4386,21,978,0,0,0,0,0,0,978,801,9,0,0,0,0,0,810,1788
4386,22,983,2,0,0,0,0,0,985,844,19,0,0,0,0,0,863,1848
4386,23,1064,4,1,0,0,0,0,1069,910,22,0,0,0,0,0,932,2001
4386,24,1046,10,0,0,0,0,0,1056,902,31,0,0,0,0,0,933,1989
4386,25,1107,13,1,0,0,0,0,1121,941,41,0,0,0,0,0,982,2103
4386,26,961,21,0,0,0,0,0,982,873,71,1,0,0,0,0,945,1927
4386,27,1038,32,0,0,0,0,0,1070,783,99,4,0,0,0,0,886,1956
4386,28,1009,53,1,0,0,0,0,1063,797,118,3,0,1,0,0,919,1982
4386,29,961,79,0,0,0,0,0,1040,772,166,2,2,0,0,0,942,1982
4386,30,989,97,0,0,0,0,0,1086,774,207,6,0,0,0,0,987,2073
4386,31,959,148,3,0,0,0,0,1110,708,260,10,2,0,0,0,980,2090
4386,32,884,202,5,1,1,0,0,1093,653,346,11,0,1,0,0,1011,2104
4386,33,884,247,8,0,0,0,0,1139,613,339,14,1,1,0,0,968,2107
4386,34,785,304,8,2,1,0,0,1100,587,437,18,2,2,0,0,1046,2146
4386,35,772,329,12,0,0,0,0,1113,585,489,23,2,0,0,0,1099,2212
4386,36,744,355,17,0,1,0,0,1117,499,541,20,3,0,0,0,1063,2180
4386,37,689,381,21,0,0,0,0,1091,493,556,27,3,1,0,0,1080,2171
4386,38,676,426,22,0,1,0,0,1125,474,615,36,6,1,0,0,1132,2257
4386,39,635,516,24,0,1,0,0,1176,409,657,34,5,0,0,0,1105,2281
4386,40,613,533,26,1,2,0,0,1175,407,721,48,4,0,0,0,1180,2355
4386,41,580,588,32,1,0,0,0,1201,407,661,61,8,0,0,0,1137,2338
4386,42,570,596,29,7,1,0,0,1203,394,702,64,4,0,0,0,1164,2367
4386,43,573,669,32,2,2,0,0,1278,353,764,68,16,0,0,0,1201,2479
4386,44,517,700,46,13,0,0,0,1276,364,825,79,9,1,0,0,1278,2554
4386,45,539,686,63,3,1,0,0,1292,377,895,108,11,0,0,0,1391,2683
4386,46,498,734,45,4,2,0,0,1283,360,989,88,16,0,0,0,1453,2736
4386,47,486,799,72,5,3,0,0,1365,310,950,105,24,1,0,0,1390,2755
4386,48,472,916,77,1,0,0,0,1466,335,1008,112,14,1,0,0,1470,2936
4386,49,506,944,69,7,2,0,0,1528,358,1024,121,29,0,0,0,1532,3060
4386,50,492,938,91,4,2,0,0,1527,287,1071,121,26,1,0,0,1506,3033
4386,51,504,976,93,6,0,0,0,1579,330,1165,132,30,1,0,0,1658,3237
4386,52,419,1029,102,7,1,0,0,1558,275,1155,133,43,0,0,0,1606,3164
4386,53,423,987,94,10,0,0,0,1514,242,1209,159,54,0,0,0,1664,3178
4386,54,394,1054,108,8,2,0,0,1566,257,1210,174,45,0,0,0,1686,3252
4386,55,364,1144,117,17,3,0,0,1645,245,1236,156,67,0,0,0,1704,3349
4386,56,336,1123,127,11,3,0,0,1600,194,1266,155,67,0,0,0,1682,3282
4386,57,300,1094,107,22,3,0,0,1526,199,1238,145,87,1,0,0,1670,3196
4386,58,274,1236,131,16,2,0,0,1659,205,1284,143,85,0,0,0,1717,3376
4386,59,257,1286,125,19,0,0,0,1687,210,1358,154,97,0,0,0,1819,3506
4386,60,241,1164,132,19,2,0,0,1558,161,1309,140,113,0,0,0,1723,3281
4386,61,205,1162,107,22,0,0,0,1496,147,1168,135,125,0,0,0,1575,3071
4386,62,177,1147,116,31,1,0,0,1472,160,1123,130,130,1,0,0,1544,3016
4386,63,177,1157,104,31,4,0,0,1473,147,1170,108,133,0,0,0,1558,3031
4386,64,163,1100,92,20,2,0,0,1377,138,1112,96,158,1,0,0,1505,2882
4386,65,157,1055,78,35,1,0,0,1326,131,1138,109,178,0,0,0,1556,2882
4386,66,126,1040,72,33,0,0,0,1271,116,1103,95,165,0,0,0,1479,2750
4386,67,137,1044,75,37,0,0,0,1293,96,1056,69,236,0,0,0,1457,2750
4386,68,112,1028,54,39,0,0,0,1233,104,992,70,246,0,0,0,1412,2645
4386,69,113,946,62,54,1,0,0,1176,94,995,59,211,0,0,0,1359,2535
4386,70,88,990,47,44,0,0,0,1169,89,899,64,268,1,0,0,1321,2490
4386,71,99,932,35,56,0,0,0,1122,72,883,51,281,1,0,0,1288,2410
4386,72,74,921,52,53,0,0,0,1100,56,812,34,331,0,0,0,1233,2333
4386,73,67,970,40,73,0,0,0,1150,58,854,41,324,0,0,0,1277,2427
4386,74,75,924,37,62,0,0,0,1098,61,828,41,327,0,0,0,1257,2355
4386,75,56,949,20,68,0,0,0,1093,66,781,26,450,0,0,0,1323,2416
4386,76,58,873,38,80,0,0,0,1049,65,691,42,459,0,0,0,1257,2306
4386,77,53,809,21,83,0,0,0,966,71,619,42,455,0,0,0,1187,2153
4386,78,49,663,21,72,1,0,0,806,38,497,27,454,0,0,0,1016,1822
4386,79,44,584,15,74,0,0,0,717,40,401,20,414,0,0,0,875,1592
4386,80,44,673,19,92,0,0,0,828,41,395,18,517,0,0,0,971,1799
4386,81,33,609,14,75,0,0,0,731,32,346,14,529,0,0,0,921,1652
4386,82,38,555,13,81,0,0,0,687,63,324,10,553,0,0,0,950,1637
4386,83,37,601,17,115,0,0,0,770,58,335,18,631,0,0,0,1042,1812
4386,84,40,538,7,117,0,0,0,702,41,302,11,640,0,0,0,994,1696
4386,85,28,501,6,114,0,0,0,649,47,258,17,653,0,0,0,975,1624
4386,86,27,438,4,103,0,0,0,572,33,185,6,599,0,0,0,823,1395
4386,87,26,342,3,91,0,0,0,462,39,142,8,550,0,0,0,739,1201
4386,88,17,313,4,100,0,0,0,434,26,100,7,528,0,0,0,661,1095
4386,89,14,253,0,93,0,0,0,360,28,61,4,481,0,0,0,574,934
4386,90,10,196,3,95,0,0,0,304,33,46,3,464,0,0,0,546,850
4386,91,14,119,2,74,0,0,0,209,23,32,2,347,0,0,0,404,613
4386,92,5,89,3,63,0,0,0,160,23,19,4,346,0,0,0,392,552
4386,93,5,67,1,39,0,0,0,112,13,20,0,289,0,0,0,322,434
4386,94,9,44,0,43,0,0,0,96,10,8,2,210,0,0,0,230,326
4386,95,2,40,0,33,0,0,0,75,15,4,0,142,0,0,0,161,236
4386,96,2,18,0,27,0,0,0,47,12,7,2,117,0,0,0,138,185
4386,97,1,13,1,16,0,0,0,31,9,5,0,83,0,0,0,97,128
4386,98,0,7,0,12,0,0,0,19,8,2,0,63,0,0,0,73,92
4386,99,0,2,0,2,0,0,0,4,3,1,0,34,0,0,0,38,42
4386,100,1,2,0,10,0,0,0,13,5,1,0,70,0,0,0,76,89
4386,999,46060,46131,3024,2548,46,0,0,97809,38162,46783,4060,14066,17,0,0,103088,200897
4441,0,835,0,0,0,0,0,0,835,848,0,0,0,0,0,0,848,1683
4441,1,917,0,0,0,0,0,0,917,851,0,0,0,0,0,0,851,1768
4441,2,938,0,0,0,0,0,0,938,885,0,0,0,0,0,0,885,1823
4441,3,947,0,0,0,0,0,0,947,903,0,0,0,0,0,0,903,1850
4441,4,1006,0,0,0,0,0,0,1006,948,0,0,0,0,0,0,948,1954
4441,5,1106,0,0,0,0,0,0,1106,1034,0,0,0,0,0,0,1034,2140
4441,6,1136,0,0,0,0,0,0,1136,1050,0,0,0,0,0,0,1050,2186
4441,7,1134,0,0,0,0,0,0,1134,1054,0,0,0,0,0,0,1054,2188
4441,8,1227,0,0,0,0,0,0,1227,1135,0,0,0,0,0,0,1135,2362
4441,9,1246,0,0,0,0,0,0,1246,1205,0,0,0,0,0,0,1205,2451
4441,10,1221,0,0,0,0,0,0,1221,1177,0,0,0,0,0,0,1177,2398
4441,11,1371,0,0,0,0,0,0,1371,1218,0,0,0,0,0,0,1218,2589
4441,12,1397,0,0,0,0,0,0,1397,1262,0,0,0,0,0,0,1262,2659
4441,13,1336,0,0,0,0,0,0,1336,1305,0,0,0,0,0,0,1305,2641
4441,14,1398,0,0,0,0,0,0,1398,1286,0,0,0,0,0,0,1286,2684
4441,15,1483,0,0,0,0,0,0,1483,1332,0,0,0,0,0,0,1332,2815
4441,16,1444,0,0,0,0,0,0,1444,1292,0,0,0,0,0,0,1292,2736
4441,17,1384,0,0,0,0,0,0,1384,1346,0,0,0,0,0,0,1346,2730
4441,18,1396,0,0,0,0,0,0,1396,1276,2,0,0,0,0,0,1278,2674
4441,19,1428,0,0,0,0,0,0,1428,1309,4,0,0,0,0,0,1313,2741
4441,20,1379,4,0,0,0,0,0,1383,1248,11,0,0,0,0,0,1259,2642
4441,21,1490,4,0,0,0,0,0,1494,1210,19,0,0,0,0,0,1229,2723
4441,22,1376,6,0,0,0,0,0,1382,1292,39,1,0,0,0,0,1332,2714
4441,23,1453,12,0,0,0,0,0,1465,1294,55,1,0,0,0,0,1350,2815
4441,24,1370,8,0,0,1,0,0,1379,1157,74,1,0,0,0,0,1232,2611
4441,25,1456,22,1,0,0,0,0,1479,1212,107,0,0,0,0,0,1319,2798
4441,26,1335,44,6,0,0,0,0,1385,1182,139,3,0,0,0,0,1324,2709
4441,27,1347,49,3,0,0,0,0,1399,1126,190,1,0,0,0,0,1317,2716
4441,28,1296,83,1,0,0,0,0,1380,1016,240,10,0,2,0,0,1268,2648
4441,29,1257,120,4,1,1,0,0,1383,1032,242,9,0,2,0,0,1285,2668
4441,30,1229,167,2,0,2,0,0,1400,1006,322,8,0,0,1,0,1337,2737
4441,31,1198,236,7,3,1,0,0,1445,937,480,16,0,2,1,0,1436,2881
4441,32,1214,271,9,2,5,0,0,1501,859,494,21,2,5,0,0,1381,2882
4441,33,1112,383,4,1,1,0,0,1501,864,572,18,3,3,0,1,1461,2962
4441,34,1078,425,10,2,2,0,0,1517,861,598,22,4,7,0,0,1492,3009
4441,35,1057,474,17,4,1,0,0,1553,777,735,27,5,3,0,0,1547,3100
4441,36,936,568,18,0,4,0,0,1526,768,740,42,7,2,0,0,1559,3085
4441,37,874,606,32,4,2,0,0,1518,704,841,66,4,2,0,0,1617,3135
4441,38,900,635,33,2,3,0,0,1573,696,885,59,4,5,0,0,1649,3222
4441,39,906,688,43,1,5,0,0,1643,634,841,72,7,2,1,0,1557,3200
4441,40,827,818,42,1,2,0,0,1690,634,918,74,7,2,0,0,1635,3325
4441,41,807,810,54,6,5,1,0,1683,640,1018,94,11,3,0,0,1766,3449
4441,42,722,899,54,3,1,0,0,1679,600,1058,135,19,2,0,0,1814,3493
4441,43,720,996,66,8,2,0,0,1792,587,1165,112,16,5,1,0,1886,3678
4441,44,778,1042,86,5,1,0,0,1912,611,1184,143,21,3,0,0,1962,3874
4441,45,783,1123,96,8,3,0,0,2013,588,1244,159,23,2,0,0,2016,4029
4441,46,754,1172,118,7,4,0,0,2055,646,1353,156,31,1,0,0,2187,4242
4441,47,782,1146,119,9,4,0,0,2060,626,1359,181,31,2,0,0,2199,4259
4441,48,792,1327,146,8,3,0,0,2276,592,1514,227,35,4,1,0,2373,4649
4441,49,755,1429,146,11,9,0,0,2350,564,1568,218,47,5,0,0,2402,4752
4441,50,728,1460,164,7,5,0,0,2364,518,1597,265,53,3,0,0,2436,4800
4441,51,723,1465,181,19,3,0,0,2391,484,1515,264,52,4,0,0,2319,4710
4441,52,649,1523,196,22,2,0,0,2392,452,1718,284,54,3,0,0,2511,4903
4441,53,612,1565,195,21,1,0,1,2395,422,1621,284,59,2,0,1,2389,4784
4441,54,574,1651,208,21,2,0,0,2456,406,1718,251,68,3,0,0,2446,4902
4441,55,523,1528,208,13,3,0,0,2275,397,1714,266,94,3,0,0,2474,4749
4441,56,478,1591,188,17,5,0,0,2279,376,1703,285,85,3,0,0,2452,4731
4441,57,441,1621,219,27,3,0,0,2311,337,1693,292,102,6,0,0,2430,4741
4441,58,407,1672,221,31,4,0,0,2335,304,1661,281,109,2,0,0,2357,4692
4441,59,391,1719,237,41,0,0,0,2388,267,1805,290,131,2,0,0,2495,4883
4441,60,295,1656,205,23,6,0,0,2185,274,1684,260,137,2,0,0,2357,4542
4441,61,283,1642,216,42,4,1,0,2188,236,1589,258,149,0,0,0,2232,4420
4441,62,274,1622,151,45,1,0,1,2094,181,1639,241,191,1,0,0,2253,4347
4441,63,214,1564,206,45,0,0,0,2029,174,1620,186,195,0,0,0,2175,4204
4441,64,228,1535,159,42,1,0,0,1965,174,1501,207,203,1,0,0,2086,4051
4441,65,195,1458,149,59,1,0,0,1862,159,1420,183,229,1,0,0,1992,3854
4441,66,146,1427,138,55,1,0,0,1767,151,1435,166,273,0,0,0,2025,3792
4441,67,133,1382,135,59,0,0,0,1709,113,1330,161,264,1,0,0,1869,3578
4441,68,163,1385,118,72,1,0,0,1739,135,1281,154,303,1,0,0,1874,3613
4441,69,126,1322,97,81,1,0,0,1627,112,1256,126,307,1,0,0,1802,3429
4441,70,129,1254,97,80,0,0,0,1560,110,1137,127,344,0,0,0,1718,3278
4441,71,99,1251,89,91,2,0,0,1532,98,1219,142,312,0,0,0,1771,3303
4441,72,116,1290,98,89,0,0,0,1593,96,1150,108,384,1,0,0,1739,3332
4441,73,89,1258,92,109,0,0,0,1548,83,1065,113,430,1,0,0,1692,3240
4441,74,100,1219,75,115,1,0,0,1510,95,1135,81,455,1,0,0,1767,3277
4441,75,109,1311,69,134,0,0,0,1623,95,1187,99,513,0,0,0,1894,3517
4441,76,84,1370,56,131,1,0,0,1642,82,1138,113,591,0,0,0,1924,3566
4441,77,94,1264,43,166,0,0,0,1567,89,1102,83,646,0,0,0,1920,3487
4441,78,63,988,40,131,1,0,0,1223,65,785,58,594,0,0,0,1502,2725
4441,79,59,911,41,129,0,0,0,1140,52,724,58,635,0,0,0,1469,2609
4441,80,58,943,21,136,1,0,0,1159,58,710,51,641,0,0,0,1460,2619
4441,81,59,770,31,137,1,0,0,998,53,609,42,654,0,0,0,1358,2356
4441,82,50,754,22,162,1,0,0,989,54,579,47,702,0,0,0,1382,2371
4441,83,47,744,24,193,0,0,0,1008,60,526,47,842,0,0,0,1475,2483
4441,84,56,739,18,188,0,0,0,1001,52,436,31,819,0,0,0,1338,2339
4441,85,41,614,16,187,0,0,0,858,47,375,24,822,0,0,0,1268,2126
4441,86,39,548,15,191,0,0,0,793,63,286,28,839,0,0,0,1216,2009
4441,87,36,415,8,174,0,0,0,633,59,219,24,764,0,0,0,1066,1699
4441,88,26,399,8,142,0,0,0,575,45,175,16,724,0,0,0,960,1535
4441,89,21,296,5,149,1,0,0,472,37,114,9,653,0,0,0,813,1285
4441,90,14,215,4,117,0,0,0,350,31,77,10,572,0,0,0,690,1040
4441,91,25,169,1,92,0,0,0,287,28,62,8,546,0,0,0,644,931
4441,92,9,131,2,95,0,0,0,237,25,35,4,404,0,0,0,468,705
4441,93,1,104,3,80,0,0,0,188,19,33,6,396,0,0,0,454,642
4441,94,6,62,1,66,0,0,0,135,9,20,4,313,0,0,0,346,481
4441,95,6,46,0,45,0,0,0,97,14,14,1,251,0,0,0,280,377
4441,96,1,20,0,33,0,0,0,54,7,2,1,163,0,0,0,173,227
4441,97,2,16,0,24,0,0,0,42,8,6,0,129,0,0,0,143,185
4441,98,0,6,0,12,0,0,0,18,5,3,1,101,0,0,0,110,128
4441,99,1,5,0,11,0,0,0,17,3,3,1,65,0,0,0,72,89
4441,100,0,5,0,16,0,0,0,21,5,0,1,97,0,0,0,103,124
4441,999,65356,65472,5587,4253,115,2,2,140787,55898,66437,7918,18736,106,5,2,149102,289889
4480,0,1066,0,0,0,0,0,0,1066,960,0,0,0,0,0,0,960,2026
4480,1,1088,0,0,0,0,0,0,1088,1012,0,0,0,0,0,0,1012,2100
4480,2,1167,0,0,0,0,0,0,1167,1146,0,0,0,0,0,0,1146,2313
4480,3,1114,0,0,0,0,0,0,1114,1118,0,0,0,0,0,0,1118,2232
4480,4,1257,0,0,0,0,0,0,1257,1233,0,0,0,0,0,0,1233,2490
4480,5,1258,0,0,0,0,0,0,1258,1260,0,0,0,0,0,0,1260,2518
4480,6,1404,0,0,0,0,0,0,1404,1275,0,0,0,0,0,0,1275,2679
4480,7,1447,0,0,0,0,0,0,1447,1364,0,0,0,0,0,0,1364,2811
4480,8,1482,0,0,0,0,0,0,1482,1364,0,0,0,0,0,0,1364,2846
4480,9,1517,0,0,0,0,0,0,1517,1459,0,0,0,0,0,0,1459,2976
4480,10,1595,0,0,0,0,0,0,1595,1534,0,0,0,0,0,0,1534,3129
4480,11,1732,0,0,0,0,0,0,1732,1652,0,0,0,0,0,0,1652,3384
4480,12,1646,0,0,0,0,0,0,1646,1637,0,0,0,0,0,0,1637,3283
4480,13,1758,0,0,0,0,0,0,1758,1656,0,0,0,0,0,0,1656,3414
4480,14,1778,0,0,0,0,0,0,1778,1577,0,0,0,0,0,0,1577,3355
4480,15,1878,0,0,0,0,0,0,1878,1798,0,0,0,0,0,0,1798,3676
4480,16,1853,0,0,0,0,0,0,1853,1715,0,0,0,0,0,0,1715,3568
4480,17,1839,0,0,0,0,0,0,1839,1742,0,0,0,0,0,0,1742,3581
4480,18,1898,0,0,0,0,0,0,1898,1718,0,0,0,0,0,0,1718,3616
4480,19,1808,0,0,0,0,0,0,1808,1672,4,0,0,0,0,0,1676,3484
4480,20,1829,4,0,0,0,0,0,1833,1620,9,1,0,1,0,0,1631,3464
4480,21,1797,2,0,0,1,0,0,1800,1630,16,0,0,0,0,0,1646,3446
4480,22,1825,3,1,0,0,0,0,1829,1665,38,1,0,0,0,0,1704,3533
4480,23,1781,11,2,0,1,0,0,1795,1586,41,1,0,0,0,0,1628,3423
4480,24,1824,27,3,0,0,0,0,1854,1530,63,5,0,0,0,0,1598,3452
4480,25,1838,28,1,0,1,0,0,1868,1583,78,2,0,0,0,0,1663,3531
4480,26,1812,43,2,0,0,0,0,1857,1503,127,2,0,2,0,0,1634,3491
4480,27,1755,61,2,0,0,0,0,1818,1582,165,4,1,0,0,0,1752,3570
4480,28,1712,82,5,0,2,0,1,1802,1409,245,6,0,2,0,0,1662,3464
4480,29,1660,142,1,0,0,0,0,1803,1400,286,11,0,2,0,0,1699,3502
4480,30,1699,175,10,0,0,0,0,1884,1321,400,11,0,2,0,0,1734,3618
4480,31,1608,252,8,0,4,0,0,1872,1286,509,14,1,3,0,0,1813,3685
4480,32,1580,334,7,1,3,0,0,1925,1220,598,24,0,2,1,0,1845,3770
4480,33,1515,410,16,0,2,1,0,1944,1195,664,28,4,8,0,0,1899,3843
4480,34,1378,479,15,2,4,0,0,1878,1044,714,39,3,8,0,0,1808,3686
4480,35,1348,582,24,0,5,1,0,1960,1065,893,37,6,7,0,1,2009,3969
4480,36,1238,612,23,1,3,0,0,1877,904,924,56,0,11,0,0,1895,3772
4480,37,1201,715,32,1,3,2,0,1954,842,913,69,7,12,0,0,1843,3797
4480,38,1144,816,47,0,3,1,0,2011,919,1064,76,9,5,0,0,2073,4084
4480,39,1124,894,60,0,6,0,0,2084,822,1137,93,7,11,0,0,2070,4154
4480,40,1047,941,58,4,4,0,1,2055,823,1159,109,10,7,0,0,2108,4163
4480,41,1121,1017,64,1,10,0,0,2213,827,1288,114,12,6,0,0,2247,4460
4480,42,1059,1119,80,6,4,0,0,2268,771,1319,142,16,5,1,0,2254,4522
4480,43,1027,1165,109,6,0,1,0,2308,802,1448,148,25,6,3,0,2432,4740
4480,44,1033,1265,93,9,8,0,0,2408,766,1517,166,20,4,0,0,2473,4881
4480,45,1019,1387,101,4,9,0,1,2521,822,1642,198,25,6,1,0,2694,5215
4480,46,1109,1475,138,11,7,0,0,2740,760,1696,240,30,8,0,1,2735,5475
4480,47,1063,1608,161,8,8,0,0,2848,767,1812,240,38,6,1,0,2864,5712
4480,48,1122,1667,182,9,11,2,1,2994,829,1949,281,44,10,1,0,3114,6108
4480,49,1055,1775,198,16,6,0,0,3050,738,2055,298,55,6,0,0,3152,6202
4480,50,1033,1837,220,17,6,1,0,3114,691,2115,344,53,4,1,0,3208,6322
4480,51,927,1927,262,15,9,0,0,3140,651,2212,374,57,12,0,0,3306,6446
4480,52,882,1978,282,16,5,0,0,3163,655,2220,380,95,6,0,0,3356,6519
4480,53,903,1983,282,26,3,1,0,3198,563,2170,404,85,10,0,0,3232,6430
4480,54,791,2066,328,13,6,0,0,3204,557,2252,402,113,3,0,0,3327,6531
4480,55,722,2169,318,22,12,0,0,3243,540,2287,395,115,5,0,0,3342,6585
4480,56,701,2151,320,36,5,0,0,3213,484,2293,409,135,6,0,0,3327,6540
4480,57,684,2192,335,39,10,0,0,3260,485,2312,407,132,4,0,0,3340,6600
4480,58,623,2324,329,36,10,0,0,3322,483,2458,419,165,5,0,0,3530,6852
4480,59,567,2281,368,40,8,0,1,3265,430,2415,467,190,3,0,0,3505,6770
4480,60,508,2253,347,49,12,0,0,3169,319,2236,417,208,1,0,0,3181,6350
4480,61,481,2099,276,48,9,0,0,2913,327,2119,368,242,3,0,0,3059,5972
4480,62,422,2117,269,50,7,0,0,2865,309,2121,399,260,2,0,0,3091,5956
4480,63,389,2138,295,60,8,0,0,2890,275,2027,332,280,5,0,0,2919,5809
4480,64,343,1996,234,54,5,0,0,2632,230,2016,321,307,1,0,0,2875,5507
4480,65,293,1894,251,64,2,0,0,2504,229,1943,258,280,0,0,0,2710,5214
4480,66,269,1808,208,65,4,0,0,2354,209,1858,275,337,2,0,0,2681,5035
4480,67,258,1849,207,105,5,0,0,2424,173,1786,224,356,1,0,0,2540,4964
4480,68,239,1750,190,90,6,0,0,2275,152,1753,201,390,1,0,0,2497,4772
4480,69,213,1817,177,79,4,0,0,2290,163,1706,225,419,0,0,0,2513,4803
4480,70,185,1745,157,104,1,0,0,2192,160,1544,183,474,1,0,0,2362,4554
4480,71,190,1699,124,127,4,0,0,2144,142,1620,166,541,1,0,0,2470,4614
4480,72,156,1641,141,133,4,0,0,2075,106,1570,184,515,0,0,0,2375,4450
4480,73,154,1741,113,136,5,0,1,2150,123,1504,158,568,0,0,0,2353,4503
4480,74,156,1704,106,150,1,0,1,2118,117,1447,132,663,0,0,0,2359,4477
4480,75,182,1764,112,159,0,0,0,2217,147,1530,132,763,0,0,0,2572,4789
4480,76,177,1682,97,193,2,0,0,2151,123,1473,114,853,0,0,0,2563,4714
4480,77,156,1738,85,227,1,0,0,2207,104,1401,104,972,1,0,0,2582,4789
4480,78,108,1205,60,188,2,0,0,1563,84,978,85,728,0,0,0,1875,3438
4480,79,125,1253,58,157,0,0,0,1593,99,939,74,903,1,0,0,2016,3609
4480,80,91,1164,47,214,0,0,0,1516,85,838,67,894,2,0,0,1886,3402
4480,81,101,1037,37,211,4,0,0,1390,94,795,69,954,0,0,0,1912,3302
4480,82,90,1092,29,229,2,0,0,1442,86,698,57,1057,1,0,0,1899,3341
4480,83,104,979,30,246,1,0,0,1360,89,655,52,1166,0,0,0,1962,3322
4480,84,89,905,28,198,0,0,0,1220,91,580,36,1128,1,0,0,1836,3056
4480,85,66,845,19,286,0,0,0,1216,76,492,34,1144,2,0,0,1748,2964
4480,86,75,646,21,221,0,0,0,963,70,356,31,1036,1,0,0,1494,2457
4480,87,58,509,19,231,1,0,0,818,71,258,32,910,0,0,0,1271,2089
4480,88,38,458,10,240,0,0,0,746,69,202,31,934,0,0,0,1236,1982
4480,89,29,341,16,171,0,0,0,557,57,154,14,817,0,0,0,1042,1599
4480,90,30,268,4,154,0,0,0,456,60,107,8,725,0,0,0,900,1356
4480,91,18,204,4,145,0,0,0,371,59,86,10,641,0,0,0,796,1167
4480,92,13,153,0,105,0,0,0,271,59,56,10,558,0,0,0,683,954
4480,93,18,113,4,103,0,0,0,238,36,33,6,489,0,0,0,564,802
4480,94,9,40,4,74,0,0,0,127,29,23,5,376,0,0,0,433,560
4480,95,6,35,2,48,0,0,0,91,24,11,3,294,0,0,0,332,423
4480,96,3,18,1,39,0,0,0,61,25,11,4,202,0,0,0,242,303
4480,97,3,13,1,24,0,0,0,41,15,2,1,143,0,0,0,161,202
4480,98,5,12,0,10,0,0,0,27,14,2,2,111,0,0,0,129,156
4480,99,1,8,0,12,0,0,0,21,10,1,1,80,0,0,0,92,113
4480,100,3,8,1,21,0,0,0,33,11,6,2,97,0,0,0,116,149
4480,999,86595,84740,8271,5559,269,10,7,185451,73183,86444,11244,25268,225,9,2,196375,381826
4497,0,2976,0,0,0,0,0,0,2976,2936,0,0,0,0,0,0,2936,5912
4497,1,3273,0,0,0,0,0,0,3273,3022,0,0,0,0,0,0,3022,6295
4497,2,3297,0,0,0,0,0,0,3297,3189,0,0,0,0,0,0,3189,6486
4497,3,3370,0,0,0,0,0,0,3370,3073,0,0,0,0,0,0,3073,6443
4497,4,3392,0,0,0,0,0,0,3392,3223,0,0,0,0,0,0,3223,6615
4497,5,3565,0,0,0,0,0,0,3565,3484,0,0,0,0,0,0,3484,7049
4497,6,3788,0,0,0,0,0,0,3788,3598,0,0,0,0,0,0,3598,7386
4497,7,3874,0,0,0,0,0,0,3874,3713,0,0,0,0,0,0,3713,7587
4497,8,4009,0,0,0,0,0,0,4009,3663,0,0,0,0,0,0,3663,7672
4497,9,4221,0,0,0,0,0,0,4221,4029,0,0,0,0,0,0,4029,8250
4497,10,4260,0,0,0,0,0,0,4260,3991,0,0,0,0,0,0,3991,8251
4497,11,4479,0,0,0,0,0,0,4479,4267,0,0,0,0,0,0,4267,8746
4497,12,4495,0,0,0,0,0,0,4495,4206,0,0,0,0,0,0,4206,8701
4497,13,4706,0,0,0,0,0,0,4706,4358,0,0,0,0,0,0,4358,9064
4497,14,4679,0,0,0,0,0,0,4679,4504,0,0,0,0,0,0,4504,9183
4497,15,5015,0,0,0,0,0,0,5015,4413,0,0,0,0,0,0,4413,9428
4497,16,4893,0,0,0,0,0,0,4893,4424,0,0,0,0,0,0,4424,9317
4497,17,4875,0,0,0,0,0,0,4875,4507,0,1,0,0,0,0,4508,9383
4497,18,4946,0,0,0,0,0,0,4946,4632,2,0,0,0,0,0,4634,9580
4497,19,5181,0,0,0,0,0,0,5181,4526,9,0,0,0,0,0,4535,9716
4497,20,5039,0,0,0,0,0,0,5039,4446,23,0,0,0,0,0,4469,9508
4497,21,4939,5,0,0,1,0,0,4945,4544,51,0,0,0,0,0,4595,9540
4497,22,4886,10,2,0,0,0,0,4898,4453,66,2,0,0,0,0,4521,9419
4497,23,5139,19,2,0,1,0,0,5161,4433,118,4,0,0,0,0,4555,9716
4497,24,4941,40,4,0,1,0,0,4986,4251,173,4,0,0,0,0,4428,9414
4497,25,5065,87,8,0,0,0,0,5160,4293,254,7,0,0,0,0,4554,9714
4497,26,5005,123,7,0,1,0,0,5136,4294,324,7,0,1,0,0,4626,9762
4497,27,4750,169,9,1,1,0,0,4930,4155,438,6,1,2,1,0,4603,9533
4497,28,4636,266,8,0,5,0,0,4915,4138,628,13,1,4,0,0,4784,9699
4497,29,4554,366,17,0,1,1,0,4939,3959,801,23,0,2,0,0,4785,9724
4497,30,4506,466,20,0,9,0,0,5001,3777,940,34,2,14,2,0,4769,9770
4497,31,4484,682,12,0,4,1,0,5183,3884,1272,30,3,8,1,0,5198,10381
4497,32,4262,813,24,1,11,0,0,5111,3695,1417,65,3,10,1,0,5191,10302
4497,33,4324,1075,36,2,9,0,0,5446,3493,1678,57,4,11,0,0,5243,10689
4497,34,4003,1229,32,4,9,0,0,5277,3426,1958,80,8,7,0,0,5479,10756
4497,35,3860,1613,55,3,9,0,0,5540,3234,2199,86,8,12,1,0,5540,11080
4497,36,3618,1738,56,4,10,1,0,5427,2955,2224,110,17,17,0,0,5323,10750
4497,37,3299,1786,63,5,14,0,0,5167,2822,2440,166,26,15,2,0,5471,10638
4497,38,3367,2035,90,2,16,1,0,5511,2739,2664,174,33,11,2,0,5623,11134
4497,39,3124,2247,100,8,13,0,0,5492,2740,2801,215,22,9,1,0,5788,11280
4497,40,3152,2411,133,7,14,1,0,5718,2667,3014,222,29,17,0,0,5949,11667
4497,41,3081,2642,126,11,15,0,0,5875,2525,3040,241,28,13,0,0,5847,11722
4497,42,2995,2775,171,14,14,2,0,5971,2461,3241,263,45,14,1,0,6025,11996
4497,43,2831,2835,197,18,16,1,0,5898,2450,3298,297,49,6,0,0,6100,11998
4497,44,2805,3099,212,23,18,0,0,6157,2476,3476,332,83,11,0,0,6378,12535
4497,45,2914,3315,226,21,12,1,0,6489,2560,3764,426,89,13,1,0,6853,13342
4497,46,2858,3609,269,27,9,0,1,6773,2473,3972,455,77,11,0,0,6988,13761
4497,47,3003,3644,313,32,12,0,0,7004,2493,4312,500,94,12,2,0,7413,14417
4497,48,3120,3897,374,24,17,0,0,7432,2491,4536,573,105,14,0,0,7719,15151
4497,49,3105,4332,420,33,20,1,0,7911,2533,5077,631,108,11,0,0,8360,16271
4497,50,2913,4426,442,29,13,1,0,7824,2597,5038,663,152,11,0,1,8462,16286
4497,51,2654,4774,474,42,21,1,0,7966,2307,5146,759,149,13,0,0,8374,16340
4497,52,2580,4882,527,43,7,1,0,8040,2229,5352,785,197,7,2,0,8572,16612
4497,53,2476,4903,540,56,18,1,0,7994,2005,5219,793,198,3,0,0,8218,16212
4497,54,2331,5079,605,61,21,1,1,8099,2006,5383,832,191,8,0,0,8420,16519
4497,55,2145,5142,609,58,18,1,0,7973,1900,5350,841,236,8,0,0,8335,16308
4497,56,2020,5221,649,74,14,1,0,7979,1730,5631,865,292,3,1,1,8523,16502
4497,57,1968,5428,664,88,19,0,0,8167,1636,5615,881,308,7,0,0,8447,16614
4497,58,1741,5483,653,93,14,0,0,7984,1549,5717,904,300,4,0,0,8474,16458
4497,59,1625,5508,648,103,18,0,0,7902,1453,5588,907,350,2,1,1,8302,16204
4497,60,1384,5167,589,102,13,2,0,7257,1292,5210,845,367,4,0,0,7718,14975
4497,61,1203,5023,659,99,25,0,0,7009,1118,5096,772,430,2,0,0,7418,14427
4497,62,1144,4855,590,132,13,0,0,6734,1064,4795,734,484,10,0,0,7087,13821
4497,63,962,4891,571,137,12,0,0,6573,969,4877,749,475,6,0,0,7076,13649
4497,64,863,4773,558,145,12,0,2,6353,913,4745,714,539,4,0,0,6915,13268
4497,65,756,4582,454,161,12,0,1,5966,826,4483,649,597,4,0,1,6560,12526
4497,66,679,4455,449,171,9,0,0,5763,757,4354,624,636,4,0,0,6375,12138
4497,67,645,4200,394,199,14,0,1,5453,692,4287,589,715,2,0,1,6286,11739
4497,68,608,4207,374,217,11,0,0,5417,649,4120,556,819,2,0,0,6146,11563
4497,69,518,4199,392,212,8,0,1,5330,594,4207,511,854,1,0,1,6168,11498
4497,70,502,3995,312,234,7,0,0,5050,530,3817,459,871,1,0,0,5678,10728
4497,71,443,3910,293,232,10,0,0,4888,457,3882,416,970,3,0,0,5728,10616
4497,72,406,3969,279,276,3,0,0,4933,400,3819,427,1072,2,0,0,5720,10653
4497,73,390,4003,276,297,2,0,0,4968,410,3844,405,1216,3,0,0,5878,10846
4497,74,373,4171,253,347,8,0,0,5152,404,3959,381,1452,0,0,0,6196,11348
4497,75,352,4420,258,381,4,0,0,5415,391,4022,389,1697,1,1,0,6501,11916
4497,76,330,4286,229,449,4,0,0,5298,364,3916,371,1866,1,0,0,6518,11816
4497,77,311,4223,192,523,7,0,1,5257,368,3683,355,2003,0,0,0,6409,11666
4497,78,236,3178,157,429,2,0,0,4002,273,2810,256,1741,0,0,0,5080,9082
4497,79,207,3141,129,478,4,0,0,3959,288,2538,218,1841,0,0,0,4885,8844
4497,80,207,3032,97,484,3,0,0,3823,262,2487,214,2048,0,0,0,5011,8834
4497,81,199,2674,108,470,4,0,0,3455,283,2060,188,2098,0,0,0,4629,8084
4497,82,227,2607,102,501,2,0,0,3439,254,2139,179,2282,0,0,0,4854,8293
4497,83,200,2817,87,626,1,0,1,3732,288,2032,168,2720,0,0,0,5208,8940
4497,84,202,2576,74,675,1,0,0,3528,241,1807,165,2797,0,0,0,5010,8538
4497,85,159,2314,66,673,1,0,0,3213,265,1487,119,2827,0,0,0,4698,7911
4497,86,136,1802,68,615,0,0,0,2621,241,1100,104,2637,0,0,0,4082,6703
4497,87,101,1416,31,538,0,0,0,2086,207,823,81,2418,0,0,0,3529,5615
4497,88,101,1383,34,502,0,0,0,2020,194,706,71,2317,0,0,0,3288,5308
4497,89,62,1034,32,452,0,0,0,1580,172,514,53,2154,0,0,0,2893,4473
4497,90,70,861,13,427,1,0,0,1372,124,366,26,1962,0,0,0,2478,3850
4497,91,56,612,8,388,0,0,0,1064,148,237,41,1739,0,0,0,2165,3229
4497,92,43,509,12,308,1,0,0,873,111,173,29,1543,0,0,0,1856,2729
4497,93,39,349,7,264,1,0,0,660,102,125,32,1332,0,0,0,1591,2251
4497,94,24,251,7,218,0,0,0,500,88,76,16,1092,0,0,0,1272,1772
4497,95,15,167,3,179,0,0,0,364,72,50,15,848,0,0,0,985,1349
4497,96,13,114,1,127,0,0,0,255,63,29,9,661,1,0,0,763,1018
4497,97,6,50,0,91,0,0,0,147,41,13,6,456,0,0,0,516,663
4497,98,7,23,1,61,0,0,0,92,31,10,5,324,0,0,0,370,462
4497,99,4,16,1,42,0,0,0,63,25,6,3,226,0,0,0,260,323
4497,100,4,23,1,67,0,0,0,95,31,7,3,397,0,0,0,438,533
4497,999,237599,208452,16958,13816,620,19,9,477473,214032,212960,25201,58731,362,20,6,511312,988785
4534,0,881,0,0,0,0,0,0,881,840,0,0,0,0,0,0,840,1721
4534,1,925,0,0,0,0,0,0,925,925,0,0,0,0,0,0,925,1850
4534,2,984,0,0,0,0,0,0,984,906,0,0,0,0,0,0,906,1890
4534,3,952,0,0,0,0,0,0,952,908,0,0,0,0,0,0,908,1860
4534,4,984,0,0,0,0,0,0,984,1018,0,0,0,0,0,0,1018,2002
4534,5,1100,0,0,0,0,0,0,1100,1081,0,0,0,0,0,0,1081,2181
4534,6,1140,0,0,0,0,0,0,1140,1154,0,0,0,0,0,0,1154,2294
4534,7,1196,0,0,0,0,0,0,1196,1124,0,0,0,0,0,0,1124,2320
4534,8,1239,0,0,0,0,0,0,1239,1186,0,0,0,0,0,0,1186,2425
4534,9,1293,0,0,0,0,0,0,1293,1240,0,0,0,0,0,0,1240,2533
4534,10,1305,0,0,0,0,0,0,1305,1254,0,0,0,0,0,0,1254,2559
4534,11,1373,0,0,0,0,0,0,1373,1394,0,0,0,0,0,0,1394,2767
4534,12,1417,0,0,0,0,0,0,1417,1365,0,0,0,0,0,0,1365,2782
4534,13,1503,0,0,0,0,0,0,1503,1399,0,0,0,0,0,0,1399,2902
4534,14,1518,0,0,0,0,0,0,1518,1449,0,0,0,0,0,0,1449,2967
4534,15,1543,0,0,0,0,0,0,1543,1428,0,0,0,0,0,0,1428,2971
4534,16,1596,0,0,0,0,0,0,1596,1462,0,0,0,0,0,0,1462,3058
4534,17,1571,0,0,0,0,0,0,1571,1476,0,0,0,0,0,0,1476,3047
4534,18,1539,0,0,0,0,0,0,1539,1396,3,0,0,0,0,0,1399,2938
4534,19,1638,0,0,0,0,0,0,1638,1437,2,0,0,0,0,0,1439,3077
4534,20,1485,2,0,0,0,0,0,1487,1388,8,0,0,0,0,0,1396,2883
4534,21,1471,0,0,0,0,0,0,1471,1355,14,0,0,0,0,0,1369,2840
4534,22,1490,5,0,0,0,0,0,1495,1407,23,1,0,0,0,0,1431,2926
4534,23,1516,10,0,0,0,0,0,1526,1309,34,0,0,1,0,0,1344,2870
4534,24,1542,18,0,0,0,0,0,1560,1245,66,0,0,1,0,0,1312,2872
4534,25,1487,28,2,0,2,0,0,1519,1285,81,2,0,1,0,0,1369,2888
4534,26,1559,28,1,0,1,0,0,1589,1250,117,0,0,2,0,0,1369,2958
4534,27,1409,56,0,0,0,0,0,1465,1157,166,2,1,0,0,0,1326,2791
4534,28,1410,86,4,0,1,0,0,1501,1174,214,7,0,1,0,0,1396,2897
4534,29,1418,118,1,0,0,0,0,1537,1122,271,6,0,1,0,0,1400,2937
4534,30,1352,163,5,0,2,0,0,1522,1027,335,9,0,2,0,0,1373,2895
4534,31,1332,252,7,0,1,1,0,1593,1014,425,14,0,4,1,0,1458,3051
4534,32,1274,315,4,1,1,0,0,1595,958,493,24,1,2,1,0,1479,3074
4534,33,1285,383,11,3,3,0,0,1685,956,561,38,1,0,0,0,1556,3241
4534,34,1195,421,17,0,3,1,0,1637,867,618,25,3,5,0,0,1518,3155
4534,35,1140,502,15,0,3,0,0,1660,827,730,40,4,3,0,0,1604,3264
4534,36,973,536,16,1,6,0,0,1532,832,750,39,13,11,0,0,1645,3177
4534,37,921,604,23,1,3,0,0,1552,743,774,41,6,5,0,0,1569,3121
4534,38,974,676,48,1,2,0,0,1701,789,803,69,13,2,0,0,1676,3377
4534,39,899,690,41,4,5,0,0,1639,722,867,77,7,5,0,0,1678,3317
4534,40,873,832,41,3,3,0,0,1752,683,955,97,14,3,0,0,1752,3504
4534,41,992,857,62,2,1,0,0,1914,748,965,100,12,8,0,0,1833,3747
4534,42,867,846,62,4,3,0,0,1782,719,1027,123,14,2,0,0,1885,3667
4534,43,916,951,84,9,6,0,0,1966,708,1127,106,18,3,0,0,1962,3928
4534,44,902,1043,73,2,4,1,0,2025,703,1238,140,15,2,0,0,2098,4123
4534,45,1009,1153,91,6,7,0,0,2266,733,1309,160,14,2,0,0,2218,4484
4534,46,908,1217,119,8,3,0,0,2255,715,1394,193,22,3,0,0,2327,4582
4534,47,930,1259,150,11,3,0,0,2353,723,1477,214,24,0,0,0,2438,4791
4534,48,926,1396,161,9,1,0,0,2493,725,1582,244,31,5,1,0,2588,5081
4534,49,967,1536,201,11,4,0,0,2719,711,1709,274,52,3,0,0,2749,5468
4534,50,899,1586,230,17,3,0,0,2735,666,1793,295,41,3,0,0,2798,5533
4534,51,845,1608,219,18,2,0,0,2692,640,1893,329,45,2,0,0,2909,5601
4534,52,794,1710,237,18,2,0,0,2761,563,1792,340,59,3,1,0,2758,5519
4534,53,768,1712,268,14,3,0,0,2765,529,1784,371,67,1,0,0,2752,5517
4534,54,656,1790,280,18,4,1,0,2749,430,1920,356,87,2,0,0,2795,5544
4534,55,654,1703,255,26,7,0,0,2645,455,1919,365,96,3,0,1,2839,5484
4534,56,600,1792,287,23,4,0,0,2706,414,1915,389,111,4,0,0,2833,5539
4534,57,509,1834,311,24,4,0,0,2682,413,1968,406,117,1,0,0,2905,5587
4534,58,506,1833,316,41,7,0,0,2703,389,1957,423,106,4,0,0,2879,5582
4534,59,442,2030,330,52,6,0,0,2860,388,1981,421,141,4,0,0,2935,5795
4534,60,372,1915,329,54,3,0,0,2673,310,1929,416,160,4,0,0,2819,5492
4534,61,371,1852,290,41,2,0,0,2556,275,1862,321,174,1,0,0,2633,5189
4534,62,292,1804,274,52,4,0,0,2426,284,1824,331,217,5,0,0,2661,5087
4534,63,252,1690,247,48,8,1,0,2246,233,1706,294,223,4,0,0,2460,4706
4534,64,233,1653,211,65,3,0,0,2165,221,1617,299,246,0,0,0,2383,4548
4534,65,252,1567,193,48,2,0,0,2062,180,1596,312,256,4,0,0,2348,4410
4534,66,187,1684,210,62,1,0,0,2144,178,1596,246,286,3,0,0,2309,4453
4534,67,184,1644,165,74,1,0,0,2068,166,1588,209,365,1,0,1,2330,4398
4534,68,170,1610,182,70,1,0,0,2033,139,1552,219,361,0,0,1,2272,4305
4534,69,144,1473,129,95,1,0,0,1842,136,1556,199,364,1,0,0,2256,4098
4534,70,118,1472,147,94,0,0,0,1831,107,1388,195,366,1,0,0,2057,3888
4534,71,128,1491,130,84,1,0,0,1834,104,1396,130,388,2,0,0,2020,3854
4534,72,110,1431,101,86,1,0,0,1729,100,1306,117,448,0,0,0,1971,3700
4534,73,108,1450,108,118,1,0,0,1785,98,1316,138,480,1,0,0,2033,3818
4534,74,100,1579,101,143,1,0,0,1924,108,1346,129,559,0,0,0,2142,4066
4534,75,83,1635,87,165,3,0,0,1973,81,1416,157,658,0,0,0,2312,4285
4534,76,90,1595,108,195,2,1,0,1991,80,1378,144,758,0,0,0,2360,4351
4534,77,78,1667,73,197,0,0,0,2015,96,1456,139,865,1,0,0,2557,4572
4534,78,70,1279,60,161,1,0,0,1571,61,1060,103,719,0,0,0,1943,3514
4534,79,49,1198,64,186,0,0,0,1497,66,951,74,793,0,0,0,1884,3381
4534,80,38,1060,42,203,1,0,0,1344,66,844,66,745,0,0,0,1721,3065
4534,81,54,1038,38,195,0,0,0,1325,54,766,69,827,0,0,0,1716,3041
4534,82,51,931,32,196,2,0,1,1213,73,693,53,884,0,0,0,1703,2916
4534,83,51,955,30,219,1,0,0,1256,73,628,57,975,1,0,0,1734,2990
4534,84,45,901,18,209,0,0,0,1173,59,534,49,1029,0,0,0,1671,2844
4534,85,34,855,25,248,0,0,0,1162,55,482,36,1035,0,0,0,1608,2770
4534,86,29,688,21,198,0,0,0,936,46,360,30,930,0,0,0,1366,2302
4534,87,26,495,6,169,0,0,0,696,53,256,18,845,0,0,0,1172,1868
4534,88,28,430,16,199,0,0,0,673,46,168,22,833,0,0,0,1069,1742
4534,89,23,315,10,157,0,0,0,505,43,133,10,700,0,0,0,886,1391
4534,90,18,267,4,139,0,0,0,428,31,90,13,632,0,0,0,766,1194
4534,91,7,227,2,107,0,0,0,343,37,58,8,599,0,0,0,702,1045
4534,92,7,137,3,128,0,0,0,275,33,42,10,484,0,0,0,569,844
4534,93,6,98,2,94,0,0,0,200,25,27,2,447,0,0,0,501,701
4534,94,9,69,1,79,0,0,0,158,25,12,2,339,0,0,0,378,536
4534,95,3,38,1,70,0,0,0,112,21,10,3,263,0,0,0,297,409
4534,96,2,35,1,37,0,0,0,75,17,4,0,163,0,0,0,184,259
4534,97,1,8,0,25,0,0,0,34,9,5,1,124,0,0,0,139,173
4534,98,0,10,0,21,0,0,0,31,6,1,0,78,0,0,0,85,116
4534,99,0,8,1,17,0,0,0,26,6,5,0,70,0,0,0,81,107
4534,100,3,5,0,16,0,0,0,24,6,4,1,98,0,0,0,109,133
4534,999,71618,73840,7434,5091,150,6,1,158140,61731,74021,10362,21921,133,4,3,168175,326315
4566,0,1390,0,0,0,0,0,0,1390,1255,0,0,0,0,0,0,1255,2645
4566,1,1348,0,0,0,0,0,0,1348,1265,0,0,0,0,0,0,1265,2613
4566,2,1441,0,0,0,0,0,0,1441,1328,0,0,0,0,0,0,1328,2769
4566,3,1477,0,0,0,0,0,0,1477,1358,0,0,0,0,0,0,1358,2835
4566,4,1437,0,0,0,0,0,0,1437,1438,0,0,0,0,0,0,1438,2875
4566,5,1560,0,0,0,0,0,0,1560,1516,0,0,0,0,0,0,1516,3076
4566,6,1657,0,0,0,0,0,0,1657,1553,0,0,0,0,0,0,1553,3210
4566,7,1726,0,0,0,0,0,0,1726,1647,0,0,0,0,0,0,1647,3373
4566,8,1825,0,0,0,0,0,0,1825,1663,0,0,0,0,0,0,1663,3488
4566,9,1833,0,0,0,0,0,0,1833,1831,0,0,0,0,0,0,1831,3664
4566,10,1853,0,0,0,0,0,0,1853,1816,0,0,0,0,0,0,1816,3669
4566,11,1936,0,0,0,0,0,0,1936,1798,0,0,0,0,0,0,1798,3734
4566,12,1954,0,0,0,0,0,0,1954,1882,0,0,0,0,0,0,1882,3836
4566,13,2039,0,0,0,0,0,0,2039,1967,0,0,0,0,0,0,1967,4006
4566,14,2030,0,0,0,0,0,0,2030,1931,0,0,0,0,0,0,1931,3961
4566,15,2080,0,0,0,0,0,0,2080,1949,0,0,0,0,0,0,1949,4029
4566,16,2065,1,0,0,0,0,0,2066,1925,0,0,0,0,0,0,1925,3991
4566,17,2000,0,0,0,0,0,0,2000,1846,0,0,0,0,0,0,1846,3846
4566,18,2063,0,0,0,0,0,0,2063,1815,2,0,0,0,0,0,1817,3880
4566,19,2065,0,0,0,0,0,0,2065,1851,6,0,0,0,0,0,1857,3922
4566,20,1988,2,0,0,0,0,0,1990,1796,18,0,0,0,0,0,1814,3804
4566,21,2044,2,0,0,2,0,0,2048,1768,34,0,0,0,0,0,1802,3850
4566,22,2014,9,0,0,0,0,0,2023,1748,37,3,0,0,0,0,1788,3811
4566,23,2079,18,0,0,0,0,0,2097,1823,62,0,0,1,0,0,1886,3983
4566,24,2047,30,3,0,1,0,0,2081,1729,99,4,1,0,0,0,1833,3914
4566,25,2049,51,3,0,0,0,0,2103,1658,122,3,0,1,0,0,1784,3887
4566,26,2080,52,3,1,0,0,0,2136,1734,185,9,0,1,0,0,1929,4065
4566,27,2028,68,4,0,1,0,0,2101,1689,214,5,0,3,1,0,1912,4013
4566,28,2006,132,1,0,2,0,0,2141,1693,325,4,0,2,0,0,2024,4165
4566,29,2000,140,5,0,3,0,0,2148,1584,415,3,3,2,1,0,2008,4156
4566,30,1931,270,5,1,4,0,0,2211,1560,532,4,2,5,0,0,2103,4314
4566,31,1996,365,8,1,1,0,0,2371,1573,638,14,1,2,0,0,2228,4599
4566,32,1863,440,5,0,4,0,0,2312,1402,731,20,3,6,0,0,2162,4474
4566,33,1868,554,15,3,8,0,0,2448,1429,861,36,3,7,0,0,2336,4784
4566,34,1647,650,21,0,5,0,0,2323,1302,928,37,1,3,1,0,2272,4595
4566,35,1595,736,23,1,3,0,0,2358,1145,1056,40,8,6,0,0,2255,4613
4566,36,1458,782,25,2,6,0,0,2273,1125,1011,44,2,4,0,0,2186,4459
4566,37,1325,831,37,2,7,1,0,2203,1039,1156,82,13,4,0,0,2294,4497
4566,38,1338,972,41,3,3,2,0,2359,1063,1246,91,6,13,2,0,2421,4780
4566,39,1283,1105,46,4,3,0,0,2441,1023,1322,79,10,2,0,0,2436,4877
4566,40,1191,1163,60,1,7,0,0,2422,968,1446,91,13,5,0,0,2523,4945
4566,41,1269,1336,63,3,7,0,0,2678,921,1393,116,14,5,1,0,2450,5128
4566,42,1242,1381,82,9,9,0,0,2723,889,1541,139,28,7,0,0,2604,5327
4566,43,1200,1395,91,16,9,0,0,2711,909,1609,156,21,11,1,0,2707,5418
4566,44,1222,1536,112,7,7,0,0,2884,884,1739,158,30,5,2,0,2818,5702
4566,45,1215,1636,120,9,3,1,0,2984,890,1889,215,33,7,0,0,3034,6018
4566,46,1222,1740,153,9,14,0,0,3138,922,1830,228,34,3,0,0,3017,6155
4566,47,1213,1819,169,19,9,0,0,3229,883,2147,230,58,7,0,0,3325,6554
4566,48,1144,1976,162,17,9,0,1,3309,855,2152,269,51,1,0,0,3328,6637
4566,49,1254,2098,187,13,2,0,0,3554,882,2441,302,55,5,0,0,3685,7239
4566,50,1047,2159,229,25,5,0,0,3465,807,2344,300,58,5,0,0,3514,6979
4566,51,1028,2346,231,16,5,1,0,3627,739,2286,369,64,3,0,0,3461,7088
4566,52,933,2311,209,15,6,0,0,3474,706,2419,366,82,6,1,0,3580,7054
4566,53,877,2135,278,14,6,0,1,3311,640,2263,324,83,0,0,0,3310,6621
4566,54,802,2302,294,25,4,0,0,3427,560,2371,376,103,4,0,0,3414,6841
4566,55,744,2245,254,23,3,0,0,3269,532,2326,359,124,5,0,0,3346,6615
4566,56,677,2311,287,33,6,0,0,3314,507,2387,369,147,4,0,1,3415,6729
4566,57,612,2334,321,37,4,0,0,3308,456,2401,371,153,3,0,0,3384,6692
4566,58,649,2300,304,40,5,0,0,3298,428,2369,369,147,1,0,0,3314,6612
4566,59,510,2392,315,42,4,0,0,3263,402,2548,360,162,3,0,0,3475,6738
4566,60,466,2244,248,52,3,0,0,3013,380,2372,352,165,4,0,0,3273,6286
4566,61,392,2175,238,53,4,0,0,2862,311,2353,325,207,2,0,0,3198,6060
4566,62,352,2196,263,52,8,0,0,2871,295,2263,317,259,1,0,0,3135,6006
4566,63,335,2168,243,77,3,0,0,2826,283,2144,308,256,1,0,0,2992,5818
4566,64,294,2196,231,98,3,0,0,2822,230,2089,223,291,2,0,0,2835,5657
4566,65,268,2065,222,68,10,1,0,2634,215,1998,244,315,0,0,0,2772,5406
4566,66,239,1996,150,86,3,0,0,2474,230,1923,224,353,0,0,0,2730,5204
4566,67,205,1956,168,103,7,0,0,2439,190,1921,188,417,1,0,0,2717,5156
4566,68,203,1876,153,103,3,0,0,2338,164,1855,179,362,1,0,0,2561,4899
4566,69,175,1890,125,101,1,0,0,2292,147,1867,181,440,2,0,0,2637,4929
4566,70,179,1754,138,123,2,0,0,2196,154,1700,155,445,1,0,0,2455,4651
4566,71,154,1738,108,111,2,0,0,2113,123,1665,150,475,0,0,0,2413,4526
4566,72,125,1738,88,143,2,0,0,2096,109,1595,134,461,2,0,1,2302,4398
4566,73,122,1763,109,145,1,0,0,2140,129,1691,132,602,3,0,0,2557,4697
4566,74,124,1829,101,161,3,0,0,2218,122,1643,156,665,1,0,0,2587,4805
4566,75,135,1884,87,210,2,0,0,2318,105,1693,131,752,0,0,0,2681,4999
4566,76,104,1832,78,202,0,0,0,2216,118,1684,122,783,0,0,0,2707,4923
4566,77,106,1829,75,222,0,0,0,2232,107,1576,119,965,1,0,0,2768,5000
4566,78,85,1405,50,207,0,0,0,1747,89,1124,74,798,0,0,0,2085,3832
4566,79,65,1304,41,182,0,0,0,1592,86,977,70,906,1,0,0,2040,3632
4566,80,61,1251,36,192,0,0,0,1540,75,956,71,943,0,0,0,2045,3585
4566,81,66,1125,36,206,1,0,0,1434,68,889,45,922,0,0,0,1924,3358
4566,82,63,1005,30,209,1,0,0,1308,64,726,46,972,0,0,0,1808,3116
4566,83,67,1121,23,247,0,0,0,1458,74,731,46,1173,0,0,0,2024,3482
4566,84,63,1006,23,235,1,0,0,1328,68,630,41,1127,0,0,0,1866,3194
4566,85,49,913,19,280,0,0,0,1261,67,528,26,1241,0,0,0,1862,3123
4566,86,42,737,19,258,0,0,0,1056,54,373,23,1143,0,0,0,1593,2649
4566,87,38,576,11,228,0,0,0,853,54,287,16,994,0,0,0,1351,2204
4566,88,29,541,8,238,0,0,0,816,49,217,8,925,0,0,0,1199,2015
4566,89,33,408,9,167,1,0,0,618,50,148,19,861,0,0,0,1078,1696
4566,90,14,301,5,173,0,0,0,493,31,88,17,772,0,0,0,908,1401
4566,91,18,205,2,140,0,0,0,365,30,74,7,661,0,0,0,772,1137
4566,92,7,165,4,130,0,0,0,306,41,33,5,586,0,0,0,665,971
4566,93,11,111,3,113,0,0,0,238,31,40,4,476,0,0,0,551,789
4566,94,3,61,2,80,0,0,0,146,21,21,3,393,0,0,0,438,584
4566,95,4,50,1,61,0,0,0,116,13,12,3,298,0,0,0,326,442
4566,96,2,34,0,46,0,0,0,82,11,7,2,185,0,0,0,205,287
4566,97,3,18,0,33,0,0,0,54,9,10,3,144,0,0,0,166,220
4566,98,1,6,0,15,0,0,0,22,4,1,0,108,0,0,0,113,135
4566,99,0,2,0,14,0,0,0,16,5,0,0,80,0,0,0,85,101
4566,100,1,4,0,22,0,0,0,27,8,4,1,107,0,0,0,120,147
4566,999,97172,93603,7313,5977,238,6,2,204311,82711,94809,10115,25541,175,10,2,213363,417674
4583,0,1026,0,0,0,0,0,0,1026,920,0,0,0,0,0,0,920,1946
4583,1,1038,0,0,0,0,0,0,1038,985,0,0,0,0,0,0,985,2023
4583,2,1110,0,0,0,0,0,0,1110,1121,0,0,0,0,0,0,1121,2231
4583,3,1150,0,0,0,0,0,0,1150,1059,0,0,0,0,0,0,1059,2209
4583,4,1174,0,0,0,0,0,0,1174,1071,0,0,0,0,0,0,1071,2245
4583,5,1149,0,0,0,0,0,0,1149,1126,0,0,0,0,0,0,1126,2275
4583,6,1272,0,0,0,0,0,0,1272,1177,0,0,0,0,0,0,1177,2449
4583,7,1323,0,0,0,0,0,0,1323,1279,0,0,0,0,0,0,1279,2602
4583,8,1323,0,0,0,0,0,0,1323,1233,0,0,0,0,0,0,1233,2556
4583,9,1413,0,0,0,0,0,0,1413,1314,0,0,0,0,0,0,1314,2727
4583,10,1471,0,0,0,0,0,0,1471,1221,0,0,0,0,0,0,1221,2692
4583,11,1465,0,0,0,0,0,0,1465,1429,0,0,0,0,0,0,1429,2894
4583,12,1508,0,0,0,0,0,0,1508,1463,0,0,0,0,0,0,1463,2971
4583,13,1539,0,0,0,0,0,0,1539,1430,0,0,0,0,0,0,1430,2969
4583,14,1571,0,0,0,0,0,0,1571,1435,0,0,0,0,0,0,1435,3006
4583,15,1580,0,0,0,0,0,0,1580,1510,0,0,0,0,0,0,1510,3090
4583,16,1628,0,0,0,0,0,0,1628,1510,0,0,0,0,0,0,1510,3138
4583,17,1568,0,0,0,0,0,0,1568,1515,0,0,0,0,0,0,1515,3083
4583,18,1580,0,0,0,0,0,0,1580,1507,0,1,0,0,0,0,1508,3088
4583,19,1665,0,0,0,0,0,0,1665,1545,2,0,0,0,0,0,1547,3212
4583,20,1559,2,0,0,0,0,0,1561,1433,8,1,0,0,0,0,1442,3003
4583,21,1612,3,0,0,0,0,0,1615,1486,27,0,0,0,0,0,1513,3128
4583,22,1635,3,2,0,0,0,0,1640,1454,35,0,0,0,0,0,1489,3129
4583,23,1621,10,3,0,0,0,0,1634,1416,62,4,0,0,0,0,1482,3116
4583,24,1649,24,3,0,0,0,0,1676,1358,89,1,0,0,0,0,1448,3124
4583,25,1790,32,3,0,0,0,0,1825,1314,123,2,0,0,0,0,1439,3264
4583,26,1668,58,0,0,0,0,0,1726,1323,150,3,0,1,0,0,1477,3203
4583,27,1685,86,4,0,0,0,0,1775,1349,192,9,0,0,0,0,1550,3325
4583,28,1542,117,2,0,0,1,0,1662,1240,258,2,0,0,0,0,1500,3162
4583,29,1561,157,1,0,0,0,0,1719,1216,329,9,0,2,0,0,1556,3275
4583,30,1488,197,5,0,3,0,0,1693,1107,400,7,0,0,0,0,1514,3207
4583,31,1532,276,4,0,0,0,0,1812,1144,484,8,2,2,0,0,1640,3452
4583,32,1447,355,4,3,1,0,0,1810,1061,538,21,1,3,0,0,1624,3434
4583,33,1403,417,15,1,1,1,0,1838,978,726,27,5,2,0,0,1738,3576
4583,34,1267,494,18,1,3,0,0,1783,1005,662,34,1,5,0,0,1707,3490
4583,35,1311,588,14,1,1,1,0,1916,991,742,33,6,3,0,0,1775,3691
4583,36,1227,679,20,1,0,0,0,1927,876,865,34,6,4,0,0,1785,3712
4583,37,1087,678,33,3,1,0,0,1802,831,894,61,10,3,0,0,1799,3601
4583,38,1091,752,31,2,1,1,1,1879,877,974,79,11,1,0,0,1942,3821
4583,39,1070,818,37,3,2,0,0,1930,807,982,85,8,3,0,0,1885,3815
4583,40,993,927,47,2,0,0,0,1969,731,1041,82,6,0,0,0,1860,3829
4583,41,980,962,49,1,0,0,0,1992,730,1119,87,13,3,0,0,1952,3944
4583,42,904,975,68,10,5,0,1,1963,685,1181,111,22,2,0,0,2001,3964
4583,43,840,1124,90,5,1,0,0,2060,632,1268,133,26,0,0,0,2059,4119
4583,44,891,1151,90,10,3,0,0,2145,623,1378,141,33,3,0,0,2178,4323
4583,45,940,1211,92,8,3,0,0,2254,677,1375,194,31,1,0,0,2278,4532
4583,46,845,1254,132,9,0,0,0,2240,650,1523,213,33,4,0,0,2423,4663
4583,47,892,1428,158,4,1,1,0,2484,597,1648,230,40,2,0,0,2517,5001
4583,48,844,1458,181,10,4,0,0,2497,629,1739,270,39,3,0,0,2680,5177
4583,49,806,1614,169,17,0,0,0,2606,585,1737,275,57,0,0,0,2654,5260
4583,50,752,1707,163,13,2,0,0,2637,515,1878,285,57,2,0,0,2737,5374
4583,51,716,1781,204,17,2,0,0,2720,519,1865,247,71,4,0,0,2706,5426
4583,52,698,1754,195,12,4,0,0,2663,507,1899,286,66,0,0,0,2758,5421
4583,53,647,1766,225,20,0,0,0,2658,423,1894,273,70,1,0,0,2661,5319
4583,54,558,1874,220,19,6,0,0,2677,423,2017,279,98,1,0,0,2818,5495
4583,55,563,1794,219,33,0,0,0,2609,446,1999,313,101,0,0,0,2859,5468
4583,56,545,1916,209,23,1,0,0,2694,397,1973,315,127,1,0,0,2813,5507
4583,57,540,1921,243,33,7,1,0,2745,380,2000,286,150,0,0,0,2816,5561
4583,58,472,1930,259,40,4,0,0,2705,351,2038,304,157,0,0,0,2850,5555
4583,59,442,1997,244,46,1,0,0,2730,314,1978,276,145,3,0,0,2716,5446
4583,60,380,1799,202,36,1,0,0,2418,249,1918,263,168,1,0,0,2599,5017
4583,61,335,1838,204,39,3,0,0,2419,222,1924,262,185,0,0,0,2593,5012
4583,62,286,1872,185,56,2,0,0,2401,205,1835,256,224,1,0,0,2521,4922
4583,63,260,1799,176,58,1,0,1,2295,192,1892,219,219,0,0,0,2522,4817
4583,64,252,1797,174,61,1,0,0,2285,175,1735,203,237,0,0,0,2350,4635
4583,65,222,1675,163,60,1,0,0,2121,166,1716,170,265,0,0,0,2317,4438
4583,66,199,1718,166,73,2,0,0,2158,135,1661,164,266,0,0,0,2226,4384
4583,67,194,1607,142,81,0,0,0,2024,131,1632,152,328,0,0,0,2243,4267
4583,68,168,1594,106,90,3,0,0,1961,127,1519,137,338,0,0,0,2121,4082
4583,69,153,1586,125,104,4,0,0,1972,112,1580,155,380,0,0,0,2227,4199
4583,70,146,1496,110,95,3,0,0,1850,113,1429,119,405,0,0,0,2066,3916
4583,71,145,1509,101,91,2,0,0,1848,97,1347,103,347,0,0,0,1894,3742
4583,72,161,1554,89,113,2,0,0,1919,100,1459,93,469,0,0,0,2121,4040
4583,73,139,1508,87,132,1,0,0,1867,91,1353,108,510,0,0,0,2062,3929
4583,74,123,1589,59,139,1,0,0,1911,83,1479,103,549,0,0,0,2214,4125
4583,75,138,1714,70,154,0,0,0,2076,100,1534,77,674,0,0,0,2385,4461
4583,76,115,1597,60,169,0,0,0,1941,88,1348,81,699,0,0,0,2216,4157
4583,77,103,1508,42,176,1,0,0,1830,101,1189,82,694,0,0,0,2066,3896
4583,78,76,1168,49,179,1,0,0,1473,61,914,50,614,0,0,0,1639,3112
4583,79,62,1054,25,144,0,0,0,1285,65,750,45,643,0,0,0,1503,2788
4583,80,84,1025,27,179,0,0,0,1315,63,772,40,741,0,0,0,1616,2931
4583,81,70,917,30,144,0,0,0,1161,65,648,36,699,1,0,0,1449,2610
4583,82,70,889,22,182,0,0,0,1163,64,630,28,747,0,0,0,1469,2632
4583,83,77,903,20,218,0,0,0,1218,71,583,26,997,0,0,0,1677,2895
4583,84,70,804,23,190,0,0,0,1087,71,495,30,908,0,0,0,1504,2591
4583,85,60,776,16,220,0,0,0,1072,49,434,26,1004,0,0,0,1513,2585
4583,86,63,576,10,178,0,0,0,827,64,345,12,909,0,0,0,1330,2157
4583,87,53,502,7,197,0,0,0,759,49,229,14,780,0,0,0,1072,1831
4583,88,39,441,9,192,0,0,0,681,39,209,15,804,0,0,0,1067,1748
4583,89,32,340,6,167,0,0,0,545,38,158,11,710,0,0,0,917,1462
4583,90,32,286,1,177,0,0,0,496,41,92,8,642,0,0,0,783,1279
4583,91,23,183,4,95,0,0,0,305,25,63,2,577,0,0,0,667,972
4583,92,25,148,1,133,0,0,0,307,26,39,3,546,0,0,0,614,921
4583,93,17,120,1,85,0,0,0,223,24,25,2,445,0,0,0,496,719
4583,94,12,70,0,80,0,0,0,162,9,19,0,295,0,0,0,323,485
4583,95,6,53,2,50,0,0,0,111,16,10,2,254,0,0,0,282,393
4583,96,2,30,0,44,0,0,0,76,11,10,2,224,0,0,0,247,323
4583,97,3,16,0,19,0,0,0,38,5,3,1,151,0,0,0,160,198
4583,98,3,7,0,19,0,0,0,29,6,1,0,93,0,0,0,100,129
4583,99,0,3,2,10,0,0,0,15,3,4,0,71,0,0,0,78,93
4583,100,2,1,0,18,0,0,0,21,8,3,0,101,0,0,0,112,133
4583,999,76066,76362,5972,4994,86,6,3,163489,63290,77078,8121,21304,62,0,0,169855,333344
4647,0,787,0,0,0,0,0,0,787,728,0,0,0,0,0,0,728,1515
4647,1,791,0,0,0,0,0,0,791,804,0,0,0,0,0,0,804,1595
4647,2,875,0,0,0,0,0,0,875,827,0,0,0,0,0,0,827,1702
4647,3,835,0,0,0,0,0,0,835,781,0,0,0,0,0,0,781,1616
4647,4,879,0,0,0,0,0,0,879,898,0,0,0,0,0,0,898,1777
4647,5,900,0,0,0,0,0,0,900,914,0,0,0,0,0,0,914,1814
4647,6,961,0,0,0,0,0,0,961,955,0,0,0,0,0,0,955,1916
4647,7,998,0,0,0,0,0,0,998,979,0,0,0,0,0,0,979,1977
4647,8,1050,0,0,0,0,0,0,1050,1017,0,0,0,0,0,0,1017,2067
4647,9,1147,0,0,0,0,0,0,1147,1010,0,0,0,0,0,0,1010,2157
4647,10,1121,0,0,0,0,0,0,1121,1083,0,0,0,0,0,0,1083,2204
4647,11,1142,0,0,0,0,0,0,1142,1164,0,0,0,0,0,0,1164,2306
4647,12,1217,0,0,0,0,0,0,1217,1118,0,0,0,0,0,0,1118,2335
4647,13,1237,0,0,0,0,0,0,1237,1193,0,0,0,0,0,0,1193,2430
4647,14,1220,0,0,0,0,0,0,1220,1230,0,0,0,0,0,0,1230,2450
4647,15,1231,0,0,0,0,0,0,1231,1143,0,0,0,0,0,0,1143,2374
4647,16,1230,0,0,0,0,0,0,1230,1214,0,0,0,0,0,0,1214,2444
4647,17,1248,0,0,0,0,0,0,1248,1118,0,0,0,0,0,0,1118,2366
4647,18,1318,0,0,0,0,0,0,1318,1083,2,0,0,0,0,0,1085,2403
4647,19,1306,1,0,0,0,0,0,1307,1114,9,0,0,0,0,0,1123,2430
4647,20,1298,4,0,0,0,0,0,1302,1093,12,0,0,0,0,0,1105,2407
4647,21,1240,10,0,0,0,0,0,1250,1076,31,0,0,0,0,0,1107,2357
4647,22,1296,13,0,0,0,0,0,1309,1118,49,0,0,0,0,0,1167,2476
4647,23,1346,28,0,0,0,0,0,1374,1134,54,0,0,0,0,0,1188,2562
4647,24,1328,22,4,0,0,0,0,1354,1062,66,0,0,0,0,0,1128,2482
4647,25,1365,28,0,0,0,0,0,1393,1019,113,1,0,0,0,0,1133,2526
4647,26,1304,56,1,0,0,0,0,1361,1057,141,3,0,0,0,0,1201,2562
4647,27,1363,90,4,0,0,0,0,1457,1039,125,5,0,0,0,0,1169,2626
4647,28,1251,106,2,0,0,0,0,1359,954,235,3,0,0,0,0,1192,2551
4647,29,1182,133,3,0,0,0,0,1318,984,232,2,0,0,0,0,1218,2536
4647,30,1180,194,2,0,1,0,0,1377,925,305,4,0,1,0,0,1235,2612
4647,31,1201,218,9,0,1,0,0,1429,938,415,9,2,0,0,0,1364,2793
4647,32,1067,281,3,4,1,0,0,1356,787,415,10,2,0,0,0,1214,2570
4647,33,1103,364,5,0,0,0,0,1472,826,499,16,2,1,0,0,1344,2816
4647,34,1048,387,13,1,1,0,0,1450,732,553,20,5,1,0,0,1311,2761
4647,35,958,431,10,0,1,0,0,1400,752,601,28,3,0,0,0,1384,2784
4647,36,867,461,18,1,0,1,0,1348,714,603,21,2,2,0,0,1342,2690
4647,37,869,521,21,0,3,1,0,1415,608,680,45,5,0,0,0,1338,2753
4647,38,789,601,18,0,2,0,0,1410,645,702,52,10,3,0,0,1412,2822
4647,39,781,641,27,0,2,0,0,1451,633,817,44,7,0,0,0,1501,2952
4647,40,749,659,18,0,2,0,0,1428,646,865,49,7,4,0,0,1571,2999
4647,41,772,716,34,4,3,0,0,1529,611,898,74,12,2,0,0,1597,3126
4647,42,689,720,44,5,3,0,0,1461,622,865,66,13,2,0,0,1568,3029
4647,43,721,836,37,7,1,0,0,1602,545,899,78,11,1,0,0,1534,3136
4647,44,691,840,57,1,6,0,0,1595,575,1014,100,17,4,0,0,1710,3305
4647,45,702,954,50,9,4,0,0,1719,614,1101,101,16,3,0,0,1835,3554
4647,46,748,1042,76,5,4,0,0,1875,550,1224,127,22,2,0,0,1925,3800
4647,47,673,1055,73,9,1,0,0,1811,570,1206,138,36,0,1,0,1951,3762
4647,48,722,1088,93,9,3,0,0,1915,567,1255,161,34,1,0,0,2018,3933
4647,49,712,1181,102,3,2,0,0,2000,541,1344,170,31,3,0,0,2089,4089
4647,50,659,1186,100,11,2,0,0,1958,496,1364,143,36,6,0,0,2045,4003
4647,51,708,1245,107,9,1,0,0,2070,499,1406,171,45,2,0,0,2123,4193
4647,52,608,1299,119,11,2,0,0,2039,470,1350,177,58,1,0,0,2056,4095
4647,53,579,1259,116,15,0,0,0,1969,446,1404,207,57,3,0,0,2117,4086
4647,54,538,1373,140,14,1,0,0,2066,386,1549,222,57,2,0,0,2216,4282
4647,55,472,1419,173,14,3,1,0,2082,391,1477,209,66,0,0,0,2143,4225
4647,56,462,1447,176,21,2,0,0,2108,396,1566,192,72,1,0,0,2227,4335
4647,57,450,1538,139,26,1,0,0,2154,339,1574,228,100,1,0,0,2242,4396
4647,58,402,1463,175,18,2,0,0,2060,308,1521,199,100,2,0,0,2130,4190
4647,59,329,1544,180,23,5,0,0,2081,290,1575,252,130,3,0,0,2250,4331
4647,60,320,1446,166,30,1,0,0,1963,236,1442,203,101,1,0,0,1983,3946
4647,61,277,1347,150,27,2,0,0,1803,256,1409,176,162,1,0,0,2004,3807
4647,62,246,1372,153,34,2,0,0,1807,212,1445,169,156,0,0,0,1982,3789
4647,63,243,1315,123,44,2,0,0,1727,171,1296,179,178,2,0,0,1826,3553
4647,64,208,1432,115,46,5,0,0,1806,158,1362,163,195,1,0,0,1879,3685
4647,65,195,1244,103,55,3,0,0,1600,158,1358,147,232,1,0,0,1896,3496
4647,66,161,1226,123,44,2,0,0,1556,144,1243,134,186,0,0,0,1707,3263
4647,67,154,1251,93,58,2,0,0,1558,141,1186,120,250,1,0,0,1698,3256
4647,68,147,1134,109,60,4,0,0,1454,132,1226,123,269,0,0,0,1750,3204
4647,69,128,1240,81,68,0,0,0,1517,106,1168,124,283,0,0,0,1681,3198
4647,70,121,1166,75,66,0,0,0,1428,88,1125,106,308,0,0,0,1627,3055
4647,71,96,1116,50,83,1,0,0,1346,84,1096,101,309,0,0,0,1590,2936
4647,72,127,1117,57,83,0,0,0,1384,75,1028,93,315,0,0,0,1511,2895
4647,73,102,1174,67,76,0,0,1,1420,65,1022,80,354,0,0,0,1521,2941
4647,74,117,1196,50,85,0,0,0,1448,81,1123,72,414,0,0,0,1690,3138
4647,75,93,1259,58,133,0,0,0,1543,79,1139,73,503,0,0,0,1794,3337
4647,76,113,1231,49,124,1,0,0,1518,74,1046,63,527,0,0,0,1710,3228
4647,77,86,1135,51,120,1,0,0,1393,66,928,48,570,0,0,0,1612,3005
4647,78,66,801,24,108,1,0,0,1000,56,732,35,491,0,0,0,1314,2314
4647,79,78,811,35,109,0,0,0,1033,49,626,29,518,0,0,0,1222,2255
4647,80,56,810,23,123,1,0,0,1013,51,597,42,578,0,0,0,1268,2281
4647,81,69,678,22,144,1,0,0,914,64,474,22,591,0,0,0,1151,2065
4647,82,62,700,18,119,0,0,0,899,46,517,29,639,0,0,0,1231,2130
4647,83,69,775,25,165,2,0,0,1036,47,528,22,819,0,0,0,1416,2452
4647,84,63,628,14,188,0,0,0,893,38,398,14,817,0,0,0,1267,2160
4647,85,51,634,13,143,0,0,0,841,47,346,22,846,0,0,0,1261,2102
4647,86,43,529,7,134,0,0,0,713,38,258,17,786,0,0,0,1099,1812
4647,87,31,403,5,149,0,0,0,588,28,160,16,665,0,0,0,869,1457
4647,88,40,381,4,126,0,0,0,551,33,176,14,720,0,0,0,943,1494
4647,89,32,323,5,131,0,0,0,491,33,112,8,631,0,0,0,784,1275
4647,90,35,236,5,114,0,0,0,390,30,84,4,574,0,0,0,692,1082
4647,91,17,164,2,124,0,0,0,307,26,60,1,470,0,0,0,557,864
4647,92,15,152,1,108,0,0,0,276,23,38,5,471,0,0,0,537,813
4647,93,9,88,2,68,0,0,0,167,16,29,3,401,0,0,0,449,616
4647,94,11,73,4,58,0,0,0,146,16,21,1,287,0,0,0,325,471
4647,95,5,43,1,49,0,0,0,98,13,9,1,243,0,0,0,266,364
4647,96,3,18,0,44,0,0,0,65,9,8,2,187,0,0,0,206,271
4647,97,3,20,0,39,0,0,0,62,4,4,2,148,0,0,0,158,220
4647,98,0,7,1,11,0,0,0,19,5,4,2,107,0,0,0,118,137
4647,99,0,5,0,11,0,0,0,16,4,0,0,65,0,0,0,69,85
4647,100,0,9,0,21,0,0,0,30,6,4,0,115,0,0,0,125,155
4647,999,60407,58143,4033,3742,91,3,1,126420,51339,58943,5792,17439,58,1,0,133572,259992
4663,0,536,0,0,0,0,0,0,536,557,0,0,0,0,0,0,557,1093
4663,1,617,0,0,0,0,0,0,617,572,0,0,0,0,0,0,572,1189
4663,2,613,0,0,0,0,0,0,613,612,0,0,0,0,0,0,612,1225
4663,3,642,0,0,0,0,0,0,642,595,0,0,0,0,0,0,595,1237
4663,4,628,0,0,0,0,0,0,628,613,0,0,0,0,0,0,613,1241
4663,5,776,0,0,0,0,0,0,776,672,0,0,0,0,0,0,672,1448
4663,6,723,0,0,0,0,0,0,723,664,0,0,0,0,0,0,664,1387
4663,7,798,0,0,0,0,0,0,798,719,0,0,0,0,0,0,719,1517
4663,8,795,0,0,0,0,0,0,795,760,0,0,0,0,0,0,760,1555
4663,9,773,0,0,0,0,0,0,773,731,0,0,0,0,0,0,731,1504
4663,10,807,0,0,0,0,0,0,807,793,0,0,0,0,0,0,793,1600
4663,11,888,0,0,0,0,0,0,888,805,0,0,0,0,0,0,805,1693
4663,12,979,0,0,0,0,0,0,979,850,0,0,0,0,0,0,850,1829
4663,13,905,0,0,0,0,0,0,905,903,0,0,0,0,0,0,903,1808
4663,14,982,0,0,0,0,0,0,982,899,0,0,0,0,0,0,899,1881
4663,15,1008,0,0,0,0,0,0,1008,941,0,0,0,0,0,0,941,1949
4663,16,990,1,0,0,0,0,0,991,902,0,0,0,0,0,0,902,1893
4663,17,1016,0,0,0,0,0,0,1016,896,1,0,0,0,0,0,897,1913
4663,18,1003,0,0,0,0,0,0,1003,935,1,0,0,0,0,0,936,1939
4663,19,1001,0,0,0,0,0,0,1001,886,7,0,0,0,0,0,893,1894
4663,20,1015,1,0,0,0,0,0,1016,877,13,0,0,0,0,0,890,1906
4663,21,962,4,0,0,0,0,0,966,902,12,0,0,0,0,0,914,1880
4663,22,966,10,0,0,0,0,0,976,865,24,0,0,0,0,0,889,1865
4663,23,979,11,1,0,0,0,0,991,840,40,0,0,0,0,0,880,1871
4663,24,985,13,3,0,0,0,0,1001,848,59,1,1,0,0,0,909,1910
4663,25,999,24,2,0,0,0,0,1025,840,67,1,0,0,0,0,908,1933
4663,26,965,37,0,0,0,0,0,1002,799,93,1,0,0,0,0,893,1895
4663,27,1012,46,0,0,2,0,0,1060,759,129,3,0,0,0,0,891,1951
4663,28,940,69,4,0,1,0,0,1014,669,135,3,1,0,0,0,808,1822
4663,29,971,82,3,0,2,0,0,1058,762,170,5,0,0,1,0,938,1996
4663,30,926,111,7,1,1,0,0,1046,702,208,6,0,0,0,0,916,1962
4663,31,872,167,4,0,1,0,0,1044,653,277,7,1,1,0,0,939,1983
4663,32,871,155,3,1,1,0,0,1031,697,311,13,1,0,0,0,1022,2053
4663,33,847,232,8,1,0,0,0,1088,633,326,12,2,2,0,0,975,2063
4663,34,818,239,6,0,0,0,0,1063,624,395,17,2,0,1,0,1039,2102
4663,35,848,299,29,2,0,0,0,1178,579,461,23,2,3,0,0,1068,2246
4663,36,735,362,11,0,1,0,0,1109,536,468,25,1,3,0,0,1033,2142
4663,37,664,367,15,0,1,0,0,1047,510,516,38,2,3,0,0,1069,2116
4663,38,689,422,14,2,1,0,0,1128,499,516,35,2,1,0,0,1053,2181
4663,39,677,479,26,1,0,0,0,1183,487,560,51,4,2,1,0,1105,2288
4663,40,707,450,26,1,0,0,0,1184,499,609,48,5,2,0,0,1163,2347
4663,41,629,535,27,3,0,0,0,1194,523,671,69,7,0,0,0,1270,2464
4663,42,637,562,38,2,2,0,0,1241,480,658,72,9,4,0,0,1223,2464
4663,43,686,614,46,3,0,0,0,1349,425,703,85,3,0,0,0,1216,2565
4663,44,644,669,49,1,2,0,0,1365,471,760,88,12,1,0,0,1332,2697
4663,45,627,751,63,3,1,0,0,1445,501,795,117,13,2,1,0,1429,2874
4663,46,639,752,69,6,3,1,0,1470,511,889,120,21,1,1,0,1543,3013
4663,47,639,801,90,7,2,0,0,1539,521,953,148,22,0,0,0,1644,3183
4663,48,664,897,108,8,1,0,0,1678,457,1030,156,23,0,0,0,1666,3344
4663,49,607,951,101,8,1,0,1,1669,497,1050,164,25,2,0,0,1738,3407
4663,50,580,986,118,13,0,0,0,1697,460,1120,176,28,0,0,0,1784,3481
4663,51,587,989,110,12,1,0,0,1699,458,1204,190,53,2,0,0,1907,3606
4663,52,498,1072,128,7,1,0,0,1706,387,1170,208,61,1,0,0,1827,3533
4663,53,520,1078,151,11,1,0,0,1761,370,1137,199,53,1,0,0,1760,3521
4663,54,493,1173,154,9,1,0,0,1830,385,1255,216,51,1,0,0,1908,3738
4663,55,457,1131,179,17,1,0,0,1785,352,1215,214,61,1,0,0,1843,3628
4663,56,410,1152,164,18,1,0,0,1745,339,1188,206,63,2,0,0,1798,3543
4663,57,357,1203,189,16,2,0,0,1767,306,1252,218,105,1,0,0,1882,3649
4663,58,331,1239,214,28,1,1,0,1814,311,1274,220,97,1,0,0,1903,3717
4663,59,326,1240,178,29,3,0,0,1776,282,1367,235,105,0,0,0,1989,3765
4663,60,315,1210,189,34,1,0,0,1749,259,1281,236,122,0,0,0,1898,3647
4663,61,241,1183,166,25,3,0,0,1618,215,1177,192,124,1,0,0,1709,3327
4663,62,238,1148,167,31,1,0,0,1585,206,1238,177,110,1,0,0,1732,3317
4663,63,192,1209,148,35,3,0,0,1587,189,1190,165,155,1,0,0,1700,3287
4663,64,188,1109,158,24,1,0,0,1480,173,1079,163,177,1,0,0,1593,3073
4663,65,178,1080,129,38,0,0,0,1425,171,1141,172,175,0,0,0,1659,3084
4663,66,176,1100,128,43,1,0,0,1448,163,1118,174,199,0,0,0,1654,3102
4663,67,141,1155,131,53,3,0,0,1483,156,1074,157,227,0,0,0,1614,3097
4663,68,156,1115,113,51,0,0,0,1435,134,1124,143,227,1,0,0,1629,3064
4663,69,133,1101,111,63,2,0,0,1410,125,1021,151,273,0,0,0,1570,2980
4663,70,135,1070,93,46,1,0,0,1345,88,1007,119,260,0,0,0,1474,2819
4663,71,88,1061,96,74,0,0,0,1319,86,900,90,271,0,0,0,1347,2666
4663,72,121,1002,77,78,0,0,0,1278,115,873,104,282,0,0,0,1374,2652
4663,73,106,1088,73,83,0,0,0,1350,101,946,100,317,0,0,0,1464,2814
4663,74,83,1115,73,91,0,0,0,1362,105,928,74,432,0,0,0,1539,2901
4663,75,77,1122,72,119,0,0,1,1391,89,953,85,447,1,0,0,1575,2966
4663,76,71,1047,77,109,0,0,0,1304,89,904,71,517,0,0,0,1581,2885
4663,77,77,1068,47,129,1,0,0,1322,76,834,47,531,0,0,0,1488,2810
4663,78,45,764,35,143,0,0,0,987,59,626,56,497,0,0,0,1238,2225
4663,79,56,739,51,110,1,0,0,957,44,554,33,492,0,0,0,1123,2080
4663,80,45,662,34,111,0,0,0,852,51,515,35,515,0,0,0,1116,1968
4663,81,42,606,20,111,1,0,0,780,43,474,31,530,0,0,0,1078,1858
4663,82,40,657,25,121,0,0,0,843,51,431,35,578,0,0,0,1095,1938
4663,83,47,640,28,127,0,0,0,842,44,445,31,736,0,0,0,1256,2098
4663,84,48,554,17,163,0,0,0,782,43,329,26,733,0,0,0,1131,1913
4663,85,52,514,13,147,0,0,0,726,52,293,23,692,0,0,0,1060,1786
4663,86,30,413,8,126,1,0,0,578,51,231,19,642,0,0,0,943,1521
4663,87,19,366,10,126,0,0,0,521,39,170,9,565,0,0,0,783,1304
4663,88,22,315,3,120,0,0,0,460,37,122,15,582,0,0,0,756,1216
4663,89,23,247,6,109,0,0,0,385,22,75,11,550,0,0,0,658,1043
4663,90,25,164,3,116,0,0,0,308,21,62,10,494,0,0,0,587,895
4663,91,12,142,3,73,0,0,0,230,15,44,7,350,0,0,0,416,646
4663,92,12,113,3,57,0,0,0,185,15,29,6,354,0,0,0,404,589
4663,93,9,68,0,53,0,0,0,130,10,19,7,319,0,0,0,355,485
4663,94,3,46,0,37,0,0,0,86,7,9,2,246,0,0,0,264,350
4663,95,1,37,0,39,0,0,0,77,5,9,2,193,0,0,0,209,286
4663,96,2,17,0,35,0,0,0,54,6,5,1,148,0,0,0,160,214
4663,97,4,14,0,19,0,0,0,37,4,4,1,115,0,0,0,124,161
4663,98,1,6,0,13,0,0,0,20,3,1,0,64,0,0,0,68,88
4663,99,0,3,0,6,0,0,0,9,3,0,0,49,0,0,0,52,61
4663,100,1,3,0,16,0,0,0,20,2,0,1,64,0,0,0,67,87
4663,999,48514,48449,4645,3314,55,2,2,104981,41088,48324,6171,15190,43,5,0,110821,215802
4719,0,1886,0,0,0,0,0,0,1886,1771,0,0,0,0,0,0,1771,3657
4719,1,1973,0,0,0,0,0,0,1973,1855,0,0,0,0,0,0,1855,3828
4719,2,2067,0,0,0,0,0,0,2067,2016,0,0,0,0,0,0,2016,4083
4719,3,2120,0,0,0,0,0,0,2120,1979,0,0,0,0,0,0,1979,4099
4719,4,2221,0,0,0,0,0,0,2221,2185,0,0,0,0,0,0,2185,4406
4719,5,2397,0,0,0,0,0,0,2397,2149,0,0,0,0,0,0,2149,4546
4719,6,2466,0,0,0,0,0,0,2466,2316,0,0,0,0,0,0,2316,4782
4719,7,2601,0,0,0,0,0,0,2601,2463,0,0,0,0,0,0,2463,5064
4719,8,2638,0,0,0,0,0,0,2638,2477,0,0,0,0,0,0,2477,5115
4719,9,2734,0,0,0,0,0,0,2734,2656,0,0,0,0,0,0,2656,5390
4719,10,2867,0,0,0,0,0,0,2867,2689,0,0,0,0,0,0,2689,5556
4719,11,2912,0,0,0,0,0,0,2912,2918,0,0,0,0,0,0,2918,5830
4719,12,3005,0,0,0,0,0,0,3005,2881,0,0,0,0,0,0,2881,5886
4719,13,3078,0,0,0,0,0,0,3078,2859,0,0,0,0,0,0,2859,5937
4719,14,3143,0,0,0,0,0,0,3143,2870,0,0,0,0,0,0,2870,6013
4719,15,3160,0,0,0,0,0,0,3160,3149,0,0,0,0,0,0,3149,6309
4719,16,3210,0,0,0,0,0,0,3210,2958,0,0,0,0,0,0,2958,6168
4719,17,3198,0,0,0,0,0,0,3198,2959,0,0,0,0,0,0,2959,6157
4719,18,3194,0,0,0,0,0,0,3194,2985,1,0,0,0,0,0,2986,6180
4719,19,3111,1,0,0,0,0,0,3112,2928,5,0,0,0,0,0,2933,6045
4719,20,3211,2,1,0,0,0,0,3214,2799,20,0,0,0,0,0,2819,6033
4719,21,3044,7,0,0,0,0,0,3051,2847,39,1,0,0,0,0,2887,5938
4719,22,3170,10,0,0,0,0,0,3180,2817,57,0,0,0,0,0,2874,6054
4719,23,3105,20,1,0,0,0,0,3126,2840,88,0,0,0,0,0,2928,6054
4719,24,3247,37,4,0,1,0,0,3289,2604,131,2,0,0,0,0,2737,6026
4719,25,3171,68,3,0,0,0,0,3242,2657,187,4,0,0,0,0,2848,6090
4719,26,3073,92,3,0,3,0,0,3171,2624,262,1,0,0,0,0,2887,6058
4719,27,3061,127,1,0,1,0,0,3190,2516,342,11,0,2,0,0,2871,6061
4719,28,2955,212,4,0,3,0,0,3174,2482,417,7,0,1,0,0,2907,6081
4719,29,2819,235,1,1,1,0,0,3057,2300,560,7,0,1,0,0,2868,5925
4719,30,2932,364,6,1,1,0,0,3304,2266,703,11,2,2,0,0,2984,6288
4719,31,2886,487,8,0,3,0,0,3384,2202,909,25,1,6,1,0,3144,6528
4719,32,2690,598,13,0,6,0,0,3307,2034,1032,30,7,1,0,0,3104,6411
4719,33,2625,694,16,1,3,1,0,3340,2034,1189,37,5,5,0,1,3271,6611
4719,34,2493,940,20,2,4,0,0,3459,1906,1345,57,7,1,0,0,3316,6775
4719,35,2388,1084,33,1,7,0,0,3513,1938,1562,68,8,7,0,0,3583,7096
4719,36,2201,1107,47,1,5,0,0,3361,1646,1662,71,11,3,0,0,3393,6754
4719,37,2039,1294,60,2,6,0,0,3401,1638,1744,112,11,2,0,0,3507,6908
4719,38,2064,1371,65,1,6,0,1,3508,1587,1927,124,15,2,0,0,3655,7163
4719,39,1930,1583,69,1,6,0,1,3590,1546,2048,136,19,4,0,0,3753,7343
4719,40,2007,1857,75,8,6,1,0,3954,1482,2316,182,18,5,0,0,4003,7957
4719,41,1879,1859,97,5,5,0,0,3845,1419,2193,170,27,6,0,0,3815,7660
4719,42,1756,1985,123,7,7,0,0,3878,1364,2454,211,28,11,0,0,4068,7946
4719,43,1710,2142,121,8,5,0,0,3986,1290,2515,242,40,3,0,0,4090,8076
4719,44,1712,2279,161,7,7,0,0,4166,1200,2682,261,51,5,0,0,4199,8365
4719,45,1690,2412,181,12,6,0,0,4301,1312,2797,287,47,4,0,0,4447,8748
4719,46,1607,2682,183,10,5,0,0,4487,1254,2976,331,53,4,0,0,4618,9105
4719,47,1648,2665,225,14,4,0,0,4556,1219,3219,331,69,6,0,0,4844,9400
4719,48,1616,2849,263,16,5,0,0,4749,1231,3313,384,82,3,1,0,5014,9763
4719,49,1599,3158,274,12,8,0,0,5051,1172,3522,376,99,3,0,0,5172,10223
4719,50,1489,3169,268,25,5,1,0,4957,1026,3518,407,108,2,0,0,5061,10018
4719,51,1346,3154,323,28,8,0,0,4859,1041,3528,432,103,3,0,0,5107,9966
4719,52,1285,3286,308,25,9,0,0,4913,967,3623,437,135,3,0,0,5165,10078
4719,53,1169,3373,345,26,6,0,0,4919,866,3556,448,165,2,0,0,5037,9956
4719,54,1104,3398,337,35,2,0,0,4876,852,3749,468,147,1,0,0,5217,10093
4719,55,1026,3386,351,40,5,0,0,4808,842,3720,515,234,0,0,0,5311,10119
4719,56,957,3428,378,41,5,0,0,4809,811,3749,466,197,3,0,0,5226,10035
4719,57,968,3537,360,47,11,0,0,4923,729,3712,454,221,2,0,0,5118,10041
4719,58,910,3731,342,75,6,0,0,5064,706,3858,462,283,4,0,0,5313,10377
4719,59,831,3816,421,70,3,0,0,5141,649,3879,521,308,2,1,0,5360,10501
4719,60,712,3371,358,75,13,0,0,4529,624,3784,448,307,0,0,0,5163,9692
4719,61,674,3447,341,63,5,0,1,4531,507,3718,423,338,1,0,0,4987,9518
4719,62,610,3581,334,97,1,0,0,4623,500,3597,389,404,0,0,0,4890,9513
4719,63,570,3529,319,97,3,0,0,4518,478,3586,403,414,0,0,0,4881,9399
4719,64,504,3425,297,104,5,0,0,4335,471,3359,344,456,1,0,0,4631,8966
4719,65,481,3169,215,96,7,0,0,3968,402,3146,317,455,1,0,0,4321,8289
4719,66,446,3107,230,115,1,0,0,3899,375,3066,274,564,1,0,0,4280,8179
4719,67,375,3210,223,138,4,0,0,3950,359,3047,265,564,0,0,0,4235,8185
4719,68,382,3070,198,148,1,0,0,3799,298,3012,261,569,0,0,0,4140,7939
4719,69,317,3016,208,130,0,0,0,3671,302,2920,225,687,1,0,0,4135,7806
4719,70,338,2988,149,167,3,0,0,3645,280,2751,214,753,1,0,0,3999,7644
4719,71,268,2782,128,149,3,0,0,3330,257,2518,186,754,0,0,0,3715,7045
4719,72,278,2868,143,175,2,0,1,3467,233,2654,190,837,0,0,0,3914,7381
4719,73,250,2938,142,220,4,0,0,3554,251,2576,167,925,0,0,0,3919,7473
4719,74,223,2975,129,240,2,0,0,3569,228,2593,187,1048,0,0,0,4056,7625
4719,75,242,3108,106,262,2,0,0,3720,227,2626,145,1219,1,0,0,4218,7938
4719,76,252,2761,85,258,1,0,0,3357,215,2284,132,1240,0,0,0,3871,7228
4719,77,214,2529,90,286,1,0,0,3120,176,2120,117,1318,0,0,0,3731,6851
4719,78,170,2035,52,223,0,0,0,2480,152,1559,87,1146,0,0,0,2944,5424
4719,79,178,2025,59,269,1,0,0,2532,165,1572,75,1374,0,0,0,3186,5718
4719,80,169,2073,45,313,1,0,0,2601,151,1466,75,1515,0,0,0,3207,5808
4719,81,156,1741,53,283,0,0,0,2233,128,1246,63,1432,1,0,0,2870,5103
4719,82,151,1735,43,331,0,0,0,2260,140,1105,60,1556,0,0,0,2861,5121
4719,83,150,1809,50,350,0,0,0,2359,148,1095,68,1832,0,0,0,3143,5502
4719,84,126,1586,28,357,0,0,0,2097,155,1023,56,1886,0,0,0,3120,5217
4719,85,130,1519,40,402,1,0,0,2092,124,860,42,1937,0,0,0,2963,5055
4719,86,90,1157,18,335,1,0,0,1601,98,592,47,1827,0,0,0,2564,4165
4719,87,79,966,13,322,0,0,0,1380,107,458,29,1725,0,0,0,2319,3699
4719,88,70,852,15,308,0,0,0,1245,97,354,20,1616,0,0,0,2087,3332
4719,89,74,718,14,292,0,0,0,1098,97,248,9,1616,0,0,0,1970,3068
4719,90,50,569,7,276,0,0,0,902,74,176,17,1351,0,0,0,1618,2520
4719,91,34,397,4,224,0,0,0,659,64,129,12,1208,0,0,0,1413,2072
4719,92,28,309,5,228,0,0,0,570,57,79,9,1092,0,0,0,1237,1807
4719,93,24,246,1,189,1,0,0,461,36,63,8,944,0,0,0,1051,1512
4719,94,15,148,1,130,0,0,0,294,36,27,8,711,0,0,0,782,1076
4719,95,11,99,0,90,0,0,0,200,29,19,7,543,0,0,0,598,798
4719,96,11,63,1,73,0,0,0,148,27,22,2,455,0,0,0,506,654
4719,97,1,34,1,53,0,0,0,89,17,6,7,316,0,0,0,346,435
4719,98,4,20,1,28,0,0,0,53,16,4,2,240,0,0,0,262,315
4719,99,5,15,0,33,0,0,0,53,10,1,1,151,0,0,0,163,216
4719,100,2,13,0,26,0,0,0,41,18,5,1,194,0,0,0,218,259
4719,999,146258,144502,9637,8477,237,3,4,309118,125907,146575,13481,42020,117,3,1,328104,637222
4771,0,556,0,0,0,0,0,0,556,543,0,0,0,0,0,0,543,1099
4771,1,564,0,0,0,0,0,0,564,585,0,0,0,0,0,0,585,1149
4771,2,632,0,0,0,0,0,0,632,617,0,0,0,0,0,0,617,1249
4771,3,665,0,0,0,0,0,0,665,626,0,0,0,0,0,0,626,1291
4771,4,682,0,0,0,0,0,0,682,655,0,0,0,0,0,0,655,1337
4771,5,677,0,0,0,0,0,0,677,694,0,0,0,0,0,0,694,1371
4771,6,733,0,0,0,0,0,0,733,680,0,0,0,0,0,0,680,1413
4771,7,761,0,0,0,0,0,0,761,749,0,0,0,0,0,0,749,1510
4771,8,742,0,0,0,0,0,0,742,727,0,0,0,0,0,0,727,1469
4771,9,869,0,0,0,0,0,0,869,791,0,0,0,0,0,0,791,1660
4771,10,879,0,0,0,0,0,0,879,837,0,0,0,0,0,0,837,1716
4771,11,932,0,0,0,0,0,0,932,877,0,0,0,0,0,0,877,1809
4771,12,902,0,0,0,0,0,0,902,873,0,0,0,0,0,0,873,1775
4771,13,980,0,0,0,0,0,0,980,955,0,0,0,0,0,0,955,1935
4771,14,937,0,0,0,0,0,0,937,885,0,0,0,0,0,0,885,1822
4771,15,1007,0,0,0,0,0,0,1007,929,0,0,0,0,0,0,929,1936
4771,16,1071,0,0,0,0,0,0,1071,1011,0,0,0,0,0,0,1011,2082
4771,17,1027,0,0,0,0,0,0,1027,960,0,0,0,0,0,0,960,1987
4771,18,1044,0,0,0,0,0,0,1044,913,1,0,0,0,0,0,914,1958
4771,19,1039,1,0,0,0,0,0,1040,940,2,0,0,0,0,0,942,1982
4771,20,1007,0,0,0,0,0,0,1007,882,5,0,0,0,0,0,887,1894
4771,21,1032,0,0,0,0,0,0,1032,943,9,0,0,0,0,0,952,1984
4771,22,993,0,1,0,0,0,0,994,903,12,1,0,0,0,0,916,1910
4771,23,1049,6,0,0,0,0,0,1055,923,27,0,0,1,0,0,951,2006
4771,24,1055,13,2,0,0,0,0,1070,925,39,0,0,1,0,0,965,2035
4771,25,1069,21,1,0,0,0,0,1091,855,57,0,0,1,0,0,913,2004
4771,26,1024,27,0,0,0,0,0,1051,833,71,0,1,0,0,0,905,1956
4771,27,988,44,1,0,0,0,0,1033,789,83,2,0,0,0,0,874,1907
4771,28,945,56,1,0,0,0,0,1002,747,114,3,1,0,0,0,865,1867
4771,29,928,77,5,0,0,0,0,1010,762,184,5,1,1,0,0,953,1963
4771,30,851,108,4,0,2,0,0,965,737,201,3,0,0,0,0,941,1906
4771,31,892,144,4,0,1,0,0,1041,692,280,6,0,0,0,0,978,2019
4771,32,881,154,0,1,1,0,0,1037,666,300,10,2,1,0,0,979,2016
4771,33,848,210,7,1,3,1,0,1070,660,342,19,0,1,1,0,1023,2093
4771,34,777,241,5,0,0,0,0,1023,609,404,12,6,0,0,0,1031,2054
4771,35,797,319,10,1,0,0,0,1127,570,443,20,2,2,0,0,1037,2164
4771,36,728,387,17,0,1,0,0,1133,559,470,27,4,2,1,0,1063,2196
4771,37,704,356,13,4,1,0,0,1078,547,552,38,3,3,0,0,1143,2221
4771,38,702,436,26,1,0,1,0,1166,524,585,46,6,1,0,0,1162,2328
4771,39,645,461,22,1,1,0,0,1130,447,584,50,6,3,0,0,1090,2220
4771,40,666,500,22,0,3,0,0,1191,516,663,42,4,2,0,0,1227,2418
4771,41,632,583,23,4,2,1,0,1245,496,718,57,8,0,0,0,1279,2524
4771,42,579,637,33,2,0,0,0,1251,459,732,75,13,2,0,0,1281,2532
4771,43,566,685,38,6,2,0,0,1297,408,719,86,21,2,0,0,1236,2533
4771,44,562,694,50,4,1,0,0,1311,412,849,83,22,1,0,0,1367,2678
4771,45,557,729,53,7,5,0,0,1351,432,931,114,16,1,0,0,1494,2845
4771,46,591,807,67,9,1,0,0,1475,391,985,125,23,1,0,0,1525,3000
4771,47,600,909,82,8,0,0,0,1599,382,969,128,33,0,0,0,1512,3111
4771,48,553,949,78,5,2,0,0,1587,369,1125,152,34,0,0,0,1680,3267
4771,49,499,1014,99,6,5,0,0,1623,381,1263,151,35,2,0,0,1832,3455
4771,50,518,1061,102,10,2,1,0,1694,370,1233,159,31,2,1,0,1796,3490
4771,51,467,1029,123,10,1,0,0,1630,350,1229,176,44,2,0,0,1801,3431
4771,52,451,1083,127,11,1,1,0,1674,341,1291,188,58,1,0,0,1879,3553
4771,53,437,1099,135,16,3,0,0,1690,300,1208,183,57,0,0,0,1748,3438
4771,54,384,1247,139,16,1,0,0,1787,301,1301,199,63,1,0,0,1865,3652
4771,55,386,1236,135,15,2,0,0,1774,267,1351,196,80,0,0,0,1894,3668
4771,56,357,1183,155,20,2,0,0,1717,251,1297,196,77,0,0,0,1821,3538
4771,57,331,1180,151,30,2,0,0,1694,238,1371,186,86,0,0,0,1881,3575
4771,58,317,1303,163,32,2,0,0,1817,236,1357,204,113,0,0,0,1910,3727
4771,59,273,1296,163,25,2,0,0,1759,215,1378,198,121,0,0,0,1912,3671
4771,60,216,1316,131,26,4,0,0,1693,182,1306,173,124,0,0,0,1785,3478
4771,61,230,1209,145,27,1,0,0,1612,171,1258,181,118,0,0,1,1729,3341
4771,62,213,1171,141,33,2,0,0,1560,141,1237,147,138,0,0,0,1663,3223
4771,63,163,1194,103,37,3,0,0,1500,141,1223,153,161,1,0,0,1679,3179
4771,64,166,1115,113,37,1,0,0,1432,134,1156,133,156,0,0,0,1579,3011
4771,65,181,1110,117,37,3,0,0,1448,125,1091,135,179,0,0,0,1530,2978
4771,66,136,1082,99,43,2,0,0,1362,124,1001,121,187,2,0,0,1435,2797
4771,67,137,1094,102,51,0,0,0,1384,127,1122,124,233,1,0,0,1607,2991
4771,68,137,1086,83,55,2,0,0,1363,94,1061,131,265,0,0,0,1551,2914
4771,69,98,1026,82,54,3,0,0,1263,91,1081,102,230,0,0,0,1504,2767
4771,70,93,989,78,67,1,0,0,1228,103,953,97,290,0,0,0,1443,2671
4771,71,81,1001,78,74,0,0,0,1234,92,991,88,282,0,0,0,1453,2687
4771,72,97,1046,67,69,0,0,0,1279,75,950,84,316,1,0,0,1426,2705
4771,73,97,983,68,82,0,0,0,1230,75,932,77,370,0,0,0,1454,2684
4771,74,100,1062,71,99,0,0,0,1332,81,919,72,391,2,0,0,1465,2797
4771,75,84,1206,56,97,1,0,0,1444,76,981,60,452,0,0,0,1569,3013
4771,76,92,1099,51,98,0,0,0,1340,65,885,57,496,1,0,0,1504,2844
4771,77,75,992,38,123,0,0,0,1228,53,847,60,515,0,0,0,1475,2703
4771,78,56,771,33,87,0,0,0,947,41,653,55,442,0,0,0,1191,2138
4771,79,53,732,21,105,0,0,0,911,68,600,37,483,0,0,0,1188,2099
4771,80,45,798,22,113,2,0,0,980,48,577,30,598,0,0,0,1253,2233
4771,81,49,726,24,113,0,0,0,912,37,503,48,570,0,0,0,1158,2070
4771,82,47,692,13,127,0,0,0,879,49,449,24,616,0,0,0,1138,2017
4771,83,46,711,15,141,0,0,0,913,55,415,20,699,0,0,0,1189,2102
4771,84,40,589,11,168,0,0,0,808,58,360,24,671,0,0,0,1113,1921
4771,85,34,562,10,158,0,0,0,764,40,276,28,735,0,0,0,1079,1843
4771,86,25,408,13,157,0,0,0,603,41,227,13,692,0,0,0,973,1576
4771,87,22,334,10,117,0,0,0,483,15,149,14,593,0,0,0,771,1254
4771,88,18,296,6,143,0,0,0,463,38,121,9,598,0,0,0,766,1229
4771,89,29,224,4,123,0,0,0,380,26,93,7,536,0,0,0,662,1042
4771,90,18,206,6,112,0,0,0,342,26,68,5,508,0,0,0,607,949
4771,91,8,151,3,73,0,0,0,235,20,54,4,384,0,0,0,462,697
4771,92,11,113,1,69,0,0,0,194,18,23,7,384,0,0,0,432,626
4771,93,4,79,3,65,0,0,0,151,14,25,3,336,0,0,0,378,529
4771,94,3,56,0,44,0,0,0,103,14,13,4,279,0,0,0,310,413
4771,95,3,24,1,41,0,0,0,69,7,9,0,196,0,0,0,212,281
4771,96,2,18,3,35,0,0,0,58,9,5,1,136,0,0,0,151,209
4771,97,0,18,0,26,0,0,0,44,10,0,2,113,0,0,0,125,169
4771,98,0,11,0,10,0,0,0,21,1,1,1,89,0,0,0,92,113
4771,99,0,7,0,13,0,0,0,20,0,1,0,45,0,0,0,46,66
4771,100,0,1,0,6,0,0,0,7,6,1,1,73,0,0,0,81,88
4771,999,47249,49593,3879,3400,74,5,0,104200,40126,50352,5472,15650,42,3,1,111646,215846
4796,0,877,0,0,0,0,0,0,877,812,0,0,0,0,0,0,812,1689
4796,1,907,0,0,0,0,0,0,907,900,0,0,0,0,0,0,900,1807
4796,2,933,0,0,0,0,0,0,933,915,0,0,0,0,0,0,915,1848
4796,3,948,0,0,0,0,0,0,948,920,0,0,0,0,0,0,920,1868
4796,4,1019,0,0,0,0,0,0,1019,946,0,0,0,0,0,0,946,1965
4796,5,1150,0,0,0,0,0,0,1150,1048,0,0,0,0,0,0,1048,2198
4796,6,1159,0,0,0,0,0,0,1159,1064,0,0,0,0,0,0,1064,2223
4796,7,1189,0,0,0,0,0,0,1189,1146,0,0,0,0,0,0,1146,2335
4796,8,1190,0,0,0,0,0,0,1190,1223,0,0,0,0,0,0,1223,2413
4796,9,1284,0,0,0,0,0,0,1284,1229,0,0,0,0,0,0,1229,2513
4796,10,1291,0,0,0,0,0,0,1291,1209,0,0,0,0,0,0,1209,2500
4796,11,1340,0,0,0,0,0,0,1340,1275,0,0,0,0,0,0,1275,2615
4796,12,1393,0,0,0,0,0,0,1393,1280,0,0,0,0,0,0,1280,2673
4796,13,1383,0,0,0,0,0,0,1383,1342,0,0,0,0,0,0,1342,2725
4796,14,1444,0,0,0,0,0,0,1444,1348,0,0,0,0,0,0,1348,2792
4796,15,1482,0,0,0,0,0,0,1482,1429,0,0,0,0,0,0,1429,2911
4796,16,1445,0,0,0,0,0,0,1445,1314,0,0,0,0,0,0,1314,2759
4796,17,1437,0,0,0,0,0,0,1437,1440,0,0,0,0,0,0,1440,2877
4796,18,1410,0,0,0,0,0,0,1410,1318,1,0,0,1,0,0,1320,2730
4796,19,1465,1,0,0,0,0,0,1466,1292,3,0,0,0,0,0,1295,2761
4796,20,1448,0,0,0,0,0,0,1448,1256,8,0,0,0,0,0,1264,2712
4796,21,1437,3,0,0,0,0,0,1440,1311,14,0,0,0,0,0,1325,2765
4796,22,1458,5,2,0,1,0,0,1466,1348,21,0,0,0,0,0,1369,2835
4796,23,1468,9,0,0,0,0,0,1477,1315,32,1,0,0,0,0,1348,2825
4796,24,1470,12,0,0,0,0,0,1482,1276,50,0,0,1,0,0,1327,2809
4796,25,1571,17,2,0,0,0,0,1590,1253,75,0,0,0,0,0,1328,2918
4796,26,1460,43,1,0,1,0,0,1505,1281,107,2,0,0,0,0,1390,2895
4796,27,1485,55,1,0,0,0,0,1541,1213,134,1,0,1,0,0,1349,2890
4796,28,1478,88,3,0,0,0,0,1569,1200,168,2,0,0,0,0,1370,2939
4796,29,1402,106,1,0,0,0,0,1509,1151,238,6,0,0,0,0,1395,2904
4796,30,1458,123,2,1,1,0,0,1585,1078,282,3,0,1,0,0,1364,2949
4796,31,1455,218,5,0,0,0,0,1678,1069,367,13,1,1,0,0,1451,3129
4796,32,1351,253,8,2,2,0,0,1616,988,429,14,1,3,1,0,1436,3052
4796,33,1380,337,4,0,1,0,0,1722,1057,535,15,4,1,0,0,1612,3334
4796,34,1281,373,9,1,3,0,0,1667,951,593,23,0,0,0,0,1567,3234
4796,35,1257,460,18,2,1,0,0,1738,953,709,42,3,3,2,0,1712,3450
4796,36,1219,555,11,1,2,0,0,1788,883,740,33,0,0,0,0,1656,3444
4796,37,1116,568,26,0,2,0,0,1712,800,804,55,10,1,0,0,1670,3382
4796,38,1138,654,22,1,3,0,0,1818,786,913,48,11,4,0,0,1762,3580
4796,39,1107,732,38,2,5,0,0,1884,776,930,64,8,0,0,0,1778,3662
4796,40,1013,773,27,2,4,0,0,1819,781,1037,67,15,3,0,0,1903,3722
4796,41,975,954,35,2,2,0,0,1968,773,1146,88,20,3,0,0,2030,3998
4796,42,953,1021,59,4,0,0,0,2037,707,1199,101,19,0,0,0,2026,4063
4796,43,938,990,60,4,2,0,0,1994,661,1194,95,15,2,0,0,1967,3961
4796,44,921,1145,78,5,2,0,0,2151,651,1276,135,18,1,0,0,2081,4232
4796,45,887,1248,90,4,2,0,0,2231,631,1437,147,30,1,0,0,2246,4477
4796,46,887,1325,106,3,6,0,0,2327,568,1437,172,32,5,0,0,2214,4541
4796,47,866,1371,110,7,3,0,0,2357,547,1541,188,32,1,0,0,2309,4666
4796,48,872,1523,135,6,5,1,0,2542,566,1657,217,46,2,0,0,2488,5030
4796,49,819,1547,149,6,4,0,0,2525,545,1705,230,49,1,0,0,2530,5055
4796,50,749,1534,161,8,4,0,0,2456,502,1731,257,47,1,0,0,2538,4994
4796,51,667,1619,157,12,1,0,0,2456,462,1780,265,56,0,0,0,2563,5019
4796,52,656,1578,194,14,5,0,1,2448,421,1800,234,77,2,0,0,2534,4982
4796,53,590,1654,206,24,5,0,0,2479,403,1764,243,78,3,0,0,2491,4970
4796,54,530,1717,202,18,2,0,0,2469,403,1829,271,94,1,0,0,2598,5067
4796,55,509,1768,196,31,5,0,0,2509,360,1836,265,107,3,0,0,2571,5080
4796,56,483,1803,228,21,4,1,0,2540,339,1882,271,132,1,0,0,2625,5165
4796,57,468,1912,244,35,6,0,0,2665,342,1852,256,125,0,0,0,2575,5240
4796,58,452,1886,242,34,4,0,0,2618,336,1886,258,167,2,0,0,2649,5267
4796,59,432,1922,230,33,6,0,0,2623,288,1880,267,173,0,0,0,2608,5231
4796,60,351,1834,208,48,0,0,0,2441,257,1821,227,177,0,0,0,2482,4923
4796,61,324,1776,218,47,4,0,0,2369,226,1756,221,208,1,0,0,2412,4781
4796,62,267,1761,193,53,7,0,0,2281,215,1767,190,217,1,0,0,2390,4671
4796,63,256,1713,158,66,3,0,0,2196,198,1707,191,253,1,0,0,2350,4546
4796,64,251,1697,170,57,1,0,0,2176,187,1602,192,252,1,0,0,2234,4410
4796,65,225,1674,151,68,2,0,0,2120,159,1577,159,291,0,0,0,2186,4306
4796,66,201,1587,169,68,1,0,0,2026,176,1572,155,333,0,0,0,2236,4262
4796,67,190,1592,119,78,2,0,0,1981,150,1519,160,342,1,0,0,2172,4153
4796,68,196,1589,132,103,2,0,0,2022,152,1449,144,369,0,0,0,2114,4136
4796,69,177,1622,110,89,1,0,0,1999,120,1490,141,393,1,0,0,2145,4144
4796,70,155,1534,109,90,2,0,0,1890,124,1339,102,425,0,0,0,1990,3880
4796,71,117,1491,82,89,1,0,0,1780,134,1265,115,409,2,0,0,1925,3705
4796,72,127,1356,122,83,2,0,0,1690,102,1187,110,467,2,0,0,1868,3558
4796,73,126,1459,104,126,2,0,0,1817,81,1138,99,512,0,0,0,1830,3647
4796,74,138,1368,99,129,0,0,0,1734,107,1186,80,600,0,0,0,1973,3707
4796,75,122,1457,69,142,1,0,0,1791,93,1161,75,636,1,0,0,1966,3757
4796,76,120,1441,74,153,2,0,0,1790,90,1144,69,687,0,0,0,1990,3780
4796,77,112,1264,59,156,2,0,0,1593,80,980,71,748,0,0,0,1879,3472
4796,78,61,1003,40,137,0,0,0,1241,77,701,46,682,0,0,0,1506,2747
4796,79,70,956,49,152,0,0,1,1228,67,691,42,675,0,0,0,1475,2703
4796,80,50,890,35,145,1,0,0,1121,77,569,45,703,0,0,0,1394,2515
4796,81,51,774,33,140,0,0,0,998,50,529,36,690,0,0,0,1305,2303
4796,82,52,767,33,137,0,0,0,989,60,464,25,728,0,0,0,1277,2266
4796,83,52,719,17,190,0,0,0,978,73,418,31,908,0,0,0,1430,2408
4796,84,45,690,15,187,0,0,0,937,58,336,22,893,0,0,0,1309,2246
4796,85,35,593,18,176,0,0,0,822,57,311,21,821,0,0,0,1210,2032
4796,86,32,465,12,175,0,0,0,684,51,232,21,808,0,0,0,1112,1796
4796,87,30,382,9,133,0,0,0,554,47,170,11,717,0,0,0,945,1499
4796,88,29,313,5,145,0,0,0,492,31,133,13,659,0,0,0,836,1328
4796,89,13,256,1,122,0,0,0,392,24,94,8,631,0,0,0,757,1149
4796,90,12,206,3,118,0,0,0,339,25,66,4,555,0,0,0,650,989
4796,91,11,148,4,97,0,0,0,260,32,50,11,435,0,0,0,528,788
4796,92,11,81,3,77,0,0,0,172,17,27,2,381,0,0,0,427,599
4796,93,5,85,2,55,0,0,0,147,14,19,1,369,0,0,0,403,550
4796,94,4,39,0,55,0,0,0,98,17,20,3,244,0,0,0,284,382
4796,95,3,30,0,32,0,0,0,65,7,6,2,189,0,0,0,204,269
4796,96,6,15,0,34,0,0,0,55,6,5,0,157,0,0,0,168,223
4796,97,1,13,0,13,0,0,0,27,5,4,0,97,0,0,0,106,133
4796,98,1,3,0,9,0,0,0,13,5,2,1,71,0,0,0,79,92
4796,99,0,5,0,7,0,0,0,12,4,2,0,37,0,0,0,43,55
4796,100,0,5,0,3,0,0,0,8,6,2,0,90,0,0,0,98,106
4796,999,70881,70555,5687,4267,130,2,2,151524,59142,69533,7195,20229,60,3,0,156162,307686
4856,0,444,0,0,0,0,0,0,444,375,0,0,0,0,0,0,375,819
4856,1,430,0,0,0,0,0,0,430,432,0,0,0,0,0,0,432,862
4856,2,466,0,0,0,0,0,0,466,405,0,0,0,0,0,0,405,871
4856,3,461,0,0,0,0,0,0,461,454,0,0,0,0,0,0,454,915
4856,4,514,0,0,0,0,0,0,514,426,0,0,0,0,0,0,426,940
4856,5,508,0,0,0,0,0,0,508,425,0,0,0,0,0,0,425,933
4856,6,523,0,0,0,0,0,0,523,498,0,0,0,0,0,0,498,1021
4856,7,517,0,0,0,0,0,0,517,502,0,0,0,0,0,0,502,1019
4856,8,550,0,0,0,0,0,0,550,534,0,0,0,0,0,0,534,1084
4856,9,569,0,0,0,0,0,0,569,563,0,0,0,0,0,0,563,1132
4856,10,622,0,0,0,0,0,0,622,513,0,0,0,0,0,0,513,1135
4856,11,622,0,0,0,0,0,0,622,581,0,0,0,0,0,0,581,1203
4856,12,642,0,0,0,0,0,0,642,601,0,0,0,0,0,0,601,1243
4856,13,604,0,0,0,0,0,0,604,604,0,0,0,0,0,0,604,1208
4856,14,699,0,0,0,0,0,0,699,600,0,0,0,0,0,0,600,1299
4856,15,672,0,0,0,0,0,0,672,641,0,0,0,0,0,0,641,1313
4856,16,653,0,0,0,0,0,0,653,627,0,0,0,0,0,0,627,1280
4856,17,737,0,0,0,0,0,0,737,607,0,0,0,0,0,0,607,1344
4856,18,709,0,0,0,0,0,0,709,604,0,0,0,0,0,0,604,1313
4856,19,734,0,0,0,0,0,0,734,627,2,0,0,0,0,0,629,1363
4856,20,775,0,0,0,0,0,0,775,574,4,1,0,0,0,0,579,1354
4856,21,688,2,0,0,0,0,0,690,664,5,0,0,0,0,0,669,1359
4856,22,699,3,0,0,0,0,0,702,628,5,1,0,1,0,0,635,1337
4856,23,740,2,0,0,0,0,0,742,699,18,1,0,0,0,0,718,1460
4856,24,748,6,0,0,0,0,0,754,669,22,0,0,1,0,0,692,1446
4856,25,789,13,0,0,0,0,0,802,614,33,2,0,0,0,0,649,1451
4856,26,816,25,1,0,0,0,0,842,607,47,0,0,0,0,0,654,1496
4856,27,824,32,0,0,0,0,0,856,631,66,3,0,0,0,0,700,1556
4856,28,860,49,3,0,2,0,0,914,612,90,1,0,0,0,0,703,1617
4856,29,792,61,1,0,1,0,0,855,611,118,4,0,0,0,0,733,1588
4856,30,754,85,0,0,0,0,0,839,579,119,5,0,0,0,0,703,1542
4856,31,816,106,3,2,1,0,0,928,577,169,7,0,0,0,0,753,1681
4856,32,748,137,3,1,0,0,0,889,511,184,6,2,0,0,0,703,1592
4856,33,693,140,5,0,0,0,0,838,518,206,10,1,0,0,0,735,1573
4856,34,647,180,4,0,1,0,0,832,486,272,9,1,1,0,0,769,1601
4856,35,631,226,4,0,0,0,0,861,488,250,15,1,0,0,0,754,1615
4856,36,627,217,8,1,0,0,0,853,429,321,21,2,1,0,0,774,1627
4856,37,559,241,6,1,0,0,0,807,416,377,15,3,2,1,0,814,1621
4856,38,558,295,12,1,0,0,0,866,381,418,23,1,0,0,0,823,1689
4856,39,514,347,14,2,2,0,0,879,361,409,18,3,0,0,0,791,1670
4856,40,511,393,18,1,1,0,0,924,341,420,28,3,1,0,0,793,1717
4856,41,490,407,18,0,4,0,0,919,315,459,28,4,1,0,0,807,1726
4856,42,445,401,29,0,1,0,0,876,348,535,40,8,2,0,0,933,1809
4856,43,460,435,23,2,0,0,0,920,329,516,39,8,0,0,0,892,1812
4856,44,467,483,32,0,1,0,0,983,305,537,60,7,0,0,0,909,1892
4856,45,483,539,46,5,0,0,0,1073,314,648,54,13,0,1,0,1030,2103
4856,46,442,576,37,0,0,0,0,1055,301,662,66,16,0,0,0,1045,2100
4856,47,407,622,42,2,1,0,0,1074,316,673,67,17,1,0,0,1074,2148
4856,48,411,653,51,5,2,0,0,1122,289,746,78,18,0,0,0,1131,2253
4856,49,438,726,50,4,2,0,0,1220,256,812,80,25,2,0,0,1175,2395
4856,50,385,718,48,9,0,0,0,1160,294,788,75,24,1,0,0,1182,2342
4856,51,341,750,55,11,0,0,0,1157,240,807,95,32,0,0,0,1174,2331
4856,52,324,702,62,9,1,0,0,1098,214,861,93,34,0,0,0,1202,2300
4856,53,308,769,73,7,0,0,0,1157,196,920,101,34,2,0,0,1253,2410
4856,54,329,851,80,11,0,0,0,1271,184,870,100,46,0,0,0,1200,2471
4856,55,281,827,83,8,4,0,0,1203,208,909,107,53,0,0,0,1277,2480
4856,56,265,894,70,8,0,0,0,1237,185,929,87,50,0,0,0,1251,2488
4856,57,256,862,109,19,3,0,0,1249,157,927,100,76,0,0,0,1260,2509
4856,58,233,967,84,16,2,0,0,1302,176,964,88,78,0,0,0,1306,2608
4856,59,215,951,78,23,2,0,0,1269,166,920,113,84,0,0,0,1283,2552
4856,60,198,930,94,26,2,0,0,1250,124,909,99,89,0,0,0,1221,2471
4856,61,172,893,106,18,1,0,0,1190,149,872,94,119,1,0,0,1235,2425
4856,62,149,890,94,30,2,0,0,1165,134,854,77,106,0,0,0,1171,2336
4856,63,149,907,74,21,2,0,0,1153,113,853,71,125,0,0,0,1162,2315
4856,64,131,822,57,26,1,0,0,1037,109,808,73,128,0,0,0,1118,2155
4856,65,131,817,60,15,0,0,0,1023,100,781,75,134,0,0,0,1090,2113
4856,66,107,743,62,38,1,0,0,951,80,743,66,163,0,0,0,1052,2003
4856,67,121,796,56,37,1,0,0,1011,80,756,75,149,0,0,0,1060,2071
4856,68,107,789,61,36,1,0,0,994,77,718,56,165,0,0,0,1016,2010
4856,69,90,812,49,37,1,0,0,989,64,702,58,184,0,0,0,1008,1997
4856,70,81,763,53,43,1,0,0,941,78,700,40,200,1,0,0,1019,1960
4856,71,87,733,64,46,1,0,0,931,60,657,42,191,0,0,0,950,1881
4856,72,51,756,49,48,0,0,0,904,60,677,56,206,0,0,0,999,1903
4856,73,73,804,45,80,0,0,0,1002,57,619,52,236,0,0,0,964,1966
4856,74,56,759,40,71,0,0,0,926,59,604,38,242,1,0,0,944,1870
4856,75,63,782,31,79,0,0,0,955,60,646,35,338,0,0,0,1079,2034
4856,76,52,703,35,72,0,0,0,862,56,528,31,311,0,0,0,926,1788
4856,77,51,661,19,74,0,0,0,805,41,447,21,354,0,0,0,863,1668
4856,78,34,509,23,62,0,0,0,628,34,394,29,263,0,0,0,720,1348
4856,79,35,492,21,81,0,0,0,629,44,308,22,289,0,0,1,664,1293
4856,80,38,472,17,84,0,0,0,611,34,318,24,323,0,0,0,699,1310
4856,81,35,408,14,72,1,0,0,530,24,274,10,340,0,0,0,648,1178
4856,82,39,381,20,72,0,0,0,512,28,248,12,372,0,0,0,660,1172
4856,83,26,399,10,98,0,0,0,533,37,295,18,425,0,0,0,775,1308
4856,84,32,347,8,87,1,0,0,475,34,195,7,433,0,0,0,669,1144
4856,85,22,355,10,102,0,0,0,489,24,173,13,455,0,0,0,665,1154
4856,86,15,273,4,86,0,0,0,378,22,118,11,404,0,0,0,555,933
4856,87,7,220,4,73,0,0,0,304,14,99,4,285,0,0,0,402,706
4856,88,20,189,1,88,0,0,0,298,29,78,4,382,0,0,0,493,791
4856,89,14,136,3,77,0,0,0,230,20,75,3,303,0,0,0,401,631
4856,90,4,121,2,58,0,0,0,185,15,48,3,287,0,0,0,353,538
4856,91,12,76,2,51,0,0,0,141,11,32,3,201,0,0,0,247,388
4856,92,7,69,0,41,0,0,0,117,14,33,1,209,0,0,0,257,374
4856,93,5,59,1,46,0,0,0,111,13,17,2,188,0,0,0,220,331
4856,94,3,35,0,41,0,0,0,79,6,13,0,139,0,0,0,158,237
4856,95,3,18,0,21,0,0,0,42,9,6,0,97,0,0,0,112,154
4856,96,1,20,0,18,0,0,0,39,8,11,0,84,0,0,0,103,142
4856,97,0,8,0,13,0,0,0,21,0,2,2,71,0,0,0,75,96
4856,98,0,5,0,7,0,0,0,12,2,3,1,48,0,0,0,54,66
4856,99,0,4,0,6,0,0,0,10,2,0,1,34,0,0,0,37,47
4856,100,1,6,0,4,0,0,0,11,3,0,0,49,0,0,0,52,63
4856,999,35667,34655,2341,2233,47,0,0,74943,28736,33652,2870,9765,19,2,1,75045,149988
4925,0,13180,0,0,0,0,0,0,13180,12341,0,0,0,0,0,0,12341,25521
4925,1,14108,0,0,0,0,0,0,14108,13345,0,0,0,0,0,0,13345,27453
4925,2,14748,0,0,0,0,0,0,14748,14073,0,0,0,0,0,0,14073,28821
4925,3,15023,0,0,0,0,0,0,15023,14216,0,0,0,0,0,0,14216,29239
4925,4,15827,0,0,0,0,0,0,15827,14914,0,0,0,0,0,0,14914,30741
4925,5,16710,0,0,0,0,0,0,16710,15958,0,0,0,0,0,0,15958,32668
4925,6,17457,0,0,0,0,0,0,17457,16453,0,0,0,0,0,0,16453,33910
4925,7,18237,0,0,0,0,0,0,18237,17372,0,0,0,0,0,0,17372,35609
4925,8,18812,0,0,0,0,0,0,18812,17963,0,0,0,0,0,0,17963,36775
4925,9,19806,0,0,0,0,0,0,19806,18331,0,0,0,0,0,0,18331,38137
4925,10,19787,0,0,0,0,0,0,19787,18679,0,0,0,0,0,0,18679,38466
4925,11,21028,0,0,0,0,0,0,21028,19923,0,0,0,0,0,0,19923,40951
4925,12,21084,0,0,0,0,0,0,21084,19931,0,0,0,0,0,0,19931,41015
4925,13,21553,0,0,0,0,0,0,21553,20203,0,0,0,0,0,0,20203,41756
4925,14,21713,0,0,0,0,0,0,21713,20234,0,0,0,0,0,0,20234,41947
4925,15,21699,0,0,0,0,0,0,21699,20700,0,0,0,0,0,0,20700,42399
4925,16,22026,0,0,0,0,0,0,22026,20622,2,0,0,0,0,0,20624,42650
4925,17,21875,0,0,0,0,0,0,21875,20485,0,0,0,0,0,0,20485,42360
4925,18,21412,1,1,0,0,0,0,21414,19757,3,0,0,0,0,0,19760,41174
4925,19,21495,0,0,0,0,0,0,21495,19978,22,0,0,0,0,0,20000,41495
4925,20,20780,5,1,0,0,0,0,20786,19435,61,0,0,0,0,0,19496,40282
4925,21,20494,17,0,0,0,0,0,20511,18904,87,0,1,0,0,0,18992,39503
4925,22,20586,30,7,0,0,0,0,20623,18844,207,4,0,0,0,0,19055,39678
4925,23,20932,65,7,0,3,0,0,21007,18890,305,8,0,1,0,0,19204,40211
4925,24,20467,127,11,0,4,0,0,20609,18406,463,11,1,5,0,0,18886,39495
4925,25,21029,236,14,0,5,0,0,21284,18653,772,19,1,6,0,0,19451,40735
4925,26,20444,390,11,0,8,0,0,20853,18165,1106,14,1,6,0,0,19292,40145
4925,27,20704,578,13,0,8,0,0,21303,18038,1598,17,2,9,1,0,19665,40968
4925,28,20690,919,14,0,10,2,0,21635,17626,2152,45,4,15,3,0,19845,41480
4925,29,20225,1423,32,1,29,0,0,21710,17305,2988,58,9,28,1,0,20389,42099
4925,30,19884,1872,45,2,17,3,0,21823,17213,3883,95,6,30,3,0,21230,43053
4925,31,20264,2688,38,5,29,1,0,23025,16981,5064,130,14,30,4,0,22223,45248
4925,32,19056,3584,74,6,40,2,0,22762,16100,5983,155,16,30,2,0,22286,45048
4925,33,19278,4382,97,10,43,6,0,23816,15609,7217,211,32,37,4,0,23110,46926
4925,34,17903,5457,131,7,47,0,0,23545,14490,8261,267,31,44,2,0,23095,46640
4925,35,17485,6701,153,20,66,1,0,24426,14041,9598,366,45,65,5,1,24121,48547
4925,36,16367,7364,205,11,71,0,0,24018,13275,10537,400,49,60,7,0,24328,48346
4925,37,15313,8395,227,26,58,3,0,24022,12324,11098,581,83,49,5,0,24140,48162
4925,38,15113,9635,330,28,78,3,0,25187,12155,12408,631,104,58,4,0,25360,50547
4925,39,14662,10939,361,29,63,1,1,26056,11891,13267,820,125,64,5,0,26172,52228
4925,40,14092,11963,485,40,77,5,0,26662,11471,14142,879,127,55,1,0,26675,53337
4925,41,13697,13080,583,38,93,5,0,27496,11489,15281,986,135,77,2,0,27970,55466
4925,42,13120,13535,618,74,75,2,0,27424,10847,15920,1159,221,61,0,0,28208,55632
4925,43,12589,14486,699,68,73,2,0,27917,10679,16505,1309,258,41,4,0,28796,56713
4925,44,12348,15329,892,89,104,3,0,28765,10558,17433,1562,311,61,4,0,29929,58694
4925,45,12642,16401,996,88,76,3,0,30206,10591,18767,1731,331,48,0,0,31468,61674
4925,46,12420,16929,1127,92,83,0,0,30651,10198,19539,1979,376,54,1,0,32147,62798
4925,47,12075,18077,1267,111,83,3,1,31617,10447,20630,2095,473,53,2,0,33700,65317
4925,48,12329,19332,1458,146,96,1,0,33362,10529,22020,2466,509,50,1,0,35575,68937
4925,49,12400,20278,1687,139,97,4,3,34608,10443,23537,2787,597,64,2,0,37430,72038
4925,50,11462,21073,1868,160,107,1,1,34672,9912,23683,2922,678,46,1,0,37242,71914
4925,51,11073,21928,1966,194,102,1,1,35265,9315,24512,3137,749,44,2,2,37761,73026
4925,52,10234,22422,2090,190,94,1,1,35032,8689,24781,3393,897,46,2,0,37808,72840
4925,53,9660,22693,2156,236,102,0,1,34848,8121,24707,3601,1043,41,2,0,37515,72363
4925,54,9087,23375,2418,267,89,1,2,35239,7923,25234,3768,1141,41,0,0,38107,73346
4925,55,8439,23225,2523,308,98,3,2,34598,7346,25034,3842,1278,35,4,0,37539,72137
4925,56,7718,23528,2587,322,106,2,1,34264,7035,25151,4070,1381,28,1,0,37666,71930
4925,57,7420,24118,2753,404,108,0,0,34803,6518,25224,4041,1579,24,2,0,37388,72191
4925,58,6737,24387,2817,406,104,0,1,34452,6180,25135,4095,1703,40,1,1,37155,71607
4925,59,6382,25041,2839,489,100,0,2,34853,5763,25757,4214,2026,40,2,3,37805,72658
4925,60,5314,23679,2666,551,93,4,1,32308,5128,24283,3952,2181,32,3,1,35580,67888
4925,61,4683,22675,2620,536,62,2,1,30579,4727,22887,3697,2244,29,1,1,33586,64165
4925,62,4180,22220,2435,612,69,0,2,29518,4259,22159,3419,2589,27,1,0,32454,61972
4925,63,3749,21026,2172,670,68,1,1,27687,3947,20868,3353,2786,26,1,1,30982,58669
4925,64,3356,20271,2070,657,64,1,1,26420,3652,20151,3134,2903,15,1,0,29856,56276
4925,65,2879,19274,1972,732,71,1,3,24932,3319,18973,2975,3113,19,0,0,28399,53331
4925,66,2751,18914,1818,696,55,0,1,24235,3143,18653,2717,3386,23,0,0,27922,52157
4925,67,2482,18538,1748,833,38,1,1,23641,2659,17819,2625,3718,18,0,1,26840,50481
4925,68,2151,18174,1521,843,28,0,0,22717,2691,17225,2351,3909,8,0,0,26184,48901
4925,69,1873,17280,1502,1001,36,0,1,21693,2547,16504,2303,4315,6,0,0,25675,47368
4925,70,1769,16219,1282,987,27,0,0,20284,2288,15435,2013,4341,9,0,0,24086,44370
4925,71,1496,15705,1190,1061,27,0,1,19480,2067,14616,2003,4699,10,0,0,23395,42875
4925,72,1493,15181,1077,1084,31,1,1,18868,1967,13977,1859,5081,13,0,0,22897,41765
4925,73,1363,15547,1001,1201,30,2,0,19144,1931,14012,1809,5639,7,0,0,23398,42542
4925,74,1163,15092,962,1364,24,0,2,18607,1838,13380,1643,6125,6,0,0,22992,41599
4925,75,1171,15433,906,1558,21,0,1,19090,1892,13734,1608,6958,8,0,0,24200,43290
4925,76,1059,15173,865,1769,21,0,0,18887,1735,13041,1511,7577,7,0,0,23871,42758
4925,77,1003,14423,758,1739,13,0,0,17936,1684,12160,1500,8013,6,0,0,23363,41299
4925,78,756,11040,549,1567,11,0,0,13923,1428,9121,1113,6976,4,0,1,18643,32566
4925,79,698,10658,517,1656,13,0,1,13543,1368,8303,1031,7378,3,0,1,18084,31627
4925,80,689,10673,491,1750,11,0,0,13614,1395,8311,1014,8245,2,0,0,18967,32581
4925,81,626,9769,445,1927,14,0,1,12782,1339,7261,912,8519,3,0,1,18035,30817
4925,82,566,9501,359,2032,12,0,0,12470,1289,6645,834,8988,4,0,1,17761,30231
4925,83,564,9428,350,2290,15,0,0,12647,1458,6440,783,10327,1,0,0,19009,31656
4925,84,469,8591,271,2228,4,0,0,11563,1260,5381,642,10136,1,0,0,17420,28983
4925,85,412,7478,245,2048,6,0,0,10189,1154,4428,596,9826,1,0,0,16005,26194
4925,86,341,6056,207,2054,4,0,0,8662,1051,3333,433,9184,1,0,0,14002,22664
4925,87,270,4912,166,1855,6,0,0,7209,937,2582,407,8393,0,0,0,12319,19528
4925,88,234,4385,141,1851,1,0,1,6613,861,2035,309,8126,0,0,0,11331,17944
4925,89,211,3412,108,1609,4,0,0,5344,777,1467,242,7436,0,0,0,9922,15266
4925,90,155,2610,69,1371,1,0,1,4207,635,1061,194,6489,0,0,0,8379,12586
4925,91,101,2040,52,1173,1,1,0,3368,567,765,146,5529,0,0,0,7007,10375
4925,92,91,1471,34,1098,0,0,0,2694,489,513,132,4798,0,0,0,5932,8626
4925,93,80,1136,17,936,0,0,0,2169,445,415,95,4259,0,0,0,5214,7383
4925,94,62,691,13,677,0,0,0,1443,292,221,91,3098,0,0,0,3702,5145
4925,95,42,447,10,444,0,0,0,943,275,145,45,2367,0,0,0,2832,3775
4925,96,30,274,4,346,1,0,0,655,169,84,29,1892,0,0,0,2174,2829
4925,97,21,186,7,249,0,0,0,463,145,51,25,1290,0,0,0,1511,1974
4925,98,9,90,1,161,0,0,0,261,114,51,27,929,0,0,0,1121,1382
4925,99,8,65,3,132,0,0,0,208,100,33,12,647,0,0,0,792,1000
4925,100,37,67,4,182,0,0,0,290,154,52,27,1002,0,0,0,1235,1525
4925,999,1025587,885812,68229,51536,3328,73,38,2034603,937053,908649,111479,231748,1775,87,15,2190806,4225409
5073,0,1881,0,0,0,0,0,0,1881,1825,0,0,0,0,0,0,1825,3706
5073,1,1961,0,0,0,0,0,0,1961,1876,0,0,0,0,0,0,1876,3837
5073,2,2102,0,0,0,0,0,0,2102,1955,0,0,0,0,0,0,1955,4057
5073,3,2035,0,0,0,0,0,0,2035,1987,0,0,0,0,0,0,1987,4022
5073,4,2206,0,0,0,0,0,0,2206,2086,0,0,0,0,0,0,2086,4292
5073,5,2379,0,0,0,0,0,0,2379,2230,0,0,0,0,0,0,2230,4609
5073,6,2519,0,0,0,0,0,0,2519,2293,0,0,0,0,0,0,2293,4812
5073,7,2544,0,0,0,0,0,0,2544,2364,0,0,0,0,0,0,2364,4908
5073,8,2460,0,0,0,0,0,0,2460,2412,0,0,0,0,0,0,2412,4872
5073,9,2640,0,0,0,0,0,0,2640,2493,0,0,0,0,0,0,2493,5133
5073,10,2726,0,0,0,0,0,0,2726,2598,0,0,0,0,0,0,2598,5324
5073,11,2808,0,0,0,0,0,0,2808,2615,0,0,0,0,0,0,2615,5423
5073,12,2828,0,0,0,0,0,0,2828,2700,0,0,0,0,0,0,2700,5528
5073,13,2936,0,0,0,0,0,0,2936,2735,0,0,0,0,0,0,2735,5671
5073,14,2875,0,0,0,0,0,0,2875,2767,0,0,0,0,0,0,2767,5642
5073,15,2848,0,0,0,0,0,0,2848,2750,0,0,0,0,0,0,2750,5598
5073,16,2866,0,0,0,0,0,0,2866,2698,0,0,0,0,0,0,2698,5564
5073,17,2871,0,0,0,0,0,0,2871,2748,0,0,0,0,0,0,2748,5619
5073,18,2759,0,0,0,0,0,0,2759,2686,1,0,0,0,0,0,2687,5446
5073,19,2854,0,0,0,0,0,0,2854,2679,4,0,0,0,0,0,2683,5537
5073,20,2907,3,0,0,0,0,0,2910,2699,16,0,0,0,0,0,2715,5625
5073,21,2853,3,0,0,0,0,0,2856,2587,26,0,0,0,0,0,2613,5469
5073,22,2904,8,0,0,0,0,0,2912,2649,37,0,0,0,0,0,2686,5598
5073,23,3086,12,0,0,0,0,0,3098,2631,52,2,1,0,0,0,2686,5784
5073,24,3056,27,0,0,0,0,0,3083,2608,96,0,0,0,0,0,2704,5787
5073,25,2989,45,0,0,0,0,0,3034,2422,126,4,0,0,0,0,2552,5586
5073,26,3085,84,0,1,0,0,0,3170,2480,245,1,1,1,0,0,2728,5898
5073,27,2959,124,4,0,1,0,0,3088,2465,279,4,1,0,0,0,2749,5837
5073,28,2935,170,1,0,0,0,0,3106,2301,430,7,0,2,1,0,2741,5847
5073,29,2985,237,6,1,0,0,0,3229,2228,576,12,2,2,0,0,2820,6049
5073,30,2818,363,5,0,0,0,0,3186,2159,711,11,4,0,1,0,2886,6072
5073,31,2791,471,10,0,0,0,0,3272,2086,972,14,2,3,0,0,3077,6349
5073,32,2498,633,9,1,1,0,0,3142,1934,1078,32,5,5,0,0,3054,6196
5073,33,2550,767,20,2,2,0,0,3341,1787,1299,37,3,4,0,0,3130,6471
5073,34,2371,958,21,3,2,0,0,3355,1748,1441,45,4,1,0,0,3239,6594
5073,35,2353,1105,31,4,4,0,0,3497,1624,1594,70,8,5,0,0,3301,6798
5073,36,2151,1173,32,2,6,0,0,3364,1486,1721,62,8,3,0,0,3280,6644
5073,37,2172,1431,49,1,1,0,0,3654,1378,1701,71,9,1,0,0,3160,6814
5073,38,1977,1527,48,2,3,0,0,3557,1336,1916,98,10,2,0,0,3362,6919
5073,39,1913,1724,65,4,4,0,0,3710,1229,1987,104,13,4,0,0,3337,7047
5073,40,1815,1762,58,5,3,0,0,3643,1149,2123,124,14,3,0,0,3413,7056
5073,41,1764,1974,88,5,0,0,0,3831,1149,2350,141,37,3,0,0,3680,7511
5073,42,1685,2099,88,7,2,1,0,3882,1135,2379,165,27,5,1,0,3712,7594
5073,43,1590,2227,106,12,4,0,0,3939,993,2517,174,33,0,0,0,3717,7656
5073,44,1538,2291,125,11,3,0,0,3968,971,2574,244,38,3,0,0,3830,7798
5073,45,1542,2427,135,13,2,0,0,4119,966,2815,218,55,3,0,0,4057,8176
5073,46,1498,2601,148,18,3,0,0,4268,945,2871,251,45,4,1,0,4117,8385
5073,47,1448,2897,184,17,5,0,0,4551,929,3092,284,57,0,0,0,4362,8913
5073,48,1443,2992,191,31,3,0,0,4660,917,3315,293,87,4,0,0,4616,9276
5073,49,1314,3094,219,21,2,0,0,4650,912,3392,293,95,2,0,0,4694,9344
5073,50,1290,3152,280,22,2,0,0,4746,872,3414,352,107,0,0,0,4745,9491
5073,51,1216,3192,260,24,7,1,0,4700,797,3465,328,125,1,0,0,4716,9416
5073,52,1139,3162,301,30,10,0,0,4642,744,3452,412,122,1,0,0,4731,9373
5073,53,1003,3321,274,38,4,0,1,4641,628,3492,381,150,3,0,0,4654,9295
5073,54,912,3290,301,36,5,0,0,4544,564,3551,400,183,1,0,0,4699,9243
5073,55,862,3346,261,54,3,0,0,4526,546,3581,398,176,2,0,0,4703,9229
5073,56,767,3431,312,51,5,1,0,4567,563,3487,407,216,2,0,0,4675,9242
5073,57,656,3522,321,56,3,0,0,4558,515,3572,383,246,1,0,0,4717,9275
5073,58,651,3528,322,59,4,0,0,4564,490,3479,391,231,1,0,0,4592,9156
5073,59,593,3536,306,79,7,0,0,4521,452,3607,370,310,2,0,0,4741,9262
5073,60,510,3292,319,64,2,0,0,4187,413,3272,349,318,4,0,0,4356,8543
5073,61,429,3191,269,61,2,0,0,3952,358,3175,300,330,1,0,0,4164,8116
5073,62,393,3156,236,79,2,0,0,3866,324,3159,310,376,0,0,1,4170,8036
5073,63,336,3007,246,101,9,0,0,3699,303,2948,274,449,3,0,0,3977,7676
5073,64,302,2976,226,108,1,0,0,3613,276,2820,277,468,2,0,0,3843,7456
5073,65,263,2768,217,103,1,0,0,3352,277,2687,244,449,1,0,0,3658,7010
5073,66,273,2728,195,111,2,0,0,3309,194,2655,197,534,0,0,0,3580,6889
5073,67,224,2682,166,116,1,0,0,3189,220,2553,191,527,2,0,0,3493,6682
5073,68,181,2691,163,130,2,0,0,3167,213,2578,182,559,0,0,0,3532,6699
5073,69,172,2790,172,138,1,0,0,3273,198,2471,163,693,0,0,0,3525,6798
5073,70,165,2524,111,167,0,0,0,2967,165,2222,135,625,0,0,0,3147,6114
5073,71,147,2425,126,166,0,0,0,2864,160,2115,128,707,0,0,0,3110,5974
5073,72,147,2421,112,156,1,0,0,2837,153,2142,136,808,1,0,0,3240,6077
5073,73,112,2451,126,171,1,0,0,2861,151,2147,169,906,0,0,0,3373,6234
5073,74,130,2496,133,220,1,0,0,2980,166,2063,152,1002,0,0,0,3383,6363
5073,75,135,2594,109,252,1,0,0,3091,164,2055,130,1165,0,0,0,3514,6605
5073,76,126,2540,83,248,1,0,0,2998,143,1771,126,1204,0,0,0,3244,6242
5073,77,96,2275,72,268,1,0,0,2712,144,1671,107,1285,0,0,0,3207,5919
5073,78,64,1508,54,193,0,0,0,1819,74,1093,63,883,0,0,0,2113,3932
5073,79,64,1401,53,216,0,0,0,1734,93,983,62,988,0,0,0,2126,3860
5073,80,58,1436,39,221,1,0,0,1755,76,962,47,1109,0,0,0,2194,3949
5073,81,62,1389,40,225,1,0,0,1717,87,899,46,1183,0,0,0,2215,3932
5073,82,51,1290,26,245,0,0,0,1612,113,763,42,1216,0,0,0,2134,3746
5073,83,51,1287,36,310,1,0,0,1685,80,722,53,1359,0,0,0,2214,3899
5073,84,45,1167,30,298,0,0,0,1540,87,635,43,1272,0,0,0,2037,3577
5073,85,27,991,16,288,0,0,0,1322,64,504,24,1325,0,0,0,1917,3239
5073,86,34,836,7,265,0,0,0,1142,81,375,24,1230,0,0,0,1710,2852
5073,87,21,660,14,261,0,0,0,956,65,301,21,1066,0,0,0,1453,2409
5073,88,31,591,10,235,2,0,0,869,49,232,12,1024,0,0,0,1317,2186
5073,89,19,413,7,226,0,0,0,665,58,162,23,856,0,0,0,1099,1764
5073,90,10,299,5,158,0,0,0,472,38,121,12,743,0,0,0,914,1386
5073,91,8,261,0,151,0,0,0,420,29,96,6,660,0,0,0,791,1211
5073,92,8,209,3,136,0,0,0,356,31,53,8,564,0,0,0,656,1012
5073,93,5,133,2,115,0,0,0,255,43,45,11,486,0,0,0,585,840
5073,94,5,90,2,93,0,0,0,190,20,21,3,350,0,0,0,394,584
5073,95,4,62,0,60,0,0,0,126,18,20,2,282,0,0,0,322,448
5073,96,4,35,0,39,0,0,0,78,11,8,1,196,0,0,0,216,294
5073,97,2,23,1,33,0,0,0,59,7,6,0,137,0,0,0,150,209
5073,98,0,14,0,17,0,0,0,31,4,6,2,106,0,0,0,118,149
5073,99,0,8,0,13,0,0,0,21,9,7,0,83,0,0,0,99,120
5073,100,2,12,2,23,0,0,0,39,6,10,2,110,0,0,0,128,167
5073,999,133893,131831,8009,7090,135,3,1,280962,111736,131364,10660,32058,88,4,1,285911,566873
5133,0,1403,0,0,0,0,0,0,1403,1432,0,0,0,0,0,0,1432,2835
5133,1,1567,0,0,0,0,0,0,1567,1411,0,0,0,0,0,0,1411,2978
5133,2,1543,0,0,0,0,0,0,1543,1488,0,0,0,0,0,0,1488,3031
5133,3,1570,0,0,0,0,0,0,1570,1612,0,0,0,0,0,0,1612,3182
5133,4,1670,0,0,0,0,0,0,1670,1579,0,0,0,0,0,0,1579,3249
5133,5,1740,0,0,0,0,0,0,1740,1651,0,0,0,0,0,0,1651,3391
5133,6,1853,0,0,0,0,0,0,1853,1803,0,0,0,0,0,0,1803,3656
5133,7,2053,0,0,0,0,0,0,2053,1899,0,0,0,0,0,0,1899,3952
5133,8,1921,0,0,0,0,0,0,1921,1934,0,0,0,0,0,0,1934,3855
5133,9,1956,0,0,0,0,0,0,1956,1902,0,0,0,0,0,0,1902,3858
5133,10,2025,0,0,0,0,0,0,2025,1962,0,0,0,0,0,0,1962,3987
5133,11,2097,0,0,0,0,0,0,2097,2093,0,0,0,0,0,0,2093,4190
5133,12,2107,0,0,0,0,0,0,2107,2006,0,0,0,0,0,0,2006,4113
5133,13,2270,0,0,0,0,0,0,2270,2128,0,0,0,0,0,0,2128,4398
5133,14,2202,0,0,0,0,0,0,2202,2033,0,0,0,0,0,0,2033,4235
5133,15,2188,0,0,0,0,0,0,2188,2149,0,0,0,0,0,0,2149,4337
5133,16,2278,0,0,0,0,0,0,2278,2068,0,0,0,0,0,0,2068,4346
5133,17,2144,1,1,0,0,0,0,2146,2077,0,0,0,0,0,0,2077,4223
5133,18,2189,0,0,0,0,0,0,2189,2054,1,0,0,0,0,0,2055,4244
5133,19,2310,1,0,1,0,0,0,2312,2074,3,0,0,0,0,0,2077,4389
5133,20,2215,1,0,0,0,0,0,2216,2049,11,0,0,0,0,0,2060,4276
5133,21,2195,0,0,0,0,0,0,2195,2034,18,0,0,0,0,0,2052,4247
5133,22,2259,3,0,0,0,0,0,2262,1937,42,0,0,0,0,0,1979,4241
5133,23,2349,12,0,0,0,0,0,2361,2014,66,1,0,1,0,0,2082,4443
5133,24,2372,27,0,0,0,0,0,2399,2042,70,0,1,0,0,0,2113,4512
5133,25,2354,29,0,0,1,0,0,2384,2019,103,0,0,2,0,0,2124,4508
5133,26,2441,56,1,0,0,0,0,2498,1938,180,3,0,0,0,0,2121,4619
5133,27,2271,90,2,0,0,0,0,2363,1941,240,3,1,0,1,0,2186,4549
5133,28,2335,143,4,0,2,0,0,2484,1870,315,7,0,0,0,0,2192,4676
5133,29,2342,189,2,1,0,0,0,2534,1816,461,10,1,1,0,0,2289,4823
5133,30,2221,271,3,1,0,0,0,2496,1708,593,14,1,1,1,0,2318,4814
5133,31,2297,371,4,0,2,0,0,2674,1774,729,18,2,1,0,0,2524,5198
5133,32,2160,521,7,0,3,0,0,2691,1607,863,14,2,0,0,0,2486,5177
5133,33,2027,655,9,2,0,0,0,2693,1475,983,31,2,1,0,0,2492,5185
5133,34,2014,751,23,0,0,0,0,2788,1407,1169,38,5,0,0,0,2619,5407
5133,35,1851,886,26,1,3,0,0,2767,1307,1259,42,6,2,0,0,2616,5383
5133,36,1724,1039,20,2,2,0,0,2787,1242,1268,50,8,0,1,0,2569,5356
5133,37,1589,1098,22,2,2,0,0,2713,1170,1438,78,11,2,0,0,2699,5412
5133,38,1641,1166,34,0,1,1,0,2843,1040,1541,71,9,1,0,0,2662,5505
5133,39,1523,1304,49,4,0,0,0,2880,1037,1688,84,12,0,0,0,2821,5701
5133,40,1497,1483,67,1,3,0,0,3051,933,1820,89,18,0,0,0,2860,5911
5133,41,1437,1585,63,6,5,0,0,3096,873,1904,106,17,2,0,0,2902,5998
5133,42,1292,1660,69,5,1,0,0,3027,938,1942,123,27,0,0,0,3030,6057
5133,43,1273,1744,74,8,1,0,0,3100,804,2092,138,23,1,0,0,3058,6158
5133,44,1200,1769,112,3,2,0,0,3086,814,2133,157,47,0,0,0,3151,6237
5133,45,1170,1968,110,9,3,0,0,3260,805,2223,189,44,1,0,0,3262,6522
5133,46,1177,1982,112,8,2,0,0,3281,755,2262,192,53,0,0,0,3262,6543
5133,47,1087,2154,150,7,0,0,0,3398,718,2491,209,56,0,0,0,3474,6872
5133,48,1050,2273,170,17,3,0,0,3513,660,2557,216,48,0,0,0,3481,6994
5133,49,1100,2400,156,18,2,0,0,3676,647,2670,233,78,0,0,0,3628,7304
5133,50,920,2379,173,19,0,0,0,3491,641,2646,208,78,0,0,0,3573,7064
5133,51,858,2320,183,14,0,0,0,3375,526,2789,224,104,2,0,0,3645,7020
5133,52,830,2564,189,29,3,0,0,3615,541,2782,232,97,1,0,0,3653,7268
5133,53,743,2591,179,25,1,0,0,3539,489,2725,253,113,0,0,0,3580,7119
5133,54,718,2651,173,34,0,0,0,3576,458,2971,256,127,0,0,0,3812,7388
5133,55,645,2673,163,29,0,0,0,3510,424,2831,209,173,0,0,0,3637,7147
5133,56,617,2759,212,55,1,0,0,3644,414,2995,272,168,1,0,0,3850,7494
5133,57,532,2761,213,46,1,0,0,3553,371,2971,237,182,1,0,0,3762,7315
5133,58,460,2866,230,47,1,0,0,3604,341,2983,234,241,2,0,0,3801,7405
5133,59,434,2940,225,64,0,0,0,3663,348,3161,220,279,0,0,0,4008,7671
5133,60,403,2766,182,67,1,0,0,3419,284,2909,201,257,0,0,0,3651,7070
5133,61,373,2818,199,59,2,0,0,3451,297,2833,204,346,0,0,0,3680,7131
5133,62,350,2698,167,64,2,0,0,3281,313,2726,166,359,0,0,0,3564,6845
5133,63,332,2752,168,92,0,0,0,3344,229,2702,156,440,0,0,0,3527,6871
5133,64,294,2645,165,105,0,0,0,3209,217,2661,144,433,0,0,0,3455,6664
5133,65,273,2660,111,90,0,0,0,3134,208,2531,161,489,0,0,0,3389,6523
5133,66,269,2637,122,120,0,0,0,3148,209,2385,127,533,0,0,0,3254,6402
5133,67,230,2541,122,129,2,0,0,3024,168,2326,113,569,0,0,0,3176,6200
5133,68,221,2613,124,141,1,0,0,3100,164,2386,136,624,0,0,0,3310,6410
5133,69,193,2545,103,127,0,0,0,2968,168,2238,111,685,0,0,0,3202,6170
5133,70,190,2376,91,137,0,0,0,2794,177,2106,95,666,0,0,0,3044,5838
5133,71,168,2375,74,121,0,0,0,2738,179,1989,82,727,0,0,0,2977,5715
5133,72,151,2413,74,152,0,0,0,2790,143,1915,80,838,0,0,0,2976,5766
5133,73,118,2313,71,181,0,0,0,2683,143,1861,76,879,0,0,0,2959,5642
5133,74,135,2380,86,229,0,0,0,2830,127,1875,81,934,0,0,0,3017,5847
5133,75,129,2445,57,224,0,0,0,2855,139,1836,75,1100,0,0,0,3150,6005
5133,76,110,2301,55,220,0,0,0,2686,127,1624,60,1159,0,0,0,2970,5656
5133,77,87,1928,51,232,0,0,0,2298,117,1395,42,1148,0,0,0,2702,5000
5133,78,65,1282,31,152,0,0,0,1530,68,869,34,805,0,0,0,1776,3306
5133,79,64,1300,36,200,0,0,0,1600,89,878,31,991,0,0,0,1989,3589
5133,80,65,1287,21,185,0,0,0,1558,92,824,36,999,0,0,0,1951,3509
5133,81,59,1142,12,174,0,0,0,1387,71,667,27,969,0,0,0,1734,3121
5133,82,40,1040,18,204,0,0,0,1302,81,633,22,1016,0,0,0,1752,3054
5133,83,65,1212,22,255,0,0,0,1554,79,605,23,1140,0,0,0,1847,3401
5133,84,46,1014,16,256,0,0,0,1332,82,543,20,1254,0,0,0,1899,3231
5133,85,34,862,10,246,0,0,0,1152,74,428,13,1231,0,0,0,1746,2898
5133,86,33,743,9,244,0,0,0,1029,74,361,15,1080,0,0,0,1530,2559
5133,87,28,600,7,208,0,0,0,843,50,281,9,1007,0,0,0,1347,2190
5133,88,18,506,7,205,0,0,0,736,54,208,10,945,0,0,0,1217,1953
5133,89,20,420,1,204,0,0,0,645,51,165,8,940,0,0,0,1164,1809
5133,90,13,343,5,186,0,0,0,547,37,118,5,777,0,0,0,937,1484
5133,91,10,217,2,156,0,0,0,385,38,109,3,625,0,0,0,775,1160
5133,92,10,190,2,146,0,0,0,348,37,61,2,554,0,0,0,654,1002
5133,93,1,124,1,120,0,0,0,246,26,45,0,490,0,0,0,561,807
5133,94,4,74,0,81,0,0,0,159,20,33,3,366,0,0,0,422,581
5133,95,3,48,0,74,0,0,0,125,26,14,3,257,0,0,0,300,425
5133,96,4,28,0,51,0,0,0,83,19,13,3,189,0,0,0,224,307
5133,97,0,21,0,31,0,0,0,52,11,7,2,180,0,0,0,200,252
5133,98,3,10,0,17,0,0,0,30,9,4,2,94,0,0,0,109,139
5133,99,1,7,0,15,0,0,0,23,11,6,0,83,0,0,0,100,123
5133,100,1,6,0,29,0,0,0,36,10,9,0,111,0,0,0,130,166
5133,999,104919,111818,5452,6387,53,1,0,228630,87800,111168,6842,30323,23,3,0,236159,464789
5263,0,850,0,0,0,0,0,0,850,820,0,0,0,0,0,0,820,1670
5263,1,919,0,0,0,0,0,0,919,874,0,0,0,0,0,0,874,1793
5263,2,865,0,0,0,0,0,0,865,780,0,0,0,0,0,0,780,1645
5263,3,943,0,0,0,0,0,0,943,866,0,0,0,0,0,0,866,1809
5263,4,989,0,0,0,0,0,0,989,990,0,0,0,0,0,0,990,1979
5263,5,962,0,0,0,0,0,0,962,942,0,0,0,0,0,0,942,1904
5263,6,1023,0,0,0,0,0,0,1023,1013,0,0,0,0,0,0,1013,2036
5263,7,1046,0,0,0,0,0,0,1046,1019,0,0,0,0,0,0,1019,2065
5263,8,1059,0,0,0,0,0,0,1059,969,0,0,0,0,0,0,969,2028
5263,9,1046,0,0,0,0,0,0,1046,970,0,0,0,0,0,0,970,2016
5263,10,1119,0,0,0,0,0,0,1119,1047,0,0,0,0,0,0,1047,2166
5263,11,1118,0,0,0,0,0,0,1118,1024,0,0,0,0,0,0,1024,2142
5263,12,1216,0,0,0,0,0,0,1216,1063,0,0,0,0,0,0,1063,2279
5263,13,1157,0,0,0,0,0,0,1157,1163,0,0,0,0,0,0,1163,2320
5263,14,1224,0,0,0,0,0,0,1224,1171,0,0,0,0,0,0,1171,2395
5263,15,1231,0,0,0,0,0,0,1231,1151,0,0,0,0,0,0,1151,2382
5263,16,1258,0,0,0,0,0,0,1258,1254,0,0,0,0,0,0,1254,2512
5263,17,1314,0,0,0,0,0,0,1314,1184,0,0,0,0,0,0,1184,2498
5263,18,1376,0,0,0,0,0,0,1376,1200,0,0,0,0,0,0,1200,2576
5263,19,1466,0,0,0,0,0,0,1466,1214,2,0,0,0,0,0,1216,2682
5263,20,1431,0,0,0,0,0,0,1431,1233,7,0,0,0,0,0,1240,2671
5263,21,1433,3,0,0,0,0,0,1436,1302,13,0,0,0,0,0,1315,2751
5263,22,1406,8,0,0,0,0,0,1414,1273,18,0,0,0,0,0,1291,2705
5263,23,1546,6,0,0,0,0,0,1552,1313,22,0,0,0,0,0,1335,2887
5263,24,1411,17,1,1,0,0,0,1430,1286,54,0,0,0,0,0,1340,2770
5263,25,1429,15,0,0,0,0,0,1444,1275,76,0,0,0,0,0,1351,2795
5263,26,1444,36,0,0,1,0,0,1481,1272,101,0,0,0,0,0,1373,2854
5263,27,1460,51,0,0,0,0,0,1511,1184,150,2,0,0,0,0,1336,2847
5263,28,1393,83,1,0,1,0,0,1478,1113,211,4,0,0,0,0,1328,2806
5263,29,1405,134,2,0,0,0,0,1541,1059,292,0,1,1,0,0,1353,2894
5263,30,1272,205,2,1,1,0,0,1481,1067,367,5,1,0,0,0,1440,2921
5263,31,1329,270,6,0,0,0,0,1605,946,494,3,2,0,0,0,1445,3050
5263,32,1231,353,2,1,0,0,0,1587,897,533,5,1,1,0,0,1437,3024
5263,33,1178,396,8,0,0,0,0,1582,822,673,21,2,2,0,0,1520,3102
5263,34,1054,491,11,0,0,0,0,1556,716,721,13,3,1,0,0,1454,3010
5263,35,1047,580,4,0,0,0,0,1631,666,813,28,5,1,0,0,1513,3144
5263,36,924,585,6,0,0,0,0,1515,561,846,26,3,0,0,0,1436,2951
5263,37,843,646,15,1,0,0,0,1505,495,869,36,5,0,0,0,1405,2910
5263,38,779,746,17,0,0,0,0,1542,512,923,35,6,2,0,0,1478,3020
5263,39,757,823,15,1,0,0,0,1596,486,992,47,8,1,0,0,1534,3130
5263,40,684,832,22,2,0,0,0,1540,431,1047,62,12,1,0,0,1553,3093
5263,41,680,891,23,1,0,0,0,1595,398,1061,49,13,0,0,0,1521,3116
5263,42,646,935,25,5,0,0,0,1611,403,1140,42,12,0,0,0,1597,3208
5263,43,608,942,26,4,0,0,0,1580,365,1167,47,8,0,0,0,1587,3167
5263,44,553,1040,31,3,0,0,0,1627,323,1239,65,25,0,0,0,1652,3279
5263,45,580,1042,27,4,0,0,0,1653,336,1278,70,14,0,0,0,1698,3351
5263,46,528,1076,48,5,0,0,0,1657,357,1345,68,22,1,0,0,1793,3450
5263,47,527,1295,44,4,0,0,0,1870,330,1373,77,40,0,0,0,1820,3690
5263,48,515,1233,65,7,1,0,0,1821,285,1490,92,39,0,0,0,1906,3727
5263,49,493,1303,70,4,0,0,0,1870,307,1522,91,43,0,0,0,1963,3833
5263,50,502,1365,75,12,0,0,0,1954,290,1509,97,49,0,0,0,1945,3899
5263,51,450,1355,67,10,2,0,0,1884,272,1586,104,49,1,0,0,2012,3896
5263,52,421,1420,80,20,0,0,0,1941,256,1617,103,67,0,0,0,2043,3984
5263,53,395,1495,91,18,1,0,0,2000,252,1681,96,81,0,0,0,2110,4110
5263,54,398,1552,80,17,0,0,0,2047,292,1711,114,98,0,0,0,2215,4262
5263,55,354,1627,76,22,0,1,0,2080,265,1682,104,98,1,0,0,2150,4230
5263,56,354,1609,90,19,0,0,0,2072,251,1761,99,122,0,0,0,2233,4305
5263,57,320,1700,89,22,0,0,0,2131,241,1747,115,136,0,0,0,2239,4370
5263,58,275,1759,81,34,0,0,0,2149,218,1743,91,155,0,0,0,2207,4356
5263,59,308,1757,83,39,2,0,0,2189,251,1818,99,202,0,0,0,2370,4559
5263,60,249,1715,95,43,0,0,0,2102,217,1689,89,171,2,0,0,2168,4270
5263,61,218,1666,66,44,0,0,0,1994,177,1587,80,188,0,0,0,2032,4026
5263,62,200,1685,68,35,1,0,0,1989,185,1621,70,209,0,0,0,2085,4074
5263,63,189,1615,73,40,0,0,0,1917,155,1562,54,215,0,0,0,1986,3903
5263,64,189,1571,37,66,0,0,0,1863,158,1483,60,265,1,0,0,1967,3830
5263,65,163,1440,53,36,0,0,0,1692,151,1314,60,288,0,0,0,1813,3505
5263,66,140,1423,55,46,0,0,0,1664,135,1279,61,294,0,0,0,1769,3433
5263,67,119,1336,51,74,0,0,0,1580,120,1235,40,292,0,0,0,1687,3267
5263,68,138,1399,52,75,0,0,0,1664,118,1174,47,308,1,0,0,1648,3312
5263,69,115,1320,45,70,0,0,0,1550,116,1177,45,349,0,0,0,1687,3237
5263,70,93,1238,34,70,0,0,0,1435,98,1073,25,361,0,0,0,1557,2992
5263,71,77,1205,27,71,1,0,0,1381,94,1055,36,367,0,0,0,1552,2933
5263,72,85,1216,20,83,0,0,0,1404,88,953,26,398,0,0,0,1465,2869
5263,73,78,1203,39,91,0,0,0,1411,95,908,33,494,1,0,0,1531,2942
5263,74,72,1217,25,94,0,0,0,1408,69,936,36,547,0,0,0,1588,2996
5263,75,67,1166,32,113,0,0,0,1378,91,954,28,583,0,0,0,1656,3034
5263,76,73,1154,20,124,0,0,0,1371,94,810,19,604,0,0,0,1527,2898
5263,77,56,1038,16,121,0,0,0,1231,75,726,19,577,0,0,0,1397,2628
5263,78,44,740,12,94,0,0,0,890,56,536,10,474,0,0,0,1076,1966
5263,79,26,683,9,100,0,0,0,818,57,489,14,532,0,0,0,1092,1910
5263,80,34,752,6,106,0,0,0,898,71,443,10,581,0,0,0,1105,2003
5263,81,35,597,10,98,0,0,0,740,52,385,13,497,0,0,0,947,1687
5263,82,29,553,9,102,0,0,0,693,48,363,7,577,0,0,0,995,1688
5263,83,42,634,7,171,0,0,0,854,69,381,11,700,0,0,0,1161,2015
5263,84,22,565,11,154,0,0,0,752,71,331,11,750,0,0,0,1163,1915
5263,85,14,501,4,148,0,0,0,667,57,275,6,620,0,0,0,958,1625
5263,86,31,443,5,167,0,0,0,646,56,213,7,663,0,0,0,939,1585
5263,87,18,347,3,146,0,0,0,514,52,160,5,601,0,0,0,818,1332
5263,88,10,273,2,144,0,0,0,429,47,138,6,589,0,0,0,780,1209
5263,89,14,214,3,135,0,0,0,366,41,92,4,527,0,0,0,664,1030
5263,90,8,172,0,108,0,0,0,288,38,80,7,517,0,0,0,642,930
5263,91,4,147,1,119,0,0,0,271,32,61,2,405,0,0,0,500,771
5263,92,10,99,0,80,0,0,0,189,36,56,2,404,0,0,0,498,687
5263,93,4,80,0,90,0,0,0,174,28,31,1,344,0,0,0,404,578
5263,94,3,49,0,56,0,0,0,108,17,23,1,229,0,0,0,270,378
5263,95,1,31,0,38,0,0,0,70,15,14,1,191,0,0,0,221,291
5263,96,2,16,0,28,0,0,0,46,18,9,1,143,0,0,0,171,217
5263,97,1,17,0,20,0,0,0,38,4,4,1,85,0,0,0,94,132
5263,98,1,9,0,12,0,0,0,22,7,2,1,84,0,0,0,94,116
5263,99,0,2,0,8,0,0,0,10,2,0,0,52,0,0,0,54,64
5263,100,1,1,0,19,0,0,0,21,14,5,0,77,0,0,0,96,117
5263,999,59219,63208,2173,3696,11,1,0,128308,49439,63321,2859,17474,18,0,0,133111,261419
5347,0,12046,0,0,0,0,0,0,12046,11441,0,0,0,0,0,0,11441,23487
5347,1,12600,0,0,0,0,0,0,12600,11966,0,0,0,0,0,0,11966,24566
5347,2,12396,0,0,0,0,0,0,12396,11738,0,0,0,0,0,0,11738,24134
5347,3,12875,0,0,0,0,0,0,12875,12160,0,0,0,0,0,0,12160,25035
5347,4,13325,0,0,0,0,0,0,13325,12741,0,0,0,0,0,0,12741,26066
5347,5,13820,0,0,0,0,0,0,13820,12760,0,0,0,0,0,0,12760,26580
5347,6,14144,0,0,0,0,0,0,14144,13620,0,0,0,0,0,0,13620,27764
5347,7,14293,0,0,0,0,0,0,14293,13484,0,0,0,0,0,0,13484,27777
5347,8,14551,0,0,0,0,0,0,14551,13852,0,0,0,0,0,0,13852,28403
5347,9,14792,0,0,0,0,0,0,14792,13954,0,0,0,0,0,0,13954,28746
5347,10,15124,0,0,0,0,0,0,15124,14287,0,0,0,0,0,0,14287,29411
5347,11,15963,0,0,0,0,0,0,15963,14968,0,0,0,0,0,0,14968,30931
5347,12,16262,0,0,0,0,0,0,16262,15361,0,0,0,0,0,0,15361,31623
5347,13,16995,0,0,0,0,0,0,16995,15409,0,0,0,0,0,0,15409,32404
5347,14,17054,0,0,0,0,0,0,17054,16350,0,0,0,0,0,0,16350,33404
5347,15,17328,0,0,0,0,0,0,17328,16464,0,0,0,0,0,0,16464,33792
5347,16,17803,3,1,0,0,0,0,17807,17047,1,0,0,0,0,0,17048,34855
5347,17,18218,1,1,0,0,0,0,18220,16838,1,0,0,0,0,0,16839,35059
5347,18,18177,2,1,0,0,0,0,18180,17169,12,0,0,0,0,0,17181,35361
5347,19,18751,4,0,0,0,0,0,18755,17524,27,0,0,0,0,0,17551,36306
5347,20,18381,20,2,1,0,0,0,18404,17467,63,1,0,0,0,0,17531,35935
5347,21,17980,29,1,0,0,0,0,18010,16948,118,3,0,1,0,0,17070,35080
5347,22,18242,67,0,0,0,0,0,18309,16692,280,1,0,1,0,0,16974,35283
5347,23,18218,134,0,1,1,0,0,18354,16755,430,1,0,1,0,0,17187,35541
5347,24,17895,281,3,0,1,0,0,18180,16238,721,3,1,1,0,0,16964,35144
5347,25,17698,403,5,1,0,0,0,18107,15701,1151,12,2,0,0,0,16866,34973
5347,26,16932,619,5,1,2,0,0,17559,14966,1732,11,2,1,0,0,16712,34271
5347,27,16413,1071,12,0,4,0,0,17500,14200,2471,19,4,3,0,0,16697,34197
5347,28,15480,1581,9,0,7,0,0,17077,13591,3438,20,2,4,1,0,17056,34133
5347,29,15082,2204,11,1,11,0,0,17309,12446,4444,47,6,5,1,0,16949,34258
5347,30,14056,3063,23,0,8,1,0,17151,11540,5624,64,7,6,0,0,17241,34392
5347,31,13776,4161,38,3,8,0,0,17986,10902,7238,82,13,8,2,0,18245,36231
5347,32,12808,5054,41,3,8,0,0,17914,9705,8258,123,22,6,1,0,18115,36029
5347,33,11587,6145,70,8,10,0,0,17820,8555,9039,148,24,13,1,0,17780,35600
5347,34,10622,7034,76,10,10,1,0,17753,7701,9970,209,40,11,0,0,17931,35684
5347,35,10158,7734,114,15,13,0,0,18034,7032,11056,246,45,26,2,0,18407,36441
5347,36,9047,8653,142,9,19,0,0,17870,6157,11176,266,70,12,2,0,17683,35553
5347,37,8089,9206,162,17,17,0,0,17491,5506,11714,310,61,14,0,0,17605,35096
5347,38,7816,10288,194,26,20,0,0,18344,5104,12545,379,71,6,0,0,18105,36449
5347,39,7264,10630,225,25,10,0,0,18154,4856,13370,429,105,18,0,0,18778,36932
5347,40,6734,11474,260,25,10,1,0,18504,4558,13848,468,109,10,2,0,18995,37499
5347,41,6729,12354,287,36,9,1,0,19416,4294,14539,531,168,7,0,0,19539,38955
5347,42,5909,12130,332,57,13,1,0,18442,4080,14609,593,145,4,1,0,19432,37874
5347,43,5775,13071,358,46,11,0,0,19261,3737,15047,647,210,4,1,0,19646,38907
5347,44,5520,13419,436,60,13,2,0,19450,3667,15598,727,241,14,3,0,20250,39700
5347,45,5332,14113,398,66,12,0,0,19921,3562,16197,770,304,9,0,0,20842,40763
5347,46,5279,14685,492,80,19,2,0,20557,3542,16650,850,358,7,1,0,21408,41965
5347,47,5085,15236,548,92,13,0,0,20974,3677,17063,896,402,2,0,0,22040,43014
5347,48,5205,16304,621,98,24,0,1,22253,3536,17769,979,507,6,0,0,22797,45050
5347,49,4959,17041,656,137,10,0,0,22803,3631,18724,1085,605,8,0,0,24053,46856
5347,50,4566,16794,681,130,15,0,0,22186,3395,18543,1083,639,16,0,0,23676,45862
5347,51,4373,17290,712,158,15,1,0,22549,3263,18516,1121,736,2,1,0,23639,46188
5347,52,4036,16966,775,183,19,0,0,21979,3190,18593,1182,842,9,1,0,23817,45796
5347,53,3691,16999,762,195,21,1,0,21669,3012,18227,1188,868,6,0,0,23301,44970
5347,54,3524,17619,775,220,13,0,0,22151,2919,18396,1136,1094,4,1,0,23550,45701
5347,55,3182,17557,773,264,11,1,0,21788,2780,18413,1123,1104,5,0,0,23425,45213
5347,56,3031,17901,818,273,10,0,0,22033,2885,18689,1294,1298,9,0,0,24175,46208
5347,57,2831,18301,818,358,17,0,0,22325,2784,18596,1157,1516,1,0,0,24054,46379
5347,58,2628,18169,812,364,16,0,0,21989,2664,18300,1215,1642,3,0,0,23824,45813
5347,59,2551,18570,805,444,16,0,0,22386,2548,18484,1218,1992,3,0,0,24245,46631
5347,60,2212,17279,742,504,12,0,0,20749,2445,17422,1081,2048,0,0,0,22996,43745
5347,61,1956,17074,738,489,13,0,0,20270,2309,16866,993,2230,2,0,0,22400,42670
5347,62,1766,16500,654,546,14,0,0,19480,2116,16106,1033,2368,2,0,0,21625,41105
5347,63,1609,15345,642,555,11,0,0,18162,2003,15159,918,2489,1,0,0,20570,38732
5347,64,1462,15393,604,611,11,1,0,18082,1946,14561,876,2760,5,0,0,20148,38230
5347,65,1273,14658,517,643,10,0,0,17101,1869,13619,800,2929,2,0,0,19219,36320
5347,66,1203,14427,517,751,9,0,0,16907,1701,13406,843,3086,0,0,0,19036,35943
5347,67,1078,13584,435,765,7,0,0,15869,1529,12352,756,3296,2,0,0,17935,33804
5347,68,928,13888,440,800,3,1,0,16060,1580,12377,691,3636,1,0,0,18285,34345
5347,69,893,13680,386,911,7,0,0,15877,1521,11814,664,3826,0,1,0,17826,33703
5347,70,773,12289,368,892,6,0,0,14328,1325,10590,560,3796,0,0,0,16271,30599
5347,71,736,11725,306,901,5,0,0,13673,1311,9816,565,4010,3,0,0,15705,29378
5347,72,597,11437,287,986,5,0,0,13312,1250,9404,517,4325,0,1,0,15497,28809
5347,73,577,11451,262,1093,3,0,0,13386,1279,9238,481,4633,1,0,0,15632,29018
5347,74,573,11195,244,1153,4,0,0,13169,1199,8844,444,4924,0,0,0,15411,28580
5347,75,549,11058,231,1378,3,0,0,13219,1233,8362,441,5459,2,0,0,15497,28716
5347,76,463,10202,214,1333,3,0,0,12215,1235,7649,388,5753,0,0,0,15025,27240
5347,77,431,10041,191,1529,3,0,1,12196,1112,7395,325,6307,1,0,0,15140,27336
5347,78,350,8258,125,1447,3,0,0,10183,998,5879,297,5603,0,0,0,12777,22960
5347,79,251,6164,119,1178,0,0,1,7713,760,4187,223,4919,0,0,0,10089,17802
5347,80,256,6327,99,1318,0,0,0,8000,877,4251,200,5508,1,0,0,10837,18837
5347,81,240,5558,93,1290,1,0,0,7182,804,3569,200,5386,0,0,0,9959,17141
5347,82,202,4858,75,1334,0,0,0,6469,728,3123,160,5366,1,0,0,9378,15847
5347,83,192,4634,55,1366,1,0,0,6248,788,2729,128,5621,0,1,0,9267,15515
5347,84,164,3896,54,1347,0,0,0,5461,655,2385,116,5385,0,0,0,8541,14002
5347,85,144,3221,56,1259,2,0,1,4683,652,1844,93,5018,0,0,0,7607,12290
5347,86,122,2678,31,1105,0,0,0,3936,509,1426,106,4457,0,0,0,6498,10434
5347,87,90,2025,26,1014,0,0,0,3155,456,990,77,4015,0,0,0,5538,8693
5347,88,72,1678,17,963,0,0,0,2730,421,828,62,3728,0,0,0,5039,7769
5347,89,72,1319,7,808,0,0,0,2206,391,608,49,3207,0,0,0,4255,6461
5347,90,52,1006,14,732,0,0,0,1804,342,429,36,2893,0,0,0,3700,5504
5347,91,44,725,6,631,0,0,0,1406,264,316,35,2408,0,0,0,3023,4429
5347,92,20,517,5,543,1,0,0,1086,240,220,27,1972,0,0,0,2459,3545
5347,93,30,330,5,430,0,0,0,795,167,151,24,1617,0,0,0,1959,2754
5347,94,24,238,4,289,0,0,0,555,158,111,21,1216,0,0,0,1506,2061
5347,95,13,150,3,206,0,0,0,372,99,76,13,897,0,0,0,1085,1457
5347,96,5,84,0,134,0,0,0,223,78,27,7,617,0,0,0,729,952
5347,97,4,43,0,91,0,0,0,138,56,25,4,406,0,0,0,491,629
5347,98,7,29,1,66,0,0,0,103,37,26,8,292,0,0,0,363,466
5347,99,9,17,0,47,0,0,0,73,30,17,1,188,0,0,0,236,309
5347,100,19,35,0,63,0,0,0,117,66,37,4,350,0,0,0,457,574
5347,999,696462,689396,21828,36908,573,14,4,1445185,627458,707914,35904,154199,290,24,0,1525789,2970974
5398,0,1310,0,0,0,0,0,0,1310,1257,0,0,0,0,0,0,1257,2567
5398,1,1345,0,0,0,0,0,0,1345,1270,0,0,0,0,0,0,1270,2615
5398,2,1352,0,0,0,0,0,0,1352,1231,0,0,0,0,0,0,1231,2583
5398,3,1366,0,0,0,0,0,0,1366,1273,0,0,0,0,0,0,1273,2639
5398,4,1398,0,0,0,0,0,0,1398,1406,0,0,0,0,0,0,1406,2804
5398,5,1452,0,0,0,0,0,0,1452,1447,0,0,0,0,0,0,1447,2899
5398,6,1563,0,0,0,0,0,0,1563,1540,0,0,0,0,0,0,1540,3103
5398,7,1592,0,0,0,0,0,0,1592,1514,0,0,0,0,0,0,1514,3106
5398,8,1545,0,0,0,0,0,0,1545,1444,0,0,0,0,0,0,1444,2989
5398,9,1611,0,0,0,0,0,0,1611,1470,0,0,0,0,0,0,1470,3081
5398,10,1614,0,0,0,0,0,0,1614,1611,0,0,0,0,0,0,1611,3225
5398,11,1704,0,0,0,0,0,0,1704,1611,0,0,0,0,0,0,1611,3315
5398,12,1708,0,0,0,0,0,0,1708,1636,0,0,0,0,0,0,1636,3344
5398,13,1857,0,0,0,0,0,0,1857,1703,0,0,0,0,0,0,1703,3560
5398,14,1886,0,0,0,0,0,0,1886,1786,0,0,0,0,0,0,1786,3672
5398,15,1867,0,0,0,0,0,0,1867,1840,0,0,0,0,0,0,1840,3707
5398,16,1969,0,0,0,0,0,0,1969,1808,0,0,0,0,0,0,1808,3777
5398,17,2002,0,0,0,0,0,0,2002,1851,0,0,0,0,0,0,1851,3853
5398,18,2126,0,0,0,0,0,0,2126,1811,0,0,0,0,0,0,1811,3937
5398,19,2146,1,0,0,0,0,0,2147,1968,2,0,0,0,0,0,1970,4117
5398,20,2148,1,0,0,0,0,0,2149,1981,7,0,0,0,0,0,1988,4137
5398,21,2154,1,0,0,0,0,0,2155,1941,13,0,0,0,0,0,1954,4109
5398,22,2116,3,0,0,0,0,0,2119,1929,20,0,0,0,0,0,1949,4068
5398,23,2163,8,1,0,0,0,0,2172,1980,41,4,0,0,0,0,2025,4197
5398,24,2266,15,1,0,0,0,0,2282,1972,49,0,0,0,0,0,2021,4303
5398,25,2257,37,1,0,0,0,0,2295,1986,90,1,0,2,0,0,2079,4374
5398,26,2207,54,1,0,1,0,0,2263,1889,147,3,2,1,0,0,2042,4305
5398,27,2243,77,0,0,0,0,0,2320,1861,215,2,0,2,0,0,2080,4400
5398,28,2036,111,1,0,0,0,0,2148,1755,295,1,2,0,0,0,2053,4201
5398,29,2011,151,1,0,0,0,0,2163,1650,428,4,0,0,0,0,2082,4245
5398,30,2111,263,1,1,0,0,0,2376,1560,541,9,2,0,0,0,2112,4488
5398,31,2060,378,5,0,0,0,0,2443,1559,764,16,0,0,0,0,2339,4782
5398,32,1909,471,5,1,0,0,0,2386,1326,877,19,2,1,0,0,2225,4611
5398,33,1784,628,10,0,0,0,0,2422,1292,1000,15,0,0,0,0,2307,4729
5398,34,1683,733,10,1,1,0,0,2428,1148,1098,36,10,1,0,0,2293,4721
5398,35,1618,823,11,1,1,0,0,2454,1062,1210,35,3,3,0,0,2313,4767
5398,36,1387,923,22,1,0,0,0,2333,884,1329,48,6,0,0,0,2267,4600
5398,37,1290,1049,24,1,1,0,0,2365,821,1347,44,9,1,0,0,2222,4587
5398,38,1287,1220,29,3,1,0,0,2540,836,1466,45,13,0,0,0,2360,4900
5398,39,1155,1219,42,1,0,0,0,2417,744,1597,52,9,1,0,0,2403,4820
5398,40,1054,1262,36,2,0,0,0,2354,689,1643,55,14,1,0,0,2402,4756
5398,41,1049,1434,42,1,0,0,0,2526,648,1625,71,15,0,1,0,2360,4886
5398,42,1005,1471,57,4,0,0,0,2537,579,1808,90,23,0,0,0,2500,5037
5398,43,952,1497,50,3,1,0,0,2503,508,1721,91,23,0,0,0,2343,4846
5398,44,904,1651,57,1,2,0,0,2615,554,1874,108,24,0,1,0,2561,5176
5398,45,819,1685,61,11,2,0,0,2578,501,2125,127,44,0,0,0,2797,5375
5398,46,846,1806,74,12,1,0,0,2739,532,2090,101,36,1,0,0,2760,5499
5398,47,816,1916,75,12,2,0,0,2821,492,2213,125,51,0,0,0,2881,5702
5398,48,779,1955,98,11,0,0,0,2843,506,2328,147,62,1,0,0,3044,5887
5398,49,733,2068,91,16,1,0,0,2909,462,2319,134,72,0,0,0,2987,5896
5398,50,667,2035,108,13,2,0,0,2825,435,2367,144,74,0,0,0,3020,5845
5398,51,699,2212,91,19,0,0,0,3021,408,2426,152,92,0,0,0,3078,6099
5398,52,629,2285,103,18,1,0,0,3036,429,2520,144,112,0,0,0,3205,6241
5398,53,554,2244,124,30,0,0,0,2952,399,2527,162,120,0,0,0,3208,6160
5398,54,580,2417,123,29,0,0,0,3149,371,2541,170,146,0,0,0,3228,6377
5398,55,533,2515,119,30,1,0,0,3198,407,2669,173,154,0,0,0,3403,6601
5398,56,498,2543,99,29,1,0,0,3170,369,2653,145,173,0,0,0,3340,6510
5398,57,497,2579,118,56,0,0,0,3250,378,2641,141,170,0,0,0,3330,6580
5398,58,446,2743,120,47,1,0,0,3357,339,2633,131,216,0,0,0,3319,6676
5398,59,443,2790,126,49,1,0,0,3409,348,2795,143,275,0,0,0,3561,6970
5398,60,410,2661,113,65,0,0,0,3249,330,2510,143,268,0,0,0,3251,6500
5398,61,381,2491,110,50,1,0,0,3033,308,2467,117,303,0,0,0,3195,6228
5398,62,313,2573,104,76,0,0,0,3066,288,2417,119,320,0,0,0,3144,6210
5398,63,297,2466,99,73,0,0,0,2935,313,2322,96,380,0,1,0,3112,6047
5398,64,303,2382,82,86,0,0,0,2853,294,2280,103,350,0,0,0,3027,5880
5398,65,234,2278,72,85,0,0,0,2669,221,2083,101,359,0,0,0,2764,5433
5398,66,231,2210,66,112,1,0,0,2620,236,1972,77,446,0,0,0,2731,5351
5398,67,179,2111,63,81,0,0,0,2434,215,1922,81,471,0,0,0,2689,5123
5398,68,172,2133,82,108,0,0,0,2495,178,1732,83,494,0,0,0,2487,4982
5398,69,148,2035,53,106,0,0,0,2342,187,1754,75,517,0,0,0,2533,4875
5398,70,151,1942,50,120,0,0,0,2263,163,1609,41,545,0,0,0,2358,4621
5398,71,136,1856,61,100,0,0,0,2153,172,1547,57,582,0,0,0,2358,4511
5398,72,136,1818,48,148,0,0,0,2150,163,1440,45,581,0,0,0,2229,4379
5398,73,129,1766,44,148,0,0,0,2087,151,1430,53,668,0,0,0,2302,4389
5398,74,105,1737,39,148,0,0,1,2030,148,1301,35,727,0,0,0,2211,4241
5398,75,103,1735,41,186,0,0,0,2065,146,1261,43,822,0,0,0,2272,4337
5398,76,75,1615,35,167,0,0,0,1892,145,1168,43,875,0,0,0,2231,4123
5398,77,79,1632,38,183,0,0,0,1932,135,1072,41,877,0,0,0,2125,4057
5398,78,63,1084,22,157,1,0,0,1327,91,757,18,686,0,0,0,1552,2879
5398,79,51,1085,17,161,0,0,0,1314,87,691,18,708,0,0,0,1504,2818
5398,80,58,968,8,151,0,0,0,1185,93,673,21,812,0,0,0,1599,2784
5398,81,41,883,15,202,0,0,0,1141,91,592,18,814,0,0,0,1515,2656
5398,82,36,826,13,177,0,0,0,1052,80,460,20,789,0,0,0,1349,2401
5398,83,52,856,18,215,0,0,0,1141,89,559,18,939,0,0,0,1605,2746
5398,84,35,828,7,220,0,0,0,1090,99,501,15,1010,1,0,0,1626,2716
5398,85,33,694,5,219,0,0,0,951,76,370,12,909,0,0,0,1367,2318
5398,86,25,575,7,222,0,0,0,829,74,285,13,943,0,0,0,1315,2144
5398,87,28,480,4,227,0,0,0,739,72,264,5,809,0,0,0,1150,1889
5398,88,21,392,7,200,0,0,0,620,49,207,3,825,0,0,0,1084,1704
5398,89,15,327,6,190,0,0,0,538,51,151,2,717,0,0,0,921,1459
5398,90,15,267,3,179,0,0,0,464,46,130,6,670,0,0,0,852,1316
5398,91,10,173,2,149,0,0,0,334,35,83,5,583,0,0,0,706,1040
5398,92,9,139,2,117,0,0,0,267,35,72,4,506,0,0,0,617,884
5398,93,8,94,0,115,0,0,0,217,35,39,2,472,0,0,0,548,765
5398,94,5,62,0,79,0,0,0,146,23,33,3,292,0,0,0,351,497
5398,95,1,46,1,52,0,0,0,100,20,17,0,245,0,0,0,282,382
5398,96,0,24,0,43,0,0,0,67,14,8,2,188,0,0,0,212,279
5398,97,0,23,0,33,0,0,0,56,9,7,2,137,0,0,0,155,211
5398,98,3,6,1,19,0,0,0,29,4,9,1,108,0,0,0,122,151
5398,99,2,8,0,17,0,0,0,27,5,3,1,69,0,0,0,78,105
5398,100,4,16,0,27,0,0,0,47,5,23,0,111,0,0,0,139,186
5398,999,89898,96571,3275,5616,24,0,1,195385,75983,96275,4430,24881,16,3,0,201588,396973
5624,0,3950,0,0,0,0,0,0,3950,3733,0,0,0,0,0,0,3733,7683
5624,1,3989,0,0,0,0,0,0,3989,3784,0,0,0,0,0,0,3784,7773
5624,2,4027,0,0,0,0,0,0,4027,3821,0,0,0,0,0,0,3821,7848
5624,3,4146,0,0,0,0,0,0,4146,3987,0,0,0,0,0,0,3987,8133
5624,4,4417,0,0,0,0,0,0,4417,4108,0,0,0,0,0,0,4108,8525
5624,5,4468,0,0,0,0,0,0,4468,4079,0,0,0,0,0,0,4079,8547
5624,6,4720,0,0,0,0,0,0,4720,4242,0,0,0,0,0,0,4242,8962
5624,7,4633,0,0,0,0,0,0,4633,4352,0,0,0,0,0,0,4352,8985
5624,8,4683,0,0,0,0,0,0,4683,4389,0,0,0,0,0,0,4389,9072
5624,9,4898,0,0,0,0,0,0,4898,4494,0,0,0,0,0,0,4494,9392
5624,10,4649,0,0,0,0,0,0,4649,4613,0,0,0,0,0,0,4613,9262
5624,11,5078,0,0,0,0,0,0,5078,4694,0,0,0,0,0,0,4694,9772
5624,12,5120,0,0,0,0,0,0,5120,4829,0,0,0,0,0,0,4829,9949
5624,13,5162,0,0,0,0,0,0,5162,4844,0,0,0,0,0,0,4844,10006
5624,14,5311,0,0,0,0,0,0,5311,4964,0,0,0,0,0,0,4964,10275
5624,15,5314,0,0,0,0,0,0,5314,5144,0,0,0,0,0,0,5144,10458
5624,16,5408,1,0,0,0,0,0,5409,5112,0,0,0,0,0,0,5112,10521
5624,17,5543,0,0,0,0,0,0,5543,5103,0,0,0,0,0,0,5103,10646
5624,18,5584,0,0,0,0,0,0,5584,5328,0,0,0,0,0,0,5328,10912
5624,19,5831,1,0,0,0,0,0,5832,5387,12,0,0,0,0,0,5399,11231
5624,20,5760,4,0,0,0,0,0,5764,5426,15,0,0,0,0,0,5441,11205
5624,21,5732,9,0,0,0,0,0,5741,5290,55,0,1,0,0,0,5346,11087
5624,22,5905,16,2,0,0,0,0,5923,5328,82,0,0,1,0,0,5411,11334
5624,23,6127,31,1,0,0,0,0,6159,5335,144,1,0,0,0,0,5480,11639
5624,24,6106,49,3,0,1,0,0,6159,5284,213,1,1,0,0,0,5499,11658
5624,25,5796,112,4,1,1,0,0,5914,5060,340,1,0,1,0,0,5402,11316
5624,26,5788,152,2,0,2,0,0,5944,4795,540,5,0,1,0,0,5341,11285
5624,27,5738,245,1,0,0,0,0,5984,4897,695,11,0,2,0,0,5605,11589
5624,28,5452,390,1,2,4,0,0,5849,4453,1016,8,0,2,0,0,5479,11328
5624,29,5254,592,6,0,3,0,0,5855,4236,1239,17,1,3,0,0,5496,11351
5624,30,5406,783,5,1,2,0,0,6197,4216,1683,19,2,4,0,0,5924,12121
5624,31,5242,1142,14,1,4,0,0,6403,3961,2121,32,6,2,0,0,6122,12525
5624,32,4757,1383,12,1,1,0,0,6154,3462,2567,41,3,2,0,0,6075,12229
5624,33,4588,1812,25,0,1,0,0,6426,3255,2890,58,13,6,0,0,6222,12648
5624,34,4311,2075,36,5,5,0,0,6432,2939,3106,53,10,1,0,0,6109,12541
5624,35,4061,2479,34,4,0,0,0,6578,2749,3694,85,17,6,0,0,6551,13129
5624,36,3768,2610,44,6,2,0,0,6430,2436,3746,83,13,5,0,0,6283,12713
5624,37,3452,2932,42,5,4,0,0,6435,2237,3906,94,30,4,1,0,6272,12707
5624,38,3126,3344,61,2,5,0,0,6538,2074,4067,116,29,3,0,0,6289,12827
5624,39,3086,3550,75,7,5,0,0,6723,1934,4451,139,46,1,0,0,6571,13294
5624,40,2967,3732,76,6,4,0,0,6785,1841,4525,177,33,2,0,0,6578,13363
5624,41,2782,3982,109,11,3,0,0,6887,1731,4776,142,44,0,0,0,6693,13580
5624,42,2615,4121,108,11,2,0,0,6857,1588,4889,196,48,2,0,0,6723,13580
5624,43,2517,4225,138,18,8,1,0,6907,1504,5045,209,47,3,0,0,6808,13715
5624,44,2306,4467,118,17,8,0,0,6916,1528,5137,249,62,2,0,0,6978,13894
5624,45,2394,4720,148,27,4,0,0,7293,1396,5275,287,99,4,0,0,7061,14354
5624,46,2188,4923,169,20,3,0,0,7303,1378,5485,266,108,4,0,0,7241,14544
5624,47,2185,5200,205,25,4,0,0,7619,1416,5819,306,142,2,0,0,7685,15304
5624,48,2170,5361,201,26,5,0,0,7763,1372,6026,332,142,2,0,0,7874,15637
5624,49,2034,5585,230,28,8,0,0,7885,1333,6324,357,172,4,0,0,8190,16075
5624,50,1952,5767,257,47,6,0,0,8029,1243,6396,370,182,1,0,0,8192,16221
5624,51,1771,5701,246,40,5,0,0,7763,1203,6484,366,223,3,0,0,8279,16042
5624,52,1751,6013,273,62,4,1,0,8104,1156,6607,403,249,0,0,0,8415,16519
5624,53,1597,5892,261,64,4,0,0,7818,1152,6502,393,271,3,0,0,8321,16139
5624,54,1474,6313,272,70,6,0,0,8135,1138,6766,419,306,1,0,0,8630,16765
5624,55,1439,6246,298,89,5,0,0,8077,1043,6733,414,408,0,0,0,8598,16675
5624,56,1358,6387,298,92,5,0,0,8140,1017,6717,439,402,3,0,0,8578,16718
5624,57,1285,6552,302,109,6,0,0,8254,1007,6770,423,469,0,1,0,8670,16924
5624,58,1196,6655,317,102,2,0,0,8272,992,6891,423,553,0,0,0,8859,17131
5624,59,1170,6789,303,139,4,0,0,8405,980,6754,392,658,0,0,0,8784,17189
5624,60,978,6384,286,133,4,0,0,7785,836,6571,402,601,1,0,0,8411,16196
5624,61,913,6214,271,166,5,0,0,7569,851,6549,370,743,1,0,0,8514,16083
5624,62,821,6404,260,171,3,0,0,7659,805,6217,341,855,0,0,0,8218,15877
5624,63,791,6252,258,194,3,0,0,7498,764,5998,324,866,0,0,0,7952,15450
5624,64,634,6290,231,236,0,0,0,7391,770,5659,316,979,0,0,0,7724,15115
5624,65,566,5860,209,223,2,0,0,6860,648,5375,316,985,0,0,0,7324,14184
5624,66,553,5658,245,246,5,0,0,6707,602,5275,284,1083,1,0,0,7245,13952
5624,67,442,5462,208,262,0,0,0,6374,563,4972,252,1160,0,0,0,6947,13321
5624,68,457,5526,164,268,2,0,0,6417,537,4713,234,1297,0,0,0,6781,13198
5624,69,421,5229,157,281,1,0,0,6089,530,4653,242,1390,0,0,0,6815,12904
5624,70,362,4944,159,312,2,0,0,5779,509,4115,195,1402,1,0,0,6222,12001
5624,71,315,4624,131,320,4,0,0,5394,412,3701,185,1499,0,0,0,5797,11191
5624,72,316,4667,139,347,1,0,0,5470,383,3804,157,1612,0,0,0,5956,11426
5624,73,302,4595,129,384,0,0,0,5410,419,3525,182,1738,0,0,0,5864,11274
5624,74,254,4444,105,413,0,0,0,5216,384,3462,172,1978,0,0,0,5996,11212
5624,75,244,4417,93,422,0,0,0,5176,422,3435,136,2159,1,0,0,6153,11329
5624,76,206,4165,101,460,1,0,0,4933,312,3041,97,2221,0,0,0,5671,10604
5624,77,190,3961,78,523,2,0,0,4754,331,2745,121,2199,0,0,0,5396,10150
5624,78,128,2845,64,385,0,0,0,3422,250,1871,78,1755,0,0,0,3954,7376
5624,79,112,2404,43,409,2,0,0,2970,211,1680,62,1800,0,0,0,3753,6723
5624,80,106,2521,39,426,0,0,1,3093,271,1569,60,2090,0,0,0,3990,7083
5624,81,100,2378,51,458,0,0,0,2987,230,1469,59,2102,0,0,0,3860,6847
5624,82,93,2063,37,429,0,0,0,2622,223,1208,43,2083,0,0,0,3557,6179
5624,83,79,2219,26,537,0,0,0,2861,227,1308,54,2411,0,0,0,4000,6861
5624,84,77,2084,37,587,1,0,0,2786,213,1130,44,2568,0,0,0,3955,6741
5624,85,62,1607,22,525,0,0,0,2216,205,890,35,2305,0,0,0,3435,5651
5624,86,63,1447,12,484,0,0,0,2006,184,655,35,2252,0,0,0,3126,5132
5624,87,67,1085,9,482,0,0,0,1643,146,503,35,2039,0,0,0,2723,4366
5624,88,56,1008,9,513,0,0,0,1586,152,464,20,1953,0,0,0,2589,4175
5624,89,48,739,7,423,0,0,0,1217,142,336,22,1713,0,0,0,2213,3430
5624,90,35,638,5,408,0,0,0,1086,130,261,12,1614,0,0,0,2017,3103
5624,91,26,446,3,328,0,0,0,803,90,148,19,1367,0,0,0,1624,2427
5624,92,24,351,3,278,0,0,0,656,73,127,13,1098,0,0,0,1311,1967
5624,93,23,257,0,255,0,0,0,535,75,92,6,1015,0,0,0,1188,1723
5624,94,11,140,0,192,0,0,0,343,56,57,8,735,0,0,0,856,1199
5624,95,6,89,3,122,0,0,0,220,46,35,5,588,0,0,0,674,894
5624,96,6,65,1,87,0,0,0,159,29,28,2,374,0,0,0,433,592
5624,97,4,28,1,62,0,0,0,95,31,16,2,272,0,0,0,321,416
5624,98,5,22,1,37,0,0,0,65,18,9,2,200,0,0,0,229,294
5624,99,1,15,1,30,0,0,0,47,11,9,2,144,0,0,0,166,213
5624,100,7,12,0,40,0,0,0,59,23,10,1,219,0,0,0,253,312
5624,999,245441,251902,8295,13896,174,2,1,519711,209506,254188,12272,62254,85,2,0,538307,1058018
5715,0,887,0,0,0,0,0,0,887,772,0,0,0,0,0,0,772,1659
5715,1,880,0,0,0,0,0,0,880,873,0,0,0,0,0,0,873,1753
5715,2,862,0,0,0,0,0,0,862,864,0,0,0,0,0,0,864,1726
5715,3,992,0,0,0,0,0,0,992,913,0,0,0,0,0,0,913,1905
5715,4,974,0,0,0,0,0,0,974,928,0,0,0,0,0,0,928,1902
5715,5,1070,0,0,0,0,0,0,1070,977,0,0,0,0,0,0,977,2047
5715,6,1099,0,0,0,0,0,0,1099,1031,0,0,0,0,0,0,1031,2130
5715,7,1188,0,0,0,0,0,0,1188,1025,0,0,0,0,0,0,1025,2213
5715,8,1225,0,0,0,0,0,0,1225,1105,0,0,0,0,0,0,1105,2330
5715,9,1168,0,0,0,0,0,0,1168,1124,0,0,0,0,0,0,1124,2292
5715,10,1202,0,0,0,0,0,0,1202,1133,0,0,0,0,0,0,1133,2335
5715,11,1292,0,0,0,0,0,0,1292,1274,0,0,0,0,0,0,1274,2566
5715,12,1306,0,0,0,0,0,0,1306,1210,0,0,0,0,0,0,1210,2516
5715,13,1282,0,0,0,0,0,0,1282,1250,0,0,0,0,0,0,1250,2532
5715,14,1304,0,0,0,0,0,0,1304,1189,0,0,0,0,0,0,1189,2493
5715,15,1338,0,0,0,0,0,0,1338,1177,0,0,0,0,0,0,1177,2515
5715,16,1294,0,0,0,0,0,0,1294,1181,0,0,0,0,0,0,1181,2475
5715,17,1272,0,0,0,0,0,0,1272,1156,0,0,0,0,0,0,1156,2428
5715,18,1309,1,0,0,0,0,0,1310,1268,0,0,0,0,0,0,1268,2578
5715,19,1447,1,0,0,0,0,0,1448,1196,3,0,0,0,0,0,1199,2647
5715,20,1370,1,0,0,0,0,0,1371,1142,10,0,0,0,0,0,1152,2523
5715,21,1285,7,0,0,0,0,0,1292,1152,21,0,0,0,0,0,1173,2465
5715,22,1392,11,0,0,0,0,0,1403,1198,31,0,0,0,0,0,1229,2632
5715,23,1453,14,0,0,0,0,0,1467,1196,55,1,0,0,0,0,1252,2719
5715,24,1424,16,0,1,0,0,0,1441,1196,70,1,0,0,0,0,1267,2708
5715,25,1411,26,0,0,1,0,0,1438,1187,96,1,0,1,0,0,1285,2723
5715,26,1334,34,1,5,0,0,0,1374,1156,122,1,0,0,0,0,1279,2653
5715,27,1357,60,0,0,0,0,0,1417,1173,137,3,0,2,1,0,1316,2733
5715,28,1389,90,1,1,0,0,0,1481,1161,180,4,0,2,0,0,1347,2828
5715,29,1393,119,4,5,0,0,0,1521,1079,289,8,1,0,0,0,1377,2898
5715,30,1371,135,1,3,0,0,0,1510,1044,286,6,3,1,0,0,1340,2850
5715,31,1375,200,4,1,1,0,0,1581,1029,398,5,1,2,0,0,1435,3016
5715,32,1393,235,4,1,2,0,0,1635,1037,465,13,0,0,0,0,1515,3150
5715,33,1310,343,5,4,0,0,0,1662,891,553,22,1,2,0,0,1469,3131
5715,34,1291,419,13,1,1,0,0,1725,866,610,19,4,0,0,0,1499,3224
5715,35,1190,470,11,1,2,0,0,1674,800,725,27,4,1,0,0,1557,3231
5715,36,1112,541,13,2,0,0,0,1668,779,748,30,3,1,0,0,1561,3229
5715,37,1085,604,14,3,2,0,0,1708,747,815,35,5,0,0,0,1602,3310
5715,38,1053,647,25,4,0,0,0,1729,738,886,50,9,2,0,0,1685,3414
5715,39,998,750,31,3,0,0,0,1782,693,956,46,7,1,0,0,1703,3485
5715,40,962,812,31,4,1,0,0,1810,658,950,57,10,1,0,0,1676,3486
5715,41,951,890,33,0,1,0,0,1875,662,1092,54,12,0,0,0,1820,3695
5715,42,900,988,52,7,1,0,0,1948,559,1135,64,19,0,0,0,1777,3725
5715,43,857,1002,48,3,3,0,0,1913,568,1100,93,17,1,0,0,1779,3692
5715,44,836,1127,65,9,0,0,0,2037,545,1236,97,22,1,0,0,1901,3938
5715,45,847,1203,90,7,2,0,0,2149,480,1234,110,22,0,0,0,1846,3995
5715,46,802,1229,62,11,0,0,0,2104,508,1271,119,25,0,0,0,1923,4027
5715,47,813,1268,110,9,1,0,0,2201,472,1334,121,28,0,0,0,1955,4156
5715,48,759,1335,100,13,1,0,0,2208,507,1430,133,36,1,0,0,2107,4315
5715,49,703,1448,97,5,2,0,0,2255,470,1559,174,56,2,0,0,2261,4516
5715,50,635,1282,109,15,0,0,0,2041,443,1540,136,45,1,0,0,2165,4206
5715,51,600,1445,132,12,1,0,0,2190,398,1626,179,53,0,0,0,2256,4446
5715,52,624,1431,139,7,0,0,0,2201,382,1588,183,55,0,0,0,2208,4409
5715,53,581,1505,118,8,2,0,0,2214,348,1565,180,71,0,0,0,2164,4378
5715,54,528,1578,136,15,1,0,0,2258,337,1570,170,81,0,0,0,2158,4416
5715,55,502,1605,132,25,1,0,0,2265,349,1661,175,117,0,0,0,2302,4567
5715,56,473,1627,151,19,1,0,0,2271,320,1743,168,76,1,0,0,2308,4579
5715,57,468,1665,149,30,0,0,0,2312,271,1801,180,126,0,0,0,2378,4690
5715,58,430,1706,169,28,0,0,0,2333,250,1778,173,121,0,0,0,2322,4655
5715,59,399,1855,150,30,1,0,0,2435,245,1755,187,161,0,0,0,2348,4783
5715,60,367,1707,163,32,1,0,0,2270,251,1783,189,186,1,0,0,2410,4680
5715,61,323,1729,166,36,0,0,0,2254,248,1685,146,203,0,0,0,2282,4536
5715,62,299,1643,135,50,0,0,0,2127,233,1739,145,200,0,0,0,2317,4444
5715,63,285,1711,117,46,0,0,0,2159,208,1699,140,229,1,0,0,2277,4436
5715,64,252,1694,110,45,0,0,0,2101,215,1664,117,243,0,0,0,2239,4340
5715,65,247,1612,103,59,0,0,0,2021,165,1557,125,236,0,0,0,2083,4104
5715,66,233,1619,96,58,0,0,0,2006,171,1525,119,270,0,0,0,2085,4091
5715,67,193,1699,107,58,1,0,0,2058,154,1429,111,317,0,0,0,2011,4069
5715,68,195,1657,90,72,0,0,0,2014,144,1437,94,370,0,0,0,2045,4059
5715,69,168,1643,82,73,0,0,0,1966,148,1439,102,377,0,0,0,2066,4032
5715,70,130,1492,81,89,0,0,0,1792,112,1308,87,382,0,0,0,1889,3681
5715,71,138,1466,81,101,0,0,0,1786,124,1221,87,429,0,0,0,1861,3647
5715,72,118,1365,74,85,0,0,0,1642,110,1175,83,461,0,0,0,1829,3471
5715,73,113,1458,67,113,0,0,0,1751,117,1139,62,480,0,0,0,1798,3549
5715,74,106,1370,55,125,1,0,0,1657,114,1231,58,547,0,0,0,1950,3607
5715,75,113,1437,56,121,1,0,0,1728,113,1079,57,639,0,0,0,1888,3616
5715,76,105,1303,46,135,0,0,0,1589,130,973,44,661,0,0,0,1808,3397
5715,77,97,1156,38,146,1,0,0,1438,102,875,35,587,0,0,0,1599,3037
5715,78,47,830,32,77,0,0,0,986,68,566,32,504,0,0,0,1170,2156
5715,79,56,869,24,106,0,0,0,1055,69,577,24,564,0,0,0,1234,2289
5715,80,70,818,23,117,0,0,0,1028,72,528,19,611,0,0,0,1230,2258
5715,81,61,708,13,121,0,0,0,903,60,454,26,635,0,0,0,1175,2078
5715,82,43,655,17,132,0,0,0,847,74,415,27,613,0,0,0,1129,1976
5715,83,48,712,24,150,0,0,0,934,64,448,27,818,0,0,0,1357,2291
5715,84,43,662,15,158,0,0,0,878,72,308,14,769,0,0,0,1163,2041
5715,85,30,527,12,150,0,0,0,719,60,289,19,717,0,0,0,1085,1804
5715,86,43,496,6,153,0,0,0,698,62,260,15,713,0,0,0,1050,1748
5715,87,28,371,10,127,0,0,0,536,61,169,8,642,0,0,0,880,1416
5715,88,27,310,1,131,0,0,0,469,48,157,10,624,0,0,0,839,1308
5715,89,16,265,0,125,0,0,0,406,44,110,6,593,0,0,0,753,1159
5715,90,18,245,1,105,0,0,0,369,34,98,6,558,0,0,0,696,1065
5715,91,12,166,3,90,0,0,0,271,42,58,5,450,0,0,0,555,826
5715,92,12,112,2,91,0,0,0,217,30,46,5,456,0,0,0,537,754
5715,93,8,114,1,88,0,0,0,211,32,32,3,377,0,0,0,444,655
5715,94,6,61,0,68,0,0,0,135,23,22,3,297,0,0,0,345,480
5715,95,3,33,0,50,0,0,0,86,17,14,1,214,0,0,0,246,332
5715,96,2,33,0,38,0,0,0,73,10,11,1,165,0,0,0,187,260
5715,97,2,14,0,22,0,0,0,38,4,5,0,108,0,0,0,117,155
5715,98,0,8,0,16,0,0,0,24,4,2,1,78,0,0,0,85,109
5715,99,0,5,0,15,0,0,0,20,6,4,0,68,0,0,0,78,98
5715,100,1,8,0,22,0,0,0,31,6,9,1,93,0,0,0,109,140
5715,999,67105,67508,4051,3888,33,0,0,142585,54503,65964,5079,18675,25,1,0,144247,286832
5815,0,996,0,0,0,0,0,0,996,914,0,0,0,0,0,0,914,1910
5815,1,1056,0,0,0,0,0,0,1056,890,0,0,0,0,0,0,890,1946
5815,2,1044,0,0,0,0,0,0,1044,954,0,0,0,0,0,0,954,1998
5815,3,1070,0,0,0,0,0,0,1070,988,0,0,0,0,0,0,988,2058
5815,4,1091,0,0,0,0,0,0,1091,1021,0,0,0,0,0,0,1021,2112
5815,5,1086,0,0,0,0,0,0,1086,1040,0,0,0,0,0,0,1040,2126
5815,6,1228,0,0,0,0,0,0,1228,1128,0,0,0,0,0,0,1128,2356
5815,7,1243,0,0,0,0,0,0,1243,1198,0,0,0,0,0,0,1198,2441
5815,8,1237,0,0,0,0,0,0,1237,1197,0,0,0,0,0,0,1197,2434
5815,9,1274,0,0,0,0,0,0,1274,1236,0,0,0,0,0,0,1236,2510
5815,10,1290,0,0,0,0,0,0,1290,1251,0,0,0,0,0,0,1251,2541
5815,11,1334,0,0,0,0,0,0,1334,1307,0,0,0,0,0,0,1307,2641
5815,12,1402,0,0,0,0,0,0,1402,1249,0,0,0,0,0,0,1249,2651
5815,13,1381,0,0,0,0,0,0,1381,1342,0,0,0,0,0,0,1342,2723
5815,14,1362,0,0,0,0,0,0,1362,1315,0,0,0,0,0,0,1315,2677
5815,15,1433,0,0,0,0,0,0,1433,1363,0,0,0,0,0,0,1363,2796
5815,16,1435,0,0,0,0,0,0,1435,1333,0,0,0,0,0,0,1333,2768
5815,17,1363,1,0,0,0,0,0,1364,1336,0,0,0,0,0,0,1336,2700
5815,18,1454,0,0,0,0,0,0,1454,1432,0,0,0,0,0,0,1432,2886
5815,19,1499,2,0,0,0,0,0,1501,1389,3,0,0,0,0,0,1392,2893
5815,20,1483,0,0,0,0,0,0,1483,1330,7,0,0,0,0,0,1337,2820
5815,21,1505,6,0,0,0,0,0,1511,1293,14,0,0,0,0,0,1307,2818
5815,22,1524,3,0,0,0,0,0,1527,1328,31,1,0,0,0,0,1360,2887
5815,23,1509,11,0,1,0,0,0,1521,1344,48,1,0,0,0,0,1393,2914
5815,24,1510,15,1,0,0,0,0,1526,1280,60,1,0,0,0,0,1341,2867
5815,25,1556,28,2,0,0,0,0,1586,1338,82,0,0,0,0,0,1420,3006
5815,26,1517,50,0,0,1,0,0,1568,1269,130,0,0,1,0,0,1400,2968
5815,27,1478,60,1,2,0,0,0,1541,1294,163,1,1,0,0,0,1459,3000
5815,28,1444,97,1,0,1,0,0,1543,1183,194,3,0,1,0,0,1381,2924
5815,29,1462,102,2,0,2,0,0,1568,1264,281,5,0,1,0,0,1551,3119
5815,30,1435,173,2,2,0,0,0,1612,1181,349,3,1,0,1,0,1535,3147
5815,31,1448,254,8,1,0,0,0,1711,1077,443,8,3,0,0,0,1531,3242
5815,32,1332,302,9,6,2,0,0,1651,1060,543,9,1,0,0,0,1613,3264
5815,33,1301,372,4,2,0,0,0,1679,1011,585,18,3,1,1,0,1619,3298
5815,34,1263,445,10,1,2,0,0,1721,826,642,25,3,3,0,0,1499,3220
5815,35,1204,557,15,6,0,0,0,1782,927,706,25,3,3,0,0,1664,3446
5815,36,1070,574,16,6,2,0,0,1668,800,810,39,5,4,0,0,1658,3326
5815,37,1008,673,26,3,2,0,0,1712,772,932,54,6,2,0,0,1766,3478
5815,38,1017,755,22,6,0,0,0,1800,757,949,48,4,8,0,0,1766,3566
5815,39,1032,800,30,4,5,0,0,1871,690,1029,64,12,3,0,0,1798,3669
5815,40,957,877,38,5,1,0,0,1878,615,1121,66,7,2,0,0,1811,3689
5815,41,880,941,42,2,1,0,0,1866,665,1130,81,15,3,0,0,1894,3760
5815,42,857,946,55,4,5,0,0,1867,576,1176,77,19,2,0,0,1850,3717
5815,43,859,1079,64,6,2,0,1,2011,602,1195,98,16,1,0,0,1912,3923
5815,44,802,1139,58,6,2,0,0,2007,548,1311,117,38,1,0,0,2015,4022
5815,45,800,1201,65,4,0,0,0,2070,531,1468,122,23,1,0,0,2145,4215
5815,46,783,1210,92,9,3,0,0,2097,475,1447,122,22,2,0,0,2068,4165
5815,47,730,1332,94,10,1,0,0,2167,476,1491,120,37,2,0,0,2126,4293
5815,48,711,1354,72,16,2,0,0,2155,507,1538,150,40,0,0,0,2235,4390
5815,49,727,1432,113,14,1,0,0,2287,455,1687,165,54,0,0,0,2361,4648
5815,50,684,1471,113,11,4,0,0,2283,399,1752,173,41,0,0,0,2365,4648
5815,51,676,1587,134,11,2,0,0,2410,429,1752,166,48,0,0,0,2395,4805
5815,52,617,1608,158,10,1,0,0,2394,446,1808,196,69,0,0,0,2519,4913
5815,53,572,1572,137,17,3,0,0,2301,338,1850,210,72,2,0,0,2472,4773
5815,54,589,1745,145,23,0,0,0,2502,371,1947,207,98,0,0,0,2623,5125
5815,55,579,1754,163,22,3,0,0,2521,328,1845,199,92,0,0,0,2464,4985
5815,56,517,1848,170,22,4,0,1,2562,312,1918,190,108,0,0,0,2528,5090
5815,57,462,1902,163,20,2,0,0,2549,284,1994,169,130,0,0,0,2577,5126
5815,58,369,1862,172,27,3,0,0,2433,282,2025,210,154,1,0,0,2672,5105
5815,59,396,1894,140,36,0,0,0,2466,269,1990,210,149,1,0,0,2619,5085
5815,60,320,1818,127,40,1,0,0,2306,236,1874,178,182,0,0,0,2470,4776
5815,61,288,1735,148,46,4,0,0,2221,193,1751,157,174,0,0,0,2275,4496
5815,62,244,1668,154,36,0,0,0,2102,189,1717,153,189,1,0,0,2249,4351
5815,63,242,1683,126,43,3,0,0,2097,193,1678,140,206,0,0,0,2217,4314
5815,64,230,1695,109,66,3,0,0,2103,172,1715,122,250,0,0,0,2259,4362
5815,65,207,1601,99,58,2,0,0,1967,175,1576,113,270,0,0,0,2134,4101
5815,66,202,1576,97,70,0,0,0,1945,143,1488,97,290,0,0,0,2018,3963
5815,67,156,1569,110,70,2,0,0,1907,136,1446,103,331,0,0,0,2016,3923
5815,68,169,1486,72,75,0,0,0,1802,118,1398,104,360,0,0,0,1980,3782
5815,69,129,1500,78,74,1,0,0,1782,129,1382,74,397,0,1,0,1983,3765
5815,70,128,1348,76,60,0,0,0,1612,95,1249,73,389,0,0,0,1806,3418
5815,71,125,1351,50,80,1,0,0,1607,113,1162,53,400,0,0,0,1728,3335
5815,72,109,1359,40,86,0,0,0,1594,74,1139,67,488,0,0,0,1768,3362
5815,73,94,1357,50,102,0,0,0,1603,94,1137,63,531,0,0,0,1825,3428
5815,74,101,1312,39,104,1,0,0,1557,77,1076,53,601,0,0,0,1807,3364
5815,75,96,1373,44,101,0,0,0,1614,86,1086,43,603,1,0,0,1819,3433
5815,76,88,1217,40,115,0,0,0,1460,66,921,47,628,0,0,0,1662,3122
5815,77,94,1185,31,101,0,0,0,1411,46,854,43,692,0,0,0,1635,3046
5815,78,56,898,24,94,0,0,0,1072,46,712,23,586,0,0,0,1367,2439
5815,79,58,898,21,95,0,0,0,1072,50,582,28,614,0,0,0,1274,2346
5815,80,50,879,15,126,0,0,0,1070,40,559,25,678,0,0,0,1302,2372
5815,81,50,778,15,110,1,0,0,954,48,477,13,705,0,0,0,1243,2197
5815,82,40,727,9,154,0,0,0,930,38,420,17,757,0,0,0,1232,2162
5815,83,35,774,9,138,0,0,0,956,51,394,15,826,0,0,0,1286,2242
5815,84,37,697,20,147,0,0,0,901,37,321,9,889,0,0,0,1256,2157
5815,85,34,586,8,175,0,0,0,803,40,326,16,820,0,0,0,1202,2005
5815,86,30,512,8,164,0,0,0,714,36,227,9,797,0,0,0,1069,1783
5815,87,30,421,7,149,0,0,0,607,26,175,5,702,0,0,0,908,1515
5815,88,22,383,4,133,0,0,0,542,29,156,6,714,0,0,0,905,1447
5815,89,21,253,4,119,0,0,0,397,28,92,4,643,0,0,0,767,1164
5815,90,18,233,0,105,1,0,0,357,22,71,6,582,0,0,0,681,1038
5815,91,6,148,1,91,0,0,0,246,22,52,1,473,0,0,0,548,794
5815,92,12,119,0,98,0,0,0,229,21,40,2,399,0,0,0,462,691
5815,93,5,79,3,78,0,0,0,165,20,34,2,367,0,0,0,423,588
5815,94,7,66,4,51,0,0,0,128,19,18,1,249,0,0,0,287,415
5815,95,1,39,0,45,0,0,0,85,6,8,1,187,0,0,0,202,287
5815,96,7,16,0,21,0,0,0,44,4,8,0,146,0,0,0,158,202
5815,97,1,6,0,18,0,0,0,25,5,8,0,109,0,0,0,122,147
5815,98,2,6,1,11,0,0,0,20,5,3,0,95,0,0,0,103,123
5815,99,0,2,0,7,0,0,0,9,2,0,1,61,0,0,0,64,73
5815,100,2,7,0,12,0,0,0,21,6,6,0,90,0,0,0,102,123
5815,999,69489,69394,3980,3783,77,0,2,146725,57751,69784,5220,19744,47,3,0,152549,299274
5849,0,913,0,0,0,0,0,0,913,919,0,0,0,0,0,0,919,1832
5849,1,1087,0,0,0,0,0,0,1087,1004,0,0,0,0,0,0,1004,2091
5849,2,1122,0,0,0,0,0,0,1122,1097,0,0,0,0,0,0,1097,2219
5849,3,1154,0,0,0,0,0,0,1154,1072,0,0,0,0,0,0,1072,2226
5849,4,1158,0,0,0,0,0,0,1158,1105,0,0,0,0,0,0,1105,2263
5849,5,1187,0,0,0,0,0,0,1187,1138,0,0,0,0,0,0,1138,2325
5849,6,1259,0,0,0,0,0,0,1259,1194,0,0,0,0,0,0,1194,2453
5849,7,1364,0,0,0,0,0,0,1364,1258,0,0,0,0,0,0,1258,2622
5849,8,1375,0,0,0,0,0,0,1375,1268,0,0,0,0,0,0,1268,2643
5849,9,1432,0,0,0,0,0,0,1432,1342,0,0,0,0,0,0,1342,2774
5849,10,1397,0,0,0,0,0,0,1397,1359,0,0,0,0,0,0,1359,2756
5849,11,1429,0,0,0,0,0,0,1429,1388,0,0,0,0,0,0,1388,2817
5849,12,1552,0,0,0,0,0,0,1552,1395,0,0,0,0,0,0,1395,2947
5849,13,1551,0,0,0,0,0,0,1551,1418,0,0,0,0,0,0,1418,2969
5849,14,1501,0,0,0,0,0,0,1501,1433,0,0,0,0,0,0,1433,2934
5849,15,1623,0,0,0,0,0,0,1623,1533,0,0,0,0,0,0,1533,3156
5849,16,1552,0,0,0,0,0,0,1552,1492,1,0,0,0,0,0,1493,3045
5849,17,1639,0,0,0,0,0,0,1639,1463,0,0,0,0,0,0,1463,3102
5849,18,1582,1,0,0,0,0,0,1583,1434,2,0,0,0,0,0,1436,3019
5849,19,1668,1,0,0,0,0,0,1669,1443,7,0,0,0,0,0,1450,3119
5849,20,1544,1,0,0,0,0,0,1545,1473,9,0,0,0,0,0,1482,3027
5849,21,1557,2,0,0,0,0,0,1559,1408,8,0,0,0,0,0,1416,2975
5849,22,1514,7,0,0,0,0,0,1521,1471,18,0,0,0,0,0,1489,3010
5849,23,1621,10,0,0,0,0,0,1631,1391,21,1,0,0,0,0,1413,3044
5849,24,1545,15,0,0,0,0,0,1560,1370,32,0,0,0,0,0,1402,2962
5849,25,1622,29,0,0,2,0,0,1653,1381,72,1,0,0,0,0,1454,3107
5849,26,1565,39,0,0,0,0,0,1604,1296,109,1,0,0,0,0,1406,3010
5849,27,1461,52,0,0,1,0,0,1514,1290,136,2,0,1,0,0,1429,2943
5849,28,1484,85,1,0,0,0,0,1570,1224,181,5,0,2,0,0,1412,2982
5849,29,1449,124,1,0,0,0,0,1574,1210,286,9,0,0,1,0,1506,3080
5849,30,1517,170,2,1,3,0,0,1693,1197,338,10,0,0,0,0,1545,3238
5849,31,1462,214,2,0,0,0,0,1678,1230,422,12,1,0,0,0,1665,3343
5849,32,1308,310,5,2,2,0,0,1627,1103,498,11,1,2,0,0,1615,3242
5849,33,1296,393,9,0,1,1,0,1700,1063,619,14,2,1,0,0,1699,3399
5849,34,1280,420,14,1,2,0,0,1717,976,639,27,2,1,0,0,1645,3362
5849,35,1202,506,16,3,2,0,0,1729,926,737,25,2,0,0,0,1690,3419
5849,36,1075,573,17,3,3,0,0,1671,888,813,47,2,2,0,0,1752,3423
5849,37,1084,649,20,2,2,0,0,1757,824,898,40,7,3,0,0,1772,3529
5849,38,1049,759,21,0,1,0,0,1830,781,913,59,6,1,0,0,1760,3590
5849,39,939,861,39,3,5,0,0,1847,723,1052,89,6,2,1,0,1873,3720
5849,40,897,869,35,2,1,0,0,1804,700,1087,56,3,1,0,0,1847,3651
5849,41,835,883,58,3,3,1,0,1783,684,1203,88,11,1,1,0,1988,3771
5849,42,818,962,49,6,3,0,0,1838,589,1263,107,17,0,0,0,1976,3814
5849,43,821,1051,61,5,1,0,0,1939,576,1256,112,29,1,1,0,1975,3914
5849,44,784,1096,87,9,0,1,0,1977,567,1350,147,23,1,0,0,2088,4065
5849,45,796,1223,75,7,3,0,0,2104,522,1463,166,14,2,0,0,2167,4271
5849,46,809,1225,81,7,2,0,0,2124,521,1500,156,37,3,0,0,2217,4341
5849,47,799,1317,99,5,2,0,0,2222,538,1633,172,34,1,0,0,2378,4600
5849,48,743,1386,137,11,2,0,0,2279,517,1648,218,46,0,0,0,2429,4708
5849,49,786,1577,137,11,0,0,0,2511,467,1713,209,44,4,0,0,2437,4948
5849,50,684,1602,156,16,1,0,0,2459,458,1810,258,50,2,0,0,2578,5037
5849,51,647,1703,155,15,1,0,0,2521,439,1914,234,54,1,0,0,2642,5163
5849,52,632,1645,179,17,1,0,0,2474,456,1972,206,64,1,0,0,2699,5173
5849,53,614,1749,173,20,3,0,0,2559,391,1915,215,69,1,0,0,2591,5150
5849,54,590,1845,182,10,3,0,0,2630,417,1963,305,85,3,0,0,2773,5403
5849,55,540,1754,183,20,2,0,0,2499,381,1933,255,94,2,0,0,2665,5164
5849,56,475,1716,172,25,2,0,0,2390,348,1965,256,119,3,0,0,2691,5081
5849,57,446,1879,171,32,4,0,0,2532,351,1988,255,134,2,0,0,2730,5262
5849,58,457,1864,221,43,3,0,0,2588,308,1979,238,131,2,0,0,2658,5246
5849,59,407,1966,212,38,4,0,0,2627,279,1986,256,165,0,0,0,2686,5313
5849,60,328,1903,185,35,1,0,0,2452,258,1843,238,176,0,0,0,2515,4967
5849,61,335,1729,180,37,0,0,0,2281,258,1832,196,188,0,0,0,2474,4755
5849,62,269,1697,147,41,1,0,0,2155,235,1747,188,213,1,0,0,2384,4539
5849,63,230,1640,160,48,1,0,0,2079,213,1625,196,251,2,0,0,2287,4366
5849,64,217,1625,128,55,1,0,0,2026,169,1627,189,246,2,0,0,2233,4259
5849,65,199,1562,126,38,0,0,0,1925,189,1549,156,258,1,0,0,2153,4078
5849,66,166,1585,117,57,2,0,0,1927,173,1549,137,277,0,0,0,2136,4063
5849,67,156,1528,111,45,0,0,0,1840,150,1468,102,330,0,0,0,2050,3890
5849,68,142,1486,105,73,1,0,0,1807,171,1486,139,311,0,0,0,2107,3914
5849,69,143,1410,91,81,1,0,0,1726,140,1358,113,386,1,0,0,1998,3724
5849,70,118,1368,76,65,0,0,0,1627,140,1270,117,339,1,0,0,1867,3494
5849,71,115,1286,65,72,0,0,0,1538,129,1165,122,432,1,0,0,1849,3387
5849,72,81,1297,73,84,0,0,0,1535,116,1320,98,446,0,0,0,1980,3515
5849,73,77,1353,57,83,1,0,0,1571,112,1279,82,489,0,0,0,1962,3533
5849,74,100,1328,61,84,1,0,0,1574,107,1187,91,533,0,0,0,1918,3492
5849,75,91,1348,43,111,0,0,0,1593,126,1118,73,634,0,0,0,1951,3544
5849,76,90,1298,50,110,0,0,0,1548,82,1068,80,658,0,0,0,1888,3436
5849,77,69,1249,42,124,1,0,0,1485,89,969,63,693,0,0,0,1814,3299
5849,78,43,897,24,108,0,0,0,1072,64,667,59,560,0,0,0,1350,2422
5849,79,60,955,40,106,0,0,0,1161,64,693,48,651,0,0,0,1456,2617
5849,80,54,877,23,108,0,0,0,1062,62,619,40,686,0,0,0,1407,2469
5849,81,33,783,23,146,0,0,0,985,68,566,40,671,0,0,0,1345,2330
5849,82,52,754,15,133,0,0,0,954,69,496,29,699,0,0,0,1293,2247
5849,83,46,778,27,161,1,0,0,1013,64,506,35,846,0,0,0,1451,2464
5849,84,34,763,21,157,0,0,0,975,77,472,30,926,0,0,0,1505,2480
5849,85,33,617,16,171,0,0,0,837,74,306,20,790,0,0,0,1190,2027
5849,86,28,561,11,174,0,0,0,774,63,267,15,762,0,0,0,1107,1881
5849,87,15,450,8,160,0,0,0,633,60,199,19,709,0,0,0,987,1620
5849,88,17,388,8,160,0,0,0,573,47,179,15,665,0,0,0,906,1479
5849,89,11,318,1,122,0,0,0,452,35,140,9,619,0,0,0,803,1255
5849,90,15,230,8,103,0,0,0,356,46,110,9,585,0,0,0,750,1106
5849,91,8,189,2,116,0,0,0,315,32,71,3,495,0,0,0,601,916
5849,92,4,141,2,88,0,0,0,235,25,47,6,434,0,0,0,512,747
5849,93,10,108,1,68,0,0,0,187,42,48,6,348,0,0,0,444,631
5849,94,4,75,0,49,0,0,0,128,19,19,4,280,0,0,0,322,450
5849,95,2,45,2,44,0,0,0,93,11,27,0,189,0,0,0,227,320
5849,96,2,38,0,29,0,0,0,69,18,11,3,153,0,0,0,185,254
5849,97,1,16,0,17,0,0,0,34,10,8,2,99,0,0,0,119,153
5849,98,0,12,0,19,0,0,0,31,8,5,0,86,0,0,0,99,130
5849,99,0,12,0,12,0,0,0,24,6,6,0,40,0,0,0,52,76
5849,100,3,6,0,12,0,0,0,21,9,3,0,92,0,0,0,104,125
5849,999,72100,70238,4819,3823,77,3,0,151060,62319,72277,7034,19497,55,4,0,161186,312246
5943,0,630,0,0,0,0,0,0,630,570,0,0,0,0,0,0,570,1200
5943,1,604,0,0,0,0,0,0,604,578,0,0,0,0,0,0,578,1182
5943,2,610,0,0,0,0,0,0,610,609,0,0,0,0,0,0,609,1219
5943,3,677,0,0,0,0,0,0,677,609,0,0,0,0,0,0,609,1286
5943,4,712,0,0,0,0,0,0,712,677,0,0,0,0,0,0,677,1389
5943,5,703,0,0,0,0,0,0,703,666,0,0,0,0,0,0,666,1369
5943,6,786,0,0,0,0,0,0,786,725,0,0,0,0,0,0,725,1511
5943,7,766,0,0,0,0,0,0,766,727,0,0,0,0,0,0,727,1493
5943,8,794,0,0,0,0,0,0,794,742,0,0,0,0,0,0,742,1536
5943,9,834,0,0,0,0,0,0,834,740,0,0,0,0,0,0,740,1574
5943,10,826,0,0,0,0,0,0,826,781,0,0,0,0,0,0,781,1607
5943,11,867,0,0,0,0,0,0,867,770,0,0,0,0,0,0,770,1637
5943,12,873,0,0,0,0,0,0,873,860,0,0,0,0,0,0,860,1733
5943,13,955,0,0,0,0,0,0,955,863,0,0,0,0,0,0,863,1818
5943,14,867,0,0,0,0,0,0,867,815,0,0,0,0,0,0,815,1682
5943,15,975,0,0,0,0,0,0,975,873,0,0,0,0,0,0,873,1848
5943,16,970,0,1,0,0,0,0,971,901,0,0,0,0,0,0,901,1872
5943,17,991,0,0,0,0,0,0,991,892,0,0,0,0,0,0,892,1883
5943,18,1064,0,0,0,0,0,0,1064,882,0,0,0,0,0,0,882,1946
5943,19,1095,2,0,0,0,0,0,1097,899,0,0,0,0,0,0,899,1996
5943,20,1090,2,0,0,0,0,0,1092,957,5,0,0,0,0,0,962,2054
5943,21,1095,1,0,0,0,0,0,1096,952,13,0,0,0,0,0,965,2061
5943,22,1081,5,0,0,1,0,0,1087,961,12,2,0,0,0,0,975,2062
5943,23,1121,5,0,2,1,0,0,1129,1017,14,1,0,0,0,0,1032,2161
5943,24,1242,16,0,0,1,0,0,1259,1037,31,0,0,0,0,0,1068,2327
5943,25,1216,11,0,0,1,0,0,1228,962,55,0,0,0,0,0,1017,2245
5943,26,1189,26,0,0,0,0,0,1215,934,61,1,0,0,0,0,996,2211
5943,27,1071,54,0,1,2,0,0,1128,906,120,2,0,0,0,0,1028,2156
5943,28,1108,63,0,0,0,0,0,1171,901,127,3,1,0,0,0,1032,2203
5943,29,1121,80,2,2,0,0,0,1205,822,198,5,1,1,0,0,1027,2232
5943,30,1082,134,1,1,2,0,0,1220,799,257,2,1,0,0,0,1059,2279
5943,31,1097,157,3,0,2,0,0,1259,828,289,4,0,1,0,0,1122,2381
5943,32,1037,190,4,0,0,0,0,1231,715,321,7,0,0,0,0,1043,2274
5943,33,972,248,2,0,0,0,0,1222,638,440,12,3,2,0,0,1095,2317
5943,34,895,295,9,0,0,0,0,1199,625,428,13,1,0,0,0,1067,2266
5943,35,841,351,7,1,0,0,0,1200,596,496,23,5,1,0,0,1121,2321
5943,36,824,427,14,1,0,0,0,1266,484,526,29,5,1,0,0,1045,2311
5943,37,740,410,8,2,0,0,0,1160,502,525,25,5,2,0,0,1059,2219
5943,38,695,481,19,1,2,0,0,1198,459,681,27,6,0,0,0,1173,2371
5943,39,656,527,30,1,1,0,0,1215,404,705,42,1,1,0,0,1153,2368
5943,40,648,591,19,1,0,0,0,1259,396,731,40,5,0,0,0,1172,2431
5943,41,638,616,25,0,3,0,0,1282,396,783,60,6,0,1,0,1246,2528
5943,42,614,628,24,2,0,0,0,1268,356,810,60,9,0,0,0,1235,2503
5943,43,573,671,32,0,0,0,0,1276,338,839,59,8,0,0,0,1244,2520
5943,44,547,787,39,3,0,0,0,1376,301,943,74,24,0,0,0,1342,2718
5943,45,535,806,51,2,1,0,0,1395,325,996,59,20,0,0,0,1400,2795
5943,46,490,840,61,4,0,0,0,1395,319,1014,59,25,1,0,0,1418,2813
5943,47,495,947,60,5,0,0,1,1508,298,974,82,29,0,0,0,1383,2891
5943,48,534,997,66,7,0,0,0,1604,317,1154,108,23,0,0,0,1602,3206
5943,49,474,1100,65,2,2,0,0,1643,285,1207,98,26,0,0,0,1616,3259
5943,50,466,991,69,11,0,0,0,1537,235,1214,101,36,0,0,0,1586,3123
5943,51,410,1120,61,9,0,0,0,1600,276,1259,75,34,0,0,0,1644,3244
5943,52,395,1089,90,14,1,0,0,1589,206,1232,102,38,0,0,0,1578,3167
5943,53,352,1178,80,12,0,0,0,1622,225,1260,101,55,2,0,0,1643,3265
5943,54,346,1237,95,16,1,0,0,1695,229,1331,108,70,0,0,0,1738,3433
5943,55,356,1208,80,18,0,0,0,1662,236,1301,102,74,0,0,0,1713,3375
5943,56,305,1247,93,18,0,0,0,1663,186,1411,115,76,1,0,0,1789,3452
5943,57,289,1312,89,19,0,0,0,1709,200,1431,105,93,1,0,0,1830,3539
5943,58,268,1371,103,19,1,0,0,1762,183,1356,96,118,0,0,0,1753,3515
5943,59,299,1409,73,22,0,0,0,1803,183,1410,99,138,1,0,0,1831,3634
5943,60,254,1287,98,26,1,0,0,1666,138,1300,83,124,0,0,0,1645,3311
5943,61,190,1294,86,24,1,0,0,1595,144,1307,75,161,0,0,0,1687,3282
5943,62,205,1333,64,40,1,0,0,1643,131,1235,87,161,0,0,0,1614,3257
5943,63,207,1310,69,28,0,0,0,1614,153,1258,81,194,1,0,0,1687,3301
5943,64,166,1218,67,38,0,0,0,1489,139,1245,62,186,0,0,0,1632,3121
5943,65,142,1118,62,40,0,0,0,1362,125,1189,66,210,0,0,0,1590,2952
5943,66,136,1180,53,40,0,0,0,1409,107,1086,58,235,0,0,0,1486,2895
5943,67,129,1187,45,50,0,0,0,1411,103,1070,44,264,0,0,0,1481,2892
5943,68,117,1163,40,57,0,0,1,1378,115,1052,49,255,0,0,0,1471,2849
5943,69,117,1093,54,58,0,0,0,1322,98,1059,56,291,0,0,0,1504,2826
5943,70,90,1045,42,53,0,0,0,1230,95,914,34,266,0,0,0,1309,2539
5943,71,108,1087,30,51,0,0,0,1276,95,995,34,312,0,0,0,1436,2712
5943,72,71,1030,32,62,0,0,0,1195,85,846,37,315,0,0,0,1283,2478
5943,73,57,1090,35,74,0,0,0,1256,83,858,24,406,0,0,1,1372,2628
5943,74,72,1089,34,84,0,0,0,1279,82,854,25,463,0,0,0,1424,2703
5943,75,65,1057,25,78,0,0,0,1225,87,805,31,447,0,0,0,1370,2595
5943,76,70,931,25,77,0,0,0,1103,71,673,21,505,0,0,0,1270,2373
5943,77,71,906,17,92,0,0,0,1086,76,626,19,447,0,0,0,1168,2254
5943,78,39,630,20,86,0,0,0,775,53,458,10,429,0,0,0,950,1725
5943,79,26,630,8,89,0,0,0,753,45,419,10,416,0,0,0,890,1643
5943,80,35,555,7,79,0,0,0,676,50,350,13,435,0,0,0,848,1524
5943,81,33,508,8,73,0,0,0,622,40,317,14,430,0,0,0,801,1423
5943,82,22,518,7,104,0,0,0,651,45,349,13,505,0,0,0,912,1563
5943,83,36,566,7,106,0,0,0,715,63,315,11,613,0,0,0,1002,1717
5943,84,28,537,7,109,0,0,0,681,60,330,9,662,0,0,0,1061,1742
5943,85,24,432,3,124,0,0,0,583,35,191,3,558,0,0,0,787,1370
5943,86,21,344,4,144,0,0,0,513,46,208,5,566,0,0,0,825,1338
5943,87,19,313,3,114,0,0,0,449,48,162,7,563,0,0,0,780,1229
5943,88,12,264,4,117,0,0,0,397,31,113,4,552,0,0,0,700,1097
5943,89,15,219,1,111,0,0,0,346,48,113,5,486,0,0,0,652,998
5943,90,11,171,0,89,0,0,0,271,38,65,5,423,0,0,0,531,802
5943,91,6,109,0,94,0,0,0,209,32,62,4,349,0,0,0,447,656
5943,92,5,80,0,73,0,0,0,158,26,49,4,292,0,0,0,371,529
5943,93,2,66,3,62,0,0,0,133,23,25,2,266,0,0,0,316,449
5943,94,2,46,0,58,0,0,0,106,16,14,0,213,0,0,0,243,349
5943,95,2,28,0,36,0,0,0,66,12,12,1,159,0,0,0,184,250
5943,96,2,18,0,27,0,0,0,47,7,8,0,145,0,0,0,160,207
5943,97,1,10,0,17,0,0,0,28,8,9,1,87,0,0,0,105,133
5943,98,0,6,0,13,0,0,0,19,1,0,1,61,0,0,0,63,82
5943,99,0,4,0,4,0,0,0,8,3,3,0,46,0,0,0,52,60
5943,100,0,5,1,18,0,0,0,24,8,4,1,86,0,0,0,99,123
5943,999,48414,50107,2336,2915,25,0,2,103799,38833,49908,2910,14520,16,1,1,106189,209988
6045,0,2188,0,0,0,0,0,0,2188,2046,0,0,0,0,0,0,2046,4234
6045,1,2207,0,0,0,0,0,0,2207,1970,0,0,0,0,0,0,1970,4177
6045,2,2175,0,0,0,0,0,0,2175,2019,0,0,0,0,0,0,2019,4194
6045,3,2301,0,0,0,0,0,0,2301,2079,0,0,0,0,0,0,2079,4380
6045,4,2323,0,0,0,0,0,0,2323,2179,0,0,0,0,0,0,2179,4502
6045,5,2389,0,0,0,0,0,0,2389,2172,0,0,0,0,0,0,2172,4561
6045,6,2442,0,0,0,0,0,0,2442,2389,0,0,0,0,0,0,2389,4831
6045,7,2638,0,0,0,0,0,0,2638,2374,0,0,0,0,0,0,2374,5012
6045,8,2651,0,0,0,0,0,0,2651,2521,0,0,0,0,0,0,2521,5172
6045,9,2771,0,0,0,0,0,0,2771,2544,0,0,0,0,0,0,2544,5315
6045,10,2770,0,0,0,0,0,0,2770,2595,0,0,0,0,0,0,2595,5365
6045,11,2792,0,0,0,0,0,0,2792,2654,0,0,0,0,0,0,2654,5446
6045,12,2879,0,0,0,0,0,0,2879,2754,0,0,0,0,0,0,2754,5633
6045,13,3060,0,0,0,0,0,0,3060,2849,0,0,0,0,0,0,2849,5909
6045,14,3138,0,0,0,0,0,0,3138,3011,0,0,0,0,0,0,3011,6149
6045,15,3233,0,0,0,0,0,0,3233,2957,0,0,0,0,0,0,2957,6190
6045,16,3185,0,0,0,0,0,0,3185,2957,0,0,0,0,0,0,2957,6142
6045,17,3230,0,0,0,0,0,0,3230,3048,0,1,0,0,0,0,3049,6279
6045,18,3347,0,0,0,0,0,0,3347,3154,3,0,0,0,0,0,3157,6504
6045,19,3577,1,1,0,0,0,0,3579,3234,6,0,0,0,0,0,3240,6819
6045,20,3398,0,0,0,0,0,0,3398,3266,16,0,0,0,0,0,3282,6680
6045,21,3418,3,0,0,0,0,0,3421,3261,25,0,0,0,0,0,3286,6707
6045,22,3513,14,0,0,0,0,0,3527,3180,56,0,0,1,0,0,3237,6764
6045,23,3591,17,0,0,0,0,0,3608,3271,88,0,0,0,0,0,3359,6967
6045,24,3747,33,3,0,0,0,0,3783,3150,120,1,2,0,0,0,3273,7056
6045,25,3768,65,6,0,0,0,0,3839,3071,216,1,1,1,0,0,3290,7129
6045,26,3522,109,3,0,0,0,0,3634,2870,324,3,0,0,0,0,3197,6831
6045,27,3313,151,5,0,0,0,0,3469,2656,471,8,0,1,0,0,3136,6605
6045,28,3184,260,8,0,2,0,0,3454,2371,575,4,0,0,1,0,2951,6405
6045,29,3092,375,8,0,0,0,0,3475,2220,763,11,2,0,0,0,2996,6471
6045,30,3022,518,7,0,0,0,0,3547,2057,941,25,3,1,1,0,3028,6575
6045,31,2927,696,13,1,2,0,0,3639,2011,1210,23,1,1,0,0,3246,6885
6045,32,2714,858,11,0,2,0,0,3585,1813,1316,21,5,1,0,0,3156,6741
6045,33,2557,1107,24,2,1,0,0,3691,1661,1547,36,7,0,0,0,3251,6942
6045,34,2295,1150,25,3,1,0,0,3474,1552,1696,51,7,0,0,0,3306,6780
6045,35,2188,1324,27,1,0,0,0,3540,1407,1796,52,7,0,0,0,3262,6802
6045,36,1984,1553,36,3,0,0,0,3576,1249,1943,68,9,0,1,0,3270,6846
6045,37,1987,1569,38,6,2,0,0,3602,1126,1957,97,14,1,0,0,3195,6797
6045,38,1640,1679,62,1,1,0,0,3383,1040,2065,102,14,0,0,0,3221,6604
6045,39,1536,1796,58,5,2,0,0,3397,1034,2228,107,20,1,0,0,3390,6787
6045,40,1547,1901,65,9,2,0,0,3524,928,2312,126,22,1,0,0,3389,6913
6045,41,1483,2113,90,3,4,0,0,3693,904,2485,153,32,1,0,0,3575,7268
6045,42,1374,2192,98,9,2,0,0,3675,871,2612,140,42,2,0,0,3667,7342
6045,43,1319,2405,117,13,3,0,0,3857,763,2670,170,44,0,0,0,3647,7504
6045,44,1342,2443,118,19,1,0,1,3924,811,2779,186,46,0,0,0,3822,7746
6045,45,1315,2541,121,13,1,0,0,3991,715,3009,213,56,2,0,0,3995,7986
6045,46,1195,2832,149,20,2,0,0,4198,740,3122,197,57,1,0,0,4117,8315
6045,47,1228,2903,155,17,2,0,0,4305,717,3216,193,67,0,0,0,4193,8498
6045,48,1179,3059,168,25,1,0,0,4432,723,3257,220,93,1,0,0,4294,8726
6045,49,1068,3134,180,38,3,0,0,4423,638,3549,230,109,0,0,0,4526,8949
6045,50,1023,3093,169,23,1,0,0,4309,658,3420,247,119,0,0,0,4444,8753
6045,51,909,3203,174,24,0,0,0,4310,628,3432,231,127,1,0,0,4419,8729
6045,52,872,3333,220,28,3,0,0,4456,613,3583,250,152,1,0,0,4599,9055
6045,53,829,3291,203,33,0,0,0,4356,570,3513,258,172,0,0,0,4513,8869
6045,54,808,3540,190,40,3,0,0,4581,605,3620,252,191,3,0,0,4671,9252
6045,55,739,3555,176,35,2,0,0,4507,547,3703,226,223,1,1,0,4701,9208
6045,56,685,3688,204,50,2,0,0,4629,558,3801,262,240,0,0,0,4861,9490
6045,57,652,3673,250,67,0,0,0,4642,543,3651,244,267,0,0,0,4705,9347
6045,58,549,3757,194,77,1,0,0,4578,501,3750,215,288,0,0,0,4754,9332
6045,59,569,3794,202,77,2,0,0,4644,522,3833,253,338,0,0,0,4946,9590
6045,60,459,3493,203,80,2,0,0,4237,471,3599,197,354,0,0,0,4621,8858
6045,61,451,3454,175,81,0,0,0,4161,412,3471,198,357,0,0,0,4438,8599
6045,62,385,3361,150,75,0,0,0,3971,420,3213,186,370,0,0,0,4189,8160
6045,63,376,3358,154,107,1,0,0,3996,382,3210,175,467,0,0,0,4234,8230
6045,64,353,3172,148,114,0,0,0,3787,394,3088,164,461,0,0,0,4107,7894
6045,65,302,3095,114,116,0,0,0,3627,309,3041,167,521,0,0,0,4038,7665
6045,66,284,2972,112,124,0,0,0,3492,341,2838,148,577,0,0,0,3904,7396
6045,67,261,3035,93,125,0,0,0,3514,328,2783,163,618,0,0,0,3892,7406
6045,68,227,3019,106,144,1,0,0,3497,302,2651,137,680,0,0,0,3770,7267
6045,69,236,3006,105,146,1,0,0,3494,280,2608,110,671,0,0,0,3669,7163
6045,70,179,2673,101,182,0,0,0,3135,272,2386,95,702,0,0,0,3455,6590
6045,71,179,2595,75,183,0,0,0,3032,260,2180,95,777,0,0,0,3312,6344
6045,72,135,2545,67,181,0,0,0,2928,237,2159,109,797,1,0,0,3303,6231
6045,73,161,2517,79,194,1,0,0,2952,258,2200,85,885,0,0,0,3428,6380
6045,74,124,2727,59,207,0,0,0,3117,246,2158,84,956,0,0,0,3444,6561
6045,75,133,2687,67,251,0,0,0,3138,250,2193,76,1242,0,0,0,3761,6899
6045,76,131,2465,44,235,0,0,0,2875,253,1826,55,1098,0,0,0,3232,6107
6045,77,92,2276,42,283,0,0,0,2693,196,1735,74,1313,0,0,0,3318,6011
6045,78,85,1845,43,254,0,0,0,2227,190,1397,57,1078,0,0,0,2722,4949
6045,79,63,1610,30,244,0,0,0,1947,162,1192,37,1027,0,0,0,2418,4365
6045,80,53,1443,18,237,0,0,0,1751,188,1000,32,1037,0,0,0,2257,4008
6045,81,66,1490,23,297,0,0,0,1876,154,933,29,1155,0,0,0,2271,4147
6045,82,50,1306,17,270,0,0,0,1643,144,811,26,1162,0,0,0,2143,3786
6045,83,51,1287,14,301,0,0,0,1653,157,735,32,1426,0,0,0,2350,4003
6045,84,53,1220,17,360,0,0,0,1650,184,636,32,1390,0,0,0,2242,3892
6045,85,43,1046,12,313,0,0,0,1414,156,530,13,1330,0,0,0,2029,3443
6045,86,25,846,10,276,0,0,0,1157,122,453,17,1289,0,0,0,1881,3038
6045,87,30,653,9,308,0,0,0,1000,133,272,17,1209,0,0,0,1631,2631
6045,88,25,574,3,262,0,0,0,864,101,258,17,1096,0,0,0,1472,2336
6045,89,18,443,3,274,0,0,0,738,103,177,11,1033,0,0,0,1324,2062
6045,90,21,347,4,217,0,0,0,589,87,140,7,899,0,0,0,1133,1722
6045,91,15,248,1,211,0,0,0,475,76,107,7,763,0,0,0,953,1428
6045,92,7,173,3,164,0,0,0,347,46,61,9,623,0,0,0,739,1086
6045,93,7,138,1,143,0,0,0,289,51,38,3,577,0,0,0,669,958
6045,94,1,105,1,101,0,0,0,208,40,27,0,404,0,0,0,471,679
6045,95,1,46,2,105,0,0,0,154,33,14,6,338,0,0,0,391,545
6045,96,2,33,0,52,0,0,0,87,29,13,1,257,0,0,0,300,387
6045,97,3,19,0,42,0,0,0,64,15,9,1,177,0,0,0,202,266
6045,98,1,10,0,34,0,0,0,45,18,3,1,118,0,0,0,140,185
6045,99,1,8,0,30,0,0,0,39,7,4,0,99,0,0,0,110,149
6045,100,2,10,0,21,0,0,0,33,15,4,0,140,0,0,0,159,192
6045,999,138468,141078,5683,7986,54,0,1,293270,117149,140832,7550,34250,23,4,0,299808,593078
6087,0,4224,0,0,0,0,0,0,4224,4131,0,0,0,0,0,0,4131,8355
6087,1,4452,0,0,0,0,0,0,4452,4181,0,0,0,0,0,0,4181,8633
6087,2,4429,0,0,0,0,0,0,4429,4209,0,0,0,0,0,0,4209,8638
6087,3,4480,0,0,0,0,0,0,4480,4110,0,0,0,0,0,0,4110,8590
6087,4,4637,0,0,0,0,0,0,4637,4465,0,0,0,0,0,0,4465,9102
6087,5,4959,0,0,0,0,0,0,4959,4623,0,0,0,0,0,0,4623,9582
6087,6,5115,0,0,0,0,0,0,5115,4789,0,0,0,0,0,0,4789,9904
6087,7,5287,0,0,0,0,0,0,5287,4859,0,0,0,0,0,0,4859,10146
6087,8,5217,0,0,0,0,0,0,5217,4942,0,0,0,0,0,0,4942,10159
6087,9,5430,0,0,0,0,0,0,5430,5110,0,0,0,0,0,0,5110,10540
6087,10,5445,0,0,0,0,0,0,5445,5129,0,0,0,0,0,0,5129,10574
6087,11,5692,0,0,0,0,0,0,5692,5287,0,0,0,0,0,0,5287,10979
6087,12,5905,0,0,0,0,0,0,5905,5537,0,0,0,0,0,0,5537,11442
6087,13,5896,0,0,0,0,0,0,5896,5799,0,0,0,0,0,0,5799,11695
6087,14,5989,0,0,0,0,0,0,5989,5601,0,0,0,0,0,0,5601,11590
6087,15,6076,0,0,0,0,0,0,6076,5745,0,0,0,0,0,0,5745,11821
6087,16,6100,0,0,0,0,0,0,6100,5809,0,0,0,0,0,0,5809,11909
6087,17,6222,0,0,0,0,0,0,6222,5854,0,0,0,0,0,0,5854,12076
6087,18,6520,0,0,0,0,0,0,6520,5811,0,0,0,0,0,0,5811,12331
6087,19,6406,3,0,0,0,0,0,6409,6204,12,0,0,0,0,0,6216,12625
6087,20,6490,5,0,0,0,0,0,6495,6200,23,0,0,0,0,0,6223,12718
6087,21,6371,6,1,0,0,0,0,6378,6052,42,0,0,1,0,0,6095,12473
6087,22,6691,18,0,0,1,0,0,6710,6110,92,1,0,1,0,0,6204,12914
6087,23,6798,38,0,0,0,0,0,6836,6214,137,1,0,2,0,0,6354,13190
6087,24,6673,63,0,0,0,0,0,6736,6058,217,0,0,4,1,0,6280,13016
6087,25,6555,112,1,0,0,0,0,6668,5954,360,4,0,1,0,0,6319,12987
6087,26,6527,183,0,0,0,0,0,6710,5611,505,3,0,3,0,0,6122,12832
6087,27,6490,285,2,0,0,1,0,6778,5622,731,5,1,2,0,0,6361,13139
6087,28,6122,453,6,0,3,0,0,6584,5145,1112,12,1,4,0,0,6274,12858
6087,29,5852,672,3,1,1,0,0,6529,4776,1472,18,0,2,0,0,6268,12797
6087,30,5766,971,13,0,5,0,0,6755,4560,1902,24,3,6,0,0,6495,13250
6087,31,5554,1276,15,0,10,0,0,6855,4366,2415,36,3,7,0,0,6827,13682
6087,32,5305,1685,27,1,8,0,0,7026,3911,2805,52,6,3,0,0,6777,13803
6087,33,4788,2182,13,3,4,0,0,6990,3415,3268,50,9,5,0,0,6747,13737
6087,34,4395,2376,43,4,11,0,0,6829,3152,3544,89,13,5,0,0,6803,13632
6087,35,4259,2989,64,2,12,0,0,7326,2956,4079,103,16,6,0,0,7160,14486
6087,36,3882,3104,54,3,7,0,0,7050,2610,4251,127,13,3,0,0,7004,14054
6087,37,3489,3399,83,4,9,0,0,6984,2345,4440,168,25,2,1,0,6981,13965
6087,38,3281,3648,78,2,7,0,0,7016,2195,4552,185,31,10,0,0,6973,13989
6087,39,3074,4066,119,4,9,1,0,7273,2150,4962,214,38,6,0,0,7370,14643
6087,40,2907,4355,124,4,11,0,0,7401,1989,5107,257,36,6,0,0,7395,14796
6087,41,2785,4535,128,13,9,3,0,7473,1965,5664,233,43,6,0,0,7911,15384
6087,42,2698,4780,126,17,5,0,0,7626,1848,5617,289,73,9,0,0,7836,15462
6087,43,2518,4895,193,12,4,0,0,7622,1720,5942,321,67,9,0,0,8059,15681
6087,44,2480,5410,212,13,7,0,0,8122,1704,6095,406,88,6,0,0,8299,16421
6087,45,2551,5705,264,22,4,0,0,8546,1594,6422,415,88,5,0,0,8524,17070
6087,46,2466,6013,287,36,8,2,0,8812,1608,6718,462,91,7,0,0,8886,17698
6087,47,2362,6236,336,29,6,1,0,8970,1666,7149,489,116,9,0,0,9429,18399
6087,48,2331,6631,368,28,10,0,0,9368,1562,7540,564,143,3,0,0,9812,19180
6087,49,2236,6878,360,53,6,1,0,9534,1530,7833,594,158,3,0,0,10118,19652
6087,50,1989,6953,405,43,1,0,0,9391,1424,7635,580,170,9,0,0,9818,19209
6087,51,1924,6910,431,50,6,1,0,9322,1331,7430,599,199,1,0,0,9560,18882
6087,52,1782,7029,473,54,4,0,0,9342,1312,7570,594,251,3,0,0,9730,19072
6087,53,1665,7234,474,68,4,1,0,9446,1158,7624,594,249,3,0,0,9628,19074
6087,54,1563,7206,439,86,5,0,0,9299,1160,7846,667,318,0,0,0,9991,19290
6087,55,1392,7387,531,101,7,0,0,9418,1172,7849,610,363,4,0,0,9998,19416
6087,56,1335,7694,501,99,3,0,0,9632,1113,7972,597,423,0,0,0,10105,19737
6087,57,1181,7994,475,114,5,0,2,9771,1047,8181,593,440,3,0,0,10264,20035
6087,58,1157,7923,501,118,2,0,0,9701,1062,8212,654,535,0,0,0,10463,20164
6087,59,1072,8091,495,161,8,0,0,9827,1029,8134,585,604,6,0,0,10358,20185
6087,60,888,7396,420,160,1,0,0,8865,917,7606,552,608,2,0,0,9685,18550
6087,61,812,7328,386,166,7,0,0,8699,890,7306,518,705,2,0,0,9421,18120
6087,62,706,7432,372,148,4,0,0,8662,834,7195,526,754,1,0,0,9310,17972
6087,63,671,7108,386,208,3,0,0,8376,761,6820,473,851,4,0,0,8909,17285
6087,64,581,6867,365,187,1,0,0,8001,716,6931,449,878,0,0,0,8974,16975
6087,65,489,6492,311,217,1,0,0,7510,669,6356,404,920,0,0,0,8349,15859
6087,66,519,6573,317,270,2,0,0,7681,652,6229,403,1068,0,0,1,8353,16034
6087,67,448,6353,274,252,1,0,1,7329,660,6060,353,1132,0,0,0,8205,15534
6087,68,392,6154,246,259,2,0,1,7054,561,5716,338,1229,0,0,0,7844,14898
6087,69,384,6096,231,319,1,0,0,7031,595,5630,302,1340,0,1,0,7868,14899
6087,70,325,5700,222,300,1,0,0,6548,534,5146,302,1418,0,0,0,7400,13948
6087,71,298,5547,190,298,2,0,0,6335,502,4949,269,1399,0,0,0,7119,13454
6087,72,303,5503,167,382,3,0,0,6358,542,4591,235,1565,1,0,0,6934,13292
6087,73,254,5716,176,377,0,0,0,6523,528,4838,265,1780,0,0,0,7411,13934
6087,74,267,5474,160,414,1,0,0,6316,589,4458,252,1903,0,0,0,7202,13518
6087,75,230,5738,133,504,1,0,0,6606,524,4553,234,2276,0,0,0,7587,14193
6087,76,204,5071,129,508,1,0,0,5913,515,4058,177,2319,1,0,0,7070,12983
6087,77,197,4894,118,581,2,0,0,5792,452,3763,192,2449,0,0,0,6856,12648
6087,78,158,4122,98,515,2,0,0,4895,442,2906,136,2285,0,0,0,5769,10664
6087,79,144,3369,64,468,1,0,0,4046,380,2468,102,2137,0,0,0,5087,9133
6087,80,121,3216,60,476,0,0,0,3873,341,2190,99,2186,0,0,0,4816,8689
6087,81,126,3064,48,549,0,0,0,3787,373,2009,99,2484,0,0,0,4965,8752
6087,82,94,2800,46,592,0,0,0,3532,353,1789,81,2364,0,0,0,4587,8119
6087,83,118,2861,41,626,0,0,0,3646,338,1604,84,2660,0,0,0,4686,8332
6087,84,106,2407,38,641,0,0,0,3192,312,1366,82,2545,0,0,0,4305,7497
6087,85,68,2104,38,611,0,0,0,2821,271,1095,48,2638,0,0,0,4052,6873
6087,86,64,1810,29,594,0,0,0,2497,277,878,39,2550,0,0,0,3744,6241
6087,87,48,1417,20,578,0,0,0,2063,247,652,31,2254,0,0,0,3184,5247
6087,88,37,1259,15,556,0,0,0,1867,215,534,36,2180,0,0,0,2965,4832
6087,89,52,979,9,546,0,0,0,1586,202,376,27,1955,0,0,0,2560,4146
6087,90,28,816,5,464,0,0,0,1313,164,272,27,1754,0,0,0,2217,3530
6087,91,25,559,5,405,0,0,0,994,144,186,18,1508,0,0,0,1856,2850
6087,92,18,393,5,347,0,0,0,763,129,104,19,1302,1,0,0,1555,2318
6087,93,18,321,1,324,0,0,0,664,110,95,10,1113,0,0,0,1328,1992
6087,94,10,204,0,216,0,0,0,430,100,63,1,787,0,0,0,951,1381
6087,95,5,128,1,149,0,0,0,283,63,34,3,672,0,0,0,772,1055
6087,96,3,87,1,124,0,0,0,215,64,19,4,500,0,0,0,587,802
6087,97,3,60,1,81,0,0,0,145,34,15,3,317,0,0,0,369,514
6087,98,4,27,1,52,0,0,0,84,29,3,0,226,0,0,0,258,342
6087,99,4,22,0,37,0,0,0,63,13,5,5,132,0,0,0,155,218
6087,100,1,22,0,53,0,0,0,76,37,5,1,277,0,0,0,320,396
6087,999,266460,300882,12774,15699,239,11,4,596069,236670,304334,18394,66034,177,3,1,625613,1221682
6150,0,1774,0,0,0,0,0,0,1774,1616,0,0,0,0,0,0,1616,3390
6150,1,1807,0,0,0,0,0,0,1807,1676,0,0,0,0,0,0,1676,3483
6150,2,1843,0,0,0,0,0,0,1843,1782,0,0,0,0,0,0,1782,3625
6150,3,1885,0,0,0,0,0,0,1885,1753,0,0,0,0,0,0,1753,3638
6150,4,2002,0,0,0,0,0,0,2002,1832,0,0,0,0,0,0,1832,3834
6150,5,2033,0,0,0,0,0,0,2033,1940,0,0,0,0,0,0,1940,3973
6150,6,2233,0,0,0,0,0,0,2233,2033,0,0,0,0,0,0,2033,4266
6150,7,2168,0,0,0,0,0,0,2168,2176,0,0,0,0,0,0,2176,4344
6150,8,2290,0,0,0,0,0,0,2290,2201,0,0,0,0,0,0,2201,4491
6150,9,2461,0,0,0,0,0,0,2461,2370,0,0,0,0,0,0,2370,4831
6150,10,2423,0,0,0,0,0,0,2423,2332,0,0,0,0,0,0,2332,4755
6150,11,2674,0,0,0,0,0,0,2674,2437,0,0,0,0,0,0,2437,5111
6150,12,2671,0,0,0,0,0,0,2671,2592,0,0,0,0,0,0,2592,5263
6150,13,2845,0,0,0,0,0,0,2845,2567,0,0,0,0,0,0,2567,5412
6150,14,2764,0,0,0,0,0,0,2764,2627,0,0,0,0,0,0,2627,5391
6150,15,2784,0,0,0,0,0,0,2784,2645,0,0,0,0,0,0,2645,5429
6150,16,2819,0,0,0,0,0,0,2819,2711,0,0,0,0,0,0,2711,5530
6150,17,2808,0,0,0,0,0,0,2808,2758,0,0,0,0,0,0,2758,5566
6150,18,2948,0,0,0,0,0,0,2948,2772,0,0,0,0,0,0,2772,5720
6150,19,2933,0,0,0,0,0,0,2933,2888,2,0,0,0,0,0,2890,5823
6150,20,2975,0,0,0,0,0,0,2975,2933,7,0,0,0,0,0,2940,5915
6150,21,2995,3,0,0,0,0,0,2998,2781,9,0,0,0,0,0,2790,5788
6150,22,3023,3,0,0,1,0,0,3027,2734,32,0,0,0,0,0,2766,5793
6150,23,3031,9,0,0,2,0,0,3042,2740,46,0,0,1,0,0,2787,5829
6150,24,3056,21,2,0,1,0,0,3080,2619,58,0,0,1,0,0,2678,5758
6150,25,2997,35,1,0,0,0,0,3033,2532,111,0,1,4,0,0,2648,5681
6150,26,2840,54,0,0,1,0,0,2895,2486,194,0,0,4,0,0,2684,5579
6150,27,2752,112,0,1,3,0,0,2868,2384,250,0,0,2,0,0,2636,5504
6150,28,2635,158,2,0,1,0,0,2796,2253,359,5,2,0,0,0,2619,5415
6150,29,2603,215,0,0,1,0,0,2819,2119,490,7,0,2,0,0,2618,5437
6150,30,2563,335,4,0,3,0,0,2905,2086,648,14,0,2,0,0,2750,5655
6150,31,2611,373,5,2,1,0,0,2992,1951,872,14,3,2,0,0,2842,5834
6150,32,2354,505,6,1,2,0,0,2868,1837,1007,21,3,2,0,0,2870,5738
6150,33,2284,630,10,3,1,1,0,2929,1717,1155,26,7,2,0,0,2907,5836
6150,34,2134,753,9,4,2,0,0,2902,1632,1254,39,10,2,0,0,2937,5839
6150,35,2082,1030,11,5,4,0,0,3132,1431,1507,50,8,1,0,0,2997,6129
6150,36,1852,1140,28,2,2,0,0,3024,1293,1604,59,7,4,0,0,2967,5991
6150,37,1794,1317,28,4,0,0,0,3143,1252,1797,67,12,3,0,0,3131,6274
6150,38,1642,1386,50,1,3,0,0,3082,1158,1937,86,11,2,0,0,3194,6276
6150,39,1617,1537,47,4,2,0,0,3207,1130,2030,108,14,1,2,0,3285,6492
6150,40,1544,1712,50,3,3,0,0,3312,1025,2101,121,16,4,0,0,3267,6579
6150,41,1459,1791,69,5,1,1,0,3326,940,2164,113,22,3,0,0,3242,6568
6150,42,1349,1963,63,6,0,0,1,3382,953,2465,157,18,0,0,0,3593,6975
6150,43,1356,2181,103,10,3,0,0,3653,878,2467,151,32,2,0,0,3530,7183
6150,44,1335,2304,136,10,3,0,0,3788,843,2820,166,37,2,0,0,3868,7656
6150,45,1285,2468,128,10,1,0,0,3892,862,2882,212,36,1,0,0,3993,7885
6150,46,1314,2778,132,18,3,1,0,4246,826,3022,222,48,0,0,0,4118,8364
6150,47,1275,2868,149,19,1,0,0,4312,814,3158,242,66,0,0,0,4280,8592
6150,48,1229,2996,149,25,5,0,0,4404,829,3329,250,74,0,0,0,4482,8886
6150,49,1199,3036,183,23,3,0,0,4444,754,3482,250,84,3,0,0,4573,9017
6150,50,1002,3100,190,17,2,0,0,4311,687,3267,253,95,1,0,0,4303,8614
6150,51,974,3032,184,23,4,0,0,4217,640,3339,252,104,0,0,0,4335,8552
6150,52,883,3094,207,27,2,0,0,4213,591,3343,273,139,0,0,0,4346,8559
6150,53,799,2999,206,39,3,0,0,4046,571,3246,254,116,1,0,0,4188,8234
6150,54,792,3134,244,41,5,0,0,4216,563,3437,296,155,0,0,0,4451,8667
6150,55,692,3112,213,48,2,0,0,4067,554,3503,284,200,0,0,0,4541,8608
6150,56,653,3240,222,37,4,1,0,4157,547,3407,282,198,3,0,0,4437,8594
6150,57,619,3310,208,56,2,1,0,4196,495,3536,284,230,0,0,0,4545,8741
6150,58,561,3445,213,66,5,0,0,4290,505,3575,270,261,1,0,0,4612,8902
6150,59,458,3439,211,76,3,0,0,4187,524,3568,254,255,0,0,0,4601,8788
6150,60,437,3188,204,71,1,0,0,3901,422,3296,239,281,0,0,0,4238,8139
6150,61,421,3114,171,69,0,0,0,3775,405,3264,236,352,1,0,0,4258,8033
6150,62,384,3220,173,79,0,0,0,3856,360,3381,215,398,0,0,0,4354,8210
6150,63,301,3247,185,88,0,0,0,3821,370,3117,198,421,0,0,0,4106,7927
6150,64,303,3106,180,96,0,0,0,3685,320,3024,191,472,0,0,0,4007,7692
6150,65,266,2958,143,94,1,0,0,3462,357,2883,149,503,1,0,0,3893,7355
6150,66,271,2973,141,120,1,0,0,3506,342,2962,164,552,0,0,0,4020,7526
6150,67,218,2944,112,114,0,0,0,3388,289,2721,162,601,0,0,0,3773,7161
6150,68,208,2959,117,117,0,0,0,3401,305,2808,151,674,0,0,0,3938,7339
6150,69,193,2720,113,123,1,0,0,3150,243,2615,137,642,0,0,0,3637,6787
6150,70,173,2808,86,147,2,0,0,3216,235,2440,122,736,0,0,0,3533,6749
6150,71,147,2551,74,169,3,0,0,2944,228,2318,98,775,0,0,0,3419,6363
6150,72,141,2712,84,188,0,0,0,3125,273,2303,99,828,0,0,1,3504,6629
6150,73,135,2727,65,188,2,0,0,3117,242,2297,94,943,0,0,0,3576,6693
6150,74,120,2709,65,224,1,0,0,3119,247,2119,90,1007,0,0,0,3463,6582
6150,75,122,2757,60,238,1,0,0,3178,260,2065,80,1173,0,0,0,3578,6756
6150,76,114,2560,51,253,0,0,0,2978,252,1946,74,1171,0,0,0,3443,6421
6150,77,93,2310,47,252,1,0,0,2703,228,1811,64,1301,0,0,0,3404,6107
6150,78,67,2033,37,240,0,0,0,2377,216,1438,52,1102,0,0,0,2808,5185
6150,79,68,1700,23,251,0,0,0,2042,152,1198,47,1167,0,0,0,2564,4606
6150,80,72,1566,29,243,0,0,0,1910,155,1049,57,1168,0,0,0,2429,4339
6150,81,58,1474,18,280,1,0,0,1831,168,999,46,1225,0,0,0,2438,4269
6150,82,54,1387,33,273,0,0,0,1747,161,817,24,1202,0,0,0,2204,3951
6150,83,46,1409,19,338,0,0,0,1812,203,830,36,1390,0,0,0,2459,4271
6150,84,40,1248,3,290,0,0,0,1581,167,694,20,1407,0,0,0,2288,3869
6150,85,24,1040,11,301,0,0,0,1376,145,529,25,1299,0,0,0,1998,3374
6150,86,28,864,10,277,0,0,0,1179,129,425,15,1283,0,0,0,1852,3031
6150,87,24,670,7,272,0,0,0,973,114,309,12,1097,0,0,0,1532,2505
6150,88,32,583,3,252,0,0,0,870,116,208,6,1088,0,0,0,1418,2288
6150,89,16,446,5,260,0,0,0,727,107,158,7,969,0,0,0,1241,1968
6150,90,13,331,1,216,0,0,0,561,93,111,3,754,0,0,0,961,1522
6150,91,12,251,0,171,0,0,0,434,76,73,4,690,0,0,0,843,1277
6150,92,10,186,1,135,0,0,0,332,54,53,5,597,0,0,0,709,1041
6150,93,2,127,3,145,0,0,0,277,55,38,3,551,0,0,0,647,924
6150,94,4,80,3,86,0,0,0,173,31,20,0,393,0,0,0,444,617
6150,95,4,58,0,70,0,0,0,132,40,11,0,271,0,0,0,322,454
6150,96,5,35,1,49,0,0,0,90,22,6,1,210,0,0,0,239,329
6150,97,3,11,0,31,0,0,0,45,17,6,0,138,0,0,0,161,206
6150,98,1,8,0,25,0,0,0,34,9,5,1,97,0,0,0,112,146
6150,99,0,9,0,20,0,0,0,29,10,3,0,46,0,0,0,59,88
6150,100,2,7,0,17,0,0,0,26,16,4,1,123,0,0,0,144,170
6150,999,123415,132704,5741,7458,100,5,1,269424,108811,133834,8010,33361,58,2,1,284077,553501
6153,0,1175,0,0,0,0,0,0,1175,1162,0,0,0,0,0,0,1162,2337
6153,1,1321,0,0,0,0,0,0,1321,1197,0,0,0,0,0,0,1197,2518
6153,2,1275,0,0,0,0,0,0,1275,1134,0,0,0,0,0,0,1134,2409
6153,3,1299,0,0,0,0,0,0,1299,1210,0,0,0,0,0,0,1210,2509
6153,4,1219,0,0,0,0,0,0,1219,1230,0,0,0,0,0,0,1230,2449
6153,5,1359,0,0,0,0,0,0,1359,1313,0,0,0,0,0,0,1313,2672
6153,6,1375,0,0,0,0,0,0,1375,1396,0,0,0,0,0,0,1396,2771
6153,7,1484,0,0,0,0,0,0,1484,1390,0,0,0,0,0,0,1390,2874
6153,8,1499,0,0,0,0,0,0,1499,1457,0,0,0,0,0,0,1457,2956
6153,9,1577,0,0,0,0,0,0,1577,1504,0,0,0,0,0,0,1504,3081
6153,10,1675,0,0,0,0,0,0,1675,1585,0,0,0,0,0,0,1585,3260
6153,11,1673,0,0,0,0,0,0,1673,1597,0,0,0,0,0,0,1597,3270
6153,12,1781,0,0,0,0,0,0,1781,1617,0,0,0,0,0,0,1617,3398
6153,13,1750,0,0,0,0,0,0,1750,1709,0,0,0,0,0,0,1709,3459
6153,14,1921,0,0,0,0,0,0,1921,1732,0,0,0,0,0,0,1732,3653
6153,15,1825,0,0,0,0,0,0,1825,1741,0,0,0,0,0,0,1741,3566
6153,16,1938,0,0,0,0,0,0,1938,1694,0,0,0,0,0,0,1694,3632
6153,17,1924,0,0,0,0,0,0,1924,1759,0,0,0,0,0,0,1759,3683
6153,18,1943,0,0,0,0,0,0,1943,1761,3,0,0,0,0,0,1764,3707
6153,19,2018,0,0,0,0,0,0,2018,1832,5,0,0,0,0,0,1837,3855
6153,20,1934,1,0,0,0,0,0,1935,1722,6,0,0,0,0,0,1728,3663
6153,21,1975,2,0,0,0,0,0,1977,1817,14,0,0,0,0,0,1831,3808
6153,22,1998,3,0,0,1,0,0,2002,1835,22,0,0,0,0,0,1857,3859
6153,23,1962,4,0,0,1,0,0,1967,1925,22,0,0,0,1,0,1948,3915
6153,24,2076,14,0,0,1,0,0,2091,1857,64,0,0,1,0,0,1922,4013
6153,25,2011,19,0,0,0,0,0,2030,1776,86,0,1,0,0,0,1863,3893
6153,26,1886,51,0,0,0,0,0,1937,1668,124,1,1,0,0,0,1794,3731
6153,27,1944,71,0,0,0,0,0,2015,1645,160,2,1,0,0,0,1808,3823
6153,28,1795,124,0,1,1,0,0,1921,1518,276,5,0,1,0,0,1800,3721
6153,29,1791,175,3,0,1,0,0,1970,1484,349,9,0,1,0,0,1843,3813
6153,30,1824,233,3,1,1,0,0,2062,1468,451,16,0,1,0,0,1936,3998
6153,31,1827,315,4,1,3,0,0,2150,1390,646,8,0,2,0,0,2046,4196
6153,32,1703,375,6,0,1,0,0,2085,1289,726,13,1,2,0,0,2031,4116
6153,33,1644,490,9,2,0,0,0,2145,1202,776,19,1,1,0,0,1999,4144
6153,34,1565,565,12,1,4,0,0,2147,1164,882,33,0,2,0,0,2081,4228
6153,35,1422,704,12,0,2,0,0,2140,1035,1042,41,6,0,0,0,2124,4264
6153,36,1395,811,19,1,4,0,0,2230,1024,1092,59,5,2,0,0,2182,4412
6153,37,1265,819,29,3,1,0,0,2117,871,1152,53,4,0,0,0,2080,4197
6153,38,1250,953,34,2,4,0,0,2243,823,1291,71,13,0,0,0,2198,4441
6153,39,1138,1045,30,1,2,0,0,2216,800,1366,66,7,0,0,0,2239,4455
6153,40,1009,1165,32,3,3,0,0,2212,724,1410,79,6,0,0,0,2219,4431
6153,41,1007,1247,62,3,6,0,0,2325,685,1616,96,9,1,0,0,2407,4732
6153,42,981,1239,59,1,1,0,0,2281,656,1570,104,19,1,0,0,2350,4631
6153,43,906,1432,70,2,2,0,0,2412,618,1603,124,18,1,0,0,2364,4776
6153,44,954,1539,73,9,5,0,0,2580,619,1764,136,20,1,0,0,2540,5120
6153,45,839,1612,98,6,2,0,0,2557,622,1821,150,27,2,1,0,2623,5180
6153,46,850,1695,119,10,1,0,0,2675,599,1990,171,38,1,0,0,2799,5474
6153,47,834,1833,125,11,4,0,0,2807,618,2038,198,34,1,0,0,2889,5696
6153,48,807,1914,145,14,0,0,0,2880,578,2151,215,52,1,0,0,2997,5877
6153,49,821,2002,136,15,2,0,0,2976,557,2253,211,56,0,0,0,3077,6053
6153,50,702,1901,153,17,4,0,0,2777,539,2176,207,60,0,0,0,2982,5759
6153,51,622,1991,148,15,2,0,0,2778,489,2150,208,58,0,0,0,2905,5683
6153,52,619,1978,173,21,2,0,0,2793,461,2236,189,87,0,0,0,2973,5766
6153,53,567,2082,145,22,2,0,0,2818,451,2253,201,97,1,0,0,3003,5821
6153,54,522,2091,182,23,3,0,0,2821,425,2348,229,99,0,0,0,3101,5922
6153,55,507,2245,191,28,3,0,0,2974,412,2357,221,126,0,0,0,3116,6090
6153,56,437,2321,155,35,4,0,0,2952,459,2328,216,148,0,0,0,3151,6103
6153,57,450,2331,177,28,2,0,0,2988,396,2314,176,136,1,0,0,3023,6011
6153,58,397,2343,170,54,0,0,0,2964,375,2429,203,163,1,0,0,3171,6135
6153,59,366,2413,166,49,2,0,0,2996,406,2452,188,197,0,0,0,3243,6239
6153,60,294,2297,157,53,2,0,0,2803,401,2374,190,225,2,0,0,3192,5995
6153,61,269,2262,147,59,1,0,0,2738,356,2115,153,243,1,0,0,2868,5606
6153,62,266,2247,110,54,2,0,0,2679,320,2308,151,256,0,0,0,3035,5714
6153,63,202,2151,136,53,2,0,0,2544,297,2225,151,269,0,0,0,2942,5486
6153,64,183,2177,122,86,0,0,0,2568,282,2011,141,335,0,0,0,2769,5337
6153,65,185,2034,97,82,2,0,0,2400,248,1935,137,356,0,0,0,2676,5076
6153,66,151,2029,128,65,0,0,0,2373,273,1903,123,356,0,0,0,2655,5028
6153,67,168,2047,103,56,0,0,0,2374,258,1959,110,356,0,0,0,2683,5057
6153,68,139,1904,98,91,0,0,0,2232,255,1817,116,450,1,0,0,2639,4871
6153,69,143,1891,70,87,1,0,0,2192,218,1615,81,425,0,0,0,2339,4531
6153,70,139,1730,55,118,1,0,0,2043,211,1568,89,478,1,0,0,2347,4390
6153,71,109,1763,72,110,1,0,0,2055,240,1561,86,532,1,0,0,2420,4475
6153,72,112,1709,72,109,0,0,0,2002,214,1577,66,626,0,0,0,2483,4485
6153,73,94,1831,42,150,0,0,0,2117,218,1515,62,671,0,0,0,2466,4583
6153,74,94,1830,46,140,2,0,0,2112,222,1524,66,732,0,0,0,2544,4656
6153,75,77,1838,45,154,0,0,0,2114,230,1439,79,784,0,0,0,2532,4646
6153,76,83,1620,37,189,0,0,0,1929,194,1341,57,792,0,0,0,2384,4313
6153,77,77,1504,51,166,1,0,0,1799,180,1200,60,885,0,0,0,2325,4124
6153,78,43,1233,32,155,1,0,0,1464,167,886,43,759,0,0,0,1855,3319
6153,79,48,1070,24,144,0,0,0,1286,173,793,42,819,0,0,0,1827,3113
6153,80,22,1115,21,158,0,0,0,1316,161,733,30,841,0,0,0,1765,3081
6153,81,49,1027,27,184,1,0,0,1288,148,679,30,893,0,0,0,1750,3038
6153,82,38,906,18,181,1,0,0,1144,126,550,28,822,0,0,0,1526,2670
6153,83,31,886,14,210,0,0,0,1141,130,508,24,937,0,0,0,1599,2740
6153,84,33,830,9,237,0,0,0,1109,147,481,28,979,0,0,0,1635,2744
6153,85,20,705,14,199,0,0,0,938,139,341,18,906,0,0,0,1404,2342
6153,86,16,569,9,203,0,0,0,797,115,268,18,834,0,0,0,1235,2032
6153,87,20,473,3,197,0,0,0,693,88,210,18,756,0,0,0,1072,1765
6153,88,14,368,3,165,0,0,0,550,78,165,13,685,0,0,0,941,1491
6153,89,13,307,2,141,0,0,0,463,97,103,5,671,0,0,0,876,1339
6153,90,4,244,1,141,0,0,0,390,67,92,7,559,0,0,0,725,1115
6153,91,9,187,1,115,0,0,0,312,45,62,14,486,0,0,0,607,919
6153,92,9,146,0,84,0,0,0,239,56,51,3,428,0,0,0,538,777
6153,93,1,109,0,100,0,0,0,210,40,29,1,363,0,0,0,433,643
6153,94,3,78,0,45,0,0,0,126,26,11,1,263,0,0,0,301,427
6153,95,3,29,0,42,0,0,0,74,31,11,2,210,0,0,0,254,328
6153,96,4,22,0,42,0,0,0,68,17,8,0,161,0,0,0,186,254
6153,97,1,23,0,28,0,0,0,52,12,2,1,113,0,0,0,128,180
6153,98,1,9,0,23,0,0,0,33,7,1,1,60,0,0,0,69,102
6153,99,2,3,0,7,0,0,0,12,11,1,0,48,0,0,0,60,72
6153,100,7,11,1,13,0,0,0,32,20,2,0,74,0,0,0,96,128
6153,999,83809,89362,4507,5015,95,0,0,182788,75540,89788,6163,22928,31,2,0,194452,377240
6206,0,2391,0,0,0,0,0,0,2391,2227,0,0,0,0,0,0,2227,4618
6206,1,2524,0,0,0,0,0,0,2524,2352,0,0,0,0,0,0,2352,4876
6206,2,2536,0,0,0,0,0,0,2536,2369,0,0,0,0,0,0,2369,4905
6206,3,2539,0,0,0,0,0,0,2539,2410,0,0,0,0,0,0,2410,4949
6206,4,2736,0,0,0,0,0,0,2736,2476,0,0,0,0,0,0,2476,5212
6206,5,2871,0,0,0,0,0,0,2871,2605,0,0,0,0,0,0,2605,5476
6206,6,2787,0,0,0,0,0,0,2787,2789,0,0,0,0,0,0,2789,5576
6206,7,2953,0,0,0,0,0,0,2953,2831,0,0,0,0,0,0,2831,5784
6206,8,2940,0,0,0,0,0,0,2940,2909,0,0,0,0,0,0,2909,5849
6206,9,3230,0,0,0,0,0,0,3230,2862,0,0,0,0,0,0,2862,6092
6206,10,3309,0,0,0,0,0,0,3309,3085,0,0,0,0,0,0,3085,6394
6206,11,3462,0,0,0,0,0,0,3462,3222,0,0,0,0,0,0,3222,6684
6206,12,3444,0,0,0,0,0,0,3444,3286,0,0,0,0,0,0,3286,6730
6206,13,3666,0,0,0,0,0,0,3666,3399,0,0,0,0,0,0,3399,7065
6206,14,3549,0,0,0,0,0,0,3549,3384,0,0,0,0,0,0,3384,6933
6206,15,3736,0,0,0,0,0,0,3736,3508,0,0,0,0,0,0,3508,7244
6206,16,3839,0,0,0,0,0,0,3839,3454,0,0,0,0,0,0,3454,7293
6206,17,3749,0,0,0,0,0,0,3749,3552,0,0,0,0,0,0,3552,7301
6206,18,3900,0,0,0,0,0,0,3900,3586,0,0,0,0,0,0,3586,7486
6206,19,4061,0,0,0,0,0,0,4061,3833,2,0,0,0,0,0,3835,7896
6206,20,4051,0,0,0,0,0,0,4051,3696,7,0,0,0,0,0,3703,7754
6206,21,3906,3,0,0,0,0,0,3909,3705,11,1,0,0,0,0,3717,7626
6206,22,4115,3,0,1,0,0,0,4119,3805,35,0,0,0,0,0,3840,7959
6206,23,4222,12,0,0,0,0,0,4234,3748,50,1,0,0,0,0,3799,8033
6206,24,4017,29,1,0,0,0,0,4047,3532,106,0,0,0,0,0,3638,7685
6206,25,4067,48,3,0,1,0,0,4119,3552,130,3,0,1,0,0,3686,7805
6206,26,3873,74,1,0,0,0,0,3948,3420,231,4,0,1,0,0,3656,7604
6206,27,3660,127,2,0,2,0,0,3791,3288,365,3,1,2,0,0,3659,7450
6206,28,3709,219,0,0,5,0,0,3933,3162,463,5,1,0,0,0,3631,7564
6206,29,3531,296,2,0,3,0,0,3832,3045,620,5,1,2,0,0,3673,7505
6206,30,3591,374,8,0,0,0,0,3973,2987,871,22,1,4,0,0,3885,7858
6206,31,3674,584,9,0,1,0,0,4268,2920,1090,19,3,1,0,0,4033,8301
6206,32,3342,707,12,0,3,0,0,4064,2687,1304,29,5,3,0,0,4028,8092
6206,33,3140,896,11,1,6,0,0,4054,2452,1465,31,5,3,1,0,3957,8011
6206,34,2934,1033,18,0,2,0,0,3987,2238,1682,50,6,3,0,0,3979,7966
6206,35,2862,1283,26,3,5,0,0,4179,2153,1930,66,10,3,1,0,4163,8342
6206,36,2626,1414,35,3,4,0,0,4082,1969,2014,76,9,6,1,0,4075,8157
6206,37,2506,1661,45,0,2,0,0,4214,1690,2157,95,14,1,1,0,3958,8172
6206,38,2325,1781,54,3,4,0,0,4167,1722,2447,121,15,2,0,0,4307,8474
6206,39,2285,1948,72,5,3,0,0,4313,1754,2608,141,15,0,0,0,4518,8831
6206,40,2214,2051,67,4,2,0,0,4338,1631,2774,158,23,2,0,0,4588,8926
6206,41,2110,2313,81,3,7,0,0,4514,1494,2957,169,36,1,0,0,4657,9171
6206,42,2026,2436,111,9,5,1,0,4588,1469,3211,214,41,1,0,0,4936,9524
6206,43,1991,2776,130,13,5,0,0,4915,1446,3373,239,38,3,0,0,5099,10014
6206,44,1942,3116,161,17,9,0,0,5245,1347,3740,263,46,3,0,0,5399,10644
6206,45,1861,3298,173,16,5,0,0,5353,1362,3841,302,46,3,0,0,5554,10907
6206,46,1902,3338,191,11,5,0,0,5447,1272,4116,284,78,4,0,0,5754,11201
6206,47,1848,3775,208,21,5,0,0,5857,1306,4317,335,78,2,0,0,6038,11895
6206,48,1709,3947,253,25,3,0,0,5937,1216,4271,376,107,2,0,0,5972,11909
6206,49,1535,4153,271,27,5,0,0,5991,1199,4521,380,103,4,0,0,6207,12198
6206,50,1425,3999,308,26,4,0,0,5762,1122,4462,389,110,1,0,0,6084,11846
6206,51,1317,3997,259,26,3,0,0,5602,958,4354,396,112,0,0,0,5820,11422
6206,52,1263,4248,281,30,11,0,0,5833,1003,4479,363,163,1,0,0,6009,11842
6206,53,1124,4262,280,39,3,0,0,5708,1004,4538,357,211,0,0,0,6110,11818
6206,54,1077,4363,297,61,3,0,0,5801,952,4773,361,205,2,0,0,6293,12094
6206,55,1009,4341,346,70,4,0,0,5770,932,4891,376,204,3,0,0,6406,12176
6206,56,970,4582,340,63,3,0,0,5958,942,4903,373,221,4,0,0,6443,12401
6206,57,886,4701,320,73,3,0,0,5983,962,4953,384,280,1,0,0,6580,12563
6206,58,771,4646,307,79,3,0,0,5806,881,4972,367,332,3,0,0,6555,12361
6206,59,697,4945,332,96,3,1,0,6074,870,4981,368,355,3,0,0,6577,12651
6206,60,603,4614,270,106,5,0,0,5598,788,4634,324,366,1,0,0,6113,11711
6206,61,545,4497,283,104,1,0,0,5430,773,4467,274,428,0,0,0,5942,11372
6206,62,507,4421,230,117,2,0,0,5277,711,4402,270,495,1,0,0,5879,11156
6206,63,441,4386,273,116,4,0,0,5220,657,4359,287,525,1,0,0,5829,11049
6206,64,413,4231,223,151,5,0,0,5023,658,4157,229,542,0,0,0,5586,10609
6206,65,359,3802,223,142,3,0,0,4529,606,3844,240,624,0,0,0,5314,9843
6206,66,355,4050,227,145,1,0,0,4778,571,3962,222,679,0,0,0,5434,10212
6206,67,291,4028,177,172,1,0,1,4670,585,3758,175,763,0,0,0,5281,9951
6206,68,294,4113,165,175,2,0,0,4749,558,3804,177,808,0,0,0,5347,10096
6206,69,273,3837,147,181,1,0,0,4439,542,3515,143,895,0,0,0,5095,9534
6206,70,256,3843,125,203,3,0,0,4430,462,3512,195,1012,0,0,0,5181,9611
6206,71,184,3500,109,193,0,0,0,3986,427,3117,152,976,1,0,0,4673,8659
6206,72,211,3841,125,233,1,0,0,4411,432,3348,152,1179,0,0,0,5111,9522
6206,73,177,3902,118,241,0,0,0,4438,472,3182,164,1282,0,0,0,5100,9538
6206,74,161,3600,93,281,2,0,0,4137,485,3026,136,1355,1,0,0,5003,9140
6206,75,174,3785,89,318,0,0,0,4366,478,3147,126,1609,0,0,0,5360,9726
6206,76,158,3567,92,370,0,0,0,4187,439,2804,103,1680,0,0,0,5026,9213
6206,77,143,3329,72,375,0,0,0,3919,435,2585,111,1782,0,0,0,4913,8832
6206,78,99,2713,49,320,0,0,0,3181,379,1896,92,1536,0,0,0,3903,7084
6206,79,88,2329,47,290,0,0,0,2754,338,1602,65,1442,0,0,0,3447,6201
6206,80,98,2328,42,356,2,0,0,2826,348,1630,59,1730,0,0,0,3767,6593
6206,81,86,2246,37,375,0,0,0,2744,356,1477,51,1771,0,0,0,3655,6399
6206,82,89,1974,24,384,0,0,0,2471,344,1274,55,1718,0,0,0,3391,5862
6206,83,83,1901,35,418,0,0,0,2437,327,1155,49,1940,0,0,0,3471,5908
6206,84,64,1830,31,483,0,0,0,2408,333,1068,45,2175,0,0,0,3621,6029
6206,85,43,1599,23,450,0,0,0,2115,313,851,27,2052,0,0,0,3243,5358
6206,86,57,1219,12,397,0,0,0,1685,282,643,27,1775,0,0,0,2727,4412
6206,87,42,1032,5,402,0,0,0,1481,201,454,23,1715,0,0,0,2393,3874
6206,88,29,924,12,407,0,0,0,1372,226,429,28,1638,0,0,0,2321,3693
6206,89,35,691,7,337,0,0,0,1070,203,287,12,1519,0,0,0,2021,3091
6206,90,22,517,8,316,0,0,0,863,156,214,16,1382,0,0,0,1768,2631
6206,91,19,397,2,278,0,0,0,696,136,159,10,1232,0,0,0,1537,2233
6206,92,19,307,3,239,0,0,0,568,129,103,6,1037,0,0,0,1275,1843
6206,93,13,225,2,214,0,0,0,454,93,71,16,993,0,0,0,1173,1627
6206,94,8,149,3,161,0,0,0,321,89,46,8,658,0,0,0,801,1122
6206,95,3,78,3,116,0,0,0,200,59,25,2,472,0,0,0,558,758
6206,96,4,56,0,74,0,0,0,134,33,12,4,390,0,0,0,439,573
6206,97,1,22,0,69,0,0,0,92,37,10,2,241,0,0,0,290,382
6206,98,1,18,0,44,0,0,0,63,21,7,2,159,0,0,0,189,252
6206,99,1,12,0,22,0,0,0,35,13,5,0,105,0,0,0,123,158
6206,100,2,17,1,37,0,0,0,57,14,7,0,181,0,0,0,202,259
6206,999,168786,181709,8402,10537,165,2,1,369602,155541,183063,11205,47736,80,4,0,397629,767231
6331,0,982,0,0,0,0,0,0,982,984,0,0,0,0,0,0,984,1966
6331,1,1107,0,0,0,0,0,0,1107,949,0,0,0,0,0,0,949,2056
6331,2,1060,0,0,0,0,0,0,1060,988,0,0,0,0,0,0,988,2048
6331,3,1191,0,0,0,0,0,0,1191,1032,0,0,0,0,0,0,1032,2223
6331,4,1212,0,0,0,0,0,0,1212,1103,0,0,0,0,0,0,1103,2315
6331,5,1209,0,0,0,0,0,0,1209,1123,0,0,0,0,0,0,1123,2332
6331,6,1308,0,0,0,0,0,0,1308,1194,0,0,0,0,0,0,1194,2502
6331,7,1287,0,0,0,0,0,0,1287,1200,0,0,0,0,0,0,1200,2487
6331,8,1314,0,0,0,0,0,0,1314,1273,0,0,0,0,0,0,1273,2587
6331,9,1322,0,0,0,0,0,0,1322,1228,0,0,0,0,0,0,1228,2550
6331,10,1298,0,0,0,0,0,0,1298,1215,0,0,0,0,0,0,1215,2513
6331,11,1496,0,0,0,0,0,0,1496,1321,0,0,0,0,0,0,1321,2817
6331,12,1449,0,0,0,0,0,0,1449,1326,0,0,0,0,0,0,1326,2775
6331,13,1479,0,0,0,0,0,0,1479,1392,0,0,0,0,0,0,1392,2871
6331,14,1590,0,0,0,0,0,0,1590,1435,0,0,0,0,0,0,1435,3025
6331,15,1618,0,0,0,0,0,0,1618,1474,0,0,0,0,0,0,1474,3092
6331,16,1650,0,0,0,0,0,0,1650,1492,0,0,0,0,0,0,1492,3142
6331,17,1648,0,0,0,0,0,0,1648,1546,0,0,0,0,0,0,1546,3194
6331,18,1704,0,0,0,0,0,0,1704,1527,0,0,0,0,0,0,1527,3231
6331,19,1783,0,0,0,0,0,0,1783,1634,2,0,0,1,0,0,1637,3420
6331,20,1797,1,0,0,0,0,0,1798,1574,5,1,0,0,0,0,1580,3378
6331,21,1846,0,0,0,0,0,0,1846,1638,7,1,0,0,0,0,1646,3492
6331,22,1880,2,0,0,0,0,0,1882,1627,11,0,0,0,0,0,1638,3520
6331,23,1879,9,0,0,0,0,0,1888,1670,20,0,0,0,0,0,1690,3578
6331,24,1894,13,1,0,0,0,0,1908,1688,40,1,0,0,0,0,1729,3637
6331,25,1936,17,1,0,0,0,0,1954,1545,95,2,0,1,0,0,1643,3597
6331,26,1847,45,0,0,0,0,0,1892,1477,128,1,0,0,0,0,1606,3498
6331,27,1810,64,0,0,0,0,0,1874,1397,220,1,1,0,0,0,1619,3493
6331,28,1756,91,1,0,0,0,0,1848,1427,272,1,1,0,0,0,1701,3549
6331,29,1725,166,1,0,0,0,0,1892,1372,354,4,2,0,0,0,1732,3624
6331,30,1684,239,3,0,1,0,0,1927,1241,435,5,0,0,0,0,1681,3608
6331,31,1721,293,5,0,1,0,0,2020,1284,576,8,5,1,0,0,1874,3894
6331,32,1477,417,7,1,0,0,0,1902,1106,686,11,2,0,0,0,1805,3707
6331,33,1479,514,3,0,1,0,0,1997,1035,809,14,0,0,0,0,1858,3855
6331,34,1431,596,9,3,1,0,0,2040,907,903,22,4,0,0,0,1836,3876
6331,35,1286,729,8,3,1,0,0,2027,839,958,31,3,1,0,0,1832,3859
6331,36,1247,745,17,0,0,0,0,2009,764,1031,34,4,2,0,0,1835,3844
6331,37,1123,845,14,2,2,0,0,1986,683,1109,25,7,1,0,0,1825,3811
6331,38,1147,949,17,2,1,0,0,2116,666,1152,38,5,0,0,0,1861,3977
6331,39,1019,1032,31,1,0,0,0,2083,665,1244,50,9,0,0,0,1968,4051
6331,40,984,1023,24,2,0,0,0,2033,587,1296,61,17,0,0,0,1961,3994
6331,41,911,1103,33,0,1,0,0,2048,595,1430,49,16,0,0,0,2090,4138
6331,42,844,1138,27,6,0,0,0,2015,480,1431,63,13,0,0,0,1987,4002
6331,43,814,1204,48,5,0,0,0,2071,479,1453,72,11,0,0,0,2015,4086
6331,44,826,1289,39,4,0,0,0,2158,428,1515,79,27,2,0,0,2051,4209
6331,45,799,1394,53,2,0,0,0,2248,422,1629,76,21,0,0,0,2148,4396
6331,46,772,1428,59,11,0,0,0,2270,405,1754,93,24,0,0,0,2276,4546
6331,47,795,1594,68,10,1,0,0,2468,468,1828,106,44,0,0,0,2446,4914
6331,48,726,1604,79,10,0,0,0,2419,455,1971,102,38,0,0,0,2566,4985
6331,49,740,1739,78,6,1,0,0,2564,437,1941,101,52,0,0,0,2531,5095
6331,50,663,1767,82,15,2,0,0,2529,423,2002,121,57,1,0,0,2604,5133
6331,51,644,1805,97,19,0,0,0,2565,430,2084,136,69,1,0,0,2720,5285
6331,52,587,1922,85,21,0,0,0,2615,388,2126,119,72,0,0,0,2705,5320
6331,53,540,1977,104,24,1,0,0,2646,376,2203,122,93,0,0,0,2794,5440
6331,54,568,2213,105,24,1,0,0,2911,371,2247,120,110,0,0,0,2848,5759
6331,55,547,2125,93,24,0,0,0,2789,349,2228,136,139,0,0,0,2852,5641
6331,56,496,2246,107,40,0,0,0,2889,346,2385,135,158,1,0,0,3025,5914
6331,57,470,2118,80,36,1,0,0,2705,335,2333,117,169,0,0,0,2954,5659
6331,58,489,2246,97,40,0,0,0,2872,337,2298,131,170,0,0,0,2936,5808
6331,59,429,2332,110,55,0,0,0,2926,336,2399,134,203,0,0,0,3072,5998
6331,60,381,2228,118,51,0,0,0,2778,327,2276,103,208,1,0,0,2915,5693
6331,61,388,2395,97,46,0,0,0,2926,295,2240,118,239,0,0,0,2892,5818
6331,62,315,2240,93,61,0,0,0,2709,272,2163,104,295,0,0,0,2834,5543
6331,63,278,2227,82,58,0,0,0,2645,269,2126,112,303,0,0,0,2810,5455
6331,64,304,2048,74,61,0,0,0,2487,253,1964,81,330,0,0,0,2628,5115
6331,65,247,2035,79,61,2,0,0,2424,257,1867,76,318,0,0,0,2518,4942
6331,66,237,1886,81,63,0,0,0,2267,213,1906,66,391,0,0,0,2576,4843
6331,67,203,1974,80,83,0,0,0,2340,214,1824,75,431,0,0,0,2544,4884
6331,68,194,1987,72,100,1,0,0,2354,175,1706,59,392,0,0,0,2332,4686
6331,69,181,1917,52,88,0,0,0,2238,195,1691,72,480,0,0,0,2438,4676
6331,70,171,1794,53,99,0,0,0,2117,188,1478,58,472,0,0,0,2196,4313
6331,71,132,1689,44,112,0,0,0,1977,189,1467,47,492,0,0,0,2195,4172
6331,72,114,1640,48,116,0,0,0,1918,131,1397,31,571,0,0,0,2130,4048
6331,73,110,1733,38,130,0,0,0,2011,150,1308,41,623,0,0,0,2122,4133
6331,74,114,1726,36,123,0,0,0,1999,137,1233,48,692,0,0,0,2110,4109
6331,75,107,1629,33,140,0,0,0,1909,149,1226,33,837,0,0,0,2245,4154
6331,76,108,1411,21,141,0,0,0,1681,136,1088,27,808,0,0,0,2059,3740
6331,77,84,1274,27,143,0,0,0,1528,114,945,22,764,0,0,0,1845,3373
6331,78,53,890,19,111,0,0,0,1073,102,643,19,647,0,0,0,1411,2484
6331,79,52,903,13,112,0,0,0,1080,83,550,12,649,0,0,0,1294,2374
6331,80,49,842,8,151,0,0,0,1050,80,542,15,654,0,0,0,1291,2341
6331,81,35,777,10,139,0,0,0,961,68,492,14,736,0,0,0,1310,2271
6331,82,44,756,8,165,0,0,0,973,72,466,10,734,0,0,0,1282,2255
6331,83,54,842,16,192,0,0,0,1104,68,423,16,930,0,0,0,1437,2541
6331,84,31,820,9,188,0,0,0,1048,80,452,8,955,0,0,0,1495,2543
6331,85,25,738,12,225,0,0,0,1000,90,332,6,967,0,0,0,1395,2395
6331,86,32,578,8,217,0,0,0,835,79,288,11,946,0,0,0,1324,2159
6331,87,29,510,6,210,0,0,0,755,61,202,3,896,0,0,0,1162,1917
6331,88,22,447,3,161,0,0,0,633,70,183,7,797,0,0,0,1057,1690
6331,89,16,334,2,183,0,0,0,535,60,152,4,820,0,0,0,1036,1571
6331,90,11,268,3,172,0,0,0,454,39,98,4,703,0,0,0,844,1298
6331,91,6,195,0,161,0,0,0,362,39,72,4,550,0,0,0,665,1027
6331,92,11,141,0,111,0,0,0,263,35,45,5,494,0,0,0,579,842
6331,93,10,85,1,99,0,0,0,195,30,26,1,452,0,0,0,509,704
6331,94,4,79,0,92,0,0,0,175,29,25,2,342,0,0,0,398,573
6331,95,5,39,1,66,0,0,0,111,20,14,0,233,0,0,0,267,378
6331,96,1,38,0,52,0,0,0,91,11,12,1,192,0,0,0,216,307
6331,97,2,14,0,27,0,0,0,43,9,4,1,136,0,0,0,150,193
6331,98,0,6,0,25,0,0,0,31,10,5,1,89,0,0,0,105,136
6331,99,1,2,0,13,0,0,0,16,4,6,0,62,0,0,0,72,88
6331,100,2,7,0,32,0,0,0,41,7,5,0,99,0,0,0,111,152
6331,999,77498,84178,2833,4946,19,0,0,169474,63298,83552,3640,23275,13,0,0,173778,343252
6382,0,595,0,0,0,0,0,0,595,537,0,0,0,0,0,0,537,1132
6382,1,616,0,0,0,0,0,0,616,535,0,0,0,0,0,0,535,1151
6382,2,677,0,0,0,0,0,0,677,617,0,0,0,0,0,0,617,1294
6382,3,660,0,0,0,0,0,0,660,645,0,0,0,0,0,0,645,1305
6382,4,712,0,0,0,0,0,0,712,643,0,0,0,0,0,0,643,1355
6382,5,675,0,0,0,0,0,0,675,718,0,0,0,0,0,0,718,1393
6382,6,759,0,0,0,0,0,0,759,679,0,0,0,0,0,0,679,1438
6382,7,776,0,0,0,0,0,0,776,756,0,0,0,0,0,0,756,1532
6382,8,766,0,0,0,0,0,0,766,712,0,0,0,0,0,0,712,1478
6382,9,753,0,0,0,0,0,0,753,788,0,0,0,0,0,0,788,1541
6382,10,803,0,0,0,0,0,0,803,741,0,0,0,0,0,0,741,1544
6382,11,836,0,0,0,0,0,0,836,790,0,0,0,0,0,0,790,1626
6382,12,828,0,0,0,0,0,0,828,810,0,0,0,0,0,0,810,1638
6382,13,863,0,0,0,0,0,0,863,844,0,0,0,0,0,0,844,1707
6382,14,898,0,0,0,0,0,0,898,844,0,0,0,0,0,0,844,1742
6382,15,936,0,0,0,0,0,0,936,871,0,0,0,0,0,0,871,1807
6382,16,930,0,0,0,0,0,0,930,842,1,0,0,0,0,0,843,1773
6382,17,1027,0,0,0,0,0,0,1027,853,0,0,0,0,0,0,853,1880
6382,18,1011,1,0,0,0,0,0,1012,875,1,0,0,0,0,0,876,1888
6382,19,1060,1,0,0,0,0,0,1061,1015,1,0,0,0,0,0,1016,2077
6382,20,1126,0,0,0,0,0,0,1126,944,9,0,0,0,0,0,953,2079
6382,21,1053,1,0,0,0,0,0,1054,968,10,0,0,0,0,0,978,2032
6382,22,1072,1,0,0,0,0,0,1073,903,25,0,0,0,0,0,928,2001
6382,23,1173,12,0,0,0,0,0,1185,927,31,0,0,0,0,0,958,2143
6382,24,1133,14,0,0,0,0,0,1147,929,29,0,0,0,0,0,958,2105
6382,25,1135,14,1,0,0,0,0,1150,838,60,1,0,2,0,0,901,2051
6382,26,1081,26,0,0,1,0,0,1108,910,75,1,0,0,0,0,986,2094
6382,27,1075,39,1,0,0,0,0,1115,824,115,1,0,0,0,0,940,2055
6382,28,1013,59,2,0,0,0,0,1074,760,159,0,0,0,0,0,919,1993
6382,29,955,84,1,0,0,0,0,1040,739,212,4,1,0,0,0,956,1996
6382,30,944,111,3,0,0,0,0,1058,738,218,9,0,2,0,0,967,2025
6382,31,1022,166,0,0,0,0,0,1188,682,285,5,0,0,0,0,972,2160
6382,32,919,226,3,1,0,0,0,1149,642,366,10,1,2,0,0,1021,2170
6382,33,922,287,9,0,1,0,0,1219,575,491,15,0,2,0,0,1083,2302
6382,34,848,314,6,1,1,0,0,1170,533,461,13,4,0,0,0,1011,2181
6382,35,771,362,9,1,0,0,0,1143,471,562,27,0,0,0,0,1060,2203
6382,36,717,433,15,2,0,0,0,1167,434,540,21,4,1,0,0,1000,2167
6382,37,677,417,12,1,1,0,0,1108,395,574,25,1,2,0,0,997,2105
6382,38,583,497,15,2,1,0,0,1098,371,697,33,6,1,0,0,1108,2206
6382,39,601,538,13,1,2,0,0,1155,345,723,29,9,1,0,0,1107,2262
6382,40,575,591,18,2,0,0,0,1186,329,765,47,3,0,0,0,1144,2330
6382,41,508,632,30,2,0,0,0,1172,334,769,46,8,0,0,0,1157,2329
6382,42,522,682,34,4,1,0,0,1243,302,799,57,16,1,0,0,1175,2418
6382,43,466,707,30,2,1,0,0,1206,297,818,39,11,0,0,0,1165,2371
6382,44,468,763,35,4,0,0,0,1270,252,874,62,15,1,0,0,1204,2474
6382,45,505,837,44,2,0,0,0,1388,264,959,61,18,0,0,0,1302,2690
6382,46,431,802,46,2,0,0,0,1281,274,1008,101,17,0,0,0,1400,2681
6382,47,468,954,54,1,0,0,0,1477,255,992,105,27,0,0,0,1379,2856
6382,48,405,939,73,6,0,0,0,1423,245,1048,99,35,0,0,0,1427,2850
6382,49,409,984,70,13,2,0,0,1478,221,1125,91,28,0,0,0,1465,2943
6382,50,370,1019,82,5,1,0,0,1477,247,1001,118,28,1,0,0,1395,2872
6382,51,319,1010,90,8,3,0,0,1430,220,1096,100,32,1,0,0,1449,2879
6382,52,380,945,88,6,0,0,0,1419,214,1111,98,57,1,0,0,1481,2900
6382,53,304,1064,61,11,0,0,0,1440,202,1148,93,49,0,0,0,1492,2932
6382,54,288,1028,69,12,0,0,0,1397,193,1118,82,62,0,0,0,1455,2852
6382,55,258,1089,63,11,1,0,0,1422,195,1151,82,69,1,0,0,1498,2920
6382,56,268,1077,79,17,2,0,0,1443,191,1156,89,66,2,0,0,1504,2947
6382,57,215,1107,71,23,0,0,0,1416,196,1199,84,68,0,0,0,1547,2963
6382,58,215,1120,75,19,0,0,0,1429,176,1234,59,74,0,0,0,1543,2972
6382,59,189,1239,74,23,0,0,0,1525,181,1213,80,101,0,0,0,1575,3100
6382,60,183,1131,78,33,0,0,0,1425,172,1094,58,117,0,0,0,1441,2866
6382,61,151,1098,75,23,1,0,0,1348,138,1153,65,104,0,0,0,1460,2808
6382,62,161,1047,78,21,0,0,0,1307,132,1183,64,130,0,0,0,1509,2816
6382,63,121,1101,49,28,0,0,0,1299,137,1090,58,157,0,0,0,1442,2741
6382,64,132,1089,55,33,0,0,0,1309,141,1075,43,149,0,0,0,1408,2717
6382,65,109,1097,42,24,1,0,0,1273,120,1030,44,174,0,0,0,1368,2641
6382,66,108,1010,42,25,0,0,0,1185,134,995,47,195,0,0,0,1371,2556
6382,67,106,1082,47,38,0,0,0,1273,114,975,39,223,0,0,0,1351,2624
6382,68,96,1024,28,38,0,0,0,1186,100,955,32,212,0,0,0,1299,2485
6382,69,63,1021,39,44,0,0,0,1167,100,921,32,235,1,0,0,1289,2456
6382,70,67,914,36,54,0,0,0,1071,87,781,15,248,0,0,0,1131,2202
6382,71,60,906,30,52,0,0,0,1048,88,764,32,282,0,0,0,1166,2214
6382,72,55,879,25,54,0,0,0,1013,75,766,38,291,0,0,0,1170,2183
6382,73,71,892,34,58,0,0,0,1055,79,793,22,326,0,0,0,1220,2275
6382,74,49,912,19,78,0,0,0,1058,62,764,23,357,0,0,0,1206,2264
6382,75,46,975,18,73,0,0,0,1112,82,739,16,390,0,0,0,1227,2339
6382,76,44,832,20,90,0,0,0,986,72,599,12,407,0,0,0,1090,2076
6382,77,33,722,10,72,0,0,0,837,53,476,13,393,0,0,0,935,1772
6382,78,18,575,11,49,0,0,0,653,56,392,7,356,0,0,0,811,1464
6382,79,28,567,11,57,0,0,0,663,52,350,6,390,0,0,0,798,1461
6382,80,19,525,5,71,0,0,0,620,46,273,12,421,0,0,0,752,1372
6382,81,24,462,4,67,0,0,0,557,52,267,8,408,0,0,0,735,1292
6382,82,15,432,6,63,0,0,0,516,40,226,6,393,0,0,0,665,1181
6382,83,22,480,7,90,0,0,0,599,52,226,2,510,0,0,0,790,1389
6382,84,17,437,3,110,0,0,0,567,40,222,3,518,0,0,0,783,1350
6382,85,17,359,4,74,0,0,0,454,39,173,5,493,0,0,0,710,1164
6382,86,16,328,3,88,0,0,0,435,40,136,7,507,0,0,0,690,1125
6382,87,15,260,5,78,0,0,0,358,33,122,3,470,0,0,0,628,986
6382,88,11,195,4,87,0,0,0,297,29,81,0,426,0,0,0,536,833
6382,89,8,178,3,83,0,0,0,272,27,58,2,353,0,0,0,440,712
6382,90,5,135,1,82,0,0,0,223,22,40,5,351,0,0,0,418,641
6382,91,4,116,0,76,0,0,0,196,24,27,2,261,0,0,0,314,510
6382,92,4,75,0,73,0,0,0,152,10,17,0,230,0,0,0,257,409
6382,93,5,58,3,52,0,0,0,118,18,17,1,201,0,0,0,237,355
6382,94,1,35,0,29,0,0,0,65,14,7,0,138,0,0,0,159,224
6382,95,1,21,1,27,0,0,0,50,8,5,1,117,0,0,0,131,181
6382,96,1,19,1,22,0,0,0,43,8,4,0,78,0,0,0,90,133
6382,97,0,11,1,17,0,0,0,29,2,1,0,68,0,0,0,71,100
6382,98,0,5,0,9,0,0,0,14,2,3,0,40,0,0,0,45,59
6382,99,1,6,0,9,0,0,0,16,0,0,0,16,0,0,0,16,32
6382,100,2,2,0,9,0,0,0,13,4,3,1,42,0,0,0,50,63
6382,999,44453,45205,2074,2342,20,0,0,94094,36335,45032,2511,11987,22,0,0,95887,189981
6442,0,2324,0,0,0,0,0,0,2324,2242,0,0,0,0,0,0,2242,4566
6442,1,2395,0,0,0,0,0,0,2395,2235,0,0,0,0,0,0,2235,4630
6442,2,2392,0,0,0,0,0,0,2392,2246,0,0,0,0,0,0,2246,4638
6442,3,2439,0,0,0,0,0,0,2439,2453,0,0,0,0,0,0,2453,4892
6442,4,2610,0,0,0,0,0,0,2610,2489,0,0,0,0,0,0,2489,5099
6442,5,2777,0,0,0,0,0,0,2777,2555,0,0,0,0,0,0,2555,5332
6442,6,2753,0,0,0,0,0,0,2753,2757,0,0,0,0,0,0,2757,5510
6442,7,2933,0,0,0,0,0,0,2933,2760,0,0,0,0,0,0,2760,5693
6442,8,2844,0,0,0,0,0,0,2844,2821,0,0,0,0,0,0,2821,5665
6442,9,2920,0,0,0,0,0,0,2920,2774,0,0,0,0,0,0,2774,5694
6442,10,2870,0,0,0,0,0,0,2870,2877,0,0,0,0,0,0,2877,5747
6442,11,3016,0,0,0,0,0,0,3016,2810,0,0,0,0,0,0,2810,5826
6442,12,3105,0,0,0,0,0,0,3105,2893,0,0,0,0,0,0,2893,5998
6442,13,3019,0,0,0,0,0,0,3019,2907,0,0,0,0,0,0,2907,5926
6442,14,3251,0,0,0,0,0,0,3251,3053,0,0,0,0,0,0,3053,6304
6442,15,3081,0,0,0,0,0,0,3081,3044,0,0,0,0,0,0,3044,6125
6442,16,3195,0,1,0,0,0,0,3196,3001,0,0,0,0,0,0,3001,6197
6442,17,3448,1,0,0,0,0,0,3449,3083,0,0,0,0,0,0,3083,6532
6442,18,3395,0,0,0,0,0,0,3395,3041,0,0,0,0,0,0,3041,6436
6442,19,3507,1,0,0,0,0,0,3508,3152,4,0,0,0,0,0,3156,6664
6442,20,3379,0,0,0,0,0,0,3379,3204,10,0,0,0,0,0,3214,6593
6442,21,3484,9,0,0,0,0,0,3493,3132,30,0,0,0,0,0,3162,6655
6442,22,3393,13,1,0,0,0,0,3407,3176,37,0,0,0,0,0,3213,6620
6442,23,3542,18,1,0,0,0,0,3561,3161,83,3,0,1,0,0,3248,6809
6442,24,3529,31,0,0,0,0,0,3560,3109,134,3,1,0,0,0,3247,6807
6442,25,3573,61,2,0,1,0,0,3637,3051,186,1,0,0,0,0,3238,6875
6442,26,3454,95,3,1,0,0,0,3553,2947,284,3,0,1,0,0,3235,6788
6442,27,3587,152,1,0,0,0,0,3740,2825,416,7,1,0,0,0,3249,6989
6442,28,3365,227,2,1,2,0,0,3597,2704,555,4,1,3,0,0,3267,6864
6442,29,3398,381,3,1,1,0,0,3784,2703,726,12,1,3,0,0,3445,7229
6442,30,3368,521,3,2,0,0,0,3894,2502,983,12,2,1,0,0,3500,7394
6442,31,3191,636,10,1,1,0,0,3839,2369,1255,16,2,3,0,0,3645,7484
6442,32,3114,802,6,1,1,0,0,3924,2207,1442,25,8,1,0,0,3683,7607
6442,33,2901,985,13,3,1,0,0,3903,2151,1580,40,8,2,0,0,3781,7684
6442,34,2792,1215,20,0,1,0,0,4028,1994,1919,44,10,1,1,0,3969,7997
6442,35,2603,1430,18,3,2,0,0,4056,1803,2057,61,9,3,0,0,3933,7989
6442,36,2473,1524,30,2,4,0,0,4033,1659,2221,78,5,2,0,0,3965,7998
6442,37,2280,1638,33,0,3,0,0,3954,1518,2375,74,21,2,0,0,3990,7944
6442,38,2211,1869,42,2,1,0,0,4125,1489,2447,89,20,0,0,0,4045,8170
6442,39,2119,2149,47,4,1,0,0,4320,1347,2601,99,25,2,0,0,4074,8394
6442,40,1978,2232,53,1,1,0,0,4265,1207,2769,107,15,1,0,0,4099,8364
6442,41,1862,2350,66,0,1,0,0,4279,1179,2920,126,34,0,0,0,4259,8538
6442,42,1763,2473,67,6,5,0,0,4314,1126,3034,131,24,0,0,0,4315,8629
6442,43,1632,2661,102,13,1,0,0,4409,1070,3088,156,40,0,0,0,4354,8763
6442,44,1602,2782,88,13,1,0,0,4486,1048,3215,169,43,0,0,0,4475,8961
6442,45,1529,2888,111,13,0,0,0,4541,941,3358,212,55,2,0,0,4568,9109
6442,46,1547,3010,115,7,0,0,0,4679,935,3510,199,74,2,0,0,4720,9399
6442,47,1521,3187,134,20,1,0,0,4863,903,3713,206,89,1,0,0,4912,9775
6442,48,1419,3388,134,17,1,0,0,4959,886,3691,236,94,0,0,0,4907,9866
6442,49,1280,3376,143,24,0,1,0,4824,851,3906,223,83,0,0,1,5064,9888
6442,50,1240,3400,178,27,0,0,0,4845,830,3919,257,135,0,0,0,5141,9986
6442,51,1215,3600,191,36,1,0,0,5043,789,3991,257,159,0,0,0,5196,10239
6442,52,1147,3542,170,32,0,0,0,4891,701,4038,290,175,1,0,0,5205,10096
6442,53,1027,3656,177,39,0,0,0,4899,743,3959,272,223,0,0,0,5197,10096
6442,54,1030,3807,242,51,1,0,0,5131,733,4376,275,225,0,0,0,5609,10740
6442,55,1041,3783,187,42,1,0,0,5054,731,4169,266,247,0,0,0,5413,10467
6442,56,913,3996,197,68,2,0,0,5176,633,4296,275,292,1,0,0,5497,10673
6442,57,825,4037,199,73,0,0,0,5134,663,4206,247,299,0,0,0,5415,10549
6442,58,776,4039,186,76,0,0,0,5077,654,4281,254,345,1,0,0,5535,10612
6442,59,737,4224,221,112,3,0,0,5297,617,4436,250,407,0,0,0,5710,11007
6442,60,699,4052,187,92,0,1,0,5031,561,4075,238,473,1,0,0,5348,10379
6442,61,622,4061,164,99,0,0,0,4946,542,4159,206,471,0,0,0,5378,10324
6442,62,580,4072,188,117,0,0,0,4957,510,4039,175,543,0,0,0,5267,10224
6442,63,547,4044,189,130,0,0,0,4910,486,3934,220,605,0,0,0,5245,10155
6442,64,504,4025,168,122,0,0,0,4819,456,3769,180,663,0,0,0,5068,9887
6442,65,470,3646,150,119,0,0,0,4385,412,3460,189,691,1,0,0,4753,9138
6442,66,386,3881,145,132,0,0,0,4544,419,3414,159,763,0,0,0,4755,9299
6442,67,386,3663,124,150,0,0,0,4323,378,3376,173,792,0,0,0,4719,9042
6442,68,331,3627,126,123,0,0,0,4207,363,3293,140,912,0,0,0,4708,8915
6442,69,296,3709,126,187,1,0,0,4319,351,3098,125,919,0,0,0,4493,8812
6442,70,244,3363,116,181,1,0,0,3905,310,2857,131,993,0,0,0,4291,8196
6442,71,236,3177,86,180,0,0,0,3679,271,2707,124,1026,0,0,0,4128,7807
6442,72,215,3192,77,202,0,0,0,3686,281,2595,122,1141,0,0,0,4139,7825
6442,73,209,3209,81,228,1,0,0,3728,279,2493,104,1200,0,0,0,4076,7804
6442,74,184,3219,106,266,0,0,0,3775,259,2398,101,1344,0,0,0,4102,7877
6442,75,163,3120,75,231,0,0,0,3589,258,2338,92,1445,0,0,0,4133,7722
6442,76,151,2940,58,289,0,0,0,3438,241,2017,86,1580,0,0,0,3924,7362
6442,77,156,2544,49,293,0,0,0,3042,215,1765,66,1471,0,0,0,3517,6559
6442,78,97,1851,27,234,0,0,0,2209,136,1190,35,1189,0,0,0,2550,4759
6442,79,106,1891,46,250,0,0,0,2293,163,1140,31,1308,0,0,0,2642,4935
6442,80,82,1715,34,233,0,0,0,2064,164,1008,39,1303,0,0,0,2514,4578
6442,81,76,1601,23,267,0,0,0,1967,143,904,30,1351,0,0,0,2428,4395
6442,82,65,1504,24,290,0,0,0,1883,124,781,42,1342,0,0,0,2289,4172
6442,83,73,1520,21,350,0,0,0,1964,126,805,36,1633,0,0,0,2600,4564
6442,84,60,1464,18,365,0,0,0,1907,137,706,32,1645,0,0,0,2520,4427
6442,85,50,1184,9,365,0,0,0,1608,120,568,27,1610,0,0,0,2325,3933
6442,86,41,1068,14,338,0,0,0,1461,127,455,14,1457,0,0,0,2053,3514
6442,87,35,902,8,318,0,0,0,1263,118,379,15,1376,0,0,0,1888,3151
6442,88,42,723,6,310,0,0,0,1081,104,265,10,1364,0,0,0,1743,2824
6442,89,34,618,4,278,0,0,0,934,94,206,14,1176,0,0,0,1490,2424
6442,90,28,419,5,287,0,0,0,739,89,154,7,1060,0,0,0,1310,2049
6442,91,13,349,4,237,0,0,0,603,74,131,8,969,0,0,0,1182,1785
6442,92,13,223,3,190,0,0,0,429,69,85,11,750,0,0,0,915,1344
6442,93,5,196,1,168,0,0,0,370,52,84,7,661,0,0,0,804,1174
6442,94,8,128,2,133,0,0,0,271,35,39,8,504,0,0,0,586,857
6442,95,5,71,0,101,0,0,0,177,26,28,1,364,0,0,0,419,596
6442,96,3,56,1,80,0,0,0,140,29,16,0,264,0,0,0,309,449
6442,97,0,26,0,55,0,0,0,81,21,10,0,195,0,0,0,226,307
6442,98,1,27,0,36,0,0,0,64,16,13,4,139,0,0,0,172,236
6442,99,2,17,0,19,0,0,0,38,13,12,0,96,0,0,0,121,159
6442,100,6,41,0,32,0,0,0,79,17,22,0,170,0,0,0,209,288
6442,999,153338,161327,5662,8768,41,2,0,329138,130073,161008,7981,42130,36,1,1,341230,670368
6562,0,1186,0,0,0,0,0,0,1186,1128,0,0,0,0,0,0,1128,2314
6562,1,1242,0,0,0,0,0,0,1242,1158,0,0,0,0,0,0,1158,2400
6562,2,1256,0,0,0,0,0,0,1256,1211,0,0,0,0,0,0,1211,2467
6562,3,1287,0,0,0,0,0,0,1287,1215,0,0,0,0,0,0,1215,2502
6562,4,1359,0,0,0,0,0,0,1359,1256,0,0,0,0,0,0,1256,2615
6562,5,1360,0,0,0,0,0,0,1360,1308,0,0,0,0,0,0,1308,2668
6562,6,1475,0,0,0,0,0,0,1475,1379,0,0,0,0,0,0,1379,2854
6562,7,1532,0,0,0,0,0,0,1532,1461,0,0,0,0,0,0,1461,2993
6562,8,1512,0,0,0,0,0,0,1512,1435,0,0,0,0,0,0,1435,2947
6562,9,1553,0,0,0,0,0,0,1553,1433,0,0,0,0,0,0,1433,2986
6562,10,1479,0,0,0,0,0,0,1479,1446,0,0,0,0,0,0,1446,2925
6562,11,1643,0,0,0,0,0,0,1643,1516,0,0,0,0,0,0,1516,3159
6562,12,1582,0,0,0,0,0,0,1582,1445,0,0,0,0,0,0,1445,3027
6562,13,1552,0,0,0,0,0,0,1552,1543,0,0,0,0,0,0,1543,3095
6562,14,1568,0,0,0,0,0,0,1568,1504,0,0,0,0,0,0,1504,3072
6562,15,1576,0,0,0,0,0,0,1576,1619,0,0,0,0,0,0,1619,3195
6562,16,1697,0,0,0,0,0,0,1697,1555,0,0,0,0,0,0,1555,3252
6562,17,1800,0,0,0,0,0,0,1800,1552,0,0,0,0,0,0,1552,3352
6562,18,1648,0,0,0,0,0,0,1648,1537,0,0,0,0,0,0,1537,3185
6562,19,1830,0,0,0,0,0,0,1830,1625,7,0,0,0,0,0,1632,3462
6562,20,1754,0,0,0,0,0,0,1754,1614,7,0,0,0,0,0,1621,3375
6562,21,1779,4,0,0,0,0,0,1783,1555,16,0,0,0,0,0,1571,3354
6562,22,1773,9,0,0,0,0,0,1782,1694,32,0,0,0,0,0,1726,3508
6562,23,1820,11,1,0,0,0,0,1832,1667,39,0,0,0,0,0,1706,3538
6562,24,1731,14,0,0,0,0,0,1745,1664,67,0,0,0,0,0,1731,3476
6562,25,1830,40,1,0,0,0,0,1871,1588,123,2,0,0,0,0,1713,3584
6562,26,1727,61,1,0,0,0,0,1789,1496,167,1,1,0,0,0,1665,3454
6562,27,1729,87,1,0,0,0,0,1817,1400,240,2,0,0,0,0,1642,3459
6562,28,1706,119,1,0,0,0,0,1826,1410,341,5,0,1,0,0,1757,3583
6562,29,1616,183,6,0,1,0,0,1806,1277,424,9,0,0,0,0,1710,3516
6562,30,1581,279,1,0,1,0,0,1862,1240,556,9,1,1,0,0,1807,3669
6562,31,1593,375,1,0,1,0,0,1970,1240,701,9,0,0,0,0,1950,3920
6562,32,1538,467,8,0,0,0,0,2013,1158,767,13,1,0,0,0,1939,3952
6562,33,1504,554,8,3,0,0,0,2069,1031,851,24,1,1,0,0,1908,3977
6562,34,1402,655,11,0,1,0,0,2069,882,1014,15,1,1,0,0,1913,3982
6562,35,1321,796,14,1,0,0,0,2132,857,1114,36,3,0,0,0,2010,4142
6562,36,1142,824,21,1,2,0,0,1990,756,1170,31,8,0,0,0,1965,3955
6562,37,1140,934,19,0,0,0,0,2093,700,1210,44,6,2,0,0,1962,4055
6562,38,1071,1001,26,1,0,0,0,2099,686,1266,56,5,0,0,0,2013,4112
6562,39,1029,1092,35,4,0,0,0,2160,673,1290,77,10,1,0,0,2051,4211
6562,40,935,1148,27,4,1,0,0,2115,567,1504,76,6,0,0,0,2153,4268
6562,41,840,1202,49,2,1,0,0,2094,579,1523,66,18,0,0,0,2186,4280
6562,42,828,1265,39,7,2,0,0,2141,543,1479,67,17,0,0,0,2106,4247
6562,43,817,1281,53,4,1,0,0,2156,459,1613,83,23,1,0,0,2179,4335
6562,44,818,1301,50,8,1,0,0,2178,504,1613,102,30,0,0,0,2249,4427
6562,45,772,1506,68,5,0,0,0,2351,471,1666,91,25,0,0,0,2253,4604
6562,46,708,1539,76,4,0,0,0,2327,490,1764,95,39,0,0,0,2388,4715
6562,47,691,1599,69,5,1,0,0,2365,478,1852,113,43,1,0,0,2487,4852
6562,48,677,1596,76,13,1,0,0,2363,439,1818,116,47,0,0,0,2420,4783
6562,49,713,1656,78,12,0,0,0,2459,413,1863,123,62,1,0,0,2462,4921
6562,50,639,1607,92,13,4,0,0,2355,378,1873,136,65,0,0,0,2452,4807
6562,51,585,1643,109,17,2,0,0,2356,369,1931,142,78,0,0,0,2520,4876
6562,52,558,1724,100,18,0,0,0,2400,380,2092,160,79,1,0,0,2712,5112
6562,53,524,1876,111,16,0,0,0,2527,385,2062,140,96,0,0,0,2683,5210
6562,54,527,1912,99,22,1,0,0,2561,386,2107,147,88,0,0,0,2728,5289
6562,55,455,1945,103,16,0,0,0,2519,360,2049,160,123,0,0,0,2692,5211
6562,56,441,1947,131,30,1,0,0,2550,340,2157,145,149,1,1,0,2793,5343
6562,57,459,1937,117,27,1,0,0,2541,352,2214,141,160,1,0,0,2868,5409
6562,58,384,2000,130,32,1,0,0,2547,307,2136,117,163,2,0,0,2725,5272
6562,59,442,2111,117,52,1,0,0,2723,349,2272,136,230,0,0,0,2987,5710
6562,60,329,2081,100,35,0,0,0,2545,280,2214,114,230,0,0,0,2838,5383
6562,61,335,2027,102,45,0,0,0,2509,291,2157,128,224,0,0,0,2800,5309
6562,62,286,2005,107,53,1,0,0,2452,265,2030,111,255,0,0,0,2661,5113
6562,63,319,2126,100,49,0,0,0,2594,235,1981,100,335,1,0,0,2652,5246
6562,64,263,1947,93,70,1,0,0,2374,258,1936,100,342,0,0,0,2636,5010
6562,65,238,1873,87,62,1,0,0,2261,224,1772,98,342,0,0,0,2436,4697
6562,66,205,1966,86,77,0,0,0,2334,196,1811,94,356,0,0,0,2457,4791
6562,67,202,1918,65,77,0,0,0,2262,188,1691,90,395,0,0,0,2364,4626
6562,68,189,1925,81,63,0,0,0,2258,153,1621,81,445,0,0,0,2300,4558
6562,69,166,1876,73,81,0,0,0,2196,177,1615,82,467,0,0,0,2341,4537
6562,70,149,1842,64,100,0,0,0,2155,167,1427,75,484,0,0,0,2153,4308
6562,71,126,1667,62,97,0,0,0,1952,141,1280,55,507,0,0,0,1983,3935
6562,72,109,1630,52,123,0,0,0,1914,160,1324,59,594,0,0,0,2137,4051
6562,73,121,1602,39,108,0,0,0,1870,179,1300,65,623,0,0,0,2167,4037
6562,74,83,1611,47,110,0,0,0,1851,134,1145,57,684,0,0,0,2020,3871
6562,75,117,1529,39,124,1,0,0,1810,136,1163,43,754,0,0,0,2096,3906
6562,76,94,1494,39,138,0,0,0,1765,126,989,34,765,0,0,0,1914,3679
6562,77,78,1291,27,151,0,0,0,1547,144,929,32,806,0,0,0,1911,3458
6562,78,42,958,24,107,0,0,0,1131,86,616,30,608,0,0,0,1340,2471
6562,79,59,984,15,119,0,0,0,1177,93,566,24,644,0,0,0,1327,2504
6562,80,46,900,23,127,0,0,0,1096,87,518,19,711,0,0,0,1335,2431
6562,81,34,859,21,131,0,0,0,1045,72,462,25,780,0,0,0,1339,2384
6562,82,40,700,11,110,0,0,0,861,93,426,17,690,0,0,0,1226,2087
6562,83,40,780,7,165,0,0,0,992,88,407,22,809,0,0,0,1326,2318
6562,84,29,677,11,170,0,0,0,887,78,327,16,771,0,0,0,1192,2079
6562,85,27,563,11,138,0,0,0,739,59,299,6,746,0,0,0,1110,1849
6562,86,23,543,7,160,0,0,0,733,74,219,9,758,0,0,0,1060,1793
6562,87,16,410,7,166,0,0,0,599,53,217,11,718,0,0,0,999,1598
6562,88,26,338,4,147,0,0,0,515,56,155,10,698,0,0,0,919,1434
6562,89,13,316,2,150,0,0,0,481,58,126,9,598,0,0,0,791,1272
6562,90,14,273,2,153,0,0,0,442,42,95,6,558,0,0,0,701,1143
6562,91,7,178,0,126,0,0,0,311,35,83,2,502,0,0,0,622,933
6562,92,11,146,2,104,0,0,0,263,25,40,4,441,0,0,0,510,773
6562,93,5,87,1,86,0,0,0,179,33,36,6,354,0,0,0,429,608
6562,94,3,55,1,54,0,0,0,113,24,24,0,300,0,0,0,348,461
6562,95,0,41,1,38,0,0,0,80,17,24,2,186,0,0,0,229,309
6562,96,4,28,1,37,0,0,0,70,17,14,2,138,0,0,0,171,241
6562,97,0,16,0,24,0,0,0,40,8,8,1,94,0,0,0,111,151
6562,98,0,11,0,25,0,0,0,36,7,6,0,76,0,0,0,89,125
6562,99,0,8,0,17,0,0,0,25,9,10,0,50,0,0,0,69,94
6562,100,0,16,0,19,0,0,0,35,9,5,1,73,0,0,0,88,123
6562,999,77584,81597,3263,4253,29,0,0,166726,66040,82058,4329,21489,16,1,0,173933,340659
6692,0,2072,0,0,0,0,0,0,2072,1972,0,0,0,0,0,0,1972,4044
6692,1,1982,0,0,0,0,0,0,1982,1937,0,0,0,0,0,0,1937,3919
6692,2,1932,0,0,0,0,0,0,1932,1903,0,0,0,0,0,0,1903,3835
6692,3,2095,0,0,0,0,0,0,2095,2007,0,0,0,0,0,0,2007,4102
6692,4,2168,0,0,0,0,0,0,2168,2095,0,0,0,0,0,0,2095,4263
6692,5,2268,0,0,0,0,0,0,2268,2151,0,0,0,0,0,0,2151,4419
6692,6,2358,0,0,0,0,0,0,2358,2174,0,0,0,0,0,0,2174,4532
6692,7,2292,0,0,0,0,0,0,2292,2164,0,0,0,0,0,0,2164,4456
6692,8,2463,0,0,0,0,0,0,2463,2261,0,0,0,0,0,0,2261,4724
6692,9,2463,0,0,0,0,0,0,2463,2262,0,0,0,0,0,0,2262,4725
6692,10,2482,0,0,0,0,0,0,2482,2324,0,0,0,0,0,0,2324,4806
6692,11,2481,0,0,0,0,0,0,2481,2326,0,0,0,0,0,0,2326,4807
6692,12,2518,0,0,0,0,0,0,2518,2444,0,0,0,0,0,0,2444,4962
6692,13,2728,0,0,0,0,0,0,2728,2491,0,0,0,0,0,0,2491,5219
6692,14,2732,0,0,0,0,0,0,2732,2472,0,0,0,0,0,0,2472,5204
6692,15,2659,0,0,0,0,0,0,2659,2591,0,0,0,0,0,0,2591,5250
6692,16,2784,0,0,0,0,0,0,2784,2604,0,0,0,0,0,0,2604,5388
6692,17,2832,0,0,0,0,0,0,2832,2639,0,0,0,0,0,0,2639,5471
6692,18,2783,0,0,0,0,0,0,2783,2649,3,0,0,0,0,0,2652,5435
6692,19,2893,0,0,0,0,0,0,2893,2596,8,0,0,0,0,0,2604,5497
6692,20,2803,5,0,0,0,0,0,2808,2563,28,0,0,0,0,0,2591,5399
6692,21,2734,8,1,0,0,0,0,2743,2521,48,0,0,0,0,0,2569,5312
6692,22,2775,18,0,0,0,0,0,2793,2560,93,0,0,0,0,0,2653,5446
6692,23,2843,29,0,0,0,0,0,2872,2587,135,1,0,0,0,0,2723,5595
6692,24,2858,34,2,1,1,0,0,2896,2465,217,1,0,0,0,0,2683,5579
6692,25,2712,104,0,0,0,0,0,2816,2373,328,0,2,0,0,0,2703,5519
6692,26,2574,145,2,0,0,0,0,2721,2159,429,1,1,0,0,0,2590,5311
6692,27,2526,203,1,1,0,0,0,2731,1985,626,6,0,0,0,0,2617,5348
6692,28,2325,352,5,0,2,0,0,2684,1904,806,4,0,0,0,0,2714,5398
6692,29,2283,499,2,0,1,0,0,2785,1696,896,11,1,0,0,0,2604,5389
6692,30,2300,589,2,0,5,0,0,2896,1647,1134,16,2,0,0,0,2799,5695
6692,31,2061,767,5,0,0,0,0,2833,1520,1364,18,2,1,0,0,2905,5738
6692,32,1950,922,9,5,0,0,0,2886,1421,1451,24,5,0,0,0,2901,5787
6692,33,1873,1133,11,3,0,0,0,3020,1298,1562,33,5,2,0,0,2900,5920
6692,34,1873,1249,16,0,1,0,0,3139,1196,1788,36,4,3,0,0,3027,6166
6692,35,1630,1446,19,4,1,0,0,3100,1105,1965,43,10,1,0,0,3124,6224
6692,36,1530,1499,21,2,0,0,0,3052,1074,2096,41,9,0,0,0,3220,6272
6692,37,1445,1649,27,6,1,0,0,3128,946,2043,73,18,0,0,0,3080,6208
6692,38,1384,1706,29,1,0,0,0,3120,881,2164,58,17,0,0,0,3120,6240
6692,39,1308,1842,41,8,0,0,0,3199,810,2223,74,17,0,0,0,3124,6323
6692,40,1184,1875,44,9,1,0,0,3113,789,2301,90,19,0,0,0,3199,6312
6692,41,1223,1972,49,6,3,0,0,3253,743,2414,106,21,0,0,0,3284,6537
6692,42,1160,2057,58,5,0,0,0,3280,705,2394,121,27,1,0,0,3248,6528
6692,43,1130,2190,63,12,2,0,0,3397,758,2485,108,31,1,0,0,3383,6780
6692,44,1135,2214,65,9,0,1,0,3424,689,2685,126,31,1,0,0,3532,6956
6692,45,1058,2285,68,12,0,0,0,3423,665,2573,125,59,0,0,0,3422,6845
6692,46,984,2329,76,14,1,0,0,3404,703,2784,155,53,0,0,0,3695,7099
6692,47,1028,2556,95,15,1,0,0,3695,698,2920,174,66,1,0,0,3859,7554
6692,48,966,2472,99,22,1,0,0,3560,639,2989,188,86,1,0,0,3903,7463
6692,49,992,2610,91,18,0,0,0,3711,644,2991,144,77,0,0,0,3856,7567
6692,50,978,2620,109,21,0,0,0,3728,583,2943,171,118,0,0,0,3815,7543
6692,51,838,2512,115,25,0,0,0,3490,625,2984,180,127,0,0,0,3916,7406
6692,52,815,2698,122,25,0,0,0,3660,582,3030,195,136,0,0,0,3943,7603
6692,53,740,2615,122,28,0,0,0,3505,545,2963,181,156,0,0,0,3845,7350
6692,54,757,2789,131,29,0,0,0,3706,552,3202,184,168,1,0,0,4107,7813
6692,55,714,2874,137,27,0,0,0,3752,585,3129,192,171,0,0,0,4077,7829
6692,56,694,2877,144,45,2,0,0,3762,549,3112,176,232,0,0,0,4069,7831
6692,57,640,2911,136,55,0,0,0,3742,484,3231,170,255,0,0,0,4140,7882
6692,58,638,2954,156,59,0,0,0,3807,454,3147,186,312,0,0,0,4099,7906
6692,59,583,3005,140,45,0,0,0,3773,500,3173,173,352,0,0,0,4198,7971
6692,60,518,2893,123,60,0,0,0,3594,414,2989,181,357,0,0,0,3941,7535
6692,61,517,2971,131,57,0,0,0,3676,407,2951,129,390,0,0,0,3877,7553
6692,62,473,2857,108,62,1,0,0,3501,404,2997,158,454,1,0,0,4014,7515
6692,63,450,2814,122,72,0,0,0,3458,403,2771,156,526,0,0,0,3856,7314
6692,64,419,2849,122,89,0,0,0,3479,368,2671,123,530,0,0,0,3692,7171
6692,65,341,2614,93,85,0,0,0,3133,318,2468,131,527,1,0,0,3445,6578
6692,66,339,2740,119,104,0,0,0,3302,316,2489,118,643,0,0,0,3566,6868
6692,67,291,2637,100,105,0,0,0,3133,269,2372,108,621,0,0,0,3370,6503
6692,68,305,2652,90,106,0,0,0,3153,275,2256,111,674,0,0,0,3316,6469
6692,69,287,2602,85,118,0,0,0,3092,245,2219,77,789,0,0,0,3330,6422
6692,70,261,2376,79,134,0,0,0,2850,262,2000,93,714,0,0,0,3069,5919
6692,71,222,2272,65,124,0,0,0,2683,225,1841,74,789,0,0,0,2929,5612
6692,72,233,2294,68,161,0,0,0,2756,217,1792,85,919,0,0,0,3013,5769
6692,73,167,2351,49,166,0,0,0,2733,217,1763,80,981,0,0,0,3041,5774
6692,74,165,2294,58,190,0,0,0,2707,232,1601,63,1051,0,0,0,2947,5654
6692,75,175,2304,56,201,0,0,0,2736,198,1568,55,1223,0,0,0,3044,5780
6692,76,158,2159,45,197,0,0,0,2559,178,1523,56,1253,0,0,0,3010,5569
6692,77,134,1927,39,193,0,0,0,2293,165,1209,51,1231,0,0,0,2656,4949
6692,78,107,1449,37,170,0,0,0,1763,177,940,38,1005,0,0,0,2160,3923
6692,79,103,1368,27,187,0,0,0,1685,134,819,35,1028,0,0,0,2016,3701
6692,80,79,1332,19,192,0,0,0,1622,157,734,30,1124,0,0,0,2045,3667
6692,81,68,1251,12,214,0,0,0,1545,136,582,18,1149,0,0,0,1885,3430
6692,82,93,1190,15,208,0,0,0,1506,119,569,28,1220,0,0,0,1936,3442
6692,83,74,1216,16,243,0,0,0,1549,133,527,22,1243,0,0,0,1925,3474
6692,84,66,1018,19,247,0,0,0,1350,123,472,18,1276,0,0,0,1889,3239
6692,85,42,822,11,230,0,0,0,1105,108,404,30,1194,0,0,0,1736,2841
6692,86,55,700,5,222,0,0,0,982,96,258,12,1064,0,0,0,1430,2412
6692,87,48,610,7,222,0,0,0,887,91,259,9,1107,0,0,0,1466,2353
6692,88,34,526,5,240,0,0,0,805,105,209,10,977,0,0,0,1301,2106
6692,89,26,422,5,218,0,0,0,671,80,137,13,943,0,0,0,1173,1844
6692,90,20,345,1,223,0,0,0,589,70,112,10,853,0,0,0,1045,1634
6692,91,18,255,0,153,0,0,0,426,64,64,5,734,0,0,0,867,1293
6692,92,16,189,2,142,0,0,0,349,62,61,7,585,0,0,0,715,1064
6692,93,13,128,1,130,0,0,0,272,48,33,2,480,0,0,0,563,835
6692,94,6,107,2,85,0,0,0,200,40,27,6,351,0,0,0,424,624
6692,95,7,53,2,76,0,0,0,138,33,16,3,294,0,0,0,346,484
6692,96,5,39,1,54,0,0,0,99,22,15,4,233,0,0,0,274,373
6692,97,2,24,0,40,0,0,0,66,19,7,1,163,0,0,0,190,256
6692,98,3,16,1,28,0,0,0,48,10,3,1,104,0,0,0,118,166
6692,99,0,12,1,21,0,0,0,34,14,5,0,95,0,0,0,114,148
6692,100,2,16,0,31,0,0,0,49,12,7,3,117,0,0,0,139,188
6692,999,117371,123308,3954,6312,24,1,0,250970,100231,124597,5739,33601,15,0,0,264183,515153
6793,0,1511,0,0,0,0,0,0,1511,1465,0,0,0,0,0,0,1465,2976
6793,1,1562,0,0,0,0,0,0,1562,1468,0,0,0,0,0,0,1468,3030
6793,2,1611,0,0,0,0,0,0,1611,1459,0,0,0,0,0,0,1459,3070
6793,3,1582,0,0,0,0,0,0,1582,1529,0,0,0,0,0,0,1529,3111
6793,4,1692,0,0,0,0,0,0,1692,1482,0,0,0,0,0,0,1482,3174
6793,5,1682,0,0,0,0,0,0,1682,1557,0,0,0,0,0,0,1557,3239
6793,6,1723,0,0,0,0,0,0,1723,1636,0,0,0,0,0,0,1636,3359
6793,7,1763,0,0,0,0,0,0,1763,1639,0,0,0,0,0,0,1639,3402
6793,8,1729,0,0,0,0,0,0,1729,1675,0,0,0,0,0,0,1675,3404
6793,9,1788,0,0,0,0,0,0,1788,1715,0,0,0,0,0,0,1715,3503
6793,10,1759,0,0,0,0,0,0,1759,1740,0,0,0,0,0,0,1740,3499
6793,11,1767,0,0,0,0,0,0,1767,1836,0,0,0,0,0,0,1836,3603
6793,12,1823,0,0,0,0,0,0,1823,1801,0,0,0,0,0,0,1801,3624
6793,13,1928,0,0,0,0,0,0,1928,1810,0,0,0,0,0,0,1810,3738
6793,14,2033,0,0,0,0,0,0,2033,1928,0,0,0,0,0,0,1928,3961
6793,15,2005,0,0,0,0,0,0,2005,1999,0,0,0,0,0,0,1999,4004
6793,16,2091,0,0,0,0,0,0,2091,2001,0,0,0,0,0,0,2001,4092
6793,17,2153,0,0,0,0,0,0,2153,1988,0,0,0,0,0,0,1988,4141
6793,18,2301,0,0,0,0,0,0,2301,2070,0,0,0,0,0,0,2070,4371
6793,19,2491,0,0,0,0,0,0,2491,2136,5,0,0,0,0,0,2141,4632
6793,20,2371,0,0,0,0,0,0,2371,2102,12,0,0,0,0,0,2114,4485
6793,21,2278,3,0,1,0,0,0,2282,2092,20,0,0,0,0,0,2112,4394
6793,22,2327,6,0,0,0,0,0,2333,2090,44,0,1,1,0,0,2136,4469
6793,23,2488,20,1,0,0,0,0,2509,2071,62,2,0,0,0,0,2135,4644
6793,24,2485,26,3,0,0,0,0,2514,2028,102,0,0,1,0,0,2131,4645
6793,25,2381,35,0,0,0,0,0,2416,1991,159,3,1,1,0,0,2155,4571
6793,26,2333,58,2,0,0,1,0,2394,1805,228,0,0,0,0,0,2033,4427
6793,27,2261,102,1,0,0,0,0,2364,1780,294,5,0,0,0,0,2079,4443
6793,28,2162,156,0,0,0,0,0,2318,1655,400,8,0,0,0,0,2063,4381
6793,29,2167,231,2,0,0,0,0,2400,1538,594,13,1,0,0,0,2146,4546
6793,30,1940,355,3,2,0,0,0,2300,1401,686,13,3,1,0,0,2104,4404
6793,31,1892,477,6,0,2,0,0,2377,1305,886,14,3,2,0,0,2210,4587
6793,32,1806,591,9,0,1,0,0,2407,1140,919,17,4,0,0,0,2080,4487
6793,33,1640,648,10,1,0,0,0,2299,1088,1069,19,4,0,0,0,2180,4479
6793,34,1579,841,8,0,4,0,0,2432,994,1236,36,7,1,0,0,2274,4706
6793,35,1403,932,19,0,1,0,0,2355,922,1316,43,7,2,0,0,2290,4645
6793,36,1319,934,19,3,1,0,0,2276,748,1333,37,9,2,1,0,2130,4406
6793,37,1271,1091,19,1,0,0,0,2382,680,1433,40,8,0,0,0,2161,4543
6793,38,1171,1208,32,1,1,0,0,2413,698,1467,70,9,3,0,0,2247,4660
6793,39,1072,1319,32,5,0,0,0,2428,658,1648,80,10,1,0,0,2397,4825
6793,40,1070,1337,38,2,1,0,0,2448,602,1620,95,9,1,0,0,2327,4775
6793,41,979,1445,55,4,2,0,0,2485,550,1775,105,20,0,0,0,2450,4935
6793,42,954,1495,61,1,0,1,0,2512,497,1800,113,27,3,0,0,2440,4952
6793,43,902,1649,63,8,3,0,0,2625,507,1969,117,32,0,0,0,2625,5250
6793,44,848,1686,93,8,1,0,0,2636,465,2054,118,32,2,0,0,2671,5307
6793,45,892,1786,98,7,1,0,0,2784,422,2031,149,33,2,0,0,2637,5421
6793,46,789,1823,89,7,4,0,0,2712,429,2199,159,34,1,0,0,2822,5534
6793,47,778,2016,126,7,1,0,0,2928,414,2299,145,41,2,0,0,2901,5829
6793,48,800,2200,135,8,3,0,0,3146,422,2369,190,40,2,0,0,3023,6169
6793,49,748,2242,173,13,3,0,0,3179,416,2541,178,61,0,0,0,3196,6375
6793,50,682,2318,126,19,2,0,0,3147,376,2544,181,80,0,0,0,3181,6328
6793,51,613,2260,139,20,2,0,0,3034,345,2510,204,76,0,0,0,3135,6169
6793,52,586,2328,144,23,0,0,0,3081,342,2708,211,73,0,0,0,3334,6415
6793,53,560,2369,183,23,3,0,1,3139,357,2684,207,106,3,0,0,3357,6496
6793,54,547,2613,181,22,0,0,0,3363,350,2745,223,139,1,0,0,3458,6821
6793,55,445,2536,156,32,1,0,0,3170,295,2660,213,137,1,0,0,3306,6476
6793,56,459,2557,154,33,2,0,0,3205,273,2620,195,159,0,0,0,3247,6452
6793,57,389,2527,132,37,4,0,0,3089,319,2563,189,170,0,0,0,3241,6330
6793,58,334,2398,165,30,3,0,0,2930,298,2534,202,189,0,0,0,3223,6153
6793,59,339,2639,177,61,3,0,0,3219,285,2682,202,223,1,0,0,3393,6612
6793,60,284,2546,142,57,1,0,1,3031,277,2543,166,239,0,0,0,3225,6256
6793,61,306,2484,154,42,1,0,0,2987,274,2521,146,274,0,0,1,3216,6203
6793,62,268,2330,138,56,0,0,0,2792,243,2389,138,295,0,0,0,3065,5857
6793,63,257,2413,134,53,0,0,0,2857,237,2333,122,336,0,0,0,3028,5885
6793,64,204,2249,96,65,0,0,0,2614,198,2142,113,344,1,0,0,2798,5412
6793,65,200,2298,97,69,0,0,0,2664,197,2071,104,395,0,0,0,2767,5431
6793,66,187,2162,110,80,1,0,0,2540,212,2042,113,383,0,0,0,2750,5290
6793,67,183,2196,107,87,1,0,0,2574,212,2026,106,451,0,0,0,2795,5369
6793,68,190,2214,89,80,0,0,0,2573,191,1914,92,514,0,0,0,2711,5284
6793,69,160,2164,73,111,1,0,0,2509,185,1868,78,560,0,0,0,2691,5200
6793,70,133,1841,72,123,0,0,0,2169,170,1582,99,537,0,0,0,2388,4557
6793,71,145,1908,85,118,1,0,0,2257,159,1623,80,598,0,0,0,2460,4717
6793,72,140,1946,77,111,0,0,0,2274,151,1582,67,636,0,0,0,2436,4710
6793,73,118,1901,49,145,0,0,0,2213,170,1532,79,701,0,0,0,2482,4695
6793,74,95,1916,47,137,0,0,0,2195,148,1571,56,883,0,0,0,2658,4853
6793,75,88,1948,46,135,0,0,0,2217,162,1508,51,865,0,0,0,2586,4803
6793,76,84,1852,39,149,0,0,0,2124,133,1304,41,1017,0,0,0,2495,4619
6793,77,81,1655,40,186,0,0,0,1962,131,1198,40,1003,0,0,0,2372,4334
6793,78,59,1351,37,170,0,0,0,1617,106,903,32,842,0,0,0,1883,3500
6793,79,62,1287,28,165,0,0,0,1542,105,820,32,929,0,0,0,1886,3428
6793,80,46,1255,26,192,0,0,0,1519,97,770,29,1024,0,0,0,1920,3439
6793,81,47,1149,26,209,0,0,0,1431,88,646,23,1059,0,0,0,1816,3247
6793,82,43,988,14,190,0,0,0,1235,86,553,25,949,0,0,0,1613,2848
6793,83,54,1136,15,226,0,0,0,1431,87,509,28,1224,0,0,0,1848,3279
6793,84,27,985,18,228,0,0,0,1258,86,431,19,1209,0,0,0,1745,3003
6793,85,24,823,9,200,0,0,0,1056,90,294,15,1071,0,0,0,1470,2526
6793,86,30,645,10,185,0,0,0,870,88,255,14,949,0,0,0,1306,2176
6793,87,23,546,9,184,0,0,0,762,74,188,10,887,0,0,0,1159,1921
6793,88,17,415,6,207,0,0,0,645,72,158,8,819,0,0,0,1057,1702
6793,89,14,407,3,164,0,0,0,588,51,98,13,751,0,0,0,913,1501
6793,90,12,308,3,154,0,0,0,477,48,73,7,648,0,0,0,776,1253
6793,91,7,199,3,118,0,0,0,327,39,60,4,520,0,0,0,623,950
6793,92,7,142,1,107,0,0,0,257,34,30,6,469,0,0,0,539,796
6793,93,6,129,2,100,0,0,0,237,27,29,4,459,0,0,0,519,756
6793,94,2,73,0,65,0,0,0,140,27,15,3,330,0,0,0,375,515
6793,95,4,36,0,53,0,0,0,93,19,12,1,229,0,0,0,261,354
6793,96,1,20,1,26,0,0,0,48,15,6,1,169,0,0,0,191,239
6793,97,2,15,0,27,0,0,0,44,11,7,2,132,0,0,0,152,196
6793,98,0,6,0,16,0,0,0,22,11,3,0,85,0,0,0,99,121
6793,99,0,4,0,10,0,0,0,14,9,4,0,73,0,0,0,86,100
6793,100,4,8,0,12,0,0,0,24,9,3,2,104,0,0,0,118,142
6793,999,92668,101207,4460,5191,55,2,2,203585,76413,100436,5765,26710,35,1,1,209361,412946
6850,0,4732,0,0,0,0,0,0,4732,4616,0,0,0,0,0,0,4616,9348
6850,1,5136,0,0,0,0,0,0,5136,4639,0,0,0,0,0,0,4639,9775
6850,2,4948,0,0,0,0,0,0,4948,4752,0,0,0,0,0,0,4752,9700
6850,3,5205,0,0,0,0,0,0,5205,4845,0,0,0,0,0,0,4845,10050
6850,4,5311,0,0,0,0,0,0,5311,5102,0,0,0,0,0,0,5102,10413
6850,5,5529,0,0,0,0,0,0,5529,5178,0,0,0,0,0,0,5178,10707
6850,6,5603,0,0,0,0,0,0,5603,5295,0,0,0,0,0,0,5295,10898
6850,7,5492,0,0,0,0,0,0,5492,5223,0,0,0,0,0,0,5223,10715
6850,8,5749,0,0,0,0,0,0,5749,5542,0,0,0,0,0,0,5542,11291
6850,9,5986,0,0,0,0,0,0,5986,5625,0,0,0,0,0,0,5625,11611
6850,10,5808,0,0,0,0,0,0,5808,5486,0,0,0,0,0,0,5486,11294
6850,11,6107,0,0,0,0,0,0,6107,5844,0,0,0,0,0,0,5844,11951
6850,12,6136,0,0,0,0,0,0,6136,5806,0,0,0,0,0,0,5806,11942
6850,13,6287,0,0,0,0,0,0,6287,6044,0,0,0,0,0,0,6044,12331
6850,14,6474,0,0,0,0,0,0,6474,6157,0,0,0,0,0,0,6157,12631
6850,15,6524,0,0,0,0,0,0,6524,6134,0,0,0,0,0,0,6134,12658
6850,16,6466,0,1,0,0,0,0,6467,6217,0,1,0,0,0,0,6218,12685
6850,17,6632,0,0,0,0,0,0,6632,6210,0,0,0,0,0,0,6210,12842
6850,18,6772,2,0,0,0,0,0,6774,6410,5,0,0,0,0,0,6415,13189
6850,19,6977,1,0,0,0,0,0,6978,6426,33,0,0,0,0,0,6459,13437
6850,20,6510,8,1,0,0,0,0,6519,6118,53,0,0,0,0,0,6171,12690
6850,21,6505,24,0,0,0,0,0,6529,6118,94,0,0,0,0,0,6212,12741
6850,22,6517,37,1,0,0,0,0,6555,5963,163,1,0,1,0,0,6128,12683
6850,23,6477,75,4,0,0,0,0,6556,5814,270,1,0,0,0,0,6085,12641
6850,24,6432,131,1,0,1,0,0,6565,5707,419,3,0,2,0,0,6131,12696
6850,25,6125,206,1,0,0,0,0,6332,5360,638,5,1,2,0,0,6006,12338
6850,26,6046,364,0,0,1,0,0,6411,5238,927,5,0,2,0,0,6172,12583
6850,27,5711,509,3,0,2,0,0,6225,5031,1223,6,0,1,0,0,6261,12486
6850,28,5453,769,3,0,0,0,0,6225,4568,1548,11,2,3,0,0,6132,12357
6850,29,5344,1018,5,1,4,0,0,6372,4281,2061,18,2,3,2,0,6367,12739
6850,30,5108,1409,11,0,6,0,0,6534,4056,2466,36,4,4,1,0,6567,13101
6850,31,5052,1855,16,3,4,0,0,6930,4000,3015,29,6,4,0,0,7054,13984
6850,32,4536,2246,24,2,7,2,0,6817,3328,3360,56,7,6,1,0,6758,13575
6850,33,4315,2534,29,1,7,0,0,6886,3120,3652,71,5,2,0,0,6850,13736
6850,34,4030,2954,33,1,6,0,0,7024,2802,4054,78,12,9,0,0,6955,13979
6850,35,3742,3283,43,5,7,0,0,7080,2632,4309,92,14,9,0,0,7056,14136
6850,36,3304,3483,62,2,4,1,0,6856,2394,4398,132,26,12,0,0,6962,13818
6850,37,3036,3748,71,6,5,1,0,6867,2221,4632,159,22,8,0,0,7042,13909
6850,38,2839,3949,83,4,9,0,0,6884,2129,4881,145,26,7,0,0,7188,14072
6850,39,2862,4238,94,5,7,0,0,7206,1988,5149,204,29,5,2,0,7377,14583
6850,40,2552,4430,117,15,16,2,0,7132,1813,5345,207,35,9,0,0,7409,14541
6850,41,2449,4840,126,9,11,1,0,7436,1762,5544,262,51,8,2,0,7629,15065
6850,42,2348,4793,146,9,7,0,0,7303,1703,5647,265,54,12,0,0,7681,14984
6850,43,2329,5204,178,14,11,1,0,7737,1618,6100,335,75,5,0,0,8133,15870
6850,44,2272,5358,228,22,15,0,0,7895,1582,6233,351,80,9,1,0,8256,16151
6850,45,2171,5610,224,32,10,2,0,8049,1529,6356,390,84,6,1,0,8366,16415
6850,46,2099,5618,251,25,10,2,0,8005,1514,6504,418,113,10,0,0,8559,16564
6850,47,2040,6018,302,28,6,1,0,8395,1509,6782,466,109,3,0,0,8869,17264
6850,48,2070,6330,338,32,11,0,0,8781,1531,6891,479,142,7,0,0,9050,17831
6850,49,2080,6565,342,36,5,0,0,9028,1458,7157,521,186,5,0,0,9327,18355
6850,50,1811,6568,375,50,13,0,0,8817,1363,6946,534,188,5,0,0,9036,17853
6850,51,1767,6569,363,42,9,0,0,8750,1333,7112,585,234,4,0,0,9268,18018
6850,52,1626,6773,426,69,10,1,1,8906,1381,7194,587,272,6,0,0,9440,18346
6850,53,1582,6747,418,63,3,0,0,8813,1292,7113,586,336,3,1,0,9331,18144
6850,54,1501,7026,439,91,8,0,0,9065,1258,7385,611,350,6,0,0,9610,18675
6850,55,1381,7016,446,90,11,0,0,8944,1333,7204,638,373,3,0,0,9551,18495
6850,56,1347,7020,450,115,5,0,0,8937,1232,7192,602,416,3,1,0,9446,18383
6850,57,1196,7073,466,111,5,0,1,8852,1215,7278,642,484,3,0,0,9622,18474
6850,58,1177,7130,449,116,4,0,0,8876,1176,7219,603,597,1,1,0,9597,18473
6850,59,1136,7256,467,159,4,0,0,9022,1095,7362,632,645,0,0,1,9735,18757
6850,60,945,6936,429,157,10,0,0,8477,1103,7047,576,655,1,0,0,9382,17859
6850,61,873,6903,392,192,5,0,0,8365,1065,6839,537,806,1,0,0,9248,17613
6850,62,833,6730,388,190,3,0,0,8144,987,6627,500,764,2,0,0,8880,17024
6850,63,761,6580,348,188,5,0,0,7882,988,6520,442,846,4,0,0,8800,16682
6850,64,706,6315,331,240,2,0,0,7594,903,6032,453,1047,0,0,0,8435,16029
6850,65,701,6165,314,250,4,0,0,7434,815,5816,412,1114,1,0,0,8158,15592
6850,66,633,6117,315,251,5,0,0,7321,829,5753,381,1232,1,0,0,8196,15517
6850,67,559,6084,291,238,2,1,0,7175,818,5505,347,1271,3,0,0,7944,15119
6850,68,516,5793,295,275,1,1,1,6882,736,5205,339,1412,0,0,0,7692,14574
6850,69,465,5764,249,316,1,0,0,6795,755,5145,336,1648,0,0,0,7884,14679
6850,70,433,5437,212,328,6,0,0,6416,723,4620,296,1498,0,0,0,7137,13553
6850,71,390,5278,180,368,1,0,0,6217,673,4609,287,1740,0,0,0,7309,13526
6850,72,378,5094,167,383,5,0,0,6027,666,4190,296,1798,0,0,0,6950,12977
6850,73,396,5234,174,422,2,0,0,6228,661,4183,283,1988,1,0,0,7116,13344
6850,74,320,4922,141,436,0,0,1,5820,618,3948,220,2293,0,0,0,7079,12899
6850,75,367,5032,149,497,0,0,0,6045,688,3800,207,2457,0,0,0,7152,13197
6850,76,289,4738,125,514,0,0,0,5666,665,3468,220,2569,0,0,0,6922,12588
6850,77,243,4245,130,481,1,0,0,5100,565,2970,173,2638,3,0,0,6349,11449
6850,78,193,3543,90,493,1,0,1,4321,494,2431,140,2285,0,0,0,5350,9671
6850,79,177,3177,72,486,1,0,0,3913,450,2120,128,2496,0,0,0,5194,9107
6850,80,149,2716,63,435,0,0,0,3363,410,1749,117,2209,0,0,0,4485,7848
6850,81,136,2583,57,524,0,0,0,3300,416,1530,96,2404,0,0,0,4446,7746
6850,82,118,2435,38,546,0,0,0,3137,408,1336,89,2482,0,0,0,4315,7452
6850,83,127,2316,41,584,0,0,0,3068,427,1312,86,2797,0,0,0,4622,7690
6850,84,110,2189,45,559,0,0,0,2903,384,1046,71,2661,1,0,0,4163,7066
6850,85,105,1871,43,553,0,0,0,2572,337,904,71,2580,0,0,0,3892,6464
6850,86,94,1485,18,477,0,0,0,2074,315,647,55,2364,0,0,0,3381,5455
6850,87,63,1258,15,442,0,0,0,1778,276,478,48,2140,0,0,0,2942,4720
6850,88,58,984,17,455,0,0,0,1514,231,386,37,2077,0,0,0,2731,4245
6850,89,58,777,11,464,1,0,0,1311,215,276,36,1945,0,0,0,2472,3783
6850,90,38,708,5,430,0,0,0,1181,205,207,24,1671,0,0,0,2107,3288
6850,91,43,472,5,338,0,0,0,858,145,134,26,1362,0,0,0,1667,2525
6850,92,25,352,2,286,0,0,0,665,137,109,15,1166,0,0,0,1427,2092
6850,93,17,274,1,233,0,0,0,525,118,60,14,1073,0,0,0,1265,1790
6850,94,12,171,3,173,0,0,0,359,99,41,4,702,0,0,0,846,1205
6850,95,8,99,3,134,0,0,0,244,70,20,8,559,0,0,0,657,901
6850,96,4,64,3,95,0,0,0,166,52,9,3,419,0,0,0,483,649
6850,97,3,30,0,85,0,0,0,118,50,10,5,302,0,0,0,367,485
6850,98,4,20,0,52,0,0,0,76,23,5,4,217,0,0,0,249,325
6850,99,2,9,0,45,0,0,0,56,14,3,1,160,0,0,0,178,234
6850,100,6,16,0,39,0,0,0,61,32,4,2,219,0,0,0,257,318
6850,999,266110,287703,12199,14812,300,16,5,581145,242682,289008,18152,69046,206,13,1,619108,1200253
6927,0,1943,0,0,0,0,0,0,1943,1892,0,0,0,0,0,0,1892,3835
6927,1,2001,0,0,0,0,0,0,2001,1921,0,0,0,0,0,0,1921,3922
6927,2,2149,0,0,0,0,0,0,2149,1991,0,0,0,0,0,0,1991,4140
6927,3,2154,0,0,0,0,0,0,2154,2038,0,0,0,0,0,0,2038,4192
6927,4,2164,0,0,0,0,0,0,2164,2122,0,0,0,0,0,0,2122,4286
6927,5,2386,0,0,0,0,0,0,2386,2149,0,0,0,0,0,0,2149,4535
6927,6,2422,0,0,0,0,0,0,2422,2334,0,0,0,0,0,0,2334,4756
6927,7,2355,0,0,0,0,0,0,2355,2218,0,0,0,0,0,0,2218,4573
6927,8,2398,0,0,0,0,0,0,2398,2304,0,0,0,0,0,0,2304,4702
6927,9,2545,0,0,0,0,0,0,2545,2456,0,0,0,0,0,0,2456,5001
6927,10,2481,0,0,0,0,0,0,2481,2472,0,0,0,0,0,0,2472,4953
6927,11,2645,0,0,0,0,0,0,2645,2485,0,0,0,0,0,0,2485,5130
6927,12,2639,0,0,0,0,0,0,2639,2524,0,0,0,0,0,0,2524,5163
6927,13,2756,0,0,0,0,0,0,2756,2689,0,0,0,0,0,0,2689,5445
6927,14,2736,0,0,0,0,0,0,2736,2624,0,0,0,0,0,0,2624,5360
6927,15,2838,0,0,0,0,0,0,2838,2766,0,0,0,0,0,0,2766,5604
6927,16,2921,0,0,0,0,0,0,2921,2747,0,1,0,0,0,0,2748,5669
6927,17,3035,0,0,0,0,0,0,3035,2713,0,0,0,0,0,0,2713,5748
6927,18,3056,0,1,0,0,0,0,3057,2657,2,0,0,0,0,0,2659,5716
6927,19,3123,5,0,0,0,0,0,3128,2839,3,1,0,1,0,0,2844,5972
6927,20,3031,1,0,0,0,0,0,3032,2815,11,0,0,1,0,0,2827,5859
6927,21,3015,6,0,0,0,0,0,3021,2802,37,0,0,0,0,0,2839,5860
6927,22,3182,13,0,0,0,0,0,3195,2821,56,0,0,1,0,0,2878,6073
6927,23,3169,16,2,0,0,0,0,3187,2814,83,1,0,0,0,0,2898,6085
6927,24,3019,28,0,0,3,0,0,3050,2853,118,1,0,0,0,0,2972,6022
6927,25,3006,66,2,0,1,0,0,3075,2698,147,4,0,0,0,0,2849,5924
6927,26,2959,79,1,0,0,0,0,3039,2553,260,5,0,1,0,0,2819,5858
6927,27,2982,145,1,0,0,0,0,3128,2565,401,2,0,0,0,0,2968,6096
6927,28,2918,194,0,1,0,0,0,3113,2429,509,10,0,1,0,0,2949,6062
6927,29,2837,317,3,0,1,0,0,3158,2355,685,7,0,0,0,0,3047,6205
6927,30,2847,441,5,0,0,0,0,3293,2330,829,11,2,3,0,0,3175,6468
6927,31,2769,565,11,0,2,0,0,3347,2243,1072,17,2,4,0,0,3338,6685
6927,32,2616,753,8,0,0,1,0,3378,1977,1273,28,4,1,0,0,3283,6661
6927,33,2505,911,29,1,4,0,0,3450,1934,1456,34,1,2,0,0,3427,6877
6927,34,2305,1002,17,0,0,0,0,3324,1908,1613,43,5,2,0,0,3571,6895
6927,35,2288,1185,26,0,1,0,0,3500,1714,1702,57,12,0,0,0,3485,6985
6927,36,2132,1369,21,1,4,0,0,3527,1550,1760,56,15,4,0,0,3385,6912
6927,37,1922,1568,34,1,0,0,0,3525,1403,1978,80,19,2,0,1,3483,7008
6927,38,1845,1593,54,2,2,0,0,3496,1352,2033,105,12,4,1,0,3507,7003
6927,39,1780,1674,67,8,0,0,0,3529,1315,2120,110,16,5,0,0,3566,7095
6927,40,1634,1751,68,7,3,0,0,3463,1117,2230,129,18,1,0,0,3495,6958
6927,41,1615,1926,83,5,1,0,0,3630,1152,2411,153,33,2,0,0,3751,7381
6927,42,1550,1942,91,6,3,0,0,3592,1017,2487,170,32,2,0,0,3708,7300
6927,43,1414,2248,80,3,2,0,0,3747,1013,2608,175,26,4,0,0,3826,7573
6927,44,1384,2277,111,6,1,0,0,3779,1018,2663,188,37,3,1,0,3910,7689
6927,45,1348,2442,121,7,5,0,0,3923,990,2775,202,52,1,0,0,4020,7943
6927,46,1395,2477,168,14,0,0,1,4055,941,2860,239,63,1,0,0,4104,8159
6927,47,1335,2657,194,16,1,0,0,4203,923,3188,253,65,0,0,0,4429,8632
6927,48,1330,2815,206,17,2,0,0,4370,932,3145,271,68,1,0,0,4417,8787
6927,49,1269,2916,201,25,2,0,0,4413,940,3427,293,88,0,0,0,4748,9161
6927,50,1165,3011,214,26,1,0,0,4417,820,3463,349,123,1,0,0,4756,9173
6927,51,1174,3079,246,26,3,0,0,4528,782,3634,345,119,0,0,0,4880,9408
6927,52,1043,3245,232,40,1,0,0,4561,803,3620,334,156,0,0,0,4913,9474
6927,53,1005,3133,231,31,2,0,0,4402,736,3469,339,156,2,0,0,4702,9104
6927,54,951,3265,245,34,3,0,0,4498,729,3683,360,172,0,0,0,4944,9442
6927,55,905,3354,276,47,6,0,0,4588,705,3579,374,237,0,0,0,4895,9483
6927,56,885,3459,286,55,3,0,0,4688,688,3641,375,252,0,0,0,4956,9644
6927,57,801,3504,296,58,3,0,0,4662,695,3726,346,276,0,0,0,5043,9705
6927,58,733,3469,269,50,0,0,0,4521,688,3799,349,281,0,1,0,5118,9639
6927,59,748,3588,294,77,2,0,0,4709,643,3787,358,328,0,0,0,5116,9825
6927,60,623,3530,267,72,1,0,0,4493,619,3507,285,375,1,0,0,4787,9280
6927,61,592,3480,259,87,6,1,0,4425,550,3696,297,440,0,0,0,4983,9408
6927,62,539,3415,229,104,1,0,0,4288,557,3450,308,493,1,0,0,4809,9097
6927,63,510,3535,259,114,1,0,0,4419,553,3453,274,536,0,0,0,4816,9235
6927,64,510,3320,230,100,1,0,0,4161,540,3186,253,566,0,0,0,4545,8706
6927,65,436,3186,198,120,1,0,0,3941,481,3114,235,625,0,0,0,4455,8396
6927,66,410,3189,197,140,2,0,0,3938,463,3111,232,672,1,0,0,4479,8417
6927,67,379,3150,172,149,0,0,0,3850,422,2950,188,720,0,0,0,4280,8130
6927,68,393,3231,180,156,1,0,0,3961,402,2849,204,744,0,0,0,4199,8160
6927,69,338,3119,165,169,1,0,0,3792,379,2733,191,820,0,0,0,4123,7915
6927,70,301,2880,148,160,3,0,0,3492,335,2543,157,878,0,0,0,3913,7405
6927,71,268,2707,143,182,1,0,0,3301,339,2320,155,891,0,0,0,3705,7006
6927,72,236,2762,139,175,1,0,0,3313,328,2209,155,966,0,0,0,3658,6971
6927,73,223,2756,118,222,0,0,0,3319,331,2193,134,1160,0,0,0,3818,7137
6927,74,229,2704,100,259,0,0,1,3293,320,2168,109,1134,0,0,0,3731,7024
6927,75,201,2800,95,276,2,0,0,3374,307,2091,117,1372,0,0,0,3887,7261
6927,76,178,2614,107,286,1,0,0,3186,316,1817,131,1360,0,0,0,3624,6810
6927,77,181,2335,62,267,1,0,0,2846,293,1612,101,1391,0,0,0,3397,6243
6927,78,130,1763,60,230,0,0,0,2183,235,1184,70,1215,0,0,0,2704,4887
6927,79,94,1667,41,242,0,0,0,2044,209,1080,74,1239,0,0,0,2602,4646
6927,80,96,1536,47,260,0,0,0,1939,207,951,48,1279,0,0,0,2485,4424
6927,81,89,1505,31,277,0,0,0,1902,171,896,63,1420,0,0,0,2550,4452
6927,82,99,1427,24,292,0,0,0,1842,211,743,66,1478,0,0,0,2498,4340
6927,83,80,1375,33,360,0,0,0,1848,187,706,55,1630,0,0,0,2578,4426
6927,84,76,1254,29,343,0,0,0,1702,178,556,42,1500,0,0,0,2276,3978
6927,85,70,986,18,289,0,0,0,1363,164,451,36,1453,0,0,0,2104,3467
6927,86,51,837,11,304,1,0,0,1204,135,376,24,1332,0,0,0,1867,3071
6927,87,36,740,11,277,0,0,0,1064,179,302,29,1279,0,0,0,1789,2853
6927,88,42,593,7,270,1,0,0,913,151,225,13,1241,0,0,0,1630,2543
6927,89,23,525,9,244,0,0,0,801,107,183,17,1160,0,0,0,1467,2268
6927,90,35,383,6,226,0,0,0,650,111,110,17,1023,0,0,0,1261,1911
6927,91,26,256,5,211,0,0,0,498,106,62,9,860,0,0,0,1037,1535
6927,92,13,212,1,179,0,0,0,405,86,67,12,729,0,0,0,894,1299
6927,93,14,169,4,134,0,0,0,321,79,34,5,620,0,0,0,738,1059
6927,94,9,80,3,90,0,0,0,182,50,26,5,456,0,0,0,537,719
6927,95,4,57,0,65,0,0,0,126,49,20,9,361,0,0,0,439,565
6927,96,4,37,0,46,0,0,0,87,20,8,2,236,0,0,0,266,353
6927,97,2,19,2,27,0,0,0,50,21,3,1,186,0,0,0,211,261
6927,98,2,15,1,17,0,0,0,35,24,11,4,137,0,0,0,176,211
6927,99,4,15,0,13,0,0,0,32,19,6,0,103,0,0,0,128,160
6927,100,7,22,0,20,0,0,0,49,19,19,1,139,0,0,0,178,227
6927,999,135111,138675,7605,8018,88,2,2,289501,119957,139364,10303,38889,53,3,1,308570,598071
6988,0,1483,0,0,0,0,0,0,1483,1463,0,0,0,0,0,0,1463,2946
6988,1,1587,0,0,0,0,0,0,1587,1508,0,0,0,0,0,0,1508,3095
6988,2,1570,0,0,0,0,0,0,1570,1442,0,0,0,0,0,0,1442,3012
6988,3,1525,0,0,0,0,0,0,1525,1532,0,0,0,0,0,0,1532,3057
6988,4,1620,0,0,0,0,0,0,1620,1532,0,0,0,0,0,0,1532,3152
6988,5,1735,0,0,0,0,0,0,1735,1557,0,0,0,0,0,0,1557,3292
6988,6,1649,0,0,0,0,0,0,1649,1693,0,0,0,0,0,0,1693,3342
6988,7,1704,0,0,0,0,0,0,1704,1599,0,0,0,0,0,0,1599,3303
6988,8,1771,0,0,0,0,0,0,1771,1593,0,0,0,0,0,0,1593,3364
6988,9,1821,0,0,0,0,0,0,1821,1727,0,0,0,0,0,0,1727,3548
6988,10,1813,0,0,0,0,0,0,1813,1643,0,0,0,0,0,0,1643,3456
6988,11,1919,0,0,0,0,0,0,1919,1819,0,0,0,0,0,0,1819,3738
6988,12,1911,0,0,0,0,0,0,1911,1914,0,0,0,0,0,0,1914,3825
6988,13,2075,0,0,0,0,0,0,2075,1882,0,0,0,0,0,0,1882,3957
6988,14,2057,0,0,0,0,0,0,2057,1970,0,0,0,0,0,0,1970,4027
6988,15,2184,0,0,0,0,0,0,2184,1949,0,0,0,0,0,0,1949,4133
6988,16,2233,0,0,0,0,0,0,2233,2043,0,0,0,0,0,0,2043,4276
6988,17,2331,0,0,0,0,0,0,2331,2085,0,0,0,0,0,0,2085,4416
6988,18,2475,0,0,0,0,0,0,2475,2176,3,0,0,0,0,0,2179,4654
6988,19,2480,0,0,0,0,0,0,2480,2184,13,0,0,0,0,0,2197,4677
6988,20,2290,5,0,0,0,0,0,2295,2151,29,0,0,0,0,0,2180,4475
6988,21,2299,13,0,0,0,0,0,2312,2147,53,0,0,0,0,0,2200,4512
6988,22,2377,21,0,0,1,0,0,2399,2155,63,0,0,0,0,0,2218,4617
6988,23,2497,27,0,0,0,0,0,2524,2136,108,2,0,0,0,0,2246,4770
6988,24,2357,45,2,0,0,0,0,2404,2131,188,0,0,0,0,0,2319,4723
6988,25,2361,79,1,0,0,0,0,2441,2025,239,1,0,0,0,0,2265,4706
6988,26,2227,122,1,0,0,0,0,2350,1769,332,0,0,1,0,0,2102,4452
6988,27,2190,182,1,0,0,0,0,2373,1668,454,3,0,0,0,0,2125,4498
6988,28,2005,252,3,0,2,0,0,2262,1495,598,5,1,1,0,0,2100,4362
6988,29,1928,327,0,0,0,0,0,2255,1387,712,5,2,0,0,0,2106,4361
6988,30,1844,466,4,0,1,0,0,2315,1211,882,13,1,0,0,0,2107,4422
6988,31,1682,638,3,0,2,0,0,2325,1128,1128,28,2,1,0,0,2287,4612
6988,32,1561,698,7,0,0,0,0,2266,1000,1193,16,3,0,0,0,2212,4478
6988,33,1461,932,7,0,0,0,0,2400,972,1338,33,1,2,0,0,2346,4746
6988,34,1347,964,10,0,2,0,0,2323,800,1443,18,4,1,0,0,2266,4589
6988,35,1292,1180,17,2,0,0,0,2491,724,1552,38,7,0,0,0,2321,4812
6988,36,1095,1168,14,0,0,0,0,2277,637,1531,37,1,0,0,0,2206,4483
6988,37,1065,1267,23,1,0,0,0,2356,623,1605,53,11,0,0,0,2292,4648
6988,38,997,1305,26,2,0,0,0,2330,571,1705,49,8,1,0,0,2334,4664
6988,39,887,1456,33,3,0,0,0,2379,536,1733,63,9,1,0,0,2342,4721
6988,40,794,1502,37,4,0,0,0,2337,449,1806,70,18,1,0,0,2344,4681
6988,41,781,1497,34,1,2,0,0,2315,436,1860,55,18,0,0,0,2369,4684
6988,42,795,1719,46,2,2,0,0,2564,418,1974,75,25,4,0,0,2496,5060
6988,43,751,1813,59,4,1,0,0,2628,424,2002,100,30,0,0,0,2556,5184
6988,44,761,1841,58,7,2,0,0,2669,363,2045,113,23,0,0,0,2544,5213
6988,45,688,1861,63,6,1,0,0,2619,351,2153,105,35,1,0,0,2645,5264
6988,46,668,1965,76,15,3,0,0,2727,374,2246,120,33,1,0,0,2774,5501
6988,47,681,2141,91,5,1,0,0,2919,404,2219,137,59,0,0,0,2819,5738
6988,48,697,2113,82,15,1,0,0,2908,387,2480,121,63,0,0,0,3051,5959
6988,49,639,2156,98,10,3,0,0,2906,428,2517,153,66,0,0,0,3164,6070
6988,50,567,2185,85,15,2,0,0,2854,423,2488,135,85,1,0,0,3132,5986
6988,51,627,2241,110,14,2,0,0,2994,377,2417,140,83,0,0,0,3017,6011
6988,52,557,2356,127,18,2,0,0,3060,369,2645,141,108,2,0,0,3265,6325
6988,53,542,2324,119,33,3,0,0,3021,396,2671,160,97,1,1,0,3326,6347
6988,54,530,2610,119,25,1,0,0,3285,415,2665,150,134,0,0,0,3364,6649
6988,55,516,2483,130,28,1,0,0,3158,392,2684,136,172,0,0,0,3384,6542
6988,56,479,2561,120,43,1,0,0,3204,397,2828,131,174,0,0,0,3530,6734
6988,57,441,2481,120,27,3,0,0,3072,408,2633,130,190,1,0,0,3362,6434
6988,58,397,2549,118,32,0,0,0,3096,388,2615,141,243,0,0,0,3387,6483
6988,59,397,2707,127,46,1,0,0,3278,376,2668,125,261,0,0,0,3430,6708
6988,60,327,2429,92,60,1,0,1,2910,325,2432,106,235,0,0,0,3098,6008
6988,61,312,2322,102,61,1,0,0,2798,324,2332,109,289,0,0,0,3054,5852
6988,62,315,2338,109,66,0,0,0,2828,290,2319,83,303,0,0,0,2995,5823
6988,63,259,2405,106,64,1,0,0,2835,342,2384,100,384,0,0,0,3210,6045
6988,64,254,2256,86,61,2,0,0,2659,292,2178,91,403,0,0,0,2964,5623
6988,65,251,2134,81,66,0,0,0,2532,281,2061,69,395,0,0,0,2806,5338
6988,66,231,2263,85,69,2,0,0,2650,245,2054,71,476,0,0,0,2846,5496
6988,67,197,2130,65,72,2,0,0,2466,239,2033,71,458,0,0,0,2801,5267
6988,68,188,2059,56,89,0,0,0,2392,268,1914,63,567,0,0,0,2812,5204
6988,69,164,2142,53,97,1,0,0,2457,238,1778,68,602,0,0,0,2686,5143
6988,70,145,1809,59,105,1,0,0,2119,188,1608,60,604,0,0,0,2460,4579
6988,71,144,1869,51,86,0,0,0,2150,167,1538,56,661,0,0,0,2422,4572
6988,72,114,1788,49,113,0,0,0,2064,202,1501,64,685,0,0,0,2452,4516
6988,73,110,1761,44,140,0,0,0,2055,193,1439,39,782,0,0,0,2453,4508
6988,74,120,1942,43,129,1,0,0,2235,183,1427,41,898,0,0,0,2549,4784
6988,75,112,1819,38,141,0,0,0,2110,197,1317,36,911,0,0,0,2461,4571
6988,76,107,1795,29,167,0,0,0,2098,172,1233,46,1111,0,0,0,2562,4660
6988,77,104,1521,23,174,1,0,0,1823,137,979,27,1057,0,0,0,2200,4023
6988,78,52,1330,14,159,0,0,0,1555,119,786,24,943,0,0,0,1872,3427
6988,79,63,1210,24,131,0,0,0,1428,131,703,22,939,0,0,0,1795,3223
6988,80,57,1033,10,154,0,0,0,1254,124,586,25,878,0,0,0,1613,2867
6988,81,53,944,8,138,1,0,0,1144,110,496,15,914,0,0,0,1535,2679
6988,82,45,892,13,143,0,0,0,1093,141,474,16,954,0,0,0,1585,2678
6988,83,54,1029,14,197,0,0,0,1294,136,430,16,1176,0,0,0,1758,3052
6988,84,36,938,8,193,0,0,0,1175,120,386,13,1173,0,0,0,1692,2867
6988,85,27,799,8,211,0,0,0,1045,113,319,8,1113,0,0,0,1553,2598
6988,86,31,671,9,187,0,0,0,898,107,230,7,1034,0,0,0,1378,2276
6988,87,27,518,3,161,0,0,0,709,85,139,8,915,0,0,0,1147,1856
6988,88,15,433,5,186,0,0,0,639,82,109,4,822,0,0,0,1017,1656
6988,89,12,368,3,206,0,0,0,589,72,87,6,733,0,0,0,898,1487
6988,90,11,284,2,134,0,0,0,431,50,69,4,653,0,0,0,776,1207
6988,91,6,203,1,129,0,0,0,339,58,52,5,550,0,0,0,665,1004
6988,92,7,165,1,137,0,0,0,310,64,22,2,452,0,0,0,540,850
6988,93,7,123,1,100,0,0,0,231,47,21,5,411,0,0,0,484,715
6988,94,2,77,0,61,0,0,0,140,40,10,0,242,0,0,0,292,432
6988,95,1,57,0,46,0,0,0,104,24,7,2,231,0,0,0,264,368
6988,96,3,38,0,39,0,0,0,80,10,2,0,163,0,0,0,175,255
6988,97,1,16,0,32,0,0,0,49,9,2,0,120,0,0,0,131,180
6988,98,0,10,0,15,0,0,0,25,11,4,0,75,0,0,0,90,115
6988,99,0,8,0,20,0,0,0,28,6,0,1,61,0,0,0,68,96
6988,100,1,8,1,23,0,0,0,33,7,3,0,71,0,0,0,81,114
6988,999,89978,102188,3267,4920,54,0,1,200408,76501,101982,4185,27411,20,1,0,210100,410508
7034,0,901,0,0,0,0,0,0,901,837,0,0,0,0,0,0,837,1738
7034,1,928,0,0,0,0,0,0,928,835,0,0,0,0,0,0,835,1763
7034,2,944,0,0,0,0,0,0,944,883,0,0,0,0,0,0,883,1827
7034,3,950,0,0,0,0,0,0,950,878,0,0,0,0,0,0,878,1828
7034,4,944,0,0,0,0,0,0,944,868,0,0,0,0,0,0,868,1812
7034,5,998,0,0,0,0,0,0,998,995,0,0,0,0,0,0,995,1993
7034,6,1027,0,0,0,0,0,0,1027,950,0,0,0,0,0,0,950,1977
7034,7,1064,0,0,0,0,0,0,1064,1042,0,0,0,0,0,0,1042,2106
7034,8,1125,0,0,0,0,0,0,1125,1035,0,0,0,0,0,0,1035,2160
7034,9,1090,0,0,0,0,0,0,1090,1110,0,0,0,0,0,0,1110,2200
7034,10,1106,0,0,0,0,0,0,1106,1043,0,0,0,0,0,0,1043,2149
7034,11,1219,0,0,0,0,0,0,1219,1185,0,0,0,0,0,0,1185,2404
7034,12,1179,0,0,0,0,0,0,1179,1104,0,0,0,0,0,0,1104,2283
7034,13,1275,0,0,0,0,0,0,1275,1183,0,0,0,0,0,0,1183,2458
7034,14,1299,0,0,0,0,0,0,1299,1238,0,0,0,0,0,0,1238,2537
7034,15,1349,0,0,0,0,0,0,1349,1241,0,0,0,0,0,0,1241,2590
7034,16,1364,0,0,0,0,0,0,1364,1219,0,0,0,0,0,0,1219,2583
7034,17,1535,0,0,0,0,0,0,1535,1296,0,0,0,0,0,0,1296,2831
7034,18,1521,0,0,0,0,0,0,1521,1381,3,0,0,0,0,0,1384,2905
7034,19,1525,2,0,0,0,0,0,1527,1425,18,0,0,0,0,0,1443,2970
7034,20,1437,2,0,0,0,0,0,1439,1344,14,0,0,0,0,0,1358,2797
7034,21,1463,5,0,0,0,0,0,1468,1309,33,0,1,0,0,0,1343,2811
7034,22,1472,18,0,0,0,0,0,1490,1350,44,0,0,1,0,0,1395,2885
7034,23,1428,21,0,0,0,0,0,1449,1278,75,0,0,0,0,0,1353,2802
7034,24,1442,38,0,0,1,0,0,1481,1325,126,0,0,0,0,0,1451,2932
7034,25,1463,50,0,0,0,0,0,1513,1159,159,4,0,0,0,0,1322,2835
7034,26,1328,79,0,0,0,0,0,1407,1129,193,1,0,0,0,0,1323,2730
7034,27,1231,121,0,0,0,0,0,1352,977,296,6,0,1,0,0,1280,2632
7034,28,1226,171,1,0,0,0,0,1398,974,355,4,1,0,0,0,1334,2732
7034,29,1157,248,3,0,0,0,0,1408,842,443,6,1,0,0,0,1292,2700
7034,30,1099,313,3,1,0,0,0,1416,845,541,15,1,0,0,0,1402,2818
7034,31,1009,407,9,0,0,0,0,1425,757,611,16,0,0,0,0,1384,2809
7034,32,975,504,9,0,0,0,0,1488,661,746,24,3,1,0,0,1435,2923
7034,33,854,518,14,0,0,0,0,1386,567,839,24,2,1,0,0,1433,2819
7034,34,852,630,10,0,0,0,0,1492,455,827,30,4,0,0,0,1316,2808
7034,35,713,699,19,2,0,1,0,1434,462,889,24,4,0,0,0,1379,2813
7034,36,656,692,18,0,0,0,0,1366,423,928,26,4,0,0,0,1381,2747
7034,37,588,730,29,0,0,0,0,1347,382,942,37,3,1,0,0,1365,2712
7034,38,562,845,23,0,0,0,0,1430,340,995,52,4,2,0,0,1393,2823
7034,39,501,822,24,1,0,0,0,1348,344,994,55,11,0,0,0,1404,2752
7034,40,486,916,34,2,1,0,0,1439,297,1098,64,13,0,0,0,1472,2911
7034,41,433,910,49,2,1,0,0,1395,264,1070,60,9,0,0,0,1403,2798
7034,42,412,975,40,5,0,0,0,1432,273,1153,68,17,0,0,0,1511,2943
7034,43,445,1011,47,1,0,0,0,1504,258,1184,78,19,0,0,0,1539,3043
7034,44,441,1024,60,4,2,0,0,1531,263,1249,82,18,0,0,0,1612,3143
7034,45,432,1070,67,2,0,0,0,1571,216,1265,81,19,1,0,0,1582,3153
7034,46,425,1163,62,5,1,0,0,1656,222,1210,93,23,1,0,0,1549,3205
7034,47,391,1189,80,8,0,0,0,1668,227,1330,114,23,0,1,0,1695,3363
7034,48,365,1262,86,8,1,1,0,1723,239,1388,95,34,0,0,0,1756,3479
7034,49,332,1323,78,8,0,0,0,1741,216,1444,117,49,1,0,0,1827,3568
7034,50,334,1313,89,14,0,0,0,1750,233,1458,135,67,1,1,0,1895,3645
7034,51,348,1337,93,16,1,0,0,1795,214,1533,108,63,0,0,0,1918,3713
7034,52,326,1364,88,22,0,0,0,1800,224,1526,107,65,0,1,0,1923,3723
7034,53,273,1405,82,12,0,0,0,1772,252,1552,116,78,0,0,0,1998,3770
7034,54,307,1423,97,11,1,0,0,1839,219,1610,117,77,0,0,0,2023,3862
7034,55,275,1440,103,25,1,0,0,1844,214,1556,127,93,0,0,0,1990,3834
7034,56,234,1568,98,20,2,0,0,1922,208,1626,106,95,0,0,0,2035,3957
7034,57,243,1519,109,25,1,0,0,1897,208,1584,115,130,0,0,0,2037,3934
7034,58,234,1533,97,23,0,0,0,1887,247,1614,105,136,0,0,0,2102,3989
7034,59,202,1568,94,28,2,0,0,1894,220,1676,118,175,1,0,0,2190,4084
7034,60,192,1572,72,31,0,0,0,1867,233,1452,87,159,1,0,0,1932,3799
7034,61,150,1466,84,27,0,0,0,1727,205,1520,98,199,0,0,0,2022,3749
7034,62,150,1401,62,39,0,0,0,1652,197,1420,77,204,0,0,0,1898,3550
7034,63,160,1559,72,40,0,0,0,1831,199,1416,71,255,0,0,0,1941,3772
7034,64,110,1383,64,46,0,0,0,1603,168,1371,80,238,0,0,0,1857,3460
7034,65,126,1321,54,51,0,0,0,1552,170,1266,63,289,0,0,0,1788,3340
7034,66,111,1270,53,39,0,0,0,1473,161,1212,67,289,0,0,0,1729,3202
7034,67,89,1218,48,46,0,0,0,1401,130,1188,57,322,0,0,0,1697,3098
7034,68,82,1330,46,77,0,0,0,1535,124,1135,56,333,0,0,0,1648,3183
7034,69,80,1246,43,62,0,0,0,1431,123,1101,63,381,0,0,0,1668,3099
7034,70,64,1056,43,55,0,0,0,1218,125,937,40,362,0,0,0,1464,2682
7034,71,63,1034,33,55,0,0,0,1185,113,918,31,415,0,0,0,1477,2662
7034,72,67,1088,31,62,0,0,0,1248,119,851,38,424,0,0,0,1432,2680
7034,73,63,1045,25,70,0,0,0,1203,125,828,42,460,0,0,0,1455,2658
7034,74,60,1110,22,105,1,0,0,1298,113,816,37,585,0,0,0,1551,2849
7034,75,41,1080,21,92,1,0,0,1235,113,799,43,601,0,0,0,1556,2791
7034,76,51,1030,21,91,0,0,0,1193,110,694,19,650,0,0,0,1473,2666
7034,77,40,905,22,104,0,0,0,1071,90,548,16,598,0,0,0,1252,2323
7034,78,47,729,10,90,0,0,0,876,94,482,6,610,0,0,0,1192,2068
7034,79,35,669,14,87,1,0,0,806,81,380,16,566,0,0,0,1043,1849
7034,80,32,636,5,84,0,0,0,757,74,319,6,595,0,0,0,994,1751
7034,81,25,580,4,88,0,0,0,697,64,265,9,556,0,0,0,894,1591
7034,82,28,503,7,92,0,0,0,630,80,265,11,579,0,0,0,935,1565
7034,83,25,565,7,111,0,0,0,708,83,242,8,682,0,0,0,1015,1723
7034,84,18,451,8,127,0,0,0,604,67,198,10,654,0,0,0,929,1533
7034,85,12,466,6,108,0,0,0,592,61,155,11,722,0,0,0,949,1541
7034,86,15,323,3,126,0,0,0,467,58,101,4,512,0,0,0,675,1142
7034,87,5,294,3,125,0,0,0,427,60,78,5,551,0,0,0,694,1121
7034,88,7,214,6,101,0,0,0,328,53,60,2,467,0,0,0,582,910
7034,89,10,196,2,95,0,0,0,303,40,53,4,391,0,0,0,488,791
7034,90,12,151,3,105,0,0,0,271,39,35,4,402,0,0,0,480,751
7034,91,7,95,1,71,0,0,0,174,47,21,3,304,0,0,0,375,549
7034,92,1,71,1,52,0,0,0,125,34,17,0,247,0,0,0,298,423
7034,93,3,66,0,46,0,0,0,115,17,6,2,225,0,0,0,250,365
7034,94,4,39,1,34,0,0,0,78,11,6,1,131,0,0,0,149,227
7034,95,0,22,0,21,0,0,0,43,9,2,3,116,0,0,0,130,173
7034,96,2,9,0,23,0,0,0,34,7,4,0,75,0,0,0,86,120
7034,97,1,9,0,15,0,0,0,25,14,1,0,42,0,0,0,57,82
7034,98,2,8,0,12,0,0,0,22,4,2,1,36,0,0,0,43,65
7034,99,0,5,0,10,0,0,0,15,5,1,0,23,0,0,0,29,44
7034,100,0,6,0,9,0,0,0,15,5,1,0,39,0,0,0,45,60
7034,999,53727,60449,2612,2969,18,2,0,119777,47010,60363,3421,16531,13,3,0,127341,247118
7061,0,530,0,0,0,0,0,0,530,488,0,0,0,0,0,0,488,1018
7061,1,510,0,0,0,0,0,0,510,496,0,0,0,0,0,0,496,1006
7061,2,530,0,0,0,0,0,0,530,514,0,0,0,0,0,0,514,1044
7061,3,531,0,0,0,0,0,0,531,507,0,0,0,0,0,0,507,1038
7061,4,548,0,0,0,0,0,0,548,534,0,0,0,0,0,0,534,1082
7061,5,572,0,0,0,0,0,0,572,574,0,0,0,0,0,0,574,1146
7061,6,639,0,0,0,0,0,0,639,555,0,0,0,0,0,0,555,1194
7061,7,569,0,0,0,0,0,0,569,605,0,0,0,0,0,0,605,1174
7061,8,624,0,0,0,0,0,0,624,607,0,0,0,0,0,0,607,1231
7061,9,592,0,0,0,0,0,0,592,592,0,0,0,0,0,0,592,1184
7061,10,596,0,0,0,0,0,0,596,613,0,0,0,0,0,0,613,1209
7061,11,659,0,0,0,0,0,0,659,590,0,0,0,0,0,0,590,1249
7061,12,711,0,0,0,0,0,0,711,658,0,0,0,0,0,0,658,1369
7061,13,688,0,0,0,0,0,0,688,713,0,0,0,0,0,0,713,1401
7061,14,799,0,0,0,0,0,0,799,692,0,0,0,0,0,0,692,1491
7061,15,761,0,0,0,0,0,0,761,727,0,0,0,0,0,0,727,1488
7061,16,774,0,0,0,0,0,0,774,738,0,0,0,0,0,0,738,1512
7061,17,862,1,0,0,0,0,0,863,727,0,0,0,0,0,0,727,1590
7061,18,853,0,0,0,0,0,0,853,788,3,0,0,0,0,0,791,1644
7061,19,848,0,0,0,0,0,0,848,769,1,0,0,0,0,0,770,1618
7061,20,898,1,0,0,0,0,0,899,765,6,0,0,0,0,0,771,1670
7061,21,828,5,0,0,0,0,0,833,842,10,0,0,0,0,0,852,1685
7061,22,865,1,0,0,0,0,0,866,868,13,1,0,1,0,0,883,1749
7061,23,891,11,0,0,0,0,0,902,841,25,0,0,0,0,0,866,1768
7061,24,947,10,0,0,0,0,0,957,817,50,0,0,0,0,0,867,1824
7061,25,881,18,1,0,0,0,0,900,764,69,0,0,0,0,0,833,1733
7061,26,848,30,0,0,0,0,0,878,696,76,1,0,0,0,0,773,1651
7061,27,817,38,0,0,0,0,0,855,688,110,1,0,1,0,0,800,1655
7061,28,805,65,2,0,0,0,0,872,679,169,2,0,0,0,0,850,1722
7061,29,779,85,0,0,0,0,0,864,601,225,3,0,0,0,0,829,1693
7061,30,798,145,5,0,0,0,0,948,514,289,5,0,0,0,0,808,1756
7061,31,703,161,3,0,0,0,0,867,551,268,5,1,0,0,0,825,1692
7061,32,660,206,3,0,0,0,0,869,450,399,6,0,0,0,0,855,1724
7061,33,597,250,2,0,1,0,0,850,436,427,6,0,0,0,0,869,1719
7061,34,554,331,1,1,0,0,0,887,392,415,17,1,0,0,0,825,1712
7061,35,510,364,8,0,0,0,0,882,326,494,22,3,0,0,0,845,1727
7061,36,460,356,11,0,0,0,0,827,314,508,24,3,1,0,0,850,1677
7061,37,443,423,10,1,0,0,0,877,310,518,14,5,0,0,0,847,1724
7061,38,420,439,9,1,0,0,0,869,259,587,24,2,0,0,0,872,1741
7061,39,418,481,10,0,0,0,0,909,232,607,35,7,0,0,0,881,1790
7061,40,358,486,13,1,1,0,0,859,212,579,28,5,0,0,0,824,1683
7061,41,351,518,25,0,1,0,0,895,212,629,29,7,0,0,0,877,1772
7061,42,338,575,20,2,0,0,0,935,192,634,39,7,0,0,0,872,1807
7061,43,333,580,31,2,0,0,0,946,195,665,44,7,0,0,0,911,1857
7061,44,295,605,17,4,1,0,0,922,162,693,46,10,1,0,0,912,1834
7061,45,276,577,33,0,0,0,0,886,167,712,63,17,0,0,0,959,1845
7061,46,244,636,36,4,0,0,0,920,184,807,56,12,0,0,0,1059,1979
7061,47,281,674,34,2,0,0,0,991,191,814,52,18,0,0,0,1075,2066
7061,48,264,744,38,4,0,0,0,1050,163,875,61,23,0,0,0,1122,2172
7061,49,254,792,46,4,1,0,0,1097,160,842,64,25,0,0,0,1091,2188
7061,50,255,760,50,13,0,0,0,1078,148,858,61,35,0,0,0,1102,2180
7061,51,229,797,67,5,0,0,0,1098,197,918,48,37,0,0,0,1200,2298
7061,52,227,837,55,11,0,0,0,1130,143,946,66,32,0,0,0,1187,2317
7061,53,208,845,51,5,0,0,0,1109,155,972,55,44,0,0,0,1226,2335
7061,54,177,927,61,13,0,0,0,1178,141,1012,62,51,0,0,0,1266,2444
7061,55,185,960,46,13,0,0,0,1204,135,1047,75,59,0,0,0,1316,2520
7061,56,186,954,54,14,0,0,0,1208,122,980,72,66,0,0,0,1240,2448
7061,57,177,1013,53,10,0,0,0,1253,159,967,56,45,0,0,0,1227,2480
7061,58,155,948,74,17,0,0,0,1194,140,943,54,73,0,0,0,1210,2404
7061,59,154,991,46,23,0,0,0,1214,160,1004,46,103,0,0,0,1313,2527
7061,60,121,918,42,20,0,1,0,1102,155,953,51,96,0,0,0,1255,2357
7061,61,127,959,49,27,0,0,0,1162,123,902,49,117,0,0,0,1191,2353
7061,62,113,895,43,15,0,0,0,1066,122,922,57,127,0,0,0,1228,2294
7061,63,107,927,42,23,0,0,0,1099,149,930,37,145,0,0,0,1261,2360
7061,64,92,927,29,22,1,0,0,1071,106,865,35,139,0,0,0,1145,2216
7061,65,75,838,30,25,0,0,0,968,109,832,41,159,0,0,0,1141,2109
7061,66,90,790,26,29,0,0,0,935,128,812,35,179,0,0,0,1154,2089
7061,67,64,835,31,32,0,0,0,962,108,739,44,184,0,0,0,1075,2037
7061,68,66,825,29,52,0,0,0,972,110,757,35,188,0,0,0,1090,2062
7061,69,74,796,23,34,0,0,0,927,115,772,27,205,0,0,0,1119,2046
7061,70,75,765,25,29,0,0,0,894,119,629,38,223,0,0,0,1009,1903
7061,71,58,719,26,45,0,1,0,849,106,645,23,252,0,0,0,1026,1875
7061,72,42,735,17,44,0,0,0,838,86,617,16,264,0,0,0,983,1821
7061,73,48,717,21,49,0,0,0,835,105,608,25,296,0,0,0,1034,1869
7061,74,50,737,24,67,0,0,0,878,97,596,20,351,0,0,0,1064,1942
7061,75,40,722,15,77,0,0,0,854,83,509,15,390,0,0,0,997,1851
7061,76,44,647,13,67,0,0,0,771,82,491,15,345,0,0,0,933,1704
7061,77,35,547,6,70,0,0,0,658,60,367,15,328,0,0,0,770,1428
7061,78,22,448,8,58,0,0,0,536,60,332,5,344,0,0,0,741,1277
7061,79,38,413,10,53,0,0,0,514,43,249,6,340,0,0,0,638,1152
7061,80,19,364,8,59,0,0,0,450,50,225,9,331,0,0,0,615,1065
7061,81,22,337,7,72,0,0,0,438,30,186,12,320,0,0,0,548,986
7061,82,25,322,7,58,0,0,0,412,39,210,6,357,0,0,0,612,1024
7061,83,18,391,3,67,0,0,0,479,56,197,10,453,0,0,0,716,1195
7061,84,12,375,2,73,0,0,0,462,51,177,8,474,0,0,0,710,1172
7061,85,18,327,5,92,0,0,0,442,50,145,4,427,0,0,0,626,1068
7061,86,13,244,6,93,0,0,0,356,38,81,3,370,0,0,0,492,848
7061,87,11,238,1,86,0,0,0,336,40,63,4,330,0,0,0,437,773
7061,88,5,158,3,73,0,0,0,239,33,57,1,301,0,0,0,392,631
7061,89,12,148,2,83,0,0,0,245,35,28,4,327,0,0,0,394,639
7061,90,11,109,0,53,0,0,0,173,22,38,1,251,0,0,0,312,485
7061,91,7,89,0,55,0,0,0,151,18,18,1,221,0,0,0,258,409
7061,92,1,46,0,44,0,0,0,91,20,15,1,210,0,0,0,246,337
7061,93,2,40,1,41,0,0,0,84,11,3,1,173,0,0,0,188,272
7061,94,2,32,0,39,0,0,0,73,9,8,1,118,0,0,0,136,209
7061,95,4,18,1,18,0,0,0,41,11,2,2,80,0,0,0,95,136
7061,96,0,8,0,22,0,0,0,30,8,1,1,62,0,0,0,72,102
7061,97,0,8,0,14,0,0,0,22,2,1,0,43,0,0,0,46,68
7061,98,1,2,0,10,0,0,0,13,5,0,1,33,0,0,0,39,52
7061,99,0,2,0,6,0,0,0,8,1,3,0,20,0,0,0,24,32
7061,100,1,3,0,12,0,0,0,16,7,0,0,29,0,0,0,36,52
7061,999,33830,37061,1470,2058,6,2,0,74427,29772,37151,1902,10300,4,0,0,79129,153556
7087,0,4364,0,0,0,0,0,0,4364,4068,0,0,0,0,0,0,4068,8432
7087,1,4608,0,0,0,0,0,0,4608,4292,0,0,0,0,0,0,4292,8900
7087,2,4619,0,0,0,0,0,0,4619,4405,0,0,0,0,0,0,4405,9024
7087,3,4711,0,0,0,0,0,0,4711,4413,0,0,0,0,0,0,4413,9124
7087,4,4848,0,0,0,0,0,0,4848,4545,0,0,0,0,0,0,4545,9393
7087,5,4969,0,0,0,0,0,0,4969,4868,0,0,0,0,0,0,4868,9837
7087,6,5157,0,0,0,0,0,0,5157,4733,0,0,0,0,0,0,4733,9890
7087,7,5104,0,0,0,0,0,0,5104,5003,0,0,0,0,0,0,5003,10107
7087,8,5418,0,0,0,0,0,0,5418,5071,0,0,0,0,0,0,5071,10489
7087,9,5475,0,0,0,0,0,0,5475,5077,0,0,0,0,0,0,5077,10552
7087,10,5327,0,0,0,0,0,0,5327,5018,0,0,0,0,0,0,5018,10345
7087,11,5420,0,0,0,0,0,0,5420,5235,0,0,0,0,0,0,5235,10655
7087,12,5467,0,0,0,0,0,0,5467,5361,0,0,0,0,0,0,5361,10828
7087,13,5619,0,0,0,0,0,0,5619,5347,0,0,0,0,0,0,5347,10966
7087,14,5751,0,0,0,0,0,0,5751,5353,0,0,0,0,0,0,5353,11104
7087,15,5938,0,0,0,0,0,0,5938,5535,0,0,0,0,0,0,5535,11473
7087,16,5745,0,0,0,0,0,0,5745,5529,0,0,0,0,0,0,5529,11274
7087,17,6053,0,0,0,0,0,0,6053,5422,0,0,0,0,0,0,5422,11475
7087,18,6152,1,0,1,0,0,0,6154,5630,4,0,0,0,0,0,5634,11788
7087,19,6267,3,0,0,0,0,0,6270,5634,15,0,1,0,0,0,5650,11920
7087,20,5985,8,0,0,0,0,0,5993,5572,35,0,2,0,0,0,5609,11602
7087,21,5854,17,0,0,0,0,0,5871,5458,77,0,1,1,0,0,5537,11408
7087,22,5791,26,0,0,0,0,0,5817,5365,118,3,1,0,0,0,5487,11304
7087,23,5952,61,0,0,1,0,0,6014,5280,237,2,0,2,0,0,5521,11535
7087,24,5809,102,1,0,2,0,0,5914,5253,332,5,0,3,0,0,5593,11507
7087,25,5693,156,3,0,0,0,0,5852,5049,489,3,1,4,0,0,5546,11398
7087,26,5565,270,1,2,2,0,0,5840,4826,678,8,1,0,0,0,5513,11353
7087,27,5421,432,1,0,0,0,0,5854,4626,924,10,2,1,0,0,5563,11417
7087,28,5098,609,6,0,1,0,0,5714,4350,1274,11,1,3,0,0,5639,11353
7087,29,5080,832,8,0,2,0,0,5922,4310,1562,22,2,2,0,0,5898,11820
7087,30,4903,1095,11,0,3,0,0,6012,4047,2004,35,4,8,0,0,6098,12110
7087,31,5009,1472,11,1,1,0,0,6494,3826,2350,33,5,6,0,0,6220,12714
7087,32,4519,1864,21,1,5,1,0,6411,3529,2852,57,7,3,0,0,6448,12859
7087,33,4339,2179,28,1,7,0,0,6554,3295,3062,79,20,4,0,0,6460,13014
7087,34,3919,2427,41,5,3,0,0,6395,3118,3359,91,18,4,0,0,6590,12985
7087,35,3783,2684,67,1,4,0,1,6540,2693,3760,96,17,6,1,0,6573,13113
7087,36,3401,2997,73,2,3,0,0,6476,2575,3884,110,17,2,0,0,6588,13064
7087,37,3173,3307,74,2,3,0,0,6559,2267,3974,141,21,6,0,0,6409,12968
7087,38,2985,3480,89,8,5,0,0,6567,2150,4362,176,25,10,1,0,6724,13291
7087,39,2850,3796,115,8,8,0,0,6777,2115,4535,211,42,3,0,0,6906,13683
7087,40,2656,3859,134,10,5,0,0,6664,1857,4486,188,38,2,1,0,6572,13236
7087,41,2622,4130,156,8,8,0,0,6924,1798,4814,225,50,6,0,0,6893,13817
7087,42,2429,4174,158,19,8,1,0,6789,1706,4955,274,52,7,0,0,6994,13783
7087,43,2312,4425,177,13,9,1,0,6937,1620,5109,269,72,8,1,0,7079,14016
7087,44,2209,4585,178,24,7,0,0,7003,1550,5322,324,83,2,0,0,7281,14284
7087,45,2280,4851,215,27,5,0,0,7378,1558,5551,372,102,7,0,0,7590,14968
7087,46,2053,5018,256,29,8,0,0,7364,1554,5519,349,109,2,0,0,7533,14897
7087,47,2134,5164,269,38,5,0,0,7610,1491,6008,400,124,3,0,0,8026,15636
7087,48,1936,5426,271,42,13,2,0,7690,1345,6128,448,142,4,0,0,8067,15757
7087,49,2011,5679,323,44,3,0,0,8060,1423,6239,464,168,5,1,0,8300,16360
7087,50,1832,5477,339,46,10,0,1,7705,1235,6275,476,194,2,1,0,8183,15888
7087,51,1717,5873,339,46,6,0,0,7981,1232,6172,484,212,8,0,0,8108,16089
7087,52,1622,5917,334,50,7,0,0,7930,1226,6486,506,207,6,0,0,8431,16361
7087,53,1429,5837,364,53,5,0,0,7688,1185,6360,559,266,4,0,0,8374,16062
7087,54,1384,6070,344,69,8,0,0,7875,1098,6497,561,337,0,2,0,8495,16370
7087,55,1295,6150,386,78,4,0,0,7913,1046,6433,504,372,3,0,0,8358,16271
7087,56,1240,6225,370,103,6,0,0,7944,1011,6571,529,419,3,0,0,8533,16477
7087,57,1173,6181,395,103,4,0,0,7856,1000,6486,504,451,2,0,0,8443,16299
7087,58,1058,6088,417,110,6,0,0,7679,955,6382,528,465,1,1,0,8332,16011
7087,59,1010,6341,414,107,7,0,0,7879,962,6451,522,587,2,0,0,8524,16403
7087,60,915,6028,358,158,4,0,1,7464,804,6126,476,585,0,0,0,7991,15455
7087,61,769,6141,401,137,5,0,0,7453,840,6063,466,681,1,0,0,8051,15504
7087,62,758,5942,351,189,2,0,0,7242,792,6050,448,732,0,0,0,8022,15264
7087,63,688,5898,340,163,1,0,0,7090,742,5976,409,873,0,0,0,8000,15090
7087,64,656,5626,297,207,4,0,0,6790,700,5493,403,886,0,0,0,7482,14272
7087,65,569,5489,281,184,3,0,0,6526,635,5299,375,954,0,0,0,7263,13789
7087,66,509,5483,257,215,3,1,0,6468,649,5188,367,1060,0,0,1,7265,13733
7087,67,485,5274,231,226,2,0,0,6218,564,5007,321,1213,0,0,0,7105,13323
7087,68,441,5301,238,260,3,0,0,6243,555,4812,305,1273,0,1,0,6946,13189
7087,69,409,5061,223,293,3,0,0,5989,572,4687,332,1372,0,0,0,6963,12952
7087,70,362,4857,195,265,2,0,0,5681,480,4187,313,1413,0,0,0,6393,12074
7087,71,350,4544,173,308,1,0,0,5376,511,3862,263,1492,1,0,0,6129,11505
7087,72,316,4444,153,305,1,0,0,5219,500,3655,205,1532,0,0,0,5892,11111
7087,73,288,4463,147,355,3,0,0,5256,516,3589,278,1728,0,0,0,6111,11367
7087,74,262,4234,147,352,0,0,0,4995,426,3307,210,1837,1,0,0,5781,10776
7087,75,285,4398,123,404,2,0,0,5212,423,3269,205,2181,0,0,0,6078,11290
7087,76,245,4115,119,440,1,0,0,4920,398,3052,197,2314,0,0,0,5961,10881
7087,77,216,3594,101,431,2,0,0,4344,389,2621,177,2291,0,0,0,5478,9822
7087,78,153,2904,70,381,0,0,0,3508,340,1925,118,1969,0,0,0,4352,7860
7087,79,163,2577,69,372,0,0,0,3181,331,1680,130,1972,0,0,0,4113,7294
7087,80,119,2305,69,393,0,0,0,2886,305,1444,112,2002,0,0,0,3863,6749
7087,81,115,2153,38,399,0,0,0,2705,287,1225,80,2090,0,0,0,3682,6387
7087,82,90,2055,37,412,0,0,0,2594,266,1069,84,2066,0,0,0,3485,6079
7087,83,94,2058,53,473,0,0,0,2678,282,1110,114,2511,0,0,0,4017,6695
7087,84,100,1813,28,500,1,0,0,2442,241,848,78,2459,0,0,0,3626,6068
7087,85,80,1576,22,456,0,0,0,2134,253,709,64,2260,0,0,0,3286,5420
7087,86,61,1228,18,386,0,0,0,1693,198,547,69,1934,0,0,0,2748,4441
7087,87,60,1038,18,392,0,0,0,1508,194,370,46,1805,0,0,0,2415,3923
7087,88,39,929,20,382,0,0,0,1370,163,295,45,1837,0,0,0,2340,3710
7087,89,33,774,12,402,0,0,0,1221,171,229,38,1710,0,0,0,2148,3369
7087,90,26,574,11,342,0,0,0,953,156,173,16,1501,0,0,0,1846,2799
7087,91,23,432,6,276,0,0,0,737,103,96,25,1131,0,0,0,1355,2092
7087,92,16,297,2,208,0,0,0,523,95,82,20,981,0,0,0,1178,1701
7087,93,22,230,4,175,1,0,0,432,88,50,19,863,0,0,0,1020,1452
7087,94,12,137,2,134,0,0,0,285,74,26,10,608,0,0,0,718,1003
7087,95,12,78,2,97,0,0,0,189,47,20,10,475,0,0,0,552,741
7087,96,11,46,0,74,0,0,0,131,37,11,3,335,0,0,0,386,517
7087,97,5,27,1,41,0,0,0,74,32,9,4,246,0,0,0,291,365
7087,98,11,16,2,27,0,0,0,56,24,5,1,165,0,0,0,195,251
7087,99,9,10,0,29,0,0,0,48,20,5,2,104,0,0,0,131,179
7087,100,15,11,1,33,0,0,0,60,33,9,1,159,0,0,0,202,262
7087,999,248335,249448,11009,12327,228,6,3,521356,221331,252311,16418,60238,148,10,1,550457,1071813
7190,0,1167,0,0,0,0,0,0,1167,1138,0,0,0,0,0,0,1138,2305
7190,1,1293,0,0,0,0,0,0,1293,1213,0,0,0,0,0,0,1213,2506
7190,2,1284,0,0,0,0,0,0,1284,1340,0,0,0,0,0,0,1340,2624
7190,3,1326,0,0,0,0,0,0,1326,1278,0,0,0,0,0,0,1278,2604
7190,4,1425,0,0,0,0,0,0,1425,1452,0,0,0,0,0,0,1452,2877
7190,5,1549,0,0,0,0,0,0,1549,1468,0,0,0,0,0,0,1468,3017
7190,6,1712,0,0,0,0,0,0,1712,1569,0,0,0,0,0,0,1569,3281
7190,7,1710,0,0,0,0,0,0,1710,1637,0,0,0,0,0,0,1637,3347
7190,8,1822,0,0,0,0,0,0,1822,1664,0,0,0,0,0,0,1664,3486
7190,9,1837,0,0,0,0,0,0,1837,1737,0,0,0,0,0,0,1737,3574
7190,10,1869,0,0,0,0,0,0,1869,1732,0,0,0,0,0,0,1732,3601
7190,11,2018,0,0,0,0,0,0,2018,1858,0,0,0,0,0,0,1858,3876
7190,12,2099,0,0,0,0,0,0,2099,2005,0,0,0,0,0,0,2005,4104
7190,13,2210,0,0,0,0,0,0,2210,2036,0,0,0,0,0,0,2036,4246
7190,14,2165,0,0,0,0,0,0,2165,2002,0,0,0,0,0,0,2002,4167
7190,15,2212,0,0,0,0,0,0,2212,2059,0,0,0,0,0,0,2059,4271
7190,16,2207,0,0,0,0,0,0,2207,2077,0,0,0,0,0,0,2077,4284
7190,17,2141,0,0,0,0,0,0,2141,2027,0,0,0,0,0,0,2027,4168
7190,18,2178,0,0,0,0,0,0,2178,2074,0,0,0,0,0,0,2074,4252
7190,19,2180,2,1,0,0,0,0,2183,1990,4,0,0,0,0,0,1994,4177
7190,20,2244,0,0,0,0,0,0,2244,2090,4,0,0,0,0,0,2094,4338
7190,21,2133,3,0,0,0,0,0,2136,2072,11,0,0,0,0,0,2083,4219
7190,22,2133,2,0,0,0,0,0,2135,2032,11,1,0,0,0,0,2044,4179
7190,23,2306,5,0,0,1,0,0,2312,2006,15,0,0,0,0,0,2021,4333
7190,24,2333,20,0,0,0,0,0,2353,2018,45,2,0,0,0,0,2065,4418
7190,25,2209,19,1,0,1,0,0,2230,1974,51,1,0,0,0,0,2026,4256
7190,26,2266,26,1,0,0,0,0,2293,1938,95,1,0,0,0,0,2034,4327
7190,27,2248,45,2,0,0,0,0,2295,1936,139,2,0,0,0,0,2077,4372
7190,28,2245,86,0,1,2,0,0,2334,1829,193,6,0,1,0,0,2029,4363
7190,29,2231,123,4,0,1,0,0,2359,1834,259,3,0,0,0,0,2096,4455
7190,30,2173,173,4,0,0,0,0,2350,1869,331,11,0,3,1,0,2215,4565
7190,31,2247,211,5,0,1,0,0,2464,1858,488,16,0,1,0,0,2363,4827
7190,32,2212,293,12,0,1,0,0,2518,1755,561,15,4,4,1,0,2340,4858
7190,33,2088,426,9,1,7,1,0,2532,1724,680,27,3,2,0,0,2436,4968
7190,34,2122,471,19,1,4,0,0,2617,1581,844,36,6,1,0,0,2468,5085
7190,35,2000,545,17,0,4,0,0,2566,1528,949,59,5,4,1,0,2546,5112
7190,36,1973,683,17,1,3,1,0,2678,1490,1033,47,6,2,0,0,2578,5256
7190,37,1885,799,28,1,3,0,0,2716,1405,1103,89,7,1,0,0,2605,5321
7190,38,1819,886,43,0,4,0,0,2752,1337,1300,84,15,0,0,0,2736,5488
7190,39,1785,950,60,1,3,0,0,2799,1209,1373,110,11,2,1,0,2706,5505
7190,40,1625,1077,66,3,2,0,0,2773,1301,1417,111,14,2,0,0,2845,5618
7190,41,1703,1253,75,4,1,0,0,3036,1256,1512,149,27,1,0,0,2945,5981
7190,42,1684,1293,85,3,5,0,0,3070,1174,1625,181,21,0,0,0,3001,6071
7190,43,1647,1502,112,8,3,0,0,3272,1148,1723,195,23,4,0,0,3093,6365
7190,44,1558,1529,113,10,0,0,0,3210,1233,1847,205,25,1,0,0,3311,6521
7190,45,1702,1756,138,12,3,0,0,3611,1161,2075,217,30,3,0,0,3486,7097
7190,46,1664,1855,170,8,5,0,0,3702,1122,2133,243,30,1,1,0,3530,7232
7190,47,1636,2020,193,10,6,0,0,3865,1108,2281,299,54,4,0,0,3746,7611
7190,48,1704,2120,239,13,4,0,0,4080,1177,2440,295,62,5,0,0,3979,8059
7190,49,1680,2252,252,17,5,0,0,4206,1116,2540,315,78,2,1,0,4052,8258
7190,50,1629,2395,250,18,2,0,0,4294,1097,2605,370,80,1,0,0,4153,8447
7190,51,1445,2352,273,20,9,0,0,4099,986,2598,364,94,2,0,0,4044,8143
7190,52,1319,2372,248,23,2,0,0,3964,945,2692,397,104,1,0,0,4139,8103
7190,53,1242,2453,330,23,3,0,0,4051,886,2626,383,109,2,0,0,4006,8057
7190,54,1238,2489,333,38,3,0,0,4101,853,2690,367,166,1,0,0,4077,8178
7190,55,1078,2574,317,47,3,0,0,4019,790,2732,377,144,2,0,0,4045,8064
7190,56,1005,2613,334,33,4,0,0,3989,757,2785,354,186,2,0,0,4084,8073
7190,57,983,2663,333,48,1,0,0,4028,750,2856,377,181,3,0,0,4167,8195
7190,58,916,2847,336,48,2,0,0,4149,723,2845,364,206,0,0,0,4138,8287
7190,59,830,2793,360,50,2,0,0,4035,669,2947,378,244,2,0,0,4240,8275
7190,60,736,2681,333,52,2,0,0,3804,614,2808,323,327,1,0,0,4073,7877
7190,61,683,2709,330,73,2,1,0,3798,534,2639,312,312,1,0,0,3798,7596
7190,62,589,2670,281,71,4,0,0,3615,513,2666,289,320,0,0,0,3788,7403
7190,63,558,2663,271,97,3,0,0,3592,468,2577,267,386,2,0,0,3700,7292
7190,64,498,2527,216,87,4,1,0,3333,433,2450,264,404,0,0,0,3551,6884
7190,65,445,2522,206,99,0,0,0,3272,399,2489,221,426,1,0,0,3536,6808
7190,66,424,2532,197,93,3,0,1,3250,362,2365,222,477,0,0,0,3426,6676
7190,67,420,2416,178,125,5,0,0,3144,360,2225,209,485,1,0,0,3280,6424
7190,68,385,2354,190,132,5,0,0,3066,361,2151,175,551,3,0,0,3241,6307
7190,69,409,2351,176,142,3,0,0,3081,340,2130,176,581,0,0,0,3227,6308
7190,70,341,2216,170,118,1,0,0,2846,321,1959,150,521,0,0,0,2951,5797
7190,71,314,2129,132,141,0,0,0,2716,349,1905,130,643,0,0,0,3027,5743
7190,72,285,2076,113,155,2,0,0,2631,298,1866,108,743,0,0,0,3015,5646
7190,73,260,2147,98,169,1,0,0,2675,319,1744,115,774,0,0,0,2952,5627
7190,74,249,2047,104,193,0,0,1,2594,261,1690,96,792,0,0,0,2839,5433
7190,75,244,1947,102,192,0,0,0,2485,307,1675,100,856,0,0,0,2938,5423
7190,76,218,1931,92,196,0,0,0,2437,275,1463,84,927,1,0,0,2750,5187
7190,77,185,1790,88,201,0,0,0,2264,239,1313,87,935,0,0,0,2574,4838
7190,78,148,1562,53,177,0,0,0,1940,251,1148,60,950,0,0,0,2409,4349
7190,79,173,1489,44,206,2,0,0,1914,241,1077,59,995,0,0,0,2372,4286
7190,80,124,1354,37,203,3,0,0,1721,224,898,48,1063,0,0,0,2233,3954
7190,81,140,1288,36,222,0,0,0,1686,204,849,44,1145,0,0,0,2242,3928
7190,82,116,1109,30,216,0,0,0,1471,229,683,40,1121,0,0,0,2073,3544
7190,83,148,1128,37,260,1,0,0,1574,226,652,29,1237,0,0,0,2144,3718
7190,84,110,976,25,251,0,0,0,1362,197,542,38,1187,0,0,0,1964,3326
7190,85,95,815,22,223,0,0,0,1155,219,389,21,1099,0,0,0,1728,2883
7190,86,83,660,16,208,0,0,0,967,169,337,17,1043,0,0,0,1566,2533
7190,87,61,570,18,214,0,0,0,863,173,252,11,843,0,0,0,1279,2142
7190,88,67,419,6,175,0,0,0,667,162,162,12,848,0,0,0,1184,1851
7190,89,71,394,5,202,0,0,0,672,137,130,10,812,0,0,0,1089,1761
7190,90,55,288,3,161,0,0,0,507,118,100,11,705,0,0,0,934,1441
7190,91,39,248,2,135,0,0,0,424,116,72,5,552,0,0,0,745,1169
7190,92,32,174,4,119,0,0,0,329,97,37,4,491,0,0,0,629,958
7190,93,21,132,2,100,0,0,0,255,74,31,2,450,0,0,0,557,812
7190,94,13,74,0,85,0,0,0,172,74,24,0,331,0,0,0,429,601
7190,95,13,55,1,55,0,0,0,124,45,10,3,243,0,0,0,301,425
7190,96,6,36,1,36,0,0,0,79,28,10,0,172,0,0,0,210,289
7190,97,9,24,0,23,0,0,0,56,37,2,1,121,0,0,0,161,217
7190,98,0,16,0,15,0,0,0,31,22,2,0,80,0,0,0,104,135
7190,99,1,7,0,11,0,0,0,19,7,3,1,79,0,0,0,90,109
7190,100,1,6,0,15,0,0,0,22,16,2,1,105,0,0,0,124,146
7190,999,116113,102508,8399,6090,141,4,2,233257,99912,101985,10196,28067,70,6,0,240236,473493
7255,0,525,0,0,0,0,0,0,525,464,0,0,0,0,0,0,464,989
7255,1,540,0,0,0,0,0,0,540,467,0,0,0,0,0,0,467,1007
7255,2,577,0,0,0,0,0,0,577,534,0,0,0,0,0,0,534,1111
7255,3,553,0,0,0,0,0,0,553,551,0,0,0,0,0,0,551,1104
7255,4,642,0,0,0,0,0,0,642,579,0,0,0,0,0,0,579,1221
7255,5,676,0,0,0,0,0,0,676,604,0,0,0,0,0,0,604,1280
7255,6,700,0,0,0,0,0,0,700,673,0,0,0,0,0,0,673,1373
7255,7,693,0,0,0,0,0,0,693,685,0,0,0,0,0,0,685,1378
7255,8,735,0,0,0,0,0,0,735,699,0,0,0,0,0,0,699,1434
7255,9,777,0,0,0,0,0,0,777,740,0,0,0,0,0,0,740,1517
7255,10,825,0,0,0,0,0,0,825,746,0,0,0,0,0,0,746,1571
7255,11,862,0,0,0,0,0,0,862,769,0,0,0,0,0,0,769,1631
7255,12,860,0,0,0,0,0,0,860,844,0,0,0,0,0,0,844,1704
7255,13,938,0,0,0,0,0,0,938,846,0,0,0,0,0,0,846,1784
7255,14,969,0,0,0,0,0,0,969,797,0,0,0,0,0,0,797,1766
7255,15,925,0,0,0,0,0,0,925,866,0,0,0,0,0,0,866,1791
7255,16,921,0,0,0,0,0,0,921,826,0,0,0,0,0,0,826,1747
7255,17,975,0,0,0,0,0,0,975,859,0,0,0,0,0,0,859,1834
7255,18,979,0,0,1,0,0,0,980,914,0,0,0,0,0,0,914,1894
7255,19,977,0,0,0,0,0,0,977,860,1,0,0,0,0,0,861,1838
7255,20,991,0,0,0,0,0,0,991,887,0,0,0,0,0,0,887,1878
7255,21,912,0,0,0,0,0,0,912,862,1,0,0,0,0,0,863,1775
7255,22,1009,1,0,0,0,0,0,1010,932,5,0,0,0,0,0,937,1947
7255,23,1006,3,0,0,0,0,0,1009,909,10,0,0,0,0,0,919,1928
7255,24,1000,1,0,0,0,0,0,1001,877,13,3,0,0,0,0,893,1894
7255,25,981,4,2,0,0,0,0,987,896,17,0,0,0,0,0,913,1900
7255,26,1006,16,0,0,0,0,0,1022,858,31,0,0,0,0,0,889,1911
7255,27,986,12,0,0,1,0,0,999,826,53,0,0,0,0,0,879,1878
7255,28,1038,39,0,0,0,0,0,1077,841,74,0,0,0,0,0,915,1992
7255,29,1004,41,0,0,1,0,0,1046,799,83,2,0,0,0,0,884,1930
7255,30,949,48,1,0,0,0,0,998,774,130,6,0,0,0,0,910,1908
7255,31,968,69,3,0,0,0,0,1040,708,192,1,0,0,0,0,901,1941
7255,32,971,95,4,0,1,0,0,1071,743,221,3,3,0,0,0,970,2041
7255,33,925,131,3,0,1,0,0,1060,696,298,9,2,1,1,0,1007,2067
7255,34,863,170,3,0,2,0,0,1038,633,289,11,1,0,1,0,935,1973
7255,35,888,238,5,0,0,0,0,1131,614,372,17,4,0,0,0,1007,2138
7255,36,708,245,9,2,0,0,0,964,569,367,19,3,2,0,0,960,1924
7255,37,745,285,12,0,1,0,0,1043,544,455,17,2,0,0,0,1018,2061
7255,38,744,331,13,1,1,0,0,1090,481,470,23,6,0,0,0,980,2070
7255,39,753,348,11,3,1,0,0,1116,493,483,23,2,1,0,0,1002,2118
7255,40,720,382,10,0,0,0,0,1112,497,541,40,9,0,1,0,1088,2200
7255,41,687,437,23,0,0,0,0,1147,446,582,36,5,0,0,0,1069,2216
7255,42,658,481,20,1,1,0,0,1161,434,652,47,9,0,0,0,1142,2303
7255,43,668,565,25,3,2,0,0,1263,414,645,43,10,1,0,0,1113,2376
7255,44,698,540,33,2,2,0,0,1275,376,706,52,13,0,0,0,1147,2422
7255,45,683,647,44,6,0,0,0,1380,419,867,71,11,1,0,0,1369,2749
7255,46,674,701,49,5,0,0,0,1429,374,839,70,21,1,0,0,1305,2734
7255,47,708,693,42,1,1,0,0,1445,400,889,89,24,0,0,0,1402,2847
7255,48,673,734,47,4,3,0,0,1461,377,918,82,22,1,0,0,1400,2861
7255,49,668,856,66,5,1,0,0,1596,348,937,80,36,0,0,0,1401,2997
7255,50,588,852,71,5,1,0,0,1517,357,1014,84,45,0,0,0,1500,3017
7255,51,599,839,86,7,0,0,0,1531,329,1015,100,54,0,0,0,1498,3029
7255,52,537,961,69,7,0,0,0,1574,330,1057,99,31,1,0,0,1518,3092
7255,53,536,926,89,5,0,0,0,1556,317,1061,99,46,0,0,0,1523,3079
7255,54,545,996,111,10,1,0,0,1663,325,1126,99,66,0,0,0,1616,3279
7255,55,528,1009,91,14,0,0,0,1642,307,1101,103,78,0,0,0,1589,3231
7255,56,532,1091,88,13,1,0,0,1725,305,1175,107,91,1,0,0,1679,3404
7255,57,478,1152,101,17,2,0,0,1750,297,1226,105,94,0,0,0,1722,3472
7255,58,457,1104,72,17,2,0,0,1652,290,1149,84,111,0,0,0,1634,3286
7255,59,378,1245,107,22,0,0,0,1752,302,1249,97,135,0,0,0,1783,3535
7255,60,356,1134,81,23,0,0,0,1594,305,1151,69,133,0,0,0,1658,3252
7255,61,341,1138,92,32,0,0,0,1603,284,1107,78,162,0,0,0,1631,3234
7255,62,361,1073,88,29,0,0,0,1551,245,1172,70,178,0,0,0,1665,3216
7255,63,312,1070,70,34,0,0,0,1486,225,1068,49,153,0,0,0,1495,2981
7255,64,293,1088,73,31,0,0,0,1485,194,1082,73,163,0,0,0,1512,2997
7255,65,286,1072,64,39,0,0,0,1461,217,989,54,197,0,0,0,1457,2918
7255,66,248,1035,50,35,1,0,0,1369,224,1013,58,220,1,0,0,1516,2885
7255,67,269,1024,53,54,0,0,0,1400,218,990,49,251,0,0,0,1508,2908
7255,68,230,1011,45,44,0,0,0,1330,230,965,41,250,0,0,0,1486,2816
7255,69,235,1014,64,48,0,0,0,1361,204,928,47,276,0,0,0,1455,2816
7255,70,198,935,42,48,0,0,0,1223,209,813,39,263,0,0,0,1324,2547
7255,71,211,992,39,55,0,0,0,1297,190,799,26,305,0,0,0,1320,2617
7255,72,181,872,31,50,0,0,0,1134,164,730,36,337,1,0,0,1268,2402
7255,73,167,861,28,77,0,0,0,1133,175,711,22,395,0,0,0,1303,2436
7255,74,149,837,24,57,0,0,0,1067,159,663,20,366,0,0,0,1208,2275
7255,75,154,849,38,66,0,0,0,1107,170,654,27,421,0,0,0,1272,2379
7255,76,147,759,14,51,0,0,0,971,145,555,18,435,0,0,0,1153,2124
7255,77,121,687,22,79,0,0,0,909,151,469,17,448,0,0,0,1085,1994
7255,78,122,631,19,80,0,0,0,852,162,467,10,455,0,0,0,1094,1946
7255,79,116,624,19,77,0,0,0,836,169,416,14,515,0,0,0,1114,1950
7255,80,96,535,15,63,0,0,0,709,162,356,8,512,0,0,0,1038,1747
7255,81,92,534,11,81,0,0,0,718,140,347,9,534,0,0,0,1030,1748
7255,82,73,472,6,56,0,0,0,607,121,258,8,539,0,0,0,926,1533
7255,83,86,491,9,76,0,0,0,662,155,261,9,614,0,0,0,1039,1701
7255,84,64,433,7,89,0,0,0,593,157,200,1,576,0,0,0,934,1527
7255,85,68,370,1,80,0,0,0,519,146,169,4,549,0,0,0,868,1387
7255,86,49,259,2,93,0,0,0,403,126,117,5,469,0,0,0,717,1120
7255,87,34,275,0,81,0,0,0,390,126,106,4,471,0,0,0,707,1097
7255,88,32,220,5,56,0,0,0,313,117,76,1,425,0,0,0,619,932
7255,89,29,169,1,73,0,0,0,272,112,43,5,378,0,0,0,538,810
7255,90,17,161,4,64,0,0,0,246,90,35,7,339,0,0,0,471,717
7255,91,21,119,0,49,0,0,0,189,81,35,0,316,0,0,0,432,621
7255,92,14,96,0,50,0,0,0,160,52,13,2,257,0,0,0,324,484
7255,93,9,65,0,58,0,0,0,132,50,18,2,229,0,0,0,299,431
7255,94,12,47,0,35,0,0,0,94,54,14,0,162,0,0,0,230,324
7255,95,9,40,0,30,0,0,0,79,39,4,1,150,0,0,0,194,273
7255,96,5,23,1,13,0,0,0,42,23,3,0,88,0,0,0,114,156
7255,97,0,13,0,23,0,0,0,36,17,2,0,87,0,0,0,106,142
7255,98,3,7,0,18,0,0,0,28,9,1,0,60,0,0,0,70,98
7255,99,0,2,0,12,0,0,0,14,5,3,0,39,0,0,0,47,61
7255,100,2,5,0,18,0,0,0,25,15,3,0,68,0,0,0,86,111
7255,999,51323,41330,2328,2278,27,0,0,97286,42346,41120,2604,13719,12,3,0,99804,197090
7294,0,965,0,0,0,0,0,0,965,887,0,0,0,0,0,0,887,1852
7294,1,1062,0,0,0,0,0,0,1062,987,0,0,0,0,0,0,987,2049
7294,2,1128,0,0,0,0,0,0,1128,1075,0,0,0,0,0,0,1075,2203
7294,3,1140,0,0,0,0,0,0,1140,1032,0,0,0,0,0,0,1032,2172
7294,4,1191,0,0,0,0,0,0,1191,1185,0,0,0,0,0,0,1185,2376
7294,5,1229,0,0,0,0,0,0,1229,1159,0,0,0,0,0,0,1159,2388
7294,6,1397,0,0,0,0,0,0,1397,1280,0,0,0,0,0,0,1280,2677
7294,7,1518,0,0,0,0,0,0,1518,1345,0,0,0,0,0,0,1345,2863
7294,8,1659,0,0,0,0,0,0,1659,1481,0,0,0,0,0,0,1481,3140
7294,9,1624,0,0,0,0,0,0,1624,1485,0,0,0,0,0,0,1485,3109
7294,10,1647,0,0,0,0,0,0,1647,1540,0,0,0,0,0,0,1540,3187
7294,11,1813,0,0,0,0,0,0,1813,1707,0,0,0,0,0,0,1707,3520
7294,12,1792,0,0,0,0,0,0,1792,1679,0,0,0,0,0,0,1679,3471
7294,13,1864,0,0,0,0,0,0,1864,1770,0,0,0,0,0,0,1770,3634
7294,14,1959,0,0,0,0,0,0,1959,1756,0,0,0,0,0,0,1756,3715
7294,15,1868,0,0,0,0,0,0,1868,1788,0,0,0,0,0,0,1788,3656
7294,16,1824,2,0,0,0,0,0,1826,1771,0,0,0,0,0,0,1771,3597
7294,17,1945,0,0,0,0,0,0,1945,1788,0,0,0,0,0,0,1788,3733
7294,18,1910,0,0,0,0,0,0,1910,1710,0,0,0,0,0,0,1710,3620
7294,19,1845,0,0,0,0,0,0,1845,1743,1,0,0,0,0,0,1744,3589
7294,20,1943,1,0,0,0,0,0,1944,1807,0,0,0,0,0,0,1807,3751
7294,21,1836,1,0,0,0,0,0,1837,1721,5,0,0,0,0,0,1726,3563
7294,22,1908,5,0,0,0,0,0,1913,1813,9,0,0,0,0,0,1822,3735
7294,23,1933,3,0,0,0,0,0,1936,1758,13,1,0,0,0,0,1772,3708
7294,24,1895,5,0,0,0,0,0,1900,1703,27,0,1,0,0,0,1731,3631
7294,25,1897,16,0,0,2,0,0,1915,1587,31,1,0,0,0,0,1619,3534
7294,26,1797,18,3,0,1,0,0,1819,1621,54,0,0,2,0,0,1677,3496
7294,27,1846,42,1,0,0,0,0,1889,1610,90,1,0,3,0,0,1704,3593
7294,28,1933,60,2,0,2,0,0,1997,1609,131,4,0,2,0,0,1746,3743
7294,29,1934,96,4,0,3,0,0,2037,1661,188,3,1,1,0,0,1854,3891
7294,30,1849,120,0,0,3,0,0,1972,1670,258,6,0,0,0,0,1934,3906
7294,31,1902,162,7,0,5,0,0,2076,1644,356,13,1,2,0,0,2016,4092
7294,32,1915,239,6,0,3,0,0,2163,1642,427,22,2,3,0,0,2096,4259
7294,33,2014,362,9,0,2,0,0,2387,1657,540,21,2,4,0,0,2224,4611
7294,34,1842,408,9,1,3,0,0,2263,1580,588,26,3,6,0,0,2203,4466
7294,35,1900,494,17,1,2,0,0,2414,1523,724,42,10,2,0,0,2301,4715
7294,36,1776,525,22,1,5,0,0,2329,1444,835,55,3,4,0,0,2341,4670
7294,37,1671,607,29,2,6,0,1,2316,1467,881,61,4,6,1,0,2420,4736
7294,38,1675,713,37,1,4,0,0,2430,1455,938,64,5,8,0,0,2470,4900
7294,39,1635,849,44,2,8,0,0,2538,1354,1000,80,4,4,0,0,2442,4980
7294,40,1683,912,50,3,6,0,0,2654,1301,1180,109,9,3,0,0,2602,5256
7294,41,1638,1048,53,2,6,0,0,2747,1332,1346,116,9,3,0,0,2806,5553
7294,42,1555,1019,79,5,4,0,0,2662,1281,1448,134,23,4,1,1,2892,5554
7294,43,1560,1244,75,0,8,1,0,2888,1264,1460,144,13,5,1,0,2887,5775
7294,44,1568,1252,107,7,10,0,0,2944,1201,1535,158,18,1,0,0,2913,5857
7294,45,1507,1454,116,9,6,0,0,3092,1259,1663,199,27,7,1,0,3156,6248
7294,46,1593,1513,121,3,8,1,0,3239,1222,1802,213,31,2,0,0,3270,6509
7294,47,1579,1602,155,6,7,0,0,3349,1235,1935,221,36,1,0,0,3428,6777
7294,48,1590,1821,195,13,5,0,0,3624,1256,2152,264,39,3,0,0,3714,7338
7294,49,1619,1977,229,9,5,0,0,3839,1300,2211,291,48,6,1,0,3857,7696
7294,50,1571,2067,245,13,8,0,0,3904,1139,2295,311,67,4,0,0,3816,7720
7294,51,1398,2082,215,27,5,0,0,3727,1146,2296,385,67,1,0,0,3895,7622
7294,52,1261,2049,254,26,7,0,0,3597,1080,2422,339,85,1,0,0,3927,7524
7294,53,1194,2135,262,22,4,0,0,3617,950,2333,350,101,3,0,0,3737,7354
7294,54,1148,2131,302,20,6,0,0,3607,857,2490,351,106,0,0,0,3804,7411
7294,55,975,2192,258,22,5,0,0,3452,874,2431,384,110,0,0,0,3799,7251
7294,56,1026,2277,283,33,5,0,0,3624,808,2464,353,124,5,0,0,3754,7378
7294,57,912,2317,278,45,5,0,0,3557,801,2461,374,139,2,0,0,3777,7334
7294,58,794,2432,303,58,2,0,0,3589,776,2559,387,194,3,0,0,3919,7508
7294,59,802,2502,296,44,1,1,0,3646,675,2614,331,201,2,0,1,3824,7470
7294,60,643,2376,327,44,2,0,0,3392,684,2420,346,226,0,0,0,3676,7068
7294,61,559,2310,290,65,2,0,0,3226,578,2399,364,225,2,0,0,3568,6794
7294,62,510,2214,230,61,4,0,0,3019,562,2335,313,274,0,0,0,3484,6503
7294,63,440,2245,251,71,2,0,0,3009,518,2168,288,273,1,0,0,3248,6257
7294,64,407,2190,238,86,2,0,0,2923,505,2218,307,330,0,0,0,3360,6283
7294,65,332,2159,218,70,2,0,0,2781,428,2068,290,321,2,0,0,3109,5890
7294,66,335,2118,203,84,2,1,0,2743,437,2108,255,401,0,0,0,3201,5944
7294,67,290,2116,181,94,3,0,0,2684,359,2172,248,429,1,0,0,3209,5893
7294,68,259,2075,176,94,2,0,0,2606,367,1933,192,431,1,0,0,2924,5530
7294,69,223,2038,156,119,2,0,0,2538,392,1989,238,448,0,0,0,3067,5605
7294,70,178,1914,157,123,1,0,0,2373,352,1813,203,515,0,0,0,2883,5256
7294,71,182,1894,122,128,2,0,0,2328,290,1761,195,524,1,0,0,2771,5099
7294,72,163,1806,120,114,1,0,0,2204,296,1717,169,544,0,0,0,2726,4930
7294,73,139,1822,137,166,1,0,0,2265,291,1594,176,668,0,0,0,2729,4994
7294,74,142,1782,76,148,0,0,0,2148,257,1575,142,674,0,0,0,2648,4796
7294,75,126,1754,94,154,0,0,0,2128,259,1554,148,719,0,0,0,2680,4808
7294,76,100,1679,100,178,0,0,1,2058,274,1414,114,800,0,0,0,2602,4660
7294,77,78,1639,68,185,0,0,0,1970,257,1186,109,766,0,0,0,2318,4288
7294,78,102,1432,41,169,0,0,0,1744,211,1098,104,842,0,0,0,2255,3999
7294,79,69,1237,57,181,0,0,0,1544,206,928,66,722,0,0,0,1922,3466
7294,80,58,1094,48,165,0,0,0,1365,198,827,61,885,0,0,0,1971,3336
7294,81,72,1151,52,212,0,0,0,1487,204,789,52,950,0,0,0,1995,3482
7294,82,42,1040,42,186,0,0,0,1310,200,701,56,925,0,0,0,1882,3192
7294,83,57,1034,30,224,0,0,0,1345,203,611,61,1046,0,0,0,1921,3266
7294,84,52,900,22,194,0,0,0,1168,185,497,50,935,0,0,0,1667,2835
7294,85,49,743,14,169,0,0,0,975,148,386,41,853,0,0,0,1428,2403
7294,86,40,586,20,198,0,0,0,844,136,328,28,821,0,0,0,1313,2157
7294,87,33,518,18,181,0,0,0,750,128,244,17,823,0,0,0,1212,1962
7294,88,17,376,7,147,0,0,0,547,121,192,17,691,0,0,0,1021,1568
7294,89,13,329,6,145,0,0,0,493,106,158,18,707,0,0,0,989,1482
7294,90,17,281,4,143,0,0,0,445,100,112,18,611,0,0,0,841,1286
7294,91,15,202,2,99,0,0,0,318,90,77,5,478,0,0,0,650,968
7294,92,10,154,2,108,0,0,0,274,64,43,10,434,0,0,0,551,825
7294,93,10,132,1,83,0,0,0,226,48,31,2,400,0,0,0,481,707
7294,94,5,71,1,61,0,0,0,138,56,25,7,328,0,0,1,417,555
7294,95,2,35,1,52,0,0,0,90,48,18,2,236,0,0,0,304,394
7294,96,3,34,0,37,0,0,0,74,28,9,3,184,0,0,0,224,298
7294,97,0,21,0,18,0,0,0,39,26,5,0,116,0,0,0,147,186
7294,98,2,10,0,11,0,0,0,23,13,2,1,85,0,0,0,101,124
7294,99,2,6,0,10,0,0,0,18,11,0,1,49,0,0,0,61,79
7294,100,1,6,0,20,0,0,0,27,12,2,1,86,0,0,0,101,128
7294,999,101231,88277,7578,5172,190,4,2,202454,92899,89700,10532,23258,111,5,3,216508,418962
7340,0,973,0,0,0,0,0,0,973,1015,0,0,0,0,0,0,1015,1988
7340,1,1076,0,0,0,0,0,0,1076,961,0,0,0,0,0,0,961,2037
7340,2,1097,0,0,0,0,0,0,1097,1066,0,0,0,0,0,0,1066,2163
7340,3,1096,0,0,0,0,0,0,1096,1075,0,0,0,0,0,0,1075,2171
7340,4,1149,0,0,0,0,0,0,1149,1112,0,0,0,0,0,0,1112,2261
7340,5,1224,0,0,0,0,0,0,1224,1110,0,0,0,0,0,0,1110,2334
7340,6,1257,0,0,0,0,0,0,1257,1174,0,0,0,0,0,0,1174,2431
7340,7,1317,0,0,0,0,0,0,1317,1267,0,0,0,0,0,0,1267,2584
7340,8,1329,0,0,0,0,0,0,1329,1246,0,0,0,0,0,0,1246,2575
7340,9,1426,0,0,0,0,0,0,1426,1318,0,0,0,0,0,0,1318,2744
7340,10,1406,0,0,0,0,0,0,1406,1422,0,0,0,0,0,0,1422,2828
7340,11,1469,0,0,0,0,0,0,1469,1358,0,0,0,0,0,0,1358,2827
7340,12,1577,0,0,0,0,0,0,1577,1368,0,0,0,0,0,0,1368,2945
7340,13,1564,0,0,0,0,0,0,1564,1453,0,0,0,0,0,0,1453,3017
7340,14,1646,0,0,0,0,0,0,1646,1503,0,0,0,0,0,0,1503,3149
7340,15,1613,0,0,0,0,0,0,1613,1490,0,0,0,0,0,0,1490,3103
7340,16,1627,0,0,0,0,0,0,1627,1530,0,0,0,0,0,0,1530,3157
7340,17,1594,0,0,0,0,0,0,1594,1482,0,0,0,0,0,0,1482,3076
7340,18,1537,0,0,0,0,0,0,1537,1437,1,0,0,0,0,0,1438,2975
7340,19,1557,0,0,0,1,0,0,1558,1519,6,0,0,0,0,0,1525,3083
7340,20,1541,1,0,0,0,0,0,1542,1392,12,0,0,0,0,0,1404,2946
7340,21,1527,2,0,0,0,0,0,1529,1376,22,0,0,0,0,0,1398,2927
7340,22,1626,4,0,0,0,0,0,1630,1347,46,0,0,0,0,0,1393,3023
7340,23,1617,17,3,0,0,0,0,1637,1427,79,1,0,0,0,0,1507,3144
7340,24,1614,25,1,0,0,0,0,1640,1341,99,4,0,0,0,0,1444,3084
7340,25,1580,50,1,0,1,0,0,1632,1273,155,1,1,1,0,0,1431,3063
7340,26,1526,78,3,0,1,0,0,1608,1229,175,1,0,0,1,0,1406,3014
7340,27,1615,86,2,0,0,0,0,1703,1193,249,6,0,0,0,0,1448,3151
7340,28,1411,150,3,0,1,0,0,1565,1046,286,4,1,1,1,0,1339,2904
7340,29,1461,188,3,0,1,0,0,1653,1022,355,8,4,0,0,0,1389,3042
7340,30,1338,253,5,0,0,0,0,1596,986,426,6,0,1,1,0,1420,3016
7340,31,1350,335,6,0,4,0,0,1695,967,526,14,0,2,0,0,1509,3204
7340,32,1303,365,8,2,2,0,0,1680,890,658,20,2,0,0,0,1570,3250
7340,33,1230,466,11,6,0,0,0,1713,849,698,16,1,2,0,0,1566,3279
7340,34,1143,514,10,4,1,0,0,1672,791,741,22,1,3,0,0,1558,3230
7340,35,1092,572,15,3,1,0,0,1683,755,863,33,3,2,0,0,1656,3339
7340,36,967,670,17,1,3,0,0,1658,641,866,49,6,0,0,0,1562,3220
7340,37,910,720,34,0,1,0,0,1665,647,947,64,10,1,0,0,1669,3334
7340,38,905,764,32,0,1,0,0,1702,657,1015,54,7,0,0,0,1733,3435
7340,39,866,899,33,1,5,0,0,1804,615,1002,73,4,3,1,0,1698,3502
7340,40,887,854,41,5,0,0,0,1787,595,1054,79,8,0,0,0,1736,3523
7340,41,853,999,49,1,0,0,0,1902,629,1182,116,13,1,0,0,1941,3843
7340,42,876,1061,58,8,0,0,0,2003,578,1190,110,13,0,0,0,1891,3894
7340,43,833,1115,69,8,3,0,0,2028,600,1211,125,19,0,1,0,1956,3984
7340,44,840,1168,85,8,0,0,0,2101,553,1276,114,30,3,0,0,1976,4077
7340,45,933,1278,89,6,1,0,0,2307,592,1341,163,33,1,0,0,2130,4437
7340,46,851,1342,115,7,1,0,0,2316,551,1415,158,21,2,0,0,2147,4463
7340,47,898,1389,107,6,3,0,0,2403,572,1496,165,46,1,1,0,2281,4684
7340,48,901,1410,133,10,5,0,0,2459,591,1574,186,37,0,0,0,2388,4847
7340,49,857,1552,155,18,3,0,0,2585,557,1729,267,49,0,0,0,2602,5187
7340,50,832,1574,134,9,2,0,0,2551,520,1665,241,44,1,0,0,2471,5022
7340,51,723,1577,174,11,1,0,0,2486,475,1855,239,53,0,0,0,2622,5108
7340,52,728,1618,202,24,1,0,0,2573,483,1738,245,66,0,0,0,2532,5105
7340,53,693,1567,211,13,1,0,0,2485,493,1791,266,77,0,0,0,2627,5112
7340,54,676,1682,207,19,3,0,0,2587,459,1785,257,75,0,0,0,2576,5163
7340,55,624,1798,197,28,1,0,0,2648,461,1798,256,96,2,0,0,2613,5261
7340,56,561,1767,210,29,3,0,0,2570,415,1827,292,96,0,1,0,2631,5201
7340,57,497,1683,216,34,3,0,0,2433,396,1756,287,122,0,0,0,2561,4994
7340,58,519,1743,202,19,2,0,0,2485,345,1740,269,117,1,0,0,2472,4957
7340,59,470,1803,221,29,2,0,0,2525,369,1827,272,129,1,0,0,2598,5123
7340,60,425,1711,203,36,1,0,0,2376,302,1795,238,152,0,0,0,2487,4863
7340,61,376,1600,202,40,1,0,0,2219,281,1679,220,175,0,0,0,2355,4574
7340,62,355,1633,175,53,1,0,0,2217,202,1637,217,164,0,0,0,2220,4437
7340,63,293,1533,179,34,2,0,0,2041,200,1545,218,188,0,0,0,2151,4192
7340,64,297,1523,163,52,0,0,0,2035,186,1535,219,237,0,0,0,2177,4212
7340,65,237,1400,161,45,1,0,0,1844,185,1453,188,217,1,0,0,2044,3888
7340,66,259,1420,121,55,2,0,0,1857,174,1451,181,246,1,0,0,2053,3910
7340,67,219,1420,122,68,0,0,0,1829,156,1301,155,303,0,0,0,1915,3744
7340,68,200,1346,118,60,0,0,0,1724,140,1309,132,305,1,0,0,1887,3611
7340,69,182,1338,106,74,1,0,0,1701,148,1318,157,335,0,0,0,1958,3659
7340,70,176,1344,110,80,0,0,0,1710,121,1249,125,328,0,0,0,1823,3533
7340,71,174,1312,88,82,0,0,0,1656,120,1303,127,378,0,0,0,1928,3584
7340,72,175,1281,65,102,0,0,0,1623,125,1195,111,415,0,0,0,1846,3469
7340,73,162,1352,76,120,0,0,0,1710,109,1210,103,459,1,0,0,1882,3592
7340,74,147,1287,79,102,0,0,0,1615,95,1096,82,490,0,0,0,1763,3378
7340,75,128,1402,74,129,0,0,0,1733,97,1176,91,536,0,0,0,1900,3633
7340,76,117,1274,45,138,0,0,0,1574,95,1080,63,608,0,0,0,1846,3420
7340,77,128,1350,51,153,0,0,0,1682,107,1087,68,673,0,0,0,1935,3617
7340,78,84,913,37,110,0,0,0,1144,64,669,50,502,0,0,0,1285,2429
7340,79,105,1010,32,151,0,0,0,1298,72,739,47,698,0,0,0,1556,2854
7340,80,99,931,34,152,1,0,0,1217,68,718,49,679,0,0,0,1514,2731
7340,81,94,887,36,147,0,0,0,1164,89,648,49,750,0,0,0,1536,2700
7340,82,80,834,12,159,0,0,0,1085,61,539,38,770,0,0,0,1408,2493
7340,83,75,788,28,197,0,0,0,1088,72,488,36,865,0,0,0,1461,2549
7340,84,53,735,12,162,0,0,1,963,76,408,25,878,0,0,0,1387,2350
7340,85,50,622,13,172,0,0,0,857,52,339,22,844,0,0,0,1257,2114
7340,86,42,545,12,144,0,0,0,743,50,254,26,784,0,0,0,1114,1857
7340,87,28,374,9,145,0,0,0,556,53,181,16,705,0,0,0,955,1511
7340,88,32,335,8,143,0,0,0,518,27,137,19,630,0,0,0,813,1331
7340,89,26,232,5,104,0,0,0,367,49,105,13,615,0,0,0,782,1149
7340,90,17,202,1,105,0,0,0,325,39,70,8,535,0,0,0,652,977
7340,91,11,161,2,92,0,0,0,266,24,51,10,517,0,0,0,602,868
7340,92,13,127,5,55,0,0,0,200,37,35,4,433,0,0,0,509,709
7340,93,8,90,4,73,0,0,0,175,25,28,3,374,0,0,0,430,605
7340,94,4,50,1,56,0,0,0,111,22,10,3,339,0,0,0,374,485
7340,95,5,37,1,33,0,0,0,76,20,8,3,237,0,0,0,268,344
7340,96,2,19,1,30,0,0,0,52,16,4,3,180,0,0,0,203,255
7340,97,1,9,0,20,0,0,0,30,12,3,1,163,0,0,0,179,209
7340,98,1,13,0,19,0,0,0,33,7,2,1,104,0,0,0,114,147
7340,99,0,5,0,12,0,0,0,17,4,1,0,71,0,0,0,76,93
7340,100,2,8,0,20,0,0,0,30,7,1,1,108,0,0,0,117,147
7340,999,74090,69592,5453,4033,68,0,1,153237,60373,70334,7605,19174,33,7,0,157526,310763
7382,0,228,0,0,0,0,0,0,228,219,0,0,0,0,0,0,219,447
7382,1,259,0,0,0,0,0,0,259,236,0,0,0,0,0,0,236,495
7382,2,233,0,0,0,0,0,0,233,223,0,0,0,0,0,0,223,456
7382,3,255,0,0,0,0,0,0,255,195,0,0,0,0,0,0,195,450
7382,4,270,0,0,0,0,0,0,270,263,0,0,0,0,0,0,263,533
7382,5,269,0,0,0,0,0,0,269,286,0,0,0,0,0,0,286,555
7382,6,289,0,0,0,0,0,0,289,282,0,0,0,0,0,0,282,571
7382,7,280,0,0,0,0,0,0,280,287,0,0,0,0,0,0,287,567
7382,8,324,0,0,0,0,0,0,324,276,0,0,0,0,0,0,276,600
7382,9,329,0,0,0,0,0,0,329,268,0,0,0,0,0,0,268,597
7382,10,316,0,0,0,0,0,0,316,297,0,0,0,0,0,0,297,613
7382,11,322,0,0,0,0,0,0,322,304,0,0,0,0,0,0,304,626
7382,12,300,0,0,0,0,0,0,300,300,0,0,0,0,0,0,300,600
7382,13,334,0,0,0,0,0,0,334,309,0,0,0,0,0,0,309,643
7382,14,329,0,0,0,0,0,0,329,296,0,0,0,0,0,0,296,625
7382,15,347,0,0,0,0,0,0,347,297,0,0,0,0,0,0,297,644
7382,16,341,0,0,0,0,0,0,341,329,0,0,0,0,0,0,329,670
7382,17,344,0,0,0,0,0,0,344,311,0,0,0,0,0,0,311,655
7382,18,367,0,0,0,0,0,0,367,352,0,0,0,0,0,0,352,719
7382,19,385,0,0,0,0,0,0,385,308,0,0,0,0,0,0,308,693
7382,20,379,0,0,0,0,0,0,379,298,1,0,0,0,0,0,299,678
7382,21,385,5,0,0,0,0,0,390,356,1,0,0,0,0,0,357,747
7382,22,398,1,0,0,0,0,0,399,342,4,0,0,1,0,0,347,746
7382,23,404,1,0,0,0,0,0,405,335,10,0,0,0,0,0,345,750
7382,24,406,5,0,1,0,0,0,412,319,7,0,0,1,0,0,327,739
7382,25,463,10,0,0,0,0,0,473,342,11,1,0,1,0,0,355,828
7382,26,421,14,1,0,0,0,0,436,322,28,0,0,0,0,0,350,786
7382,27,408,21,1,0,0,0,0,430,335,34,0,0,0,0,0,369,799
7382,28,380,28,0,0,0,0,0,408,340,49,3,0,0,0,0,392,800
7382,29,422,24,0,0,0,0,0,446,321,56,0,0,1,0,0,378,824
7382,30,397,45,0,0,0,0,0,442,320,80,1,0,0,0,0,401,843
7382,31,388,66,1,0,0,0,0,455,308,117,2,0,0,0,0,427,882
7382,32,408,62,1,0,0,0,0,471,269,125,4,1,0,0,0,399,870
7382,33,370,91,1,0,0,0,0,462,252,167,3,2,0,0,0,424,886
7382,34,336,99,2,1,0,0,0,438,244,179,4,0,0,0,0,427,865
7382,35,353,157,2,0,0,0,0,512,231,186,9,1,1,0,0,428,940
7382,36,323,132,5,0,0,0,0,460,203,236,4,1,0,0,0,444,904
7382,37,323,194,6,0,0,0,0,523,196,224,8,2,0,0,0,430,953
7382,38,271,224,9,0,0,0,0,504,189,256,5,1,0,0,0,451,955
7382,39,292,219,2,0,0,0,0,513,165,245,13,5,1,0,0,429,942
7382,40,237,230,13,1,0,0,0,481,156,247,9,3,0,0,0,415,896
7382,41,249,228,10,0,0,0,0,487,160,283,11,6,0,0,0,460,947
7382,42,216,278,8,2,1,0,0,505,161,311,22,3,0,0,0,497,1002
7382,43,219,271,7,1,1,0,0,499,126,335,21,4,0,0,0,486,985
7382,44,217,274,13,2,1,0,0,507,127,337,16,2,0,0,0,482,989
7382,45,200,303,13,1,0,0,0,517,125,349,16,5,0,0,0,495,1012
7382,46,200,336,20,2,0,0,0,558,121,351,27,6,0,0,0,505,1063
7382,47,191,380,28,2,0,0,0,601,124,374,21,7,0,0,0,526,1127
7382,48,177,404,22,3,2,0,0,608,102,370,29,10,0,0,0,511,1119
7382,49,192,408,13,0,3,0,0,616,99,439,34,17,0,0,0,589,1205
7382,50,178,378,22,4,0,0,0,582,98,452,37,16,0,0,0,603,1185
7382,51,145,395,30,2,1,0,0,573,94,440,32,7,0,0,0,573,1146
7382,52,158,392,27,6,1,0,0,584,85,494,33,17,0,0,0,629,1213
7382,53,148,391,24,0,0,0,0,563,75,452,38,25,0,0,0,590,1153
7382,54,123,404,29,4,0,0,0,560,78,488,41,21,0,0,0,628,1188
7382,55,142,443,32,7,0,0,0,624,72,524,36,31,0,0,0,663,1287
7382,56,149,450,32,6,0,0,0,637,78,506,43,34,0,0,0,661,1298
7382,57,122,502,22,2,0,0,0,648,91,481,29,46,0,0,0,647,1295
7382,58,120,476,35,7,0,0,0,638,71,496,34,52,0,0,0,653,1291
7382,59,105,522,37,7,1,0,0,672,66,520,34,59,0,0,0,679,1351
7382,60,105,494,25,15,0,0,0,639,57,509,27,46,0,0,0,639,1278
7382,61,100,445,32,17,1,0,0,595,60,473,32,53,0,0,0,618,1213
7382,62,81,463,32,12,0,0,0,588,54,470,14,69,0,0,0,607,1195
7382,63,81,500,18,12,1,0,0,612,63,471,24,81,0,0,0,639,1251
7382,64,64,495,19,13,0,0,0,591,58,456,29,87,0,0,0,630,1221
7382,65,73,440,22,19,1,0,0,555,46,438,15,81,0,0,0,580,1135
7382,66,68,473,25,17,0,0,0,583,54,415,16,107,0,0,0,592,1175
7382,67,55,507,19,18,0,0,0,599,33,419,22,85,0,0,0,559,1158
7382,68,57,446,20,19,1,0,0,543,53,411,22,96,0,0,0,582,1125
7382,69,60,478,16,26,0,0,0,580,41,402,18,118,1,0,0,580,1160
7382,70,38,436,20,30,0,0,0,524,40,384,12,126,0,0,0,562,1086
7382,71,36,445,15,18,0,0,0,514,49,349,12,116,0,0,0,526,1040
7382,72,22,397,14,28,0,0,0,461,38,315,9,133,0,0,0,495,956
7382,73,34,397,12,27,0,0,0,470,31,321,8,161,0,0,0,521,991
7382,74,33,428,17,35,0,0,0,513,33,326,12,181,0,0,0,552,1065
7382,75,34,385,10,46,0,0,0,475,34,292,5,180,0,0,0,511,986
7382,76,26,380,13,42,0,0,0,461,32,287,10,187,0,0,0,516,977
7382,77,23,342,6,42,0,0,0,413,22,237,9,172,0,0,0,440,853
7382,78,25,242,6,37,0,0,0,310,15,166,2,148,0,0,0,331,641
7382,79,15,227,6,27,0,0,0,275,16,162,9,166,0,0,0,353,628
7382,80,18,191,2,37,0,0,0,248,19,144,3,148,0,0,0,314,562
7382,81,14,204,5,46,0,0,0,269,19,119,7,150,0,0,0,295,564
7382,82,9,193,6,32,0,0,0,240,24,130,3,189,0,0,0,346,586
7382,83,13,204,2,49,0,0,0,268,22,125,6,210,0,0,0,363,631
7382,84,11,200,5,52,0,0,0,268,14,115,2,238,0,0,0,369,637
7382,85,5,174,2,34,0,0,0,215,14,102,2,184,0,0,0,302,517
7382,86,12,138,0,46,0,0,0,196,16,66,3,212,0,0,0,297,493
7382,87,5,122,0,54,0,0,0,181,9,69,2,226,0,0,0,306,487
7382,88,5,100,2,50,0,0,0,157,17,42,2,182,0,0,0,243,400
7382,89,11,85,1,51,0,0,0,148,13,31,4,178,0,0,0,226,374
7382,90,5,69,1,43,0,0,0,118,20,40,2,174,0,0,0,236,354
7382,91,5,48,0,30,0,0,0,83,9,25,2,143,0,0,0,179,262
7382,92,1,47,0,32,0,0,0,80,9,17,1,143,0,0,0,170,250
7382,93,2,32,0,26,0,0,0,60,9,11,2,115,0,0,0,137,197
7382,94,0,20,0,21,0,0,0,41,6,8,1,91,0,0,0,106,147
7382,95,0,13,0,16,0,0,0,29,9,6,0,62,0,0,0,77,106
7382,96,2,7,0,9,0,0,0,18,3,5,0,52,0,0,0,60,78
7382,97,1,10,1,6,0,0,0,18,6,2,0,48,0,0,0,56,74
7382,98,0,4,0,3,0,0,0,7,3,2,0,27,0,0,0,32,39
7382,99,1,1,0,6,0,0,0,8,2,3,0,25,0,0,0,30,38
7382,100,1,6,0,6,0,0,0,13,3,1,1,40,0,0,0,45,58
7382,999,18287,19151,842,1210,15,0,0,39505,14509,18631,970,5614,7,0,0,39731,79236
7449,0,357,0,0,0,0,0,0,357,322,0,0,0,0,0,0,322,679
7449,1,355,0,0,0,0,0,0,355,315,0,0,0,0,0,0,315,670
7449,2,391,0,0,0,0,0,0,391,366,0,0,0,0,0,0,366,757
7449,3,376,0,0,0,0,0,0,376,366,0,0,0,0,0,0,366,742
7449,4,408,0,0,0,0,0,0,408,377,0,0,0,0,0,0,377,785
7449,5,425,0,0,0,0,0,0,425,428,0,0,0,0,0,0,428,853
7449,6,494,0,0,0,0,0,0,494,445,0,0,0,0,0,0,445,939
7449,7,511,0,0,0,0,0,0,511,424,0,0,0,0,0,0,424,935
7449,8,473,0,0,0,0,0,0,473,472,0,0,0,0,0,0,472,945
7449,9,523,0,0,0,0,0,0,523,455,0,0,0,0,0,0,455,978
7449,10,510,0,0,0,0,0,0,510,521,0,0,0,0,0,0,521,1031
7449,11,516,0,0,0,0,0,0,516,469,0,0,0,0,0,0,469,985
7449,12,594,0,0,0,0,0,0,594,530,0,0,0,0,0,0,530,1124
7449,13,588,0,0,0,0,0,0,588,593,0,0,0,0,0,0,593,1181
7449,14,613,0,0,0,0,0,0,613,518,0,0,0,0,0,0,518,1131
7449,15,616,0,0,0,0,0,0,616,553,0,0,0,0,0,0,553,1169
7449,16,605,0,0,0,0,0,0,605,599,0,0,0,0,0,0,599,1204
7449,17,644,0,0,0,0,0,0,644,534,0,0,0,0,0,0,534,1178
7449,18,660,0,0,0,0,0,0,660,595,0,0,0,0,0,0,595,1255
7449,19,619,0,0,0,0,0,0,619,599,0,0,0,0,0,0,599,1218
7449,20,682,0,0,0,0,0,0,682,584,1,0,0,0,0,0,585,1267
7449,21,620,0,0,0,0,0,0,620,601,1,0,0,0,0,0,602,1222
7449,22,669,1,0,0,0,0,0,670,630,1,0,0,0,0,0,631,1301
7449,23,697,1,0,0,0,0,0,698,611,7,0,0,0,0,0,618,1316
7449,24,695,2,0,0,0,0,0,697,632,11,0,0,0,0,0,643,1340
7449,25,687,2,0,0,0,0,0,689,574,12,0,0,0,0,0,586,1275
7449,26,715,3,0,0,0,0,0,718,572,26,1,0,0,0,0,599,1317
7449,27,658,7,0,0,0,0,0,665,572,23,1,0,0,0,0,596,1261
7449,28,671,25,0,0,0,0,0,696,543,58,0,0,0,0,0,601,1297
7449,29,650,22,1,0,0,1,0,674,562,65,5,0,0,1,0,633,1307
7449,30,692,40,1,0,0,0,0,733,520,85,4,0,0,0,0,609,1342
7449,31,672,41,4,0,1,0,0,718,595,102,1,0,1,0,0,699,1417
7449,32,746,70,1,0,0,0,0,817,549,145,6,1,2,0,0,703,1520
7449,33,654,111,1,0,0,0,0,766,567,167,6,0,2,1,0,743,1509
7449,34,667,129,1,0,1,0,0,798,486,190,5,1,1,0,0,683,1481
7449,35,642,108,2,0,0,0,0,752,484,240,10,1,0,0,0,735,1487
7449,36,658,209,2,0,1,0,0,870,463,282,6,1,1,0,0,753,1623
7449,37,564,168,6,0,0,1,0,739,451,297,11,2,2,0,0,763,1502
7449,38,630,203,10,0,0,0,0,843,409,340,15,4,1,1,0,770,1613
7449,39,601,266,17,1,0,0,0,885,422,401,22,1,0,0,0,846,1731
7449,40,622,303,10,0,0,0,0,935,421,393,23,1,0,0,0,838,1773
7449,41,635,342,12,2,0,0,0,991,367,457,32,10,0,0,0,866,1857
7449,42,557,377,16,0,0,0,0,950,392,453,34,5,0,0,0,884,1834
7449,43,551,377,19,0,0,0,0,947,383,500,38,7,0,0,0,928,1875
7449,44,526,418,29,0,2,0,0,975,355,549,48,12,0,0,0,964,1939
7449,45,563,483,24,6,1,0,0,1077,332,618,42,7,2,0,0,1001,2078
7449,46,531,508,26,6,0,0,0,1071,339,639,43,15,0,0,0,1036,2107
7449,47,537,562,39,4,1,1,0,1144,327,635,47,11,0,0,0,1020,2164
7449,48,526,555,34,2,0,0,0,1117,340,705,71,22,0,0,0,1138,2255
7449,49,520,664,45,6,0,0,0,1235,321,731,67,16,1,0,0,1136,2371
7449,50,456,635,42,3,1,0,0,1137,293,757,76,26,0,0,0,1152,2289
7449,51,440,680,56,6,1,0,0,1183,280,776,69,26,0,0,0,1151,2334
7449,52,422,738,56,6,0,0,0,1222,279,856,79,31,0,0,0,1245,2467
7449,53,433,741,57,6,1,0,0,1238,258,811,66,30,1,0,0,1166,2404
7449,54,395,794,58,9,0,0,0,1256,243,863,71,39,0,0,0,1216,2472
7449,55,345,750,58,7,1,0,0,1161,249,862,74,34,0,0,0,1219,2380
7449,56,359,821,65,17,2,0,0,1264,226,899,89,57,0,0,0,1271,2535
7449,57,309,848,79,11,1,0,0,1248,226,981,94,51,0,0,0,1352,2600
7449,58,299,883,68,20,0,0,0,1270,200,919,92,90,0,0,0,1301,2571
7449,59,283,880,92,18,0,0,0,1273,209,1005,91,70,0,0,0,1375,2648
7449,60,257,846,71,24,0,0,0,1198,180,1015,74,65,0,0,0,1334,2532
7449,61,240,939,67,18,1,0,0,1265,191,934,56,103,0,0,0,1284,2549
7449,62,243,889,71,21,0,0,0,1224,178,914,68,102,0,0,0,1262,2486
7449,63,210,858,55,22,0,0,0,1145,141,892,53,114,0,0,0,1200,2345
7449,64,226,891,56,23,0,0,0,1196,115,857,55,141,0,0,0,1168,2364
7449,65,186,827,53,27,0,0,0,1093,127,880,56,157,0,0,0,1220,2313
7449,66,181,860,55,29,0,0,0,1125,145,841,44,163,0,0,0,1193,2318
7449,67,170,834,54,23,0,0,0,1081,148,776,44,177,1,0,0,1146,2227
7449,68,145,862,41,36,0,0,0,1084,120,781,43,179,1,0,0,1124,2208
7449,69,143,848,50,38,0,1,0,1080,112,754,37,217,0,0,0,1120,2200
7449,70,141,847,34,40,0,0,0,1062,122,711,47,207,0,0,0,1087,2149
7449,71,130,763,32,48,0,0,0,973,109,698,33,218,0,0,0,1058,2031
7449,72,129,779,37,52,0,0,0,997,122,617,31,275,0,0,0,1045,2042
7449,73,139,781,31,75,0,0,0,1026,125,608,29,266,0,0,0,1028,2054
7449,74,112,734,25,59,0,0,0,930,104,595,28,285,0,0,0,1012,1942
7449,75,94,691,24,73,0,0,0,882,122,557,18,283,0,0,0,980,1862
7449,76,97,652,15,71,0,0,0,835,108,519,25,315,0,0,0,967,1802
7449,77,78,609,22,65,0,0,0,774,106,439,19,320,0,0,0,884,1658
7449,78,84,556,15,70,0,0,0,725,102,369,13,314,0,0,0,798,1523
7449,79,79,552,13,86,0,0,0,730,117,396,10,424,0,0,0,947,1677
7449,80,60,481,11,63,0,0,0,615,99,353,12,397,0,0,0,861,1476
7449,81,64,456,9,80,0,0,0,609,98,310,10,394,0,0,0,812,1421
7449,82,58,387,13,66,0,0,0,524,78,219,8,353,0,0,0,658,1182
7449,83,70,388,10,98,0,0,0,566,127,229,7,487,0,0,0,850,1416
7449,84,62,387,14,108,0,0,0,571,100,197,8,418,0,0,0,723,1294
7449,85,36,297,6,86,0,0,0,425,83,172,6,395,0,0,0,656,1081
7449,86,34,254,1,70,0,0,0,359,86,109,2,383,0,0,0,580,939
7449,87,47,210,1,72,0,0,0,330,99,99,9,370,0,0,0,577,907
7449,88,31,163,1,68,0,0,0,263,76,72,6,357,0,0,0,511,774
7449,89,21,152,5,69,0,0,0,247,65,56,5,322,0,0,0,448,695
7449,90,24,126,1,71,0,0,0,222,48,35,5,339,0,0,0,427,649
7449,91,16,107,5,47,0,0,0,175,61,28,0,264,0,0,0,353,528
7449,92,9,65,1,51,0,0,0,126,36,30,1,217,0,0,0,284,410
7449,93,14,39,1,40,0,0,0,94,46,13,5,168,0,0,0,232,326
7449,94,5,35,0,36,0,0,0,76,28,8,0,150,0,0,0,186,262
7449,95,3,20,0,22,0,0,0,45,26,7,1,115,0,0,0,149,194
7449,96,4,12,0,17,0,0,0,33,15,5,0,86,0,0,0,106,139
7449,97,2,10,0,13,0,0,0,25,9,3,0,62,0,0,0,74,99
7449,98,1,4,0,6,0,0,0,11,10,0,2,41,0,0,0,53,64
7449,99,1,2,0,9,0,0,0,12,9,1,0,31,0,0,0,41,53
7449,100,2,2,0,6,0,0,0,10,8,2,0,40,0,0,0,50,60
7449,999,36505,32982,1831,2128,15,4,0,73465,30149,32964,2209,10285,16,3,0,75626,149091
7502,0,452,0,0,0,0,0,0,452,405,0,0,0,0,0,0,405,857
7502,1,450,0,0,0,0,0,0,450,409,0,0,0,0,0,0,409,859
7502,2,439,0,0,0,0,0,0,439,455,0,0,0,0,0,0,455,894
7502,3,481,0,0,0,0,0,0,481,446,0,0,0,0,0,0,446,927
7502,4,485,0,0,0,0,0,0,485,490,0,0,0,0,0,0,490,975
7502,5,504,0,0,0,0,0,0,504,536,0,0,0,0,0,0,536,1040
7502,6,539,0,0,0,0,0,0,539,454,0,0,0,0,0,0,454,993
7502,7,596,0,0,0,0,0,0,596,560,0,0,0,0,0,0,560,1156
7502,8,575,0,0,0,0,0,0,575,544,0,0,0,0,0,0,544,1119
7502,9,621,0,0,0,0,0,0,621,576,0,0,0,0,0,0,576,1197
7502,10,640,0,0,0,0,0,0,640,562,0,0,0,0,0,0,562,1202
7502,11,690,0,0,0,0,0,0,690,621,0,0,0,0,0,0,621,1311
7502,12,617,0,0,0,0,0,0,617,662,0,0,0,0,0,0,662,1279
7502,13,686,0,0,0,0,0,0,686,681,0,0,0,0,0,0,681,1367
7502,14,668,0,0,0,0,0,0,668,724,0,0,0,0,0,0,724,1392
7502,15,733,0,0,0,0,0,0,733,696,0,0,0,0,0,0,696,1429
7502,16,772,0,0,0,0,0,0,772,713,0,0,0,0,0,0,713,1485
7502,17,781,0,0,0,0,0,0,781,691,0,0,0,0,0,0,691,1472
7502,18,784,0,0,0,0,0,0,784,699,1,0,0,0,0,0,700,1484
7502,19,781,0,0,0,0,0,0,781,683,2,1,0,0,0,0,686,1467
7502,20,813,1,1,0,0,0,0,815,726,4,0,0,0,0,0,730,1545
7502,21,794,2,0,0,0,0,0,796,716,6,0,0,0,0,0,722,1518
7502,22,764,2,0,0,0,0,0,766,735,15,0,0,0,0,0,750,1516
7502,23,843,3,2,0,1,0,0,849,719,22,1,0,0,1,0,743,1592
7502,24,852,9,1,0,0,0,0,862,711,23,2,1,1,0,0,738,1600
7502,25,831,14,1,0,0,0,0,846,674,40,3,0,0,0,0,717,1563
7502,26,789,27,2,0,0,0,0,818,640,59,2,0,1,0,0,702,1520
7502,27,726,38,0,0,1,1,0,766,626,61,2,0,1,1,0,691,1457
7502,28,703,48,3,0,0,0,0,754,598,124,2,0,0,0,0,724,1478
7502,29,661,62,3,0,0,0,0,726,599,139,5,0,0,0,0,743,1469
7502,30,697,91,4,0,0,0,0,792,535,193,7,0,0,0,0,735,1527
7502,31,698,139,8,0,1,0,0,846,538,203,6,1,1,0,0,749,1595
7502,32,697,165,9,1,1,0,0,873,523,228,6,1,1,0,0,759,1632
7502,33,600,194,7,0,1,1,0,803,470,259,13,3,0,0,0,745,1548
7502,34,585,209,2,0,3,0,0,799,420,278,13,4,1,0,0,716,1515
7502,35,616,229,11,0,2,0,0,858,447,349,15,1,5,1,0,818,1676
7502,36,495,233,10,1,3,0,0,742,356,325,24,3,3,0,0,711,1453
7502,37,496,306,12,1,4,0,0,819,336,370,33,2,1,0,0,742,1561
7502,38,479,286,18,2,3,0,0,788,346,403,41,6,1,0,0,797,1585
7502,39,491,311,27,0,4,0,0,833,320,421,34,5,3,0,0,783,1616
7502,40,454,352,26,1,1,0,0,834,307,401,41,11,2,0,0,762,1596
7502,41,452,374,28,2,1,0,0,857,387,473,51,4,1,0,0,916,1773
7502,42,406,388,42,2,2,0,0,840,327,521,58,6,3,0,0,915,1755
7502,43,451,423,31,4,1,0,0,910,364,547,73,8,2,0,0,994,1904
7502,44,435,409,51,3,2,0,0,900,329,526,74,6,0,0,0,935,1835
7502,45,483,548,52,3,4,0,0,1090,364,626,97,13,0,0,0,1100,2190
7502,46,472,579,53,7,3,0,0,1114,341,660,92,15,2,0,0,1110,2224
7502,47,492,584,76,7,1,0,0,1160,317,743,117,28,0,0,0,1205,2365
7502,48,485,642,74,4,2,0,0,1207,357,764,127,28,6,0,0,1282,2489
7502,49,507,701,101,4,3,0,0,1316,327,843,126,25,1,0,0,1322,2638
7502,50,534,724,86,4,4,0,0,1352,287,830,135,26,0,0,0,1278,2630
7502,51,466,781,102,7,1,0,0,1357,307,861,183,28,3,0,0,1382,2739
7502,52,453,803,121,9,6,0,0,1392,275,937,176,31,1,0,0,1420,2812
7502,53,432,838,139,7,1,0,0,1417,265,946,176,51,1,0,0,1439,2856
7502,54,395,900,125,10,2,0,0,1432,256,961,172,41,1,0,0,1431,2863
7502,55,406,873,154,13,4,0,0,1450,252,1019,195,55,1,1,0,1523,2973
7502,56,360,919,144,16,0,0,0,1439,253,994,198,84,2,0,0,1531,2970
7502,57,340,998,144,17,5,0,0,1504,225,968,175,56,0,0,0,1424,2928
7502,58,328,983,147,23,1,0,0,1482,204,1082,219,78,0,0,0,1583,3065
7502,59,322,997,190,23,5,0,0,1537,202,1072,202,82,1,0,0,1559,3096
7502,60,256,988,136,21,0,0,0,1401,148,984,184,78,0,0,0,1394,2795
7502,61,245,892,144,29,3,0,0,1313,139,927,167,91,1,0,0,1325,2638
7502,62,201,952,145,27,0,0,0,1325,136,941,192,128,2,0,0,1399,2724
7502,63,201,896,119,37,1,0,0,1254,127,923,167,130,0,0,0,1347,2601
7502,64,179,864,135,31,1,0,0,1210,119,826,134,161,0,0,0,1240,2450
7502,65,165,836,105,43,0,0,0,1149,102,835,144,145,0,0,0,1226,2375
7502,66,136,892,128,39,1,0,0,1196,107,848,118,181,0,0,0,1254,2450
7502,67,144,857,103,45,2,0,0,1151,103,792,122,177,0,0,0,1194,2345
7502,68,121,853,95,39,1,0,0,1109,100,848,135,196,0,0,0,1279,2388
7502,69,118,851,77,43,0,0,0,1089,81,838,123,211,0,0,1,1254,2343
7502,70,99,857,85,46,0,0,1,1088,81,765,87,234,0,0,0,1167,2255
7502,71,108,837,85,70,0,0,0,1100,80,789,93,244,0,0,0,1206,2306
7502,72,80,814,63,77,0,0,0,1034,61,743,99,284,0,0,0,1187,2221
7502,73,76,806,68,71,0,0,0,1021,76,829,61,335,0,0,0,1301,2322
7502,74,90,869,69,89,0,0,0,1117,65,730,77,324,0,0,0,1196,2313
7502,75,93,875,67,101,0,0,0,1136,78,747,65,377,1,0,0,1268,2404
7502,76,81,786,52,83,0,0,0,1002,58,671,62,390,0,0,0,1181,2183
7502,77,70,732,42,112,1,0,0,957,62,641,58,412,0,0,0,1173,2130
7502,78,53,556,30,99,0,0,0,738,52,413,53,348,0,0,0,866,1604
7502,79,67,590,27,97,0,0,0,781,55,446,30,420,0,0,0,951,1732
7502,80,52,527,28,103,0,0,0,710,44,380,30,446,0,0,0,900,1610
7502,81,49,530,20,102,0,0,0,701,41,397,43,489,0,0,0,970,1671
7502,82,51,482,27,113,1,0,0,674,63,359,41,511,0,0,0,974,1648
7502,83,49,511,16,130,0,0,0,706,51,348,40,600,0,0,0,1039,1745
7502,84,31,461,11,125,0,0,0,628,52,312,41,588,0,0,0,993,1621
7502,85,41,369,11,141,0,0,0,562,55,251,22,621,0,0,0,949,1511
7502,86,26,313,16,121,0,0,0,476,48,180,20,518,0,0,0,766,1242
7502,87,22,276,8,117,0,0,0,423,30,135,15,494,0,0,0,674,1097
7502,88,23,219,8,92,0,0,0,342,35,110,15,511,0,0,0,671,1013
7502,89,10,190,9,90,0,0,0,299,51,70,14,462,0,0,0,597,896
7502,90,7,119,3,73,0,0,0,202,40,57,10,429,0,0,0,536,738
7502,91,14,96,0,68,0,0,0,178,25,35,7,378,0,0,0,445,623
7502,92,8,69,1,62,0,0,0,140,24,24,3,328,0,0,0,379,519
7502,93,5,68,1,60,0,0,0,134,20,23,2,262,0,0,0,307,441
7502,94,4,27,0,37,0,0,0,68,20,4,3,228,0,0,0,255,323
7502,95,1,18,0,26,0,0,0,45,10,5,4,152,0,0,0,171,216
7502,96,2,13,0,21,0,0,0,36,9,4,4,141,0,0,0,158,194
7502,97,2,8,0,12,0,0,0,22,10,4,0,81,0,0,0,95,117
7502,98,1,2,0,9,0,0,0,12,4,0,0,50,0,0,0,54,66
7502,99,0,3,0,2,0,0,0,5,4,1,1,42,0,0,0,48,53
7502,100,2,0,0,7,0,0,0,9,12,2,1,64,0,0,0,79,88
7502,999,37580,37089,3941,2881,84,2,1,81578,31066,37536,5384,12964,50,4,1,87005,168583
7577,0,1056,0,0,0,0,0,0,1056,993,0,0,0,0,0,0,993,2049
7577,1,1086,0,0,0,0,0,0,1086,1040,0,0,0,0,0,0,1040,2126
7577,2,1104,0,0,0,0,0,0,1104,1034,0,0,0,0,0,0,1034,2138
7577,3,1128,0,0,0,0,0,0,1128,1106,0,0,0,0,0,0,1106,2234
7577,4,1268,0,0,0,0,0,0,1268,1134,0,0,0,0,0,0,1134,2402
7577,5,1289,0,0,0,0,0,0,1289,1169,0,0,0,0,0,0,1169,2458
7577,6,1441,0,0,0,0,0,0,1441,1275,0,0,0,0,0,0,1275,2716
7577,7,1287,0,0,0,0,0,0,1287,1368,0,0,0,0,0,0,1368,2655
7577,8,1515,0,0,0,0,0,0,1515,1426,0,0,0,0,0,0,1426,2941
7577,9,1433,0,0,0,0,0,0,1433,1374,0,0,0,0,0,0,1374,2807
7577,10,1494,0,0,0,0,0,0,1494,1473,0,0,0,0,0,0,1473,2967
7577,11,1573,0,0,0,0,0,0,1573,1543,0,0,0,0,0,0,1543,3116
7577,12,1616,0,0,0,0,0,0,1616,1564,0,0,0,0,0,0,1564,3180
7577,13,1760,0,0,0,0,0,0,1760,1599,0,0,0,0,0,0,1599,3359
7577,14,1788,0,0,0,0,0,0,1788,1574,0,0,0,0,0,0,1574,3362
7577,15,1747,0,0,0,0,0,0,1747,1669,0,0,0,0,0,0,1669,3416
7577,16,1742,0,0,0,0,0,0,1742,1642,0,0,0,0,0,0,1642,3384
7577,17,1674,0,0,0,0,0,0,1674,1635,0,0,0,0,0,0,1635,3309
7577,18,1760,0,0,0,0,0,0,1760,1628,0,0,0,0,0,0,1628,3388
7577,19,1678,0,0,0,0,0,0,1678,1591,1,0,0,0,0,0,1592,3270
7577,20,1656,1,0,0,0,0,0,1657,1615,6,0,0,0,0,0,1621,3278
7577,21,1732,0,0,0,0,0,0,1732,1703,15,0,0,0,0,0,1718,3450
7577,22,1708,4,0,1,0,0,0,1713,1603,34,0,0,0,0,0,1637,3350
7577,23,1790,6,0,0,0,0,0,1796,1602,50,3,0,0,0,0,1655,3451
7577,24,1793,11,2,0,1,0,0,1807,1519,68,4,1,0,0,0,1592,3399
7577,25,1793,28,3,0,0,0,0,1824,1467,97,1,0,1,0,0,1566,3390
7577,26,1771,41,2,0,1,0,0,1815,1448,152,1,0,0,0,0,1601,3416
7577,27,1797,63,5,0,1,0,0,1866,1394,222,7,0,2,0,0,1625,3491
7577,28,1635,99,3,1,2,0,0,1740,1314,280,8,0,1,0,0,1603,3343
7577,29,1614,163,4,0,3,0,0,1784,1230,348,9,0,1,0,0,1588,3372
7577,30,1476,222,8,0,2,0,0,1708,1176,463,5,0,4,0,0,1648,3356
7577,31,1496,287,3,0,3,0,0,1789,1091,537,11,1,1,0,0,1641,3430
7577,32,1401,338,7,1,1,1,0,1749,1005,599,16,2,2,0,0,1624,3373
7577,33,1318,404,9,1,2,0,0,1734,905,678,16,4,2,0,0,1605,3339
7577,34,1256,512,15,3,2,0,0,1788,881,762,23,2,2,0,0,1670,3458
7577,35,1145,620,20,2,4,0,0,1791,843,858,34,1,3,0,0,1739,3530
7577,36,1044,690,20,0,4,0,0,1758,734,915,43,4,1,0,0,1697,3455
7577,37,1071,704,29,1,3,0,0,1808,615,956,43,6,4,0,0,1624,3432
7577,38,958,773,26,4,1,0,0,1762,677,1036,46,11,3,1,0,1774,3536
7577,39,944,825,34,3,1,0,0,1807,615,1047,70,11,4,0,0,1747,3554
7577,40,863,899,37,1,3,1,0,1804,596,1144,99,2,4,0,0,1845,3649
7577,41,921,1034,44,6,2,0,0,2007,580,1219,91,11,1,0,0,1902,3909
7577,42,912,1074,67,6,4,0,0,2063,584,1266,76,23,3,0,0,1952,4015
7577,43,826,1060,70,9,2,0,0,1967,572,1282,105,16,0,0,0,1975,3942
7577,44,871,1136,70,5,1,0,0,2083,587,1353,108,20,2,0,0,2070,4153
7577,45,823,1230,100,6,2,2,0,2163,557,1535,133,19,1,0,0,2245,4408
7577,46,829,1414,102,9,1,0,0,2355,534,1627,163,22,3,0,0,2349,4704
7577,47,889,1514,100,14,1,0,0,2518,563,1630,157,35,1,0,0,2386,4904
7577,48,873,1619,133,16,3,0,0,2644,502,1734,218,38,4,0,0,2496,5140
7577,49,909,1682,143,17,3,0,0,2754,552,1783,215,43,3,0,1,2597,5351
7577,50,816,1733,168,12,1,0,0,2730,520,1815,240,58,1,0,0,2634,5364
7577,51,778,1691,176,16,2,0,0,2663,478,1921,236,39,3,0,0,2677,5340
7577,52,781,1698,185,16,3,0,0,2683,489,1866,237,73,0,0,0,2665,5348
7577,53,690,1855,187,19,1,0,0,2752,444,1872,229,81,3,0,0,2629,5381
7577,54,724,1870,209,16,2,0,0,2821,428,1924,254,61,1,0,0,2668,5489
7577,55,691,1902,212,16,2,1,0,2824,426,1968,264,79,2,0,0,2739,5563
7577,56,620,1898,226,22,7,0,0,2773,407,2014,284,101,2,0,0,2808,5581
7577,57,608,2097,216,25,1,0,1,2948,377,2155,245,92,2,0,0,2871,5819
7577,58,556,2024,202,27,5,0,0,2814,405,2068,263,128,1,0,0,2865,5679
7577,59,545,2038,247,41,2,0,0,2873,337,1988,215,129,1,0,0,2670,5543
7577,60,446,1922,192,29,3,0,0,2592,330,1906,243,126,1,0,0,2606,5198
7577,61,394,1845,204,56,4,0,0,2503,299,1780,217,168,2,0,0,2466,4969
7577,62,349,1787,173,41,2,0,0,2352,269,1814,177,176,0,0,0,2436,4788
7577,63,338,1770,143,54,3,0,0,2308,283,1716,182,195,1,0,0,2377,4685
7577,64,310,1724,159,46,1,0,0,2240,262,1708,167,204,1,0,0,2342,4582
7577,65,293,1675,135,47,4,0,0,2154,207,1646,163,225,2,0,0,2243,4397
7577,66,251,1604,117,50,0,0,0,2022,236,1587,115,268,2,0,0,2208,4230
7577,67,221,1726,122,76,4,0,0,2149,190,1561,125,289,1,0,1,2167,4316
7577,68,239,1619,98,75,4,0,0,2035,188,1497,100,317,0,0,0,2102,4137
7577,69,195,1565,83,78,0,0,1,1922,192,1416,113,322,2,0,0,2045,3967
7577,70,187,1497,79,75,0,0,0,1838,159,1380,108,345,0,0,0,1992,3830
7577,71,178,1525,62,91,3,0,0,1859,145,1321,86,379,0,0,0,1931,3790
7577,72,179,1476,72,96,0,0,1,1824,183,1392,86,428,0,0,0,2089,3913
7577,73,171,1473,69,122,0,0,0,1835,163,1352,75,503,0,0,0,2093,3928
7577,74,184,1508,59,117,0,0,0,1868,168,1299,71,537,0,0,0,2075,3943
7577,75,144,1486,64,144,1,0,0,1839,159,1224,70,618,0,0,0,2071,3910
7577,76,149,1386,57,143,1,0,0,1736,149,1143,55,653,0,0,0,2000,3736
7577,77,127,1395,41,167,0,0,0,1730,145,1049,49,692,0,0,0,1935,3665
7577,78,99,1051,29,146,0,0,0,1325,94,771,46,564,0,0,0,1475,2800
7577,79,95,1026,24,149,0,0,0,1294,99,720,37,696,0,0,0,1552,2846
7577,80,76,939,19,130,0,0,0,1164,98,735,36,625,0,0,0,1494,2658
7577,81,79,889,25,147,0,0,0,1140,113,611,29,758,0,0,0,1511,2651
7577,82,92,879,14,183,1,0,0,1169,113,585,22,801,0,0,0,1521,2690
7577,83,95,883,16,179,0,0,0,1173,126,559,19,828,0,0,0,1532,2705
7577,84,88,766,12,198,0,0,0,1064,127,428,13,886,0,0,0,1454,2518
7577,85,65,715,6,181,0,0,0,967,122,400,20,886,0,0,0,1428,2395
7577,86,43,545,9,164,0,0,0,761,100,282,11,805,0,0,0,1198,1959
7577,87,46,391,4,159,0,0,0,600,85,198,12,720,0,0,0,1015,1615
7577,88,36,318,5,130,0,0,0,489,78,144,11,728,0,0,0,961,1450
7577,89,24,264,7,119,0,0,0,414,75,79,4,629,0,0,0,787,1201
7577,90,23,229,2,109,0,0,0,363,76,83,5,578,0,0,0,742,1105
7577,91,19,167,4,95,0,0,0,285,59,54,3,540,0,0,0,656,941
7577,92,13,124,1,73,0,0,0,211,59,39,4,424,0,0,0,526,737
7577,93,10,86,2,58,0,0,0,156,43,21,4,360,0,0,0,428,584
7577,94,8,47,0,46,0,0,0,101,36,11,3,262,0,0,0,312,413
7577,95,7,28,0,44,0,0,0,79,25,8,0,223,0,0,0,256,335
7577,96,3,18,0,30,0,0,0,51,25,9,4,166,0,0,0,204,255
7577,97,2,15,0,21,0,0,0,38,18,3,1,107,0,0,0,129,167
7577,98,3,6,0,15,0,0,0,24,11,0,0,70,0,0,0,81,105
7577,99,0,2,0,7,0,0,0,9,8,0,1,61,0,0,0,70,79
7577,100,1,3,0,14,0,0,0,18,10,2,0,85,0,0,0,97,115
7577,999,79644,75633,5192,4220,110,5,3,164807,66539,75821,6659,19360,81,1,2,168463,333270
7649,0,780,0,0,0,0,0,0,780,763,0,0,0,0,0,0,763,1543
7649,1,873,0,0,0,0,0,0,873,779,0,0,0,0,0,0,779,1652
7649,2,848,0,0,0,0,0,0,848,861,0,0,0,0,0,0,861,1709
7649,3,859,0,0,0,0,0,0,859,806,0,0,0,0,0,0,806,1665
7649,4,927,0,0,0,0,0,0,927,888,0,0,0,0,0,0,888,1815
7649,5,993,0,0,0,0,0,0,993,867,0,0,0,0,0,0,867,1860
7649,6,1036,0,0,0,0,0,0,1036,946,0,0,0,0,0,0,946,1982
7649,7,1056,0,0,0,0,0,0,1056,1025,0,0,0,0,0,0,1025,2081
7649,8,1059,0,0,0,0,0,0,1059,1035,0,0,0,0,0,0,1035,2094
7649,9,1116,0,0,0,0,0,0,1116,1057,0,0,0,0,0,0,1057,2173
7649,10,1106,0,0,0,0,0,0,1106,1019,0,0,0,0,0,0,1019,2125
7649,11,1134,0,0,0,0,0,0,1134,1064,0,0,0,0,0,0,1064,2198
7649,12,1184,0,0,0,0,0,0,1184,1050,0,0,0,0,0,0,1050,2234
7649,13,1144,0,0,0,0,0,0,1144,1115,0,0,0,0,0,0,1115,2259
7649,14,1299,0,0,0,0,0,0,1299,1161,0,0,0,0,0,0,1161,2460
7649,15,1223,0,0,0,0,0,0,1223,1083,0,0,0,0,0,0,1083,2306
7649,16,1234,0,1,0,0,0,0,1235,1105,0,0,0,0,0,0,1105,2340
7649,17,1202,0,0,0,0,0,0,1202,1110,0,0,0,0,0,0,1110,2312
7649,18,1207,0,0,0,0,0,0,1207,1098,0,0,0,0,0,0,1098,2305
7649,19,1184,0,0,0,0,0,0,1184,1157,4,0,0,0,0,0,1161,2345
7649,20,1172,1,0,0,0,0,0,1173,1081,10,0,0,0,0,0,1091,2264
7649,21,1077,2,0,0,0,0,0,1079,1051,20,2,0,0,0,0,1073,2152
7649,22,1193,3,0,0,0,0,0,1196,1017,34,1,0,0,0,0,1052,2248
7649,23,1192,8,0,0,0,0,0,1200,1036,51,1,0,0,0,0,1088,2288
7649,24,1208,14,0,0,0,0,0,1222,1015,80,4,0,0,0,0,1099,2321
7649,25,1213,26,1,0,0,1,0,1241,963,110,2,0,1,0,0,1076,2317
7649,26,1143,43,0,0,0,0,0,1186,966,144,4,0,0,0,0,1114,2300
7649,27,1169,70,4,0,0,0,0,1243,964,180,3,0,0,0,0,1147,2390
7649,28,1125,87,3,0,0,0,0,1215,885,226,8,1,2,0,0,1122,2337
7649,29,1053,125,5,0,2,1,0,1186,860,311,8,1,2,0,0,1182,2368
7649,30,1038,185,3,0,1,0,0,1227,758,350,9,0,2,0,0,1119,2346
7649,31,1071,248,4,0,3,0,0,1326,787,419,7,1,1,1,0,1216,2542
7649,32,934,307,5,0,1,0,0,1247,697,500,18,1,5,0,0,1221,2468
7649,33,928,325,7,2,1,0,0,1263,724,511,13,2,2,0,0,1252,2515
7649,34,924,426,13,0,1,0,0,1364,655,590,12,3,3,0,0,1263,2627
7649,35,847,483,12,0,2,0,0,1344,574,695,25,1,4,0,0,1299,2643
7649,36,849,507,18,1,0,0,0,1375,542,744,32,7,2,0,0,1327,2702
7649,37,779,567,26,2,1,2,0,1377,516,753,44,10,1,0,0,1324,2701
7649,38,699,672,29,1,5,0,0,1406,482,765,40,7,1,0,0,1295,2701
7649,39,741,620,19,0,0,0,0,1380,464,886,56,5,2,0,0,1413,2793
7649,40,700,720,43,3,2,0,0,1468,447,830,55,10,3,1,0,1346,2814
7649,41,655,805,37,5,2,0,0,1504,406,911,73,16,4,0,0,1410,2914
7649,42,627,791,52,7,0,0,0,1477,427,910,80,13,5,0,0,1435,2912
7649,43,597,885,60,7,2,0,0,1551,385,1025,77,18,3,0,0,1508,3059
7649,44,590,954,57,5,3,0,0,1609,402,1020,86,20,1,0,0,1529,3138
7649,45,594,958,65,6,1,0,0,1624,377,1106,102,14,3,0,0,1602,3226
7649,46,628,1071,73,6,5,0,0,1783,398,1115,122,20,0,0,0,1655,3438
7649,47,617,1062,74,8,1,0,0,1762,352,1181,124,24,1,0,0,1682,3444
7649,48,636,1125,78,5,6,0,0,1850,405,1309,130,21,2,0,0,1867,3717
7649,49,592,1234,106,4,7,0,1,1944,383,1343,147,38,3,0,0,1914,3858
7649,50,565,1248,103,8,3,0,0,1927,351,1293,131,28,0,0,0,1803,3730
7649,51,533,1305,115,4,1,0,0,1958,381,1292,160,30,1,0,0,1864,3822
7649,52,529,1279,120,12,3,0,0,1943,295,1352,161,51,1,0,0,1860,3803
7649,53,521,1338,130,14,2,0,0,2005,282,1308,158,49,0,0,0,1797,3802
7649,54,467,1336,141,19,3,0,0,1966,288,1426,184,57,0,0,0,1955,3921
7649,55,463,1358,153,19,2,0,0,1995,292,1383,176,66,1,0,0,1918,3913
7649,56,429,1386,148,15,2,0,0,1980,270,1454,177,69,2,0,0,1972,3952
7649,57,419,1426,142,27,2,0,0,2016,230,1376,171,94,1,0,0,1872,3888
7649,58,367,1471,161,33,1,0,0,2033,199,1402,191,93,1,0,0,1886,3919
7649,59,330,1356,156,26,4,0,0,1872,191,1332,152,102,0,0,0,1777,3649
7649,60,302,1351,114,26,3,0,0,1796,200,1230,151,119,0,0,0,1700,3496
7649,61,249,1243,130,35,3,0,0,1660,145,1260,134,108,0,0,0,1647,3307
7649,62,271,1162,100,35,1,0,0,1569,148,1163,120,145,0,0,0,1576,3145
7649,63,181,1173,122,34,3,0,0,1513,141,1128,139,172,1,0,0,1581,3094
7649,64,199,1201,87,33,1,0,0,1521,132,1120,111,188,2,0,0,1553,3074
7649,65,185,1085,74,48,0,0,0,1392,114,1011,111,187,1,0,0,1424,2816
7649,66,154,1075,96,47,1,0,0,1373,126,986,103,227,0,0,0,1442,2815
7649,67,134,1059,61,53,0,0,0,1307,90,1024,93,247,0,0,0,1454,2761
7649,68,129,976,81,51,0,0,0,1237,94,988,85,203,0,0,0,1370,2607
7649,69,125,992,59,51,0,0,0,1227,89,971,74,272,0,0,0,1406,2633
7649,70,112,949,61,57,0,0,0,1179,74,810,62,248,0,0,0,1194,2373
7649,71,114,958,53,63,0,0,0,1188,77,829,69,315,1,0,0,1291,2479
7649,72,108,905,44,72,0,0,0,1129,75,801,46,261,0,0,0,1183,2312
7649,73,131,973,41,81,0,0,0,1226,72,799,56,358,1,0,1,1287,2513
7649,74,107,952,35,85,0,0,0,1179,70,760,51,418,0,0,0,1299,2478
7649,75,99,932,45,109,2,0,0,1187,60,759,49,397,0,0,0,1265,2452
7649,76,74,844,27,97,0,0,0,1042,72,680,36,457,0,0,0,1245,2287
7649,77,64,829,31,110,0,0,0,1034,55,667,37,476,0,0,0,1235,2269
7649,78,59,590,21,100,0,0,0,770,50,451,25,406,0,0,0,932,1702
7649,79,55,591,22,96,0,0,0,764,56,426,23,444,0,0,0,949,1713
7649,80,50,543,14,99,0,0,0,706,60,398,24,498,0,0,0,980,1686
7649,81,63,518,14,95,1,0,0,691,50,353,18,497,0,0,0,918,1609
7649,82,46,484,9,118,0,0,0,657,55,269,18,580,0,0,0,922,1579
7649,83,49,457,14,114,0,0,0,634,44,291,23,598,0,0,0,956,1590
7649,84,53,432,7,139,0,0,0,631,49,241,15,612,0,0,0,917,1548
7649,85,44,334,11,141,0,0,0,530,41,177,14,611,0,0,0,843,1373
7649,86,24,286,4,114,0,0,0,428,54,160,10,518,0,0,0,742,1170
7649,87,27,214,4,84,0,0,0,329,41,116,6,502,0,0,0,665,994
7649,88,17,183,3,95,0,0,0,298,41,77,3,450,0,0,0,571,869
7649,89,15,133,3,60,0,0,0,211,31,55,2,388,0,0,0,476,687
7649,90,12,125,4,53,0,0,0,194,20,33,7,325,0,0,0,385,579
7649,91,10,65,1,62,0,0,0,138,14,31,7,334,0,0,0,386,524
7649,92,7,48,1,39,0,0,0,95,22,19,1,279,0,0,0,321,416
7649,93,8,54,1,32,0,0,0,95,21,6,1,208,0,0,0,236,331
7649,94,8,34,0,25,0,0,0,67,18,6,0,162,0,0,0,186,253
7649,95,1,8,1,32,0,0,0,42,7,12,0,103,0,0,0,122,164
7649,96,2,9,1,9,0,0,0,21,11,1,0,87,0,0,0,99,120
7649,97,0,3,0,18,0,0,0,21,7,0,1,61,0,0,0,69,90
7649,98,2,6,0,4,0,0,0,12,1,1,0,46,0,0,0,48,60
7649,99,0,1,0,3,0,0,0,4,5,1,0,35,0,0,0,41,45
7649,100,0,0,0,5,0,0,0,5,8,0,0,47,0,0,0,55,60
7649,999,55968,51604,3560,2863,84,4,1,114084,45327,51861,4671,13461,66,2,1,115389,229473
7691,0,1015,0,0,0,0,0,0,1015,938,0,0,0,0,0,0,938,1953
7691,1,1062,0,0,0,0,0,0,1062,1014,0,0,0,0,0,0,1014,2076
7691,2,1105,0,0,0,0,0,0,1105,989,0,0,0,0,0,0,989,2094
7691,3,1141,0,0,0,0,0,0,1141,1078,0,0,0,0,0,0,1078,2219
7691,4,1221,0,0,0,0,0,0,1221,1126,0,0,0,0,0,0,1126,2347
7691,5,1327,0,0,0,0,0,0,1327,1153,0,0,0,0,0,0,1153,2480
7691,6,1332,0,0,0,0,0,0,1332,1238,0,0,0,0,0,0,1238,2570
7691,7,1353,0,0,0,0,0,0,1353,1345,0,0,0,0,0,0,1345,2698
7691,8,1471,0,0,0,0,0,0,1471,1443,0,0,0,0,0,0,1443,2914
7691,9,1574,0,0,0,0,0,0,1574,1438,0,0,0,0,0,0,1438,3012
7691,10,1596,0,0,0,0,0,0,1596,1445,0,0,0,0,0,0,1445,3041
7691,11,1616,0,0,0,0,0,0,1616,1509,0,0,0,0,0,0,1509,3125
7691,12,1591,0,0,0,0,0,0,1591,1571,0,0,0,0,0,0,1571,3162
7691,13,1720,0,0,0,0,0,0,1720,1679,0,0,0,0,0,0,1679,3399
7691,14,1684,0,0,0,0,0,0,1684,1660,0,0,0,0,0,0,1660,3344
7691,15,1745,0,0,0,0,0,0,1745,1700,0,0,0,0,0,0,1700,3445
7691,16,1761,0,0,0,0,0,0,1761,1654,0,0,0,0,0,0,1654,3415
7691,17,1737,0,0,0,0,0,0,1737,1556,0,0,0,0,0,0,1556,3293
7691,18,1715,0,0,0,0,0,0,1715,1614,1,0,0,0,0,0,1615,3330
7691,19,1658,0,0,0,0,0,0,1658,1609,4,0,0,0,0,0,1613,3271
7691,20,1688,2,0,0,0,0,0,1690,1558,8,0,0,0,0,0,1566,3256
7691,21,1718,2,0,0,0,0,0,1720,1517,11,0,0,2,0,0,1530,3250
7691,22,1694,4,2,0,0,0,0,1700,1614,27,0,0,0,0,0,1641,3341
7691,23,1785,11,0,0,0,0,0,1796,1547,60,2,0,0,0,0,1609,3405
7691,24,1793,22,2,0,0,0,0,1817,1544,70,3,0,0,0,0,1617,3434
7691,25,1635,34,1,0,0,0,0,1670,1431,90,4,0,1,0,0,1526,3196
7691,26,1644,41,2,0,0,0,0,1687,1472,112,8,0,1,0,0,1593,3280
7691,27,1623,58,4,0,0,0,0,1685,1379,179,8,0,1,0,0,1567,3252
7691,28,1617,106,1,0,1,0,0,1725,1256,228,4,0,4,0,0,1492,3217
7691,29,1536,149,3,0,1,0,0,1689,1276,311,10,0,3,1,0,1601,3290
7691,30,1522,205,9,0,1,0,0,1737,1158,391,15,1,6,0,0,1571,3308
7691,31,1475,244,10,0,2,0,0,1731,1160,467,16,1,3,0,0,1647,3378
7691,32,1417,338,8,3,1,0,0,1767,1169,503,13,1,6,0,0,1692,3459
7691,33,1286,406,9,3,2,0,0,1706,1123,633,35,4,2,0,0,1797,3503
7691,34,1331,435,17,0,3,0,1,1787,1054,730,38,1,4,1,0,1828,3615
7691,35,1243,516,21,4,1,0,0,1785,990,788,48,4,6,0,0,1836,3621
7691,36,1134,532,20,0,3,0,1,1690,911,802,52,4,6,0,0,1775,3465
7691,37,1068,611,36,1,2,0,0,1718,917,915,75,11,4,1,0,1923,3641
7691,38,1129,725,40,3,8,0,0,1905,855,986,97,11,2,1,0,1952,3857
7691,39,1109,809,38,5,2,0,0,1963,901,1066,77,15,2,0,0,2061,4024
7691,40,1037,859,47,0,3,0,0,1946,940,1084,109,14,5,0,0,2152,4098
7691,41,1079,965,59,2,5,0,0,2110,890,1189,121,21,2,2,0,2225,4335
7691,42,1034,1059,71,7,3,0,0,2174,877,1183,112,19,4,2,0,2197,4371
7691,43,1048,996,73,4,3,0,0,2124,821,1239,155,26,2,0,0,2243,4367
7691,44,986,1171,115,8,8,0,0,2288,817,1377,132,31,2,0,0,2359,4647
7691,45,1047,1222,96,17,5,0,0,2387,852,1432,158,36,4,0,0,2482,4869
7691,46,1081,1352,118,9,4,1,0,2565,780,1593,195,35,2,0,0,2605,5170
7691,47,1013,1442,155,7,7,0,0,2624,849,1635,250,35,4,0,0,2773,5397
7691,48,1029,1518,164,13,5,0,0,2729,798,1778,247,56,3,0,0,2882,5611
7691,49,1072,1603,178,19,5,0,0,2877,862,1807,273,51,2,0,0,2995,5872
7691,50,971,1680,184,13,4,1,0,2853,719,1893,272,64,1,0,0,2949,5802
7691,51,918,1704,191,18,11,0,0,2842,699,1895,265,70,2,0,0,2931,5773
7691,52,891,1786,211,13,13,0,0,2914,692,1890,297,75,1,0,0,2955,5869
7691,53,770,1752,232,12,4,0,1,2771,684,1942,323,84,2,0,0,3035,5806
7691,54,812,1843,215,20,1,0,0,2891,632,1902,317,85,2,0,0,2938,5829
7691,55,692,1887,244,23,8,0,0,2854,590,1958,336,98,1,0,0,2983,5837
7691,56,686,1800,256,33,5,0,0,2780,581,1860,287,99,1,0,0,2828,5608
7691,57,621,1930,255,32,5,0,0,2843,496,1864,331,135,1,0,0,2827,5670
7691,58,613,1850,241,45,6,0,0,2755,458,1842,328,134,0,0,0,2762,5517
7691,59,554,1972,238,28,8,0,0,2800,467,2051,363,129,1,0,0,3011,5811
7691,60,472,1750,240,50,5,0,0,2517,425,1832,342,149,0,0,0,2748,5265
7691,61,445,1737,267,41,0,0,0,2490,318,1870,324,155,0,1,0,2668,5158
7691,62,377,1687,214,38,4,1,0,2321,305,1797,275,201,0,0,0,2578,4899
7691,63,342,1677,194,48,5,0,0,2266,282,1748,264,226,0,0,0,2520,4786
7691,64,327,1644,194,41,4,0,0,2210,246,1674,261,235,0,0,0,2416,4626
7691,65,264,1591,161,62,6,0,0,2084,292,1565,238,286,2,0,0,2383,4467
7691,66,262,1599,179,68,0,0,0,2108,226,1547,202,277,0,0,0,2252,4360
7691,67,247,1491,163,73,3,0,0,1977,191,1467,185,276,0,0,0,2119,4096
7691,68,199,1493,139,57,0,0,0,1888,192,1383,179,327,0,0,0,2081,3969
7691,69,167,1395,135,76,2,0,0,1775,162,1457,151,300,0,0,0,2070,3845
7691,70,180,1312,106,88,0,0,0,1686,162,1329,158,338,1,0,0,1988,3674
7691,71,146,1342,84,94,2,0,0,1668,148,1319,133,360,0,0,0,1960,3628
7691,72,134,1353,101,96,0,0,0,1684,121,1314,136,400,1,0,0,1972,3656
7691,73,114,1432,85,111,7,0,0,1749,110,1263,130,479,0,0,0,1982,3731
7691,74,126,1399,77,127,2,0,0,1731,115,1272,129,510,0,0,0,2026,3757
7691,75,117,1424,76,154,1,0,0,1772,112,1260,95,601,0,0,0,2068,3840
7691,76,108,1381,72,134,1,0,0,1696,86,1163,89,635,0,0,0,1973,3669
7691,77,91,1335,74,143,0,0,0,1643,114,1130,97,662,0,0,0,2003,3646
7691,78,87,1004,52,113,1,0,0,1257,74,810,71,579,0,0,0,1534,2791
7691,79,65,1002,47,134,0,0,0,1248,91,773,66,630,0,0,0,1560,2808
7691,80,73,1033,41,165,0,0,0,1312,79,744,57,669,0,0,0,1549,2861
7691,81,50,874,33,141,0,0,0,1098,82,568,54,679,0,0,0,1383,2481
7691,82,63,834,37,166,3,0,0,1103,51,565,51,741,0,0,0,1408,2511
7691,83,69,831,17,171,0,0,0,1088,65,581,49,851,0,0,0,1546,2634
7691,84,74,769,18,186,1,0,0,1048,58,458,43,822,0,0,0,1381,2429
7691,85,54,712,19,200,0,0,0,985,67,408,31,923,0,0,0,1429,2414
7691,86,45,566,12,180,0,0,0,803,57,282,25,794,0,0,0,1158,1961
7691,87,31,438,9,154,0,0,0,632,47,195,28,720,0,0,0,990,1622
7691,88,35,375,6,152,0,0,0,568,48,164,21,729,0,0,0,962,1530
7691,89,22,324,4,164,1,0,0,515,49,132,18,735,0,0,0,934,1449
7691,90,22,262,4,120,0,0,0,408,32,75,14,580,0,0,0,701,1109
7691,91,12,171,6,96,0,0,0,285,19,49,7,502,0,0,0,577,862
7691,92,17,164,0,92,0,0,0,273,32,39,4,456,0,0,0,531,804
7691,93,9,91,2,80,0,0,0,182,27,30,4,422,0,0,0,483,665
7691,94,3,64,2,60,0,0,0,129,23,12,5,282,0,0,0,322,451
7691,95,8,41,0,59,0,0,0,108,18,5,4,246,0,0,0,273,381
7691,96,1,24,0,31,0,0,0,56,9,4,1,182,0,0,0,196,252
7691,97,4,16,0,29,0,0,0,49,13,5,1,134,0,0,0,153,202
7691,98,0,8,0,11,0,0,0,19,4,1,0,79,0,0,0,84,103
7691,99,0,5,0,10,0,0,0,15,5,0,0,61,0,0,0,66,81
7691,100,3,5,0,11,0,0,0,19,5,1,0,100,0,0,0,106,125
7691,999,81690,72296,6436,4368,188,3,3,164984,71657,74087,9318,19683,99,9,0,174853,339837
7712,0,805,0,0,0,0,0,0,805,702,0,0,0,0,0,0,702,1507
7712,1,770,0,0,0,0,0,0,770,727,0,0,0,0,0,0,727,1497
7712,2,870,0,0,0,0,0,0,870,784,0,0,0,0,0,0,784,1654
7712,3,885,0,0,0,0,0,0,885,831,0,0,0,0,0,0,831,1716
7712,4,959,0,0,0,0,0,0,959,876,0,0,0,0,0,0,876,1835
7712,5,1012,0,0,0,0,0,0,1012,943,0,0,0,0,0,0,943,1955
7712,6,1126,0,0,0,0,0,0,1126,1000,0,0,0,0,0,0,1000,2126
7712,7,1120,0,0,0,0,0,0,1120,1078,0,0,0,0,0,0,1078,2198
7712,8,1126,0,0,0,0,0,0,1126,1029,0,0,0,0,0,0,1029,2155
7712,9,1205,0,0,0,0,0,0,1205,1092,0,0,0,0,0,0,1092,2297
7712,10,1198,0,0,0,0,0,0,1198,1108,0,0,0,0,0,0,1108,2306
7712,11,1267,0,0,0,0,0,0,1267,1231,0,0,0,0,0,0,1231,2498
7712,12,1285,0,0,0,0,0,0,1285,1233,0,0,0,0,0,0,1233,2518
7712,13,1440,0,0,0,0,0,0,1440,1243,0,0,0,0,0,0,1243,2683
7712,14,1430,0,0,0,0,0,0,1430,1297,0,0,0,0,0,0,1297,2727
7712,15,1442,0,0,0,0,0,0,1442,1319,0,0,0,0,0,0,1319,2761
7712,16,1433,0,0,0,0,0,0,1433,1338,0,0,0,0,0,0,1338,2771
7712,17,1486,0,0,0,0,0,0,1486,1376,0,0,0,0,0,0,1376,2862
7712,18,1500,0,0,0,0,0,0,1500,1342,1,0,0,0,0,0,1343,2843
7712,19,1371,0,0,0,0,0,0,1371,1297,1,0,0,0,0,0,1298,2669
7712,20,1378,1,0,0,0,0,0,1379,1235,6,0,0,0,0,0,1241,2620
7712,21,1381,0,0,0,0,0,0,1381,1224,9,0,0,0,0,0,1233,2614
7712,22,1355,0,3,0,0,0,0,1358,1172,24,2,0,0,0,0,1198,2556
7712,23,1397,5,8,0,0,0,0,1410,1209,29,2,0,0,0,0,1240,2650
7712,24,1321,17,4,0,0,0,0,1342,1093,36,5,0,0,0,0,1134,2476
7712,25,1321,19,3,0,0,0,0,1343,1155,54,1,0,0,0,0,1210,2553
7712,26,1304,17,4,0,0,0,0,1325,1031,78,1,1,0,0,0,1111,2436
7712,27,1248,39,1,0,0,0,0,1288,995,136,3,0,1,0,0,1135,2423
7712,28,1230,64,6,0,1,0,0,1301,972,165,3,0,0,0,0,1140,2441
7712,29,1141,90,0,0,0,0,0,1231,940,245,7,1,1,0,0,1194,2425
7712,30,1165,140,4,0,2,0,0,1311,937,266,10,0,1,0,0,1214,2525
7712,31,1176,187,7,0,0,0,0,1370,964,350,11,3,3,0,0,1331,2701
7712,32,1112,261,7,3,0,0,0,1383,863,441,16,3,3,0,0,1326,2709
7712,33,1262,338,6,4,4,0,0,1614,828,470,19,2,2,0,0,1321,2935
7712,34,1150,348,10,10,1,0,0,1519,877,575,22,0,2,0,0,1476,2995
7712,35,1110,424,12,5,1,0,0,1552,869,631,33,1,3,0,0,1537,3089
7712,36,1045,554,20,4,0,0,0,1623,779,751,47,8,4,0,0,1589,3212
7712,37,941,560,39,7,3,1,0,1551,773,794,65,12,2,1,0,1647,3198
7712,38,938,671,40,3,0,0,0,1652,674,843,76,13,3,0,0,1609,3261
7712,39,902,708,40,9,3,0,0,1662,687,943,62,14,2,0,0,1708,3370
7712,40,922,757,42,7,5,0,0,1733,670,947,73,8,1,0,0,1699,3432
7712,41,874,873,55,0,1,0,0,1803,715,1022,78,20,5,1,0,1841,3644
7712,42,799,975,63,18,2,0,0,1857,638,1017,109,25,4,0,0,1793,3650
7712,43,850,909,65,12,3,0,0,1839,628,1014,95,33,1,2,0,1773,3612
7712,44,769,966,70,15,4,0,0,1824,544,1190,113,38,0,1,0,1886,3710
7712,45,832,1050,92,21,4,0,0,1999,648,1120,123,44,2,0,0,1937,3936
7712,46,819,1074,63,20,4,0,0,1980,608,1193,172,38,2,0,0,2013,3993
7712,47,795,1150,116,18,4,0,0,2083,622,1348,165,46,3,0,0,2184,4267
7712,48,845,1216,118,28,3,0,0,2210,591,1352,158,58,2,1,0,2162,4372
7712,49,779,1276,111,21,7,1,1,2196,535,1417,189,54,2,0,0,2197,4393
7712,50,773,1335,148,23,10,0,0,2289,581,1461,235,48,4,0,0,2329,4618
7712,51,750,1345,143,20,4,0,0,2262,494,1401,214,61,0,0,0,2170,4432
7712,52,601,1434,150,15,11,0,0,2211,471,1491,212,85,2,0,0,2261,4472
7712,53,624,1470,137,10,6,0,0,2247,414,1424,196,93,0,0,0,2127,4374
7712,54,550,1507,149,13,3,0,0,2222,416,1453,209,77,3,0,0,2158,4380
7712,55,504,1453,150,17,4,0,0,2128,383,1499,206,88,1,0,0,2177,4305
7712,56,462,1344,159,21,1,1,0,1988,335,1488,202,89,2,0,0,2116,4104
7712,57,446,1423,201,27,8,0,0,2105,339,1480,213,98,3,0,0,2133,4238
7712,58,406,1460,180,33,5,0,0,2084,281,1504,216,119,1,0,0,2121,4205
7712,59,353,1478,155,35,5,0,0,2026,234,1538,193,135,2,0,0,2102,4128
7712,60,311,1356,171,32,4,0,0,1874,236,1372,196,133,1,0,0,1938,3812
7712,61,245,1359,148,34,0,0,0,1786,193,1374,197,143,0,0,0,1907,3693
7712,62,202,1237,134,29,3,0,0,1605,187,1297,195,123,1,0,0,1803,3408
7712,63,182,1260,117,45,0,0,0,1604,163,1238,175,157,0,0,0,1733,3337
7712,64,198,1172,106,58,0,0,0,1534,153,1164,146,141,1,0,0,1605,3139
7712,65,161,1138,125,48,1,0,0,1473,125,1170,143,184,0,0,0,1622,3095
7712,66,148,1185,96,51,0,0,0,1480,136,1115,125,184,0,0,0,1560,3040
7712,67,115,1155,70,58,0,0,0,1398,128,1113,116,224,0,0,0,1581,2979
7712,68,110,1137,76,58,1,0,0,1382,100,1097,97,231,0,0,0,1525,2907
7712,69,85,1009,90,82,1,0,0,1267,94,1014,114,251,1,0,0,1474,2741
7712,70,72,1011,56,78,0,0,0,1217,90,961,81,244,1,0,0,1377,2594
7712,71,87,980,59,74,1,0,0,1201,75,983,89,275,0,0,0,1422,2623
7712,72,73,985,47,68,1,0,0,1174,62,911,66,305,0,0,0,1344,2518
7712,73,60,996,45,79,1,0,0,1181,57,936,73,334,0,0,0,1400,2581
7712,74,80,1022,54,76,0,0,0,1232,72,963,63,398,0,0,0,1496,2728
7712,75,69,1078,39,97,1,0,0,1284,68,899,70,431,0,0,0,1468,2752
7712,76,60,1017,42,105,0,0,0,1224,63,882,62,465,0,0,1,1473,2697
7712,77,66,1010,33,101,2,0,0,1212,70,819,66,490,0,0,0,1445,2657
7712,78,53,757,24,81,0,0,0,915,44,641,39,416,0,0,0,1140,2055
7712,79,23,696,16,108,0,0,0,843,56,574,41,466,0,0,0,1137,1980
7712,80,35,718,16,114,1,0,0,884,48,552,30,496,0,0,0,1126,2010
7712,81,43,603,13,100,0,0,0,759,44,442,35,487,0,0,0,1008,1767
7712,82,33,600,13,122,0,0,0,768,43,428,25,528,0,0,0,1024,1792
7712,83,49,610,12,147,0,0,0,818,40,438,30,667,0,0,0,1175,1993
7712,84,44,573,10,153,0,0,0,780,49,357,27,630,0,0,0,1063,1843
7712,85,30,547,9,149,0,0,0,735,49,289,20,726,0,0,0,1084,1819
7712,86,23,383,12,129,0,0,0,547,35,213,20,611,0,0,0,879,1426
7712,87,22,332,7,140,0,0,0,501,29,173,10,528,0,0,0,740,1241
7712,88,18,267,6,117,0,0,0,408,30,126,12,540,0,0,0,708,1116
7712,89,14,203,7,97,0,0,0,321,21,82,4,478,0,0,0,585,906
7712,90,11,162,2,87,0,0,0,262,32,65,9,430,0,0,0,536,798
7712,91,13,133,4,76,0,0,0,226,17,46,7,392,0,0,0,462,688
7712,92,8,100,4,60,0,0,0,172,11,42,2,323,0,0,0,378,550
7712,93,7,71,1,64,0,0,0,143,25,25,2,282,0,0,0,334,477
7712,94,5,46,1,35,0,0,0,87,8,5,2,215,0,0,0,230,317
7712,95,3,34,0,31,0,0,0,68,8,3,0,182,0,0,0,193,261
7712,96,1,15,1,35,0,0,0,52,6,7,1,110,0,0,0,124,176
7712,97,1,13,0,16,0,0,0,30,7,0,0,91,0,0,0,98,128
7712,98,0,6,0,9,0,0,0,15,5,0,0,59,0,0,0,64,79
7712,99,0,1,1,10,0,0,0,12,8,1,0,53,0,0,0,62,74
7712,100,0,3,0,11,0,0,0,14,8,0,0,70,0,0,0,78,92
7712,999,64120,55918,4248,3483,126,3,1,127899,53965,57024,6146,14808,72,6,1,132022,259921
7724,0,629,0,0,0,0,0,0,629,607,0,0,0,0,0,0,607,1236
7724,1,716,0,0,0,0,0,0,716,635,0,0,0,0,0,0,635,1351
7724,2,650,0,0,0,0,0,0,650,626,0,0,0,0,0,0,626,1276
7724,3,718,0,0,0,0,0,0,718,656,0,0,0,0,0,0,656,1374
7724,4,699,0,0,0,0,0,0,699,732,0,0,0,0,0,0,732,1431
7724,5,777,0,0,0,0,0,0,777,698,0,0,0,0,0,0,698,1475
7724,6,769,0,0,0,0,0,0,769,719,0,0,0,0,0,0,719,1488
7724,7,754,0,0,0,0,0,0,754,746,0,0,0,0,0,0,746,1500
7724,8,816,0,0,0,0,0,0,816,738,0,0,0,0,0,0,738,1554
7724,9,783,0,0,0,0,0,0,783,736,0,0,0,0,0,0,736,1519
7724,10,805,0,0,0,0,0,0,805,745,0,0,0,0,0,0,745,1550
7724,11,847,0,0,0,0,0,0,847,760,0,0,0,0,0,0,760,1607
7724,12,868,0,0,0,0,0,0,868,791,0,0,0,0,0,0,791,1659
7724,13,875,0,0,0,0,0,0,875,919,0,0,0,0,0,0,919,1794
7724,14,917,0,0,0,0,0,0,917,804,0,0,0,0,0,0,804,1721
7724,15,972,0,0,0,0,0,0,972,845,0,0,0,0,0,0,845,1817
7724,16,878,0,0,0,0,0,0,878,815,0,0,0,0,0,0,815,1693
7724,17,893,0,0,0,0,0,0,893,909,0,0,0,0,0,0,909,1802
7724,18,968,0,0,0,0,0,0,968,905,0,0,0,0,0,0,905,1873
7724,19,1014,0,0,0,0,0,0,1014,929,2,0,0,0,0,0,931,1945
7724,20,972,3,0,0,0,0,0,975,845,5,0,0,0,0,0,850,1825
7724,21,889,5,0,0,0,0,0,894,810,15,0,0,0,0,0,825,1719
7724,22,929,4,0,0,0,0,0,933,856,17,0,0,0,0,0,873,1806
7724,23,921,4,0,0,0,0,0,925,914,37,1,0,0,0,0,952,1877
7724,24,931,13,0,0,0,0,0,944,796,54,0,0,0,0,0,850,1794
7724,25,919,13,0,0,0,0,0,932,791,85,0,0,0,0,0,876,1808
7724,26,800,42,1,0,0,0,0,843,699,124,0,0,0,0,0,823,1666
7724,27,800,54,0,0,0,0,0,854,687,169,1,1,0,0,0,858,1712
7724,28,791,84,1,0,0,0,0,876,616,203,2,0,0,0,0,821,1697
7724,29,738,137,0,0,0,0,0,875,637,258,5,0,0,0,0,900,1775
7724,30,752,164,2,0,0,0,0,918,564,333,8,0,0,0,0,905,1823
7724,31,774,202,2,0,0,0,0,978,511,362,14,0,1,0,0,888,1866
7724,32,662,275,2,0,0,0,0,939,482,440,11,2,0,1,0,936,1875
7724,33,678,311,8,1,0,0,0,998,420,495,11,3,0,0,0,929,1927
7724,34,623,403,6,0,0,0,0,1032,400,522,8,3,0,0,0,933,1965
7724,35,605,416,8,1,0,0,0,1030,353,580,14,3,0,0,0,950,1980
7724,36,560,461,14,0,0,0,0,1035,350,615,26,4,1,0,0,996,2031
7724,37,490,507,12,1,0,0,0,1010,261,633,32,4,0,0,0,930,1940
7724,38,480,490,9,2,0,0,0,981,235,691,25,2,0,0,0,953,1934
7724,39,439,565,17,1,0,0,0,1022,259,654,27,6,0,0,0,946,1968
7724,40,424,555,23,0,0,0,0,1002,249,679,25,5,0,0,0,958,1960
7724,41,427,614,23,1,0,0,0,1065,228,697,49,7,0,0,0,981,2046
7724,42,366,617,20,0,0,0,0,1003,212,736,38,8,0,0,0,994,1997
7724,43,374,688,27,1,0,0,0,1090,213,779,40,12,0,0,0,1044,2134
7724,44,358,707,40,7,1,0,0,1113,205,757,38,8,0,0,0,1008,2121
7724,45,317,723,35,5,0,0,0,1080,198,797,47,12,0,1,0,1055,2135
7724,46,302,683,25,5,0,0,0,1015,174,868,47,17,0,0,0,1106,2121
7724,47,310,788,40,5,0,0,0,1143,190,823,64,23,0,0,0,1100,2243
7724,48,274,749,57,8,0,0,0,1088,187,882,52,22,0,0,0,1143,2231
7724,49,277,842,41,6,0,0,0,1166,198,907,57,35,0,0,0,1197,2363
7724,50,241,796,68,13,0,0,0,1118,190,892,49,32,0,0,0,1163,2281
7724,51,263,859,49,7,0,0,0,1178,172,950,60,35,0,0,0,1217,2395
7724,52,239,865,54,8,0,0,0,1166,178,962,59,38,0,0,0,1237,2403
7724,53,236,882,35,10,0,0,0,1163,158,917,52,52,0,0,0,1179,2342
7724,54,224,876,57,9,0,0,0,1166,173,979,57,68,2,0,0,1279,2445
7724,55,207,873,53,13,0,0,0,1146,147,981,58,56,0,0,0,1242,2388
7724,56,186,890,45,9,0,0,0,1130,160,989,55,79,0,0,0,1283,2413
7724,57,168,937,42,18,0,0,0,1165,150,963,45,85,0,0,0,1243,2408
7724,58,172,932,40,18,0,0,0,1162,158,948,56,81,0,0,0,1243,2405
7724,59,166,1029,49,26,0,0,0,1270,137,961,52,95,0,0,0,1245,2515
7724,60,119,963,44,17,0,0,0,1143,127,966,36,94,0,0,0,1223,2366
7724,61,104,946,41,17,0,0,0,1108,117,958,50,112,0,0,0,1237,2345
7724,62,128,985,48,23,0,0,0,1184,140,883,34,137,0,0,0,1194,2378
7724,63,100,943,32,23,0,0,0,1098,113,861,37,132,0,0,0,1143,2241
7724,64,86,882,51,22,0,0,0,1041,117,839,30,153,0,0,0,1139,2180
7724,65,89,836,37,29,0,0,0,991,68,781,37,167,0,0,0,1053,2044
7724,66,75,932,28,38,0,0,0,1073,78,738,35,169,0,0,0,1020,2093
7724,67,74,860,19,42,0,0,0,995,84,769,29,193,0,0,0,1075,2070
7724,68,62,853,28,28,0,0,0,971,89,737,29,210,0,0,0,1065,2036
7724,69,62,849,24,43,0,0,0,978,80,692,31,228,0,0,0,1031,2009
7724,70,66,750,35,45,0,0,0,896,85,640,21,237,0,0,0,983,1879
7724,71,46,718,16,45,0,0,0,825,59,591,25,232,0,0,0,907,1732
7724,72,31,725,14,42,0,0,0,812,71,558,14,246,0,0,0,889,1701
7724,73,40,764,19,45,0,0,0,868,63,563,15,290,0,0,0,931,1799
7724,74,52,692,20,56,0,0,0,820,67,577,13,344,0,0,0,1001,1821
7724,75,25,689,17,54,0,0,0,785,54,531,16,334,0,0,0,935,1720
7724,76,32,632,9,65,0,0,0,738,61,434,10,367,0,0,0,872,1610
7724,77,21,598,11,60,0,0,0,690,57,377,11,354,0,0,0,799,1489
7724,78,27,460,9,69,0,0,0,565,50,297,15,321,0,0,0,683,1248
7724,79,18,419,6,56,0,0,0,499,33,266,7,294,0,0,0,600,1099
7724,80,24,375,2,57,0,0,0,458,34,209,10,314,0,0,0,567,1025
7724,81,17,354,8,58,1,0,0,438,34,201,4,335,0,0,0,574,1012
7724,82,18,313,6,52,0,0,0,389,30,164,6,350,0,0,0,550,939
7724,83,11,355,4,72,0,0,0,442,34,163,13,418,0,0,0,628,1070
7724,84,12,275,5,75,0,0,0,367,36,152,8,365,0,0,0,561,928
7724,85,7,266,4,62,0,0,0,339,33,130,5,330,0,0,0,498,837
7724,86,5,204,4,79,0,0,0,292,18,99,5,354,0,0,0,476,768
7724,87,5,188,4,68,0,0,0,265,22,65,5,320,0,0,0,412,677
7724,88,6,151,1,83,0,0,0,241,21,46,1,272,0,0,0,340,581
7724,89,3,120,1,60,0,0,0,184,12,41,0,232,0,0,0,285,469
7724,90,2,100,1,54,0,0,0,157,11,30,1,205,0,0,0,247,404
7724,91,3,72,0,51,0,0,0,126,19,21,0,180,0,0,0,220,346
7724,92,2,34,1,45,0,0,0,82,13,20,0,166,0,0,0,199,281
7724,93,5,37,0,45,0,0,0,87,10,11,0,104,0,0,0,125,212
7724,94,0,19,0,26,0,0,0,45,5,3,2,83,0,0,0,93,138
7724,95,1,20,0,25,0,0,0,46,3,4,0,67,0,0,0,74,120
7724,96,0,8,0,15,0,0,0,23,5,2,0,52,0,0,0,59,82
7724,97,1,5,0,13,0,0,0,19,3,1,1,31,0,0,0,36,55
7724,98,0,5,0,6,0,0,0,11,0,1,0,25,0,0,0,26,37
7724,99,0,2,0,3,0,0,0,5,0,1,0,21,0,0,0,22,27
7724,100,1,0,0,6,0,0,0,7,4,3,0,21,0,0,0,28,35
7724,999,38012,38457,1454,1949,2,0,0,79874,32438,38186,1741,9657,4,2,0,82028,161902
7788,0,584,0,0,0,0,0,0,584,527,0,0,0,0,0,0,527,1111
7788,1,595,0,0,0,0,0,0,595,522,0,0,0,0,0,0,522,1117
7788,2,543,0,0,0,0,0,0,543,543,0,0,0,0,0,0,543,1086
7788,3,598,0,0,0,0,0,0,598,557,0,0,0,0,0,0,557,1155
7788,4,620,0,0,0,0,0,0,620,542,0,0,0,0,0,0,542,1162
7788,5,602,0,0,0,0,0,0,602,610,0,0,0,0,0,0,610,1212
7788,6,622,0,0,0,0,0,0,622,588,0,0,0,0,0,0,588,1210
7788,7,610,0,0,0,0,0,0,610,595,0,0,0,0,0,0,595,1205
7788,8,655,0,0,0,0,0,0,655,615,0,0,0,0,0,0,615,1270
7788,9,684,0,0,0,0,0,0,684,627,0,0,0,0,0,0,627,1311
7788,10,658,0,0,0,0,0,0,658,592,0,0,0,0,0,0,592,1250
7788,11,732,0,0,0,0,0,0,732,642,0,0,0,0,0,0,642,1374
7788,12,679,0,0,0,0,0,0,679,657,0,0,0,0,0,0,657,1336
7788,13,733,0,0,0,0,0,0,733,723,0,0,0,0,0,0,723,1456
7788,14,710,0,0,0,0,0,0,710,705,0,0,0,0,0,0,705,1415
7788,15,745,0,0,0,0,0,0,745,782,0,0,0,0,0,0,782,1527
7788,16,804,0,0,0,0,0,0,804,742,0,0,0,0,0,0,742,1546
7788,17,772,0,0,0,0,0,0,772,770,0,0,0,0,0,0,770,1542
7788,18,853,0,0,0,0,0,0,853,753,0,0,0,0,0,0,753,1606
7788,19,825,0,0,0,0,0,0,825,798,2,0,0,0,0,0,800,1625
7788,20,876,0,0,0,0,0,0,876,760,4,0,0,0,0,0,764,1640
7788,21,808,1,0,0,0,0,0,809,737,16,0,0,0,0,0,753,1562
7788,22,927,1,1,0,0,0,0,929,757,38,0,0,0,0,0,795,1724
7788,23,934,4,0,0,0,0,0,938,714,33,0,0,0,0,0,747,1685
7788,24,887,14,0,0,0,0,0,901,718,56,0,0,0,0,0,774,1675
7788,25,899,33,0,0,0,0,0,932,723,75,0,0,0,0,0,798,1730
7788,26,855,43,0,0,0,0,0,898,716,128,0,0,0,0,0,844,1742
7788,27,829,61,0,0,0,0,0,890,620,167,1,0,0,0,0,788,1678
7788,28,784,93,0,0,0,0,0,877,618,214,2,0,0,0,0,834,1711
7788,29,781,119,1,0,0,0,0,901,552,251,3,1,0,0,0,807,1708
7788,30,730,164,0,0,0,0,0,894,496,341,5,0,0,0,0,842,1736
7788,31,714,231,1,0,0,0,0,946,493,410,3,0,0,0,0,906,1852
7788,32,603,258,2,0,0,0,0,863,419,402,2,0,0,0,0,823,1686
7788,33,622,311,2,0,0,0,0,935,392,473,7,1,0,0,0,873,1808
7788,34,591,348,2,0,0,0,0,941,333,499,9,2,0,0,0,843,1784
7788,35,536,405,4,0,0,0,0,945,366,528,6,0,0,0,0,900,1845
7788,36,492,406,3,1,0,0,0,902,288,563,5,3,0,0,0,859,1761
7788,37,435,455,6,1,0,0,0,897,309,584,18,5,0,0,0,916,1813
7788,38,421,449,8,1,0,0,0,879,260,645,17,2,0,0,0,924,1803
7788,39,427,522,7,2,1,0,0,959,251,574,14,5,0,0,0,844,1803
7788,40,398,515,6,0,0,0,0,919,191,580,19,5,0,0,0,795,1714
7788,41,349,553,14,0,0,0,0,916,199,692,17,10,0,0,0,918,1834
7788,42,339,529,17,2,1,0,0,888,218,658,21,7,0,0,0,904,1792
7788,43,303,595,13,1,0,0,0,912,167,674,27,10,0,0,0,878,1790
7788,44,290,618,10,0,0,0,0,918,206,710,30,11,0,0,0,957,1875
7788,45,321,607,15,3,0,0,0,946,220,707,22,12,0,0,0,961,1907
7788,46,310,638,20,4,0,0,0,972,182,775,39,17,0,0,0,1013,1985
7788,47,294,683,19,1,0,0,0,997,182,864,33,19,0,0,0,1098,2095
7788,48,300,735,31,5,0,0,0,1071,161,796,52,18,0,0,0,1027,2098
7788,49,264,708,25,3,0,0,0,1000,179,883,36,28,0,0,0,1126,2126
7788,50,256,773,27,4,0,0,0,1060,160,867,37,30,0,0,0,1094,2154
7788,51,270,771,21,12,0,0,0,1074,166,853,50,34,0,0,0,1103,2177
7788,52,247,813,32,8,0,0,0,1100,142,867,22,57,0,0,0,1088,2188
7788,53,240,724,33,5,0,0,0,1002,167,884,42,44,1,0,0,1138,2140
7788,54,245,805,34,7,0,0,0,1091,163,977,47,46,0,0,0,1233,2324
7788,55,217,849,34,15,1,0,0,1116,166,919,41,58,0,0,0,1184,2300
7788,56,216,837,36,16,0,0,0,1105,164,889,33,65,0,0,0,1151,2256
7788,57,218,903,31,8,0,0,0,1160,144,993,30,80,0,0,0,1247,2407
7788,58,191,855,36,19,0,0,0,1101,129,882,38,83,0,0,0,1132,2233
7788,59,205,944,30,17,0,0,0,1196,145,999,37,98,0,0,0,1279,2475
7788,60,185,903,30,12,0,0,0,1130,95,927,30,114,0,0,0,1166,2296
7788,61,154,888,27,21,0,0,0,1090,135,943,32,113,0,0,0,1223,2313
7788,62,167,840,25,25,0,0,0,1057,104,904,27,137,0,0,0,1172,2229
7788,63,153,852,42,18,0,0,0,1065,96,909,28,137,0,0,0,1170,2235
7788,64,131,839,25,28,0,0,0,1023,100,837,40,153,0,0,0,1130,2153
7788,65,120,808,22,33,0,0,0,983,78,754,29,139,0,0,0,1000,1983
7788,66,135,771,27,30,0,0,0,963,98,756,26,174,0,0,0,1054,2017
7788,67,113,803,23,32,0,0,0,971,71,678,21,198,0,0,0,968,1939
7788,68,95,829,26,31,1,0,0,982,88,655,24,202,0,0,0,969,1951
7788,69,104,761,16,35,0,0,0,916,61,671,25,194,0,0,0,951,1867
7788,70,87,795,23,34,0,0,0,939,78,607,19,222,0,0,0,926,1865
7788,71,67,716,20,37,0,0,0,840,69,548,19,225,0,0,0,861,1701
7788,72,62,749,22,32,0,0,0,865,64,534,17,219,0,0,0,834,1699
7788,73,60,723,21,45,0,0,0,849,59,531,19,273,0,0,0,882,1731
7788,74,59,728,13,53,0,0,0,853,65,508,11,311,0,0,0,895,1748
7788,75,45,696,15,66,1,0,0,823,54,490,16,339,0,0,0,899,1722
7788,76,57,671,10,62,0,0,0,800,53,404,10,331,0,0,0,798,1598
7788,77,33,583,8,49,0,0,0,673,55,367,9,327,0,0,0,758,1431
7788,78,29,480,17,50,0,0,0,576,42,290,8,266,0,0,0,606,1182
7788,79,24,418,4,61,0,0,0,507,32,230,5,263,0,0,0,530,1037
7788,80,24,350,8,69,0,0,0,451,50,224,8,287,0,0,0,569,1020
7788,81,14,361,6,67,0,0,0,448,26,206,8,308,0,0,0,548,996
7788,82,16,321,3,46,0,0,0,386,30,145,5,293,0,0,0,473,859
7788,83,24,371,10,79,0,0,0,484,43,197,4,345,0,0,0,589,1073
7788,84,24,343,5,77,0,0,0,449,38,167,1,352,0,0,0,558,1007
7788,85,13,276,2,76,0,0,0,367,55,130,4,338,0,0,0,527,894
7788,86,20,231,2,81,0,0,0,334,30,92,4,327,0,0,0,453,787
7788,87,12,183,2,73,0,0,0,270,31,92,1,292,0,0,0,416,686
7788,88,11,152,3,89,0,0,0,255,34,70,5,281,0,0,0,390,645
7788,89,11,138,3,56,0,0,0,208,20,56,2,262,0,0,0,340,548
7788,90,5,121,1,61,0,0,0,188,26,36,3,276,0,0,0,341,529
7788,91,4,82,0,48,0,0,0,134,21,30,1,207,0,0,0,259,393
7788,92,3,54,2,39,0,0,0,98,21,19,2,178,0,0,0,220,318
7788,93,1,44,0,44,0,0,0,89,19,20,0,149,0,0,0,188,277
7788,94,6,22,0,16,0,0,0,44,14,10,5,93,0,0,0,122,166
7788,95,1,14,0,24,0,0,0,39,12,4,0,90,0,0,0,106,145
7788,96,3,15,0,14,0,0,0,32,6,2,0,53,0,0,0,61,93
7788,97,2,7,0,14,0,0,0,23,7,0,1,35,0,0,0,43,66
7788,98,0,5,0,6,0,0,0,11,4,4,0,30,0,0,0,38,49
7788,99,1,5,0,4,0,0,0,10,3,4,0,14,0,0,0,21,31
7788,100,1,6,0,10,0,0,0,17,10,3,1,44,0,0,0,58,75
7788,999,35324,36327,984,1882,5,0,0,74522,28860,36526,1235,9342,1,0,0,75964,150486
7926,0,461,0,0,0,0,0,0,461,500,0,0,0,0,0,0,500,961
7926,1,483,0,0,0,0,0,0,483,507,0,0,0,0,0,0,507,990
7926,2,506,0,0,0,0,0,0,506,498,0,0,0,0,0,0,498,1004
7926,3,573,0,0,0,0,0,0,573,535,0,0,0,0,0,0,535,1108
7926,4,571,0,0,0,0,0,0,571,516,0,0,0,0,0,0,516,1087
7926,5,607,0,0,0,0,0,0,607,568,0,0,0,0,0,0,568,1175
7926,6,626,0,0,0,0,0,0,626,569,0,0,0,0,0,0,569,1195
7926,7,685,0,0,0,0,0,0,685,625,0,0,0,0,0,0,625,1310
7926,8,707,0,0,0,0,0,0,707,655,0,0,0,0,0,0,655,1362
7926,9,711,0,0,0,0,0,0,711,625,0,0,0,0,0,0,625,1336
7926,10,743,0,0,0,0,0,0,743,692,0,0,0,0,0,0,692,1435
7926,11,718,0,0,0,0,0,0,718,703,0,0,0,0,0,0,703,1421
7926,12,786,0,0,0,0,0,0,786,721,0,0,0,0,0,0,721,1507
7926,13,782,0,0,0,0,0,0,782,696,0,0,0,0,0,0,696,1478
7926,14,810,0,0,0,0,0,0,810,725,0,0,0,0,0,0,725,1535
7926,15,788,0,0,0,0,0,0,788,686,0,0,0,0,0,0,686,1474
7926,16,823,0,0,0,0,0,0,823,775,0,0,0,0,0,0,775,1598
7926,17,791,0,0,0,0,0,0,791,755,0,0,0,0,0,0,755,1546
7926,18,827,0,0,0,0,0,0,827,724,1,0,0,0,0,0,725,1552
7926,19,808,0,0,0,0,0,0,808,749,1,0,0,0,0,0,750,1558
7926,20,790,0,0,0,0,0,0,790,714,9,0,0,0,0,0,723,1513
7926,21,803,1,0,0,0,0,0,804,733,9,0,0,0,0,0,742,1546
7926,22,840,5,0,0,0,0,0,845,739,20,0,0,0,0,0,759,1604
7926,23,882,9,0,1,1,0,0,893,757,33,2,0,0,0,0,792,1685
7926,24,885,11,1,0,0,0,0,897,736,41,3,1,0,0,0,781,1678
7926,25,927,17,0,0,0,0,0,944,733,63,1,0,0,0,0,797,1741
7926,26,856,28,2,1,0,0,0,887,683,93,3,0,0,0,0,779,1666
7926,27,895,34,1,0,0,0,0,930,679,104,5,0,0,0,0,788,1718
7926,28,841,41,0,0,1,0,0,883,695,121,3,0,0,0,0,819,1702
7926,29,775,59,1,0,0,1,0,836,590,146,7,0,0,0,0,743,1579
7926,30,730,92,4,0,0,0,0,826,579,201,5,0,0,1,0,786,1612
7926,31,773,152,4,1,0,0,0,930,572,239,6,0,0,0,0,817,1747
7926,32,732,170,1,0,0,0,0,903,528,272,10,1,0,0,0,811,1714
7926,33,664,157,7,1,0,0,0,829,534,322,12,0,3,0,0,871,1700
7926,34,645,227,5,1,0,0,0,878,455,339,12,0,2,0,0,808,1686
7926,35,681,241,3,2,0,0,0,927,467,400,15,0,2,0,0,884,1811
7926,36,569,281,9,1,0,0,0,860,436,439,15,1,1,0,0,892,1752
7926,37,572,370,15,0,0,0,0,957,394,474,28,3,1,0,0,900,1857
7926,38,562,376,19,1,1,0,0,959,439,495,30,5,0,0,0,969,1928
7926,39,510,441,14,3,0,0,0,968,375,527,27,7,1,0,0,937,1905
7926,40,503,435,19,2,0,0,0,959,372,552,43,10,1,0,0,978,1937
7926,41,541,446,22,2,0,0,0,1011,335,569,59,7,1,0,0,971,1982
7926,42,480,489,30,7,1,0,0,1007,330,635,55,12,0,0,0,1032,2039
7926,43,460,543,37,2,3,0,0,1045,306,633,69,12,3,0,0,1023,2068
7926,44,483,595,38,3,1,0,0,1120,328,762,64,18,1,0,0,1173,2293
7926,45,456,650,44,5,0,0,0,1155,303,752,81,14,1,0,0,1151,2306
7926,46,439,664,59,3,0,0,0,1165,327,772,75,18,1,0,0,1193,2358
7926,47,489,737,58,5,1,0,0,1290,281,759,75,22,1,0,0,1138,2428
7926,48,423,707,60,4,0,0,0,1194,305,876,89,30,1,1,0,1302,2496
7926,49,418,740,72,5,0,0,0,1235,278,867,118,31,0,0,0,1294,2529
7926,50,387,775,69,4,0,0,0,1235,302,879,106,27,0,0,0,1314,2549
7926,51,376,759,65,1,1,0,0,1202,263,895,107,27,0,0,0,1292,2494
7926,52,363,827,85,9,1,0,0,1285,241,991,131,40,0,0,0,1403,2688
7926,53,386,840,85,6,1,0,0,1318,220,931,99,45,1,0,0,1296,2614
7926,54,340,877,89,11,1,0,0,1318,208,1029,113,55,0,0,0,1405,2723
7926,55,322,864,89,7,0,0,0,1282,198,966,103,57,0,0,0,1324,2606
7926,56,274,947,88,12,0,0,0,1321,163,1049,125,53,1,0,0,1391,2712
7926,57,279,937,110,17,1,0,0,1344,183,1026,104,73,0,0,0,1386,2730
7926,58,223,972,101,14,1,0,0,1311,145,1001,125,67,0,0,0,1338,2649
7926,59,238,1024,99,19,0,0,0,1380,145,1034,116,66,0,0,0,1361,2741
7926,60,206,946,88,22,1,0,0,1263,119,1043,114,68,2,0,0,1346,2609
7926,61,182,947,80,20,1,0,0,1230,116,979,87,100,0,0,0,1282,2512
7926,62,191,1001,95,28,0,0,0,1315,107,1001,114,106,0,0,0,1328,2643
7926,63,168,997,69,27,0,0,0,1261,109,969,95,107,0,0,0,1280,2541
7926,64,135,937,76,25,1,0,0,1174,92,949,93,100,0,0,0,1234,2408
7926,65,113,947,80,20,0,0,0,1160,83,908,67,147,0,0,0,1205,2365
7926,66,135,885,76,35,1,0,0,1132,84,846,80,162,1,0,0,1173,2305
7926,67,137,893,48,25,0,0,0,1103,85,948,65,212,0,0,0,1310,2413
7926,68,102,880,57,51,0,0,0,1090,78,886,52,184,0,0,0,1200,2290
7926,69,90,861,49,45,0,0,0,1045,61,822,49,186,1,0,0,1119,2164
7926,70,79,807,54,60,0,0,0,1000,61,755,50,188,0,0,0,1054,2054
7926,71,85,788,41,57,0,0,0,971,61,666,42,234,0,0,0,1003,1974
7926,72,73,774,32,57,2,0,0,938,52,704,40,271,0,0,0,1067,2005
7926,73,67,778,41,55,0,0,0,941,52,635,39,285,0,0,0,1011,1952
7926,74,55,763,31,72,0,0,0,921,47,661,25,279,0,0,0,1012,1933
7926,75,81,788,23,60,0,0,0,952,42,622,23,324,0,0,0,1011,1963
7926,76,45,718,28,63,0,0,0,854,48,597,34,341,0,0,0,1020,1874
7926,77,42,657,17,70,1,0,0,787,33,561,32,342,0,0,0,968,1755
7926,78,42,562,22,77,1,0,0,704,40,374,25,335,0,0,0,774,1478
7926,79,32,481,14,63,0,0,0,590,21,397,13,330,0,0,0,761,1351
7926,80,34,479,11,78,0,0,0,602,30,356,12,367,0,0,0,765,1367
7926,81,32,417,10,77,0,0,1,537,31,273,8,380,0,0,0,692,1229
7926,82,26,440,5,76,0,0,0,547,19,261,9,401,0,0,0,690,1237
7926,83,35,473,6,93,0,0,0,607,25,273,7,530,0,0,0,835,1442
7926,84,34,458,7,126,0,0,0,625,23,265,9,579,0,0,0,876,1501
7926,85,33,453,7,111,0,0,0,604,24,206,6,578,0,0,0,814,1418
7926,86,24,379,3,114,0,0,0,520,11,158,6,498,0,0,0,673,1193
7926,87,20,307,3,86,0,0,0,416,22,102,3,445,0,0,0,572,988
7926,88,13,245,3,101,0,0,0,362,18,95,5,504,0,0,0,622,984
7926,89,17,192,1,88,0,0,0,298,21,62,4,387,0,0,0,474,772
7926,90,7,148,3,66,0,0,0,224,14,58,4,400,0,0,0,476,700
7926,91,5,93,0,57,0,0,0,155,14,30,3,301,0,0,0,348,503
7926,92,5,90,0,65,0,0,0,160,17,23,2,255,0,0,0,297,457
7926,93,3,57,0,45,0,0,0,105,7,8,1,225,0,0,0,241,346
7926,94,5,37,0,35,0,0,0,77,8,12,0,173,0,0,0,193,270
7926,95,3,37,0,38,0,0,0,78,8,8,2,121,0,0,0,139,217
7926,96,1,15,0,15,0,0,0,31,5,5,0,95,0,0,0,105,136
7926,97,1,13,0,11,0,0,0,25,7,1,0,73,0,0,0,81,106
7926,98,1,4,0,11,0,0,0,16,4,1,0,55,0,0,0,60,76
7926,99,0,2,0,2,0,0,0,4,3,0,0,29,0,0,0,32,36
7926,100,0,3,0,10,0,0,0,13,5,0,1,41,0,0,0,47,60
7926,999,38977,38292,2485,2387,23,1,1,82166,31602,38847,3262,11440,26,2,0,85179,167345
