id,Età,Celibi,Coniugati,Divorziati,Vedovi,Uniti civilmente,Maschi già in unione civile (per scioglimento unione),Maschi già in unione civile (per decesso del partner),Totale maschi,Nubili,Coniugate,Divorziate,Vedove,Unite civilmente,Femmine già in unione civile (per scioglimento unione),Femmine già in unione civile (per decesso del partner),Totale femmine,Totale
6,0,12987,0,0,0,0,0,0,12987,12209,0,0,0,0,0,0,12209,25196
6,1,13367,0,0,0,0,0,0,13367,12852,0,0,0,0,0,0,12852,26219
6,2,14029,0,0,0,0,0,0,14029,13345,0,0,0,0,0,0,13345,27374
6,3,14420,0,0,0,0,0,0,14420,13582,0,0,0,0,0,0,13582,28002
6,4,14771,0,0,0,0,0,0,14771,14048,0,0,0,0,0,0,14048,28819
6,5,15184,0,0,0,0,0,0,15184,14785,0,0,0,0,0,0,14785,29969
6,6,16023,0,0,0,0,0,0,16023,15475,0,0,0,0,0,0,15475,31498
6,7,16908,0,0,0,0,0,0,16908,16026,0,0,0,0,0,0,16026,32934
6,8,17569,0,0,0,0,0,0,17569,16143,0,0,0,0,0,0,16143,33712
6,9,17802,0,0,0,0,0,0,17802,17147,0,0,0,0,0,0,17147,34949
6,10,18474,0,0,0,0,0,0,18474,17440,0,0,0,0,0,0,17440,35914
6,11,19132,0,0,0,0,0,0,19132,18066,0,0,0,0,0,0,18066,37198
6,12,19498,0,0,0,0,0,0,19498,17941,0,0,0,0,0,0,17941,37439
6,13,19784,0,0,0,0,0,0,19784,18544,0,0,0,0,0,0,18544,38328
6,14,20261,0,0,0,0,0,0,20261,19173,0,0,0,0,0,0,19173,39434
6,15,20468,0,0,0,0,0,0,20468,19182,0,0,0,0,0,0,19182,39650
6,16,20451,0,0,1,0,0,0,20452,19238,0,1,0,0,0,0,19239,39691
6,17,20347,0,0,0,0,0,0,20347,18906,1,0,0,0,0,0,18907,39254
6,18,20507,1,0,0,0,0,0,20508,18882,8,1,0,0,0,0,18891,39399
6,19,20915,8,0,0,0,0,0,20923,18749,59,1,0,0,0,0,18809,39732
6,20,20925,17,4,0,1,0,0,20947,18750,139,1,0,2,0,0,18892,39839
6,21,20472,31,2,0,2,0,0,20507,18647,248,4,0,2,0,0,18901,39408
6,22,20638,105,9,0,3,0,0,20755,18558,446,15,0,0,0,0,19019,39774
6,23,21902,149,10,1,3,0,0,22065,18911,698,17,2,3,1,0,19632,41697
6,24,21873,290,18,0,3,0,0,22184,18205,1025,23,5,7,1,0,19266,41450
6,25,22220,479,25,0,9,0,0,22733,18114,1403,25,2,5,0,0,19549,42282
6,26,21613,626,24,0,8,0,0,22271,17904,1934,54,2,10,1,0,19905,42176
6,27,21513,982,33,1,13,3,0,22545,17260,2524,80,5,16,2,0,19887,42432
6,28,20814,1460,47,1,15,0,0,22337,16555,3229,82,11,11,2,0,19890,42227
6,29,20171,2003,59,2,19,3,0,22257,15803,4376,138,16,33,0,0,20366,42623
6,30,19422,2815,88,0,27,2,0,22354,15235,5247,165,7,27,5,0,20686,43040
6,31,19243,3795,105,2,36,3,0,23184,14582,6563,215,15,31,6,0,21412,44596
6,32,18125,4696,146,8,27,0,0,23002,13815,7445,274,28,37,2,0,21601,44603
6,33,17565,5806,189,12,34,4,0,23610,12863,8435,416,32,47,6,0,21799,45409
6,34,16022,6578,237,24,50,4,0,22915,11978,9195,448,42,37,5,0,21705,44620
6,35,15532,7644,331,21,67,3,0,23598,11387,10302,513,55,45,3,0,22305,45903
6,36,13940,8203,334,13,53,3,0,22546,10131,10956,661,68,56,1,0,21873,44419
6,37,13510,8922,459,21,55,6,0,22973,9678,11535,790,95,37,2,0,22137,45110
6,38,13063,9702,508,19,48,5,0,23345,9426,12334,988,123,45,3,0,22919,46264
6,39,12403,10282,562,26,46,2,0,23321,9119,12717,1071,106,48,5,0,23066,46387
6,40,11887,11229,728,28,47,0,0,23919,8804,13508,1196,151,55,3,1,23718,47637
6,41,11757,12187,778,25,37,6,0,24790,8734,14362,1410,142,35,2,0,24685,49475
6,42,11205,12573,955,66,38,0,0,24837,8293,14668,1559,217,35,0,0,24772,49609
6,43,11096,13216,1028,53,47,2,0,25442,8148,15208,1790,260,37,1,0,25444,50886
6,44,10930,13871,1136,87,47,2,1,26074,7746,15989,1897,261,24,2,0,25919,51993
6,45,11308,14903,1344,99,49,2,1,27706,8099,17239,2203,323,35,2,0,27901,55607
6,46,11340,15909,1509,97,44,1,1,28901,8211,18474,2428,370,50,1,0,29534,58435
6,47,11467,16906,1772,106,43,1,0,30295,7930,19563,2874,447,30,4,0,30848,61143
6,48,11469,18299,2103,118,61,0,1,32051,8095,20758,3198,532,54,5,0,32642,64693
6,49,11555,19587,2352,128,71,4,0,33697,7880,21812,3473,572,42,5,0,33784,67481
6,50,11153,19898,2544,125,80,2,2,33804,7484,21880,3581,651,40,1,0,33637,67441
6,51,10405,20976,2677,207,49,2,1,34317,7205,22645,3946,723,32,0,0,34551,68868
6,52,10046,21275,2929,199,62,3,1,34515,6661,23622,4026,899,31,2,0,35241,69756
6,53,9293,21711,2905,240,58,1,0,34208,6276,23405,4145,1010,34,2,0,34872,69080
6,54,9042,22713,3167,264,66,2,0,35254,6087,24582,4390,1146,23,1,0,36229,71483
6,55,8418,22942,3307,310,68,4,0,35049,5550,24392,4491,1280,36,2,0,35751,70800
6,56,7895,23229,3362,335,58,0,1,34880,5312,24348,4554,1529,37,1,0,35781,70661
6,57,7558,23665,3505,422,58,1,2,35211,5014,24745,4499,1572,19,0,0,35849,71060
6,58,6896,23837,3570,431,71,1,2,34808,4731,24687,4517,1848,19,0,1,35803,70611
6,59,6470,24372,3636,478,63,0,1,35020,4522,25389,4548,1995,17,1,1,36473,71493
6,60,5572,23267,3308,536,54,2,2,32741,3918,23769,4108,2190,16,0,1,34002,66743
6,61,4998,22282,3092,583,49,0,2,31006,3540,22840,3917,2481,19,0,1,32798,63804
6,62,4602,22290,3046,582,47,0,2,30569,3236,22633,3764,2832,11,0,0,32476,63045
6,63,4094,21680,2895,663,35,0,3,29370,2881,21790,3527,3135,10,0,0,31343,60713
6,64,3829,21380,2701,754,44,0,2,28710,2656,21021,3293,3197,7,0,0,30174,58884
6,65,3490,20915,2456,803,31,0,1,27696,2404,20425,3074,3497,15,1,0,29416,57112
6,66,3282,20729,2411,864,31,0,0,27317,2301,20299,2856,3783,14,0,0,29253,56570
6,67,2907,20296,2154,979,31,0,1,26368,2054,19584,2748,4204,12,0,0,28602,54970
6,68,2734,19979,1976,1061,26,0,2,25778,1952,19021,2483,4593,6,0,0,28055,53833
6,69,2575,19395,1891,1149,14,0,0,25024,1777,18631,2328,4965,7,0,1,27709,52733
6,70,2319,18922,1691,1228,25,1,2,24188,1676,17598,2086,5253,7,0,1,26621,50809
6,71,2172,18713,1589,1349,12,1,0,23836,1595,17155,1962,5624,10,0,0,26346,50182
6,72,1996,18153,1347,1394,15,0,1,22906,1473,16794,1798,6058,8,0,0,26131,49037
6,73,2011,18716,1322,1585,14,1,3,23652,1443,17023,1734,7012,3,0,0,27215,50867
6,74,1837,18788,1230,1734,12,0,1,23602,1377,16546,1604,7625,4,0,0,27156,50758
6,75,1864,19231,1156,2059,12,0,3,24325,1450,16696,1613,8768,6,0,1,28534,52859
6,76,1651,18570,1099,2117,11,0,1,23449,1351,15551,1425,9196,4,0,0,27527,50976
6,77,1519,17430,1006,2325,12,0,1,22293,1277,14236,1358,9733,2,0,0,26606,48899
6,78,1134,12875,651,1807,13,0,0,16480,952,10179,874,8072,4,0,0,20081,36561
6,79,1123,13176,599,2150,9,0,1,17058,1043,10164,921,9198,2,0,0,21328,38386
6,80,1084,12317,484,2149,6,0,1,16041,1052,9273,839,9983,1,0,0,21148,37189
6,81,1058,11809,455,2370,7,0,0,15699,1059,8480,846,10440,3,0,0,20828,36527
6,82,1072,11096,442,2409,6,0,0,15025,1103,7796,670,11297,0,0,0,20866,35891
6,83,996,11300,433,2898,3,0,1,15631,1086,7429,637,12812,2,0,2,21968,37599
6,84,909,10342,340,2884,4,1,1,14481,1098,6417,607,13090,3,0,1,21216,35697
6,85,803,9265,295,2859,5,0,0,13227,974,5299,532,12886,1,0,0,19692,32919
6,86,656,7442,221,2700,2,0,0,11021,922,4019,411,11753,0,0,0,17105,28126
6,87,478,5900,158,2467,2,0,0,9005,794,2843,323,10674,0,0,0,14634,23639
6,88,469,4926,149,2336,2,0,0,7882,805,2272,282,10407,0,0,0,13766,21648
6,89,346,3939,107,2081,2,0,0,6475,669,1653,214,9570,0,0,0,12106,18581
6,90,254,2895,67,1763,1,0,0,4980,635,1149,184,8294,0,0,0,10262,15242
6,91,208,2182,46,1538,0,0,0,3974,581,851,122,7367,0,0,0,8921,12895
6,92,177,1632,30,1324,0,0,0,3163,473,568,113,6396,0,0,0,7550,10713
6,93,121,1215,26,1094,0,0,0,2456,441,409,81,5607,0,0,0,6538,8994
6,94,83,774,11,818,0,0,0,1686,370,228,67,4149,0,0,0,4814,6500
6,95,57,483,12,568,0,0,0,1120,271,149,44,3094,0,0,0,3558,4678
6,96,39,276,3,403,0,0,0,721,196,98,37,2300,0,0,0,2631,3352
6,97,28,166,4,282,0,0,0,480,145,42,19,1636,0,0,0,1842,2322
6,98,17,98,2,173,0,0,0,290,114,29,16,1078,0,0,0,1237,1527
6,99,19,48,3,124,1,0,0,195,82,12,9,793,0,0,0,896,1091
6,100,19,45,3,181,0,0,0,248,137,19,17,1149,0,0,0,1322,1570
6,999,989655,932829,89408,63113,2174,78,45,2077302,822799,943085,124251,282733,1361,81,11,2174321,4251623
7,0,367,0,0,0,0,0,0,367,357,0,0,0,0,0,0,357,724
7,1,405,0,0,0,0,0,0,405,382,0,0,0,0,0,0,382,787
7,2,402,0,0,0,0,0,0,402,358,0,0,0,0,0,0,358,760
7,3,386,0,0,0,0,0,0,386,405,0,0,0,0,0,0,405,791
7,4,403,0,0,0,0,0,0,403,409,0,0,0,0,0,0,409,812
7,5,490,0,0,0,0,0,0,490,407,0,0,0,0,0,0,407,897
7,6,482,0,0,0,0,0,0,482,412,0,0,0,0,0,0,412,894
7,7,512,0,0,0,0,0,0,512,448,0,0,0,0,0,0,448,960
7,8,503,0,0,0,0,0,0,503,482,0,0,0,0,0,0,482,985
7,9,562,0,0,0,0,0,0,562,499,0,0,0,0,0,0,499,1061
7,10,517,0,0,0,0,0,0,517,522,0,0,0,0,0,0,522,1039
7,11,588,0,0,0,0,0,0,588,559,0,0,0,0,0,0,559,1147
7,12,633,0,0,0,0,0,0,633,583,0,0,0,0,0,0,583,1216
7,13,592,0,0,0,0,0,0,592,579,0,0,0,0,0,0,579,1171
7,14,651,0,0,0,0,0,0,651,581,0,0,0,0,0,0,581,1232
7,15,634,0,0,0,0,0,0,634,600,0,0,0,0,0,0,600,1234
7,16,657,1,0,0,0,0,0,658,586,0,0,0,0,0,0,586,1244
7,17,667,0,0,0,0,0,0,667,597,0,0,0,0,0,0,597,1264
7,18,610,0,0,0,0,0,0,610,567,0,0,0,0,0,0,567,1177
7,19,608,0,1,0,0,0,0,609,595,0,2,0,0,0,0,597,1206
7,20,629,0,0,0,0,0,0,629,605,4,0,0,0,0,0,609,1238
7,21,623,0,0,0,0,0,0,623,531,7,0,0,0,0,0,538,1161
7,22,641,2,0,0,0,0,0,643,565,9,1,0,0,0,0,575,1218
7,23,658,1,0,0,0,0,0,659,588,22,1,0,0,0,0,611,1270
7,24,639,6,0,0,0,0,0,645,552,27,0,0,0,0,0,579,1224
7,25,625,12,0,0,0,0,0,637,541,34,1,0,1,0,0,577,1214
7,26,593,13,2,0,0,0,0,608,500,61,2,0,1,0,0,564,1172
7,27,612,28,1,0,0,0,0,641,512,68,2,0,0,0,0,582,1223
7,28,570,44,1,0,0,0,0,615,460,99,1,0,1,0,0,561,1176
7,29,531,60,1,0,0,0,0,592,425,113,2,0,1,0,0,541,1133
7,30,515,85,2,0,0,0,0,602,420,144,6,1,1,0,0,572,1174
7,31,556,96,2,0,0,0,0,654,414,196,7,0,1,0,0,618,1272
7,32,495,123,2,0,1,0,0,621,386,169,10,0,3,0,0,568,1189
7,33,469,135,6,0,0,0,0,610,395,248,12,1,1,0,0,657,1267
7,34,479,172,5,1,1,0,0,658,346,220,21,1,3,0,0,591,1249
7,35,464,197,5,0,0,0,0,666,331,278,21,1,1,0,0,632,1298
7,36,414,196,7,0,1,0,0,618,329,296,14,3,1,0,0,643,1261
7,37,375,227,11,1,0,0,0,614,293,337,23,5,2,0,0,660,1274
7,38,385,232,18,1,0,0,0,636,309,310,19,3,1,0,0,642,1278
7,39,382,278,13,2,0,0,0,675,296,323,23,1,0,0,0,643,1318
7,40,378,329,21,1,2,0,0,731,288,356,41,4,0,0,0,689,1420
7,41,341,332,22,0,0,0,0,695,278,389,43,5,1,1,0,717,1412
7,42,328,309,24,1,3,0,0,665,234,383,49,7,3,0,0,676,1341
7,43,351,379,30,2,0,0,0,762,231,411,49,8,1,0,0,700,1462
7,44,319,365,43,0,0,0,0,727,241,420,43,18,1,0,0,723,1450
7,45,418,420,39,3,1,0,0,881,303,469,63,5,0,0,0,840,1721
7,46,340,453,50,2,2,0,0,847,282,466,67,10,1,1,0,827,1674
7,47,369,437,53,1,1,0,0,861,284,549,76,15,0,0,0,924,1785
7,48,394,445,57,1,1,0,0,898,295,571,76,19,1,0,0,962,1860
7,49,401,505,63,2,0,0,0,971,291,567,111,11,1,0,0,981,1952
7,50,344,572,77,4,4,0,0,1001,257,595,130,21,2,0,0,1005,2006
7,51,359,566,66,6,3,0,0,1000,267,624,114,28,0,0,0,1033,2033
7,52,313,587,87,6,0,0,0,993,242,660,140,32,0,0,0,1074,2067
7,53,338,575,88,4,1,0,0,1006,235,629,156,38,0,0,0,1058,2064
7,54,319,622,122,7,2,0,0,1072,247,698,135,28,0,0,0,1108,2180
7,55,320,599,106,11,2,1,0,1039,210,657,164,37,2,0,0,1070,2109
7,56,297,600,134,10,2,0,0,1043,217,662,152,60,0,0,0,1091,2134
7,57,306,637,137,16,2,0,0,1098,191,698,150,49,1,0,0,1089,2187
7,58,235,662,115,10,0,0,0,1022,180,671,144,57,1,0,0,1053,2075
7,59,262,727,139,16,2,0,0,1146,202,702,162,48,1,0,0,1115,2261
7,60,226,665,127,24,1,0,0,1043,142,663,136,61,2,0,0,1004,2047
7,61,169,609,99,22,0,0,0,899,126,635,136,68,0,0,0,965,1864
7,62,186,640,122,20,3,0,0,971,126,596,126,77,0,0,0,925,1896
7,63,135,575,103,15,1,0,0,829,107,565,136,87,0,0,0,895,1724
7,64,132,632,92,15,0,0,0,871,107,603,117,104,0,0,0,931,1802
7,65,149,539,79,28,0,0,0,795,71,572,99,91,0,0,0,833,1628
7,66,122,560,82,19,1,0,0,784,94,504,114,103,0,0,0,815,1599
7,67,106,581,78,16,0,0,0,781,61,529,85,111,0,0,0,786,1567
7,68,95,502,70,33,1,0,0,701,66,542,89,155,1,0,0,853,1554
7,69,106,524,54,27,0,0,0,711,62,499,86,150,0,0,0,797,1508
7,70,99,564,54,35,0,0,0,752,54,471,63,168,0,0,0,756,1508
7,71,98,508,60,36,0,0,0,702,48,452,62,162,0,0,0,724,1426
7,72,74,499,60,47,0,0,0,680,46,465,53,172,0,0,0,736,1416
7,73,79,508,44,51,0,0,0,682,49,441,55,193,0,0,0,738,1420
7,74,64,507,51,39,0,0,0,661,50,459,55,214,0,0,0,778,1439
7,75,74,510,35,60,2,0,1,682,41,443,65,243,0,0,0,792,1474
7,76,55,523,39,58,0,0,1,676,27,371,51,259,0,0,0,708,1384
7,77,67,441,35,52,0,0,0,595,26,347,39,263,0,0,0,675,1270
7,78,49,299,21,46,0,0,0,415,25,276,29,210,0,0,0,540,955
7,79,45,356,25,65,0,0,0,491,20,226,33,248,0,0,0,527,1018
7,80,40,363,24,63,0,0,0,490,28,249,29,258,0,0,0,564,1054
7,81,45,332,17,68,0,0,0,462,23,205,20,314,0,0,0,562,1024
7,82,42,300,17,73,0,0,0,432,35,204,20,318,0,0,0,577,1009
7,83,43,281,15,75,0,0,0,414,33,179,23,347,0,0,0,582,996
7,84,32,269,7,69,0,0,0,377,32,165,17,332,0,0,0,546,923
7,85,13,240,4,81,0,0,0,338,33,134,13,341,0,0,0,521,859
7,86,17,170,8,74,0,0,0,269,26,104,9,312,0,0,0,451,720
7,87,17,142,3,55,1,0,0,218,14,62,13,290,0,0,0,379,597
7,88,9,124,6,50,0,0,0,189,20,52,11,250,0,0,0,333,522
7,89,14,87,6,44,0,0,0,151,21,35,6,243,0,0,0,305,456
7,90,9,76,1,40,0,0,0,126,18,33,3,216,0,0,0,270,396
7,91,7,48,5,41,0,0,0,101,21,19,3,179,0,0,0,222,323
7,92,6,28,0,33,0,0,0,67,13,13,4,182,0,0,0,212,279
7,93,5,28,1,29,0,0,0,63,12,12,3,150,0,0,0,177,240
7,94,1,21,0,26,0,0,0,48,10,7,1,116,0,0,0,134,182
7,95,4,16,1,8,0,0,0,29,7,6,1,95,0,0,0,109,138
7,96,1,8,0,9,0,0,0,18,7,0,0,57,0,0,0,64,82
7,97,0,4,0,7,0,0,0,11,8,1,1,51,0,0,0,61,72
7,98,1,3,1,6,0,0,0,11,0,0,0,30,0,0,0,30,41
7,99,0,1,0,4,0,0,0,5,2,0,0,16,0,0,0,18,23
7,100,0,0,0,2,0,0,0,2,2,0,1,34,0,0,0,37,39
7,999,30492,25112,2996,1673,41,1,2,60317,25414,25281,4040,7786,37,2,0,62560,122877
8,0,33981,0,0,0,0,0,0,33981,31897,0,0,0,0,0,0,31897,65878
8,1,35366,0,0,0,0,0,0,35366,33055,0,0,0,0,0,0,33055,68421
8,2,36168,0,0,0,0,0,0,36168,34359,0,0,0,0,0,0,34359,70527
8,3,36554,0,0,0,0,0,0,36554,34624,0,0,0,0,0,0,34624,71178
8,4,38537,0,0,0,0,0,0,38537,36920,0,0,0,0,0,0,36920,75457
8,5,40446,0,0,0,0,0,0,40446,38041,0,0,0,0,0,0,38041,78487
8,6,42212,0,0,0,0,0,0,42212,39564,0,0,0,0,0,0,39564,81776
8,7,43225,0,0,0,0,0,0,43225,41344,0,0,0,0,0,0,41344,84569
8,8,45181,0,0,0,0,0,0,45181,42322,0,0,0,0,0,0,42322,87503
8,9,45904,0,0,0,0,0,0,45904,43544,0,0,0,0,0,0,43544,89448
8,10,46934,0,0,0,0,0,0,46934,43791,0,0,0,0,0,0,43791,90725
8,11,48275,0,0,0,0,0,0,48275,45653,0,0,0,0,0,0,45653,93928
8,12,49345,0,0,0,0,0,0,49345,46344,0,0,0,0,0,0,46344,95689
8,13,51022,0,0,0,0,0,0,51022,47363,0,0,0,0,0,0,47363,98385
8,14,51804,0,0,0,0,0,0,51804,48752,0,0,0,0,0,0,48752,100556
8,15,52067,0,0,0,0,0,0,52067,48919,0,0,0,0,0,0,48919,100986
8,16,51536,0,1,0,0,0,0,51537,48148,2,0,0,0,0,0,48150,99687
8,17,52105,2,2,0,0,0,0,52109,48210,5,0,0,0,0,0,48215,100324
8,18,51408,5,1,1,0,0,0,51415,47122,25,1,0,0,0,0,47148,98563
8,19,52209,12,1,0,0,0,0,52222,47913,86,0,0,0,0,0,47999,100221
8,20,51588,35,0,0,1,1,0,51625,46170,310,3,0,2,0,0,46485,98110
8,21,51351,67,2,1,1,0,0,51422,45580,558,6,0,1,0,0,46145,97567
8,22,51926,185,27,1,6,0,0,52145,45948,1082,31,1,2,1,0,47065,99210
8,23,53360,308,28,0,3,0,0,53699,46144,1725,53,0,5,0,0,47927,101626
8,24,52825,640,48,0,5,0,0,53518,45152,2466,63,4,6,2,0,47693,101211
8,25,53610,1096,72,1,15,1,0,54795,44765,3435,67,4,10,2,0,48283,103078
8,26,52844,1598,59,1,20,1,0,54523,44080,4741,95,1,17,6,0,48940,103463
8,27,51891,2313,89,0,37,2,0,54332,43146,6433,130,10,40,1,0,49760,104092
8,28,50314,3537,93,2,43,2,0,53991,41292,8521,189,10,37,4,0,50053,104044
8,29,49341,4954,130,1,57,6,0,54489,39753,11061,257,26,44,4,0,51145,105634
8,30,47815,6998,153,4,69,6,0,55045,38388,13599,339,22,81,4,0,52433,107478
8,31,47530,9233,197,6,79,5,0,57050,36731,16778,436,32,72,3,0,54052,111102
8,32,44653,11641,260,38,105,3,0,56700,34353,19496,577,72,95,8,0,54601,111301
8,33,43304,14111,379,36,106,5,1,57942,32583,22278,800,86,94,2,0,55843,113785
8,34,40426,16666,459,55,117,10,0,57733,30610,24382,932,93,102,9,0,56128,113861
8,35,39227,19655,561,50,154,10,1,59658,28340,27303,1166,134,116,8,0,57067,116725
8,36,35745,21257,713,43,156,9,0,57923,25587,29009,1401,140,103,9,0,56249,114172
8,37,33351,23439,864,66,149,12,4,57885,23782,30285,1795,222,114,7,0,56205,114090
8,38,32472,25521,1139,61,160,4,1,59358,23129,32116,2149,273,113,8,0,57788,117146
8,39,31103,27929,1291,63,120,5,0,60511,21980,33935,2385,301,116,11,1,58729,119240
8,40,29883,30028,1486,79,145,9,2,61632,21560,35375,2772,363,103,4,0,60177,121809
8,41,29521,32359,1720,84,155,5,1,63845,20882,37789,2994,416,101,7,0,62189,126034
8,42,28286,33176,2109,208,157,14,3,63953,20083,38135,3460,616,94,10,2,62400,126353
8,43,27513,34875,2200,250,134,10,1,64983,19323,39792,3856,602,108,5,1,63687,128670
8,44,26677,36743,2573,238,182,6,0,66419,18953,41158,4182,717,100,5,0,65115,131534
8,45,27195,39651,3053,258,148,6,2,70313,18974,43778,4876,789,84,5,1,68507,138820
8,46,27534,41810,3356,268,186,4,2,73160,19153,45863,5441,877,99,5,0,71438,144598
8,47,27512,43695,3993,320,151,4,3,75678,18992,48162,5819,1104,80,7,1,74165,149843
8,48,28218,47372,4433,348,195,2,2,80570,19247,51697,6758,1268,102,4,1,79077,159647
8,49,27722,49644,5128,395,211,3,4,83107,18840,53528,7172,1359,87,5,2,80993,164100
8,50,25890,50476,5382,438,185,2,3,82376,18099,54056,7620,1472,79,5,0,81331,163707
8,51,24787,52107,5700,464,190,6,3,83257,16998,55092,7828,1667,85,4,1,81675,164932
8,52,23562,53107,6126,501,180,5,5,83486,15775,55356,8086,1997,87,3,0,81304,164790
8,53,21777,53650,6235,529,184,2,8,82385,14870,55506,8379,2183,82,5,0,81025,163410
8,54,20805,55538,6805,584,172,4,1,83909,14614,57198,8720,2518,60,3,1,83114,167023
8,55,19873,56103,6690,659,200,5,4,83534,13484,57344,8723,2818,63,3,1,82436,165970
8,56,18499,56300,6935,713,158,1,4,82610,13085,57408,8817,3133,64,1,1,82509,165119
8,57,17593,58294,7169,984,180,5,3,84228,12305,58910,8772,3554,50,3,0,83594,167822
8,58,16224,58092,7379,994,174,3,5,82871,11822,58462,8766,4005,55,2,1,83113,165984
8,59,14646,59058,7185,1119,148,2,7,82165,11064,58219,8588,4391,50,1,0,82313,164478
8,60,12741,55108,6514,1156,145,2,4,75670,9728,54937,8048,4696,39,0,3,77451,153121
8,61,11154,52458,6113,1257,152,1,1,71136,8862,52307,7322,5148,47,1,1,73688,144824
8,62,10050,51271,5721,1389,135,1,6,68573,8173,50547,6763,5762,42,1,0,71288,139861
8,63,9015,49777,5162,1543,104,0,5,65606,7553,48528,6438,6289,46,0,0,68854,134460
8,64,8151,48152,4820,1581,91,0,6,62801,6867,47352,5929,6862,36,0,1,67047,129848
8,65,7417,45925,4358,1728,94,1,3,59526,6305,44385,5355,7363,25,0,4,63437,122963
8,66,6739,45081,4117,1779,64,2,1,57783,5890,43373,5024,8004,29,0,1,62321,120104
8,67,6158,44339,3808,2083,60,0,8,56456,5350,42223,4733,8712,14,0,1,61033,117489
8,68,5539,42580,3380,2064,61,2,1,53627,4933,41202,4380,9354,18,0,1,59888,113515
8,69,5265,41717,3119,2373,55,3,3,52535,4647,39301,4036,10066,16,0,0,58066,110601
8,70,4815,40226,2764,2495,43,0,6,50349,4108,37438,3684,10588,10,0,1,55829,106178
8,71,4621,39424,2560,2650,56,1,1,49313,4132,36555,3403,11655,11,0,2,55758,105071
8,72,4298,38515,2364,2831,39,0,4,48051,3748,35770,3178,12688,10,0,2,55396,103447
8,73,4278,39841,2159,3282,39,0,1,49600,3744,36216,2980,14110,10,0,3,57063,106663
8,74,4009,39683,1920,3604,37,1,4,49258,3679,34886,2912,15741,9,0,0,57227,106485
8,75,3819,40363,1937,3976,43,0,1,50139,3712,34615,2887,17907,9,0,0,59130,109269
8,76,3401,38133,1695,4201,38,0,4,47472,3482,31933,2613,18744,9,0,1,56782,104254
8,77,3252,38163,1566,4689,25,0,3,47698,3425,31008,2583,20884,5,0,0,57905,105603
8,78,2286,26920,1069,3731,9,0,3,34018,2578,21027,1697,16914,1,0,1,42218,76236
8,79,2338,27578,971,4147,18,0,4,35056,2642,21326,1642,19320,4,0,0,44934,79990
8,80,2107,25661,837,4418,16,1,2,33042,2629,19543,1499,20122,1,0,0,43794,76836
8,81,2146,24871,772,4566,15,0,1,32371,2602,18049,1431,21772,2,0,0,43856,76227
8,82,2021,23545,657,5005,16,0,1,31245,2640,16415,1310,23552,1,0,0,43918,75163
8,83,1969,24035,642,5728,6,0,1,32381,2866,15587,1230,26348,3,0,0,46034,78415
8,84,1775,21729,523,5750,12,0,0,29789,2737,13178,1006,26413,2,0,1,43337,73126
8,85,1455,18923,436,5693,5,0,0,26512,2601,10844,928,26013,1,0,0,40387,66899
8,86,1133,15012,331,5083,7,0,1,21567,2291,7864,685,23665,1,0,0,34506,56073
8,87,914,11677,240,4547,4,0,0,17382,1964,5828,593,21253,1,0,0,29639,47021
8,88,807,9956,219,4446,2,0,0,15430,1935,4654,493,21170,0,0,0,28252,43682
8,89,670,7634,150,3910,3,0,0,12367,1766,3273,373,18976,0,0,0,24388,36755
8,90,481,5906,112,3285,4,0,0,9788,1503,2337,293,16708,1,0,0,20842,30630
8,91,421,4385,73,2952,2,0,0,7833,1354,1615,257,14971,0,0,0,18197,26030
8,92,278,3292,46,2374,3,0,0,5993,1224,1101,177,12728,0,0,1,15231,21224
8,93,198,2360,37,2010,2,0,1,4608,1105,693,167,10839,0,0,0,12804,17412
8,94,140,1512,28,1418,0,0,0,3098,870,444,104,8396,0,0,0,9814,12912
8,95,105,934,9,1077,1,0,0,2126,643,274,71,6278,1,0,0,7267,9393
8,96,58,566,11,800,0,0,0,1435,472,155,65,4701,0,0,0,5393,6828
8,97,46,294,5,586,0,0,0,931,328,76,42,3465,0,0,0,3911,4842
8,98,24,187,5,365,0,0,0,581,239,61,22,2383,0,0,0,2705,3286
8,99,16,70,5,196,0,0,0,287,164,33,20,1619,0,0,0,1836,2123
8,100,34,100,1,306,0,0,0,441,280,47,17,2524,0,0,0,2868,3309
8,999,2438816,2181183,173482,126937,6244,195,146,4927003,2059292,2199459,240894,581983,3207,178,38,5085051,10012054
9,0,4407,0,0,0,0,0,0,4407,4090,0,0,0,0,0,0,4090,8497
9,1,4633,0,0,0,0,0,0,4633,4368,0,0,0,0,0,0,4368,9001
9,2,4852,0,0,0,0,0,0,4852,4621,0,0,0,0,0,0,4621,9473
9,3,4820,0,0,0,0,0,0,4820,4569,0,0,0,0,0,0,4569,9389
9,4,5064,0,0,0,0,0,0,5064,4624,0,0,0,0,0,0,4624,9688
9,5,5074,0,0,0,0,0,0,5074,4808,0,0,0,0,0,0,4808,9882
9,6,5228,0,0,0,0,0,0,5228,4946,0,0,0,0,0,0,4946,10174
9,7,5304,0,0,0,0,0,0,5304,5120,0,0,0,0,0,0,5120,10424
9,8,5391,0,0,0,0,0,0,5391,5129,0,0,0,0,0,0,5129,10520
9,9,5528,0,0,0,0,0,0,5528,5237,0,0,0,0,0,0,5237,10765
9,10,5597,0,0,0,0,0,0,5597,5171,0,0,0,0,0,0,5171,10768
9,11,5731,0,0,0,0,0,0,5731,5351,0,0,0,0,0,0,5351,11082
9,12,5670,0,0,0,0,0,0,5670,5430,0,0,0,0,0,0,5430,11100
9,13,5838,0,0,0,0,0,0,5838,5418,0,0,0,0,0,0,5418,11256
9,14,5820,0,0,0,0,0,0,5820,5438,0,0,0,0,0,0,5438,11258
9,15,5892,0,0,0,0,0,0,5892,5576,0,0,0,0,0,0,5576,11468
9,16,5917,0,0,0,0,0,0,5917,5434,0,0,0,0,0,0,5434,11351
9,17,5911,1,0,0,0,0,0,5912,5495,0,0,0,0,0,0,5495,11407
9,18,6145,0,0,0,0,0,0,6145,5489,5,0,0,0,0,0,5494,11639
9,19,6159,1,0,0,0,0,0,6160,5626,25,0,0,0,0,0,5651,11811
9,20,6027,3,0,0,0,0,0,6030,5461,55,0,0,0,0,0,5516,11546
9,21,5960,14,0,0,0,0,0,5974,5372,79,1,0,0,0,0,5452,11426
9,22,6193,33,6,0,0,0,0,6232,5432,149,4,0,0,0,0,5585,11817
9,23,6180,60,4,0,0,0,0,6244,5548,244,8,0,2,0,0,5802,12046
9,24,6161,93,5,0,0,0,0,6259,5433,327,5,0,2,0,0,5767,12026
9,25,6177,179,4,0,0,0,0,6360,5371,497,18,0,0,0,0,5886,12246
9,26,6124,269,10,0,2,0,0,6405,5098,656,10,0,2,0,0,5766,12171
9,27,5934,426,5,0,6,0,0,6371,4866,899,19,4,0,0,0,5788,12159
9,28,5620,558,8,0,3,0,0,6189,4479,1114,28,1,6,0,0,5628,11817
9,29,5509,703,29,1,7,0,0,6249,4335,1414,26,0,5,0,0,5780,12029
9,30,5264,945,25,1,5,0,0,6240,4060,1687,46,2,6,0,0,5801,12041
9,31,5190,1226,24,0,7,0,0,6447,3854,2048,65,3,15,1,0,5986,12433
9,32,4891,1469,47,4,8,0,0,6419,3648,2280,73,12,7,1,0,6021,12440
9,33,4782,1685,44,5,11,0,0,6527,3364,2514,91,7,15,0,0,5991,12518
9,34,4265,1970,69,3,6,0,0,6313,3187,2711,110,9,13,1,0,6031,12344
9,35,4106,2193,74,7,10,2,1,6393,3076,2913,126,8,14,1,0,6138,12531
9,36,3729,2351,69,7,11,1,0,6168,2864,2975,147,15,10,0,0,6011,12179
9,37,3549,2540,108,3,14,0,0,6214,2571,3172,185,33,14,1,0,5976,12190
9,38,3497,2706,108,5,10,2,0,6328,2532,3377,223,28,12,1,0,6173,12501
9,39,3319,2909,114,6,13,0,0,6361,2395,3447,248,29,9,2,0,6130,12491
9,40,3189,3120,143,6,12,1,0,6471,2422,3677,254,31,6,0,0,6390,12861
9,41,3086,3413,155,7,9,1,0,6671,2331,3941,295,36,5,1,0,6609,13280
9,42,2961,3492,183,23,6,0,0,6665,2220,3904,332,56,7,0,0,6519,13184
9,43,2909,3557,199,22,8,2,0,6697,2091,4144,360,76,9,1,0,6681,13378
9,44,2777,3549,191,13,11,0,0,6541,2055,4238,406,64,4,0,0,6767,13308
9,45,2843,3867,248,15,8,0,0,6981,2131,4464,431,79,6,0,0,7111,14092
9,46,2741,3996,327,18,7,0,0,7089,2047,4458,514,97,5,1,0,7122,14211
9,47,2650,4210,337,25,12,1,0,7235,2146,4687,584,85,4,1,0,7507,14742
9,48,2740,4477,373,23,9,1,0,7623,2061,5067,636,108,6,1,0,7879,15502
9,49,2865,4835,447,30,27,0,0,8204,2090,5254,662,154,6,0,0,8166,16370
9,50,2657,4763,574,40,15,0,0,8049,1993,5413,758,150,9,2,0,8325,16374
9,51,2623,5063,529,43,11,1,0,8270,1962,5485,753,143,5,1,0,8349,16619
9,52,2652,5215,584,51,12,0,0,8514,1830,5714,859,217,6,1,0,8627,17141
9,53,2371,5212,622,49,12,0,0,8266,1744,5565,921,208,4,0,0,8442,16708
9,54,2526,5681,675,63,13,0,0,8958,1761,5759,927,259,5,1,0,8712,17670
9,55,2300,5682,660,64,20,1,1,8728,1617,5822,972,258,5,1,0,8675,17403
9,56,2134,5596,760,71,6,0,1,8568,1566,5915,960,324,9,0,0,8774,17342
9,57,2170,5820,723,48,11,0,0,8772,1446,6037,965,351,3,0,0,8802,17574
9,58,1987,6102,798,84,11,0,0,8982,1478,5902,983,365,4,0,0,8732,17714
9,59,1792,6088,809,122,12,0,1,8824,1227,6089,973,468,4,1,0,8762,17586
9,60,1556,5812,756,119,11,0,0,8254,1172,5781,827,465,2,0,0,8247,16501
9,61,1357,5504,686,122,8,0,0,7677,1062,5484,829,529,0,0,0,7904,15581
9,62,1289,5413,691,153,6,0,0,7552,1052,5396,817,586,4,0,0,7855,15407
9,63,1209,5305,694,140,9,0,1,7358,905,5170,713,606,4,0,0,7398,14756
9,64,1011,5328,605,145,4,0,0,7093,822,5002,639,642,3,0,0,7108,14201
9,65,952,4837,525,167,4,0,0,6485,805,4590,583,761,3,0,0,6742,13227
9,66,869,4675,469,170,3,0,0,6186,748,4650,579,780,3,0,0,6760,12946
9,67,852,4665,437,181,7,0,0,6142,620,4322,511,879,1,0,1,6334,12476
9,68,757,4460,420,176,3,0,0,5816,633,4148,449,857,3,0,0,6090,11906
9,69,699,4268,380,196,3,0,0,5546,548,3906,441,965,3,0,0,5863,11409
9,70,668,4156,334,215,3,0,0,5376,556,3775,415,1022,0,0,0,5768,11144
9,71,598,4029,319,242,1,0,0,5189,496,3650,332,1165,0,0,0,5643,10832
9,72,566,3970,292,242,2,0,0,5072,432,3399,342,1211,0,0,0,5384,10456
9,73,560,3929,290,265,3,0,0,5047,477,3444,337,1351,2,0,0,5611,10658
9,74,500,3796,235,340,2,0,0,4873,423,3157,302,1414,0,0,0,5296,10169
9,75,486,3846,228,345,1,0,1,4907,404,3153,268,1586,1,0,0,5412,10319
9,76,452,3531,196,379,2,0,0,4560,395,3008,264,1692,0,0,0,5359,9919
9,77,434,3725,163,416,0,0,0,4738,471,3073,258,1933,0,0,0,5735,10473
9,78,267,2620,125,336,2,0,1,3351,291,1986,185,1531,0,0,0,3993,7344
9,79,305,2903,126,384,0,0,0,3718,363,2214,160,1885,1,0,0,4623,8341
9,80,330,2908,98,451,2,0,0,3789,368,2193,168,2031,0,0,0,4760,8549
9,81,303,2757,147,424,0,0,0,3631,353,1886,149,2253,0,0,0,4641,8272
9,82,296,2554,111,472,0,0,0,3433,336,1771,133,2328,0,0,0,4568,8001
9,83,283,2244,76,473,0,0,0,3076,343,1455,124,2381,0,0,0,4303,7379
9,84,255,2097,55,478,0,0,0,2885,334,1203,104,2439,0,0,0,4080,6965
9,85,188,1772,48,477,0,0,0,2485,343,998,72,2234,0,0,0,3647,6132
9,86,157,1501,41,416,0,0,0,2115,289,724,61,2086,0,0,0,3160,5275
9,87,145,1210,30,378,0,0,0,1763,264,592,50,1974,0,0,0,2880,4643
9,88,131,972,22,354,0,0,0,1479,234,440,37,1940,0,0,0,2651,4130
9,89,99,816,15,329,0,0,0,1259,233,307,37,1837,0,0,0,2414,3673
9,90,81,651,16,298,0,0,0,1046,209,223,23,1637,0,0,0,2092,3138
9,91,50,502,13,313,0,0,0,878,177,172,20,1420,0,0,0,1789,2667
9,92,44,404,9,231,0,0,0,688,154,122,13,1244,0,0,0,1533,2221
9,93,39,292,8,199,0,0,0,538,158,93,16,1102,0,0,0,1369,1907
9,94,26,167,2,149,0,0,0,344,127,56,9,841,0,0,0,1033,1377
9,95,22,133,1,126,0,0,0,282,81,43,8,628,0,0,0,760,1042
9,96,18,80,0,89,0,0,0,187,80,19,9,466,0,0,0,574,761
9,97,7,43,1,52,0,0,0,103,66,7,3,345,0,0,0,421,524
9,98,2,24,0,39,0,0,0,65,49,5,4,239,0,0,0,297,362
9,99,3,10,0,33,0,0,0,46,35,3,0,170,0,0,0,208,254
9,100,5,11,0,41,0,0,0,57,42,3,1,299,0,0,0,345,402
9,999,281302,223992,18754,11414,421,13,7,535903,240054,225746,25270,55434,274,20,1,546799,1082702
10,0,15643,0,0,0,0,0,0,15643,14846,0,0,0,0,0,0,14846,30489
10,1,16515,0,0,0,0,0,0,16515,15601,0,0,0,0,0,0,15601,32116
10,2,17071,0,0,0,0,0,0,17071,16291,0,0,0,0,0,0,16291,33362
10,3,17487,0,0,0,0,0,0,17487,16031,0,0,0,0,0,0,16031,33518
10,4,17762,0,0,0,0,0,0,17762,16704,0,0,0,0,0,0,16704,34466
10,5,18771,0,0,0,0,0,0,18771,17702,0,0,0,0,0,0,17702,36473
10,6,19583,0,0,0,0,0,0,19583,18360,0,0,0,0,0,0,18360,37943
10,7,20121,0,0,0,0,0,0,20121,18938,0,0,0,0,0,0,18938,39059
10,8,20596,0,0,0,0,0,0,20596,19610,0,0,0,0,0,0,19610,40206
10,9,21182,0,0,0,0,0,0,21182,20262,0,0,0,0,0,0,20262,41444
10,10,21829,0,0,0,0,0,0,21829,20582,0,0,0,0,0,0,20582,42411
10,11,22840,0,0,0,0,0,0,22840,21541,0,0,0,0,0,0,21541,44381
10,12,23106,0,0,0,0,0,0,23106,22025,0,0,0,0,0,0,22025,45131
10,13,24003,0,0,0,0,0,0,24003,22488,0,0,0,0,0,0,22488,46491
10,14,24372,0,0,0,0,0,0,24372,22853,0,0,0,0,0,0,22853,47225
10,15,24792,0,0,0,0,0,0,24792,23411,0,0,0,0,0,0,23411,48203
10,16,24480,0,1,0,0,0,0,24481,23205,0,0,0,0,0,0,23205,47686
10,17,24588,0,0,0,0,0,0,24588,23152,0,0,0,0,0,0,23152,47740
10,18,24829,2,0,0,0,0,0,24831,22879,16,0,0,0,0,0,22895,47726
10,19,25356,8,1,0,0,0,0,25365,23183,71,0,0,1,0,0,23255,48620
10,20,24809,11,1,2,0,0,0,24823,22751,173,0,0,0,0,0,22924,47747
10,21,24726,42,0,0,1,0,0,24769,22238,338,4,0,1,0,0,22581,47350
10,22,24879,91,11,0,1,0,0,24982,21973,572,13,0,2,0,0,22560,47542
10,23,25751,204,14,0,2,0,0,25971,22831,920,20,0,2,0,0,23773,49744
10,24,25423,319,12,1,3,0,0,25758,22259,1375,39,2,5,0,0,23680,49438
10,25,25756,590,28,1,7,0,0,26382,21806,1868,38,3,7,0,0,23722,50104
10,26,25160,860,35,1,9,0,0,26065,21195,2481,52,3,6,2,0,23739,49804
10,27,24595,1297,40,2,6,0,0,25940,20218,3166,74,3,11,2,0,23474,49414
10,28,23674,2013,58,1,25,2,0,25773,18710,4279,91,10,15,2,0,23107,48880
10,29,22800,2570,59,2,13,0,0,25444,17981,5357,122,8,24,1,0,23493,48937
10,30,21708,3478,81,0,25,1,0,25293,17266,6598,163,11,20,0,0,24058,49351
10,31,21797,4577,108,1,17,2,0,26502,16439,7978,218,17,29,3,1,24685,51187
10,32,20254,5569,135,26,18,2,0,26004,15452,9145,261,30,30,0,0,24918,50922
10,33,19720,6793,184,12,40,5,0,26754,14453,10225,335,46,34,1,0,25094,51848
10,34,18066,7801,192,14,41,2,0,26116,13483,11277,479,32,45,4,0,25320,51436
10,35,17471,8930,283,22,44,3,0,26753,12798,12569,556,54,40,7,0,26024,52777
10,36,15894,9715,304,35,39,2,0,25989,11555,12774,619,50,62,4,0,25064,51053
10,37,14984,10359,365,28,62,2,0,25800,10980,13845,795,103,34,1,0,25758,51558
10,38,15032,11480,464,28,46,2,0,27052,10869,14932,943,119,47,3,1,26914,53966
10,39,14176,12265,520,21,45,4,0,27031,10337,15467,1037,124,26,0,0,26991,54022
10,40,13802,13328,634,36,51,1,0,27852,9805,16044,1148,172,35,2,0,27206,55058
10,41,13447,14150,738,36,34,3,0,28408,9716,17172,1406,183,34,0,0,28511,56919
10,42,13102,15022,894,98,43,2,1,29162,9427,17542,1563,292,37,2,0,28863,58025
10,43,13113,16028,1072,85,42,4,0,30344,8889,18287,1749,287,41,0,1,29254,59598
10,44,12971,16818,1210,100,45,4,2,31150,9077,19502,1985,309,33,5,0,30911,62061
10,45,13632,18029,1402,109,59,1,1,33233,9524,20755,2316,354,19,3,0,32971,66204
10,46,13367,19079,1540,93,60,2,0,34141,9323,21990,2545,464,23,2,0,34347,68488
10,47,13648,20358,1815,123,55,2,0,36001,8910,23185,2912,524,22,0,0,35553,71554
10,48,13502,21897,2091,139,61,3,1,37694,8987,24473,3183,614,36,1,0,37294,74988
10,49,13702,23723,2346,148,51,0,1,39971,9237,26219,3374,721,31,0,0,39582,79553
10,50,12947,23985,2608,185,51,2,0,39778,8583,26402,3621,730,36,1,0,39373,79151
10,51,12447,25061,2729,243,62,1,1,40544,8298,26705,3767,836,29,2,0,39637,80181
10,52,11968,25615,2890,211,52,3,1,40740,7881,27746,3899,963,30,2,1,40522,81262
10,53,11140,26319,3031,266,52,1,0,40809,7301,27787,4125,1049,19,1,0,40282,81091
10,54,10391,27672,3406,285,61,2,2,41819,7020,28880,4138,1267,23,0,0,41328,83147
10,55,9713,27595,3234,293,44,0,1,40880,6690,28876,4137,1400,7,0,1,41111,81991
10,56,9096,28420,3370,364,47,0,4,41301,6374,29120,4217,1500,18,3,0,41232,82533
10,57,8534,28981,3477,443,52,1,0,41488,5949,29820,4186,1668,21,2,0,41646,83134
10,58,7867,29432,3634,506,56,0,0,41495,5599,29698,4272,1922,26,0,1,41518,83013
10,59,7236,29808,3671,535,31,1,0,41282,5387,30402,4256,2151,7,1,0,42204,83486
10,60,6474,28305,3394,513,36,0,0,38722,4712,28602,3798,2226,18,0,0,39356,78078
10,61,5626,27589,3130,640,51,0,0,37036,4343,27367,3538,2532,12,1,0,37793,74829
10,62,5275,26979,2899,690,44,1,0,35888,3981,26757,3453,2863,13,0,0,37067,72955
10,63,4590,25889,2542,736,46,1,1,33805,3418,25301,3069,3120,11,2,1,34922,68727
10,64,4240,25649,2521,792,39,0,0,33241,3297,25120,2756,3366,8,0,0,34547,67788
10,65,3757,24060,2245,782,33,0,0,30877,2865,23647,2456,3575,6,0,0,32549,63426
10,66,3466,23619,2014,893,31,0,0,30023,2743,22569,2364,3943,12,1,0,31632,61655
10,67,3138,23087,1887,961,22,0,1,29096,2565,22164,2190,4340,4,0,0,31263,60359
10,68,2765,22285,1665,1037,21,0,1,27774,2276,21243,1977,4572,8,1,0,30077,57851
10,69,2693,21844,1581,1161,23,0,1,27303,2085,20403,1892,4903,2,0,0,29285,56588
10,70,2332,21303,1331,1206,20,0,0,26192,1871,19488,1694,5181,4,0,0,28238,54430
10,71,2203,20531,1238,1324,25,0,0,25321,1823,18989,1481,5611,3,0,0,27907,53228
10,72,2057,20264,1127,1397,26,0,2,24873,1635,18213,1422,5832,5,0,1,27108,51981
10,73,2069,20535,1061,1506,10,0,2,25183,1665,18712,1371,6770,4,0,0,28522,53705
10,74,1851,20275,961,1665,13,1,2,24768,1590,17524,1192,7416,2,0,0,27724,52492
10,75,1870,20248,904,1844,13,0,2,24881,1608,17461,1183,8327,2,0,0,28581,53462
10,76,1668,19243,751,2010,13,0,0,23685,1583,15970,1129,9008,1,0,0,27691,51376
10,77,1781,20244,787,2289,10,1,1,25113,1628,16549,1012,10509,3,0,0,29701,54814
10,78,1089,13195,501,1720,7,0,0,16512,1114,10553,715,7843,3,0,0,20228,36740
10,79,1276,14830,497,2040,8,0,0,18651,1269,11209,637,9853,0,0,0,22968,41619
10,80,1199,14285,410,2260,4,0,2,18160,1312,10599,661,10591,0,0,0,23163,41323
10,81,1164,13003,386,2307,8,0,1,16869,1316,9328,620,10929,1,0,0,22194,39063
10,82,1095,12284,332,2396,7,0,0,16114,1268,7987,499,11544,0,0,1,21299,37413
10,83,1036,11984,293,2689,4,0,0,16006,1276,7604,458,12738,1,0,0,22077,38083
10,84,896,11176,217,2654,0,0,1,14944,1248,6236,412,12752,0,0,0,20648,35592
10,85,794,9206,182,2563,2,0,0,12747,1176,5044,346,12785,0,0,0,19351,32098
10,86,606,7525,155,2400,1,0,0,10687,1065,3636,273,11725,0,0,0,16699,27386
10,87,534,5833,107,2115,1,0,0,8590,972,2665,183,10863,0,0,0,14683,23273
10,88,435,5182,89,2031,1,0,0,7738,889,2036,178,10550,0,0,0,13653,21391
10,89,360,4196,77,1890,0,0,0,6523,830,1548,136,9735,0,0,0,12249,18772
10,90,271,2985,49,1526,0,0,0,4831,747,945,127,8152,0,0,0,9971,14802
10,91,225,2204,37,1401,0,0,0,3867,649,690,87,7421,0,0,0,8847,12714
10,92,159,1681,21,1175,0,0,0,3036,564,487,56,6354,0,0,0,7461,10497
10,93,142,1157,18,957,0,0,0,2274,525,313,56,5514,0,0,0,6408,8682
10,94,97,776,13,691,0,0,0,1577,367,169,41,4026,0,0,0,4603,6180
10,95,62,497,10,553,0,0,0,1122,302,117,18,3294,0,0,0,3731,4853
10,96,42,333,8,429,0,0,0,812,267,68,14,2571,0,0,0,2920,3732
10,97,22,184,5,284,0,0,0,495,163,38,17,1808,0,0,0,2026,2521
10,98,12,96,1,181,0,0,0,290,146,17,6,1262,0,0,0,1431,1721
10,99,11,54,1,125,0,0,0,191,89,14,7,799,0,0,0,909,1100
10,100,8,57,2,147,0,0,0,214,170,14,6,1306,0,0,0,1496,1710
10,999,1156616,1084966,84137,60475,1972,64,32,2388262,970647,1093427,112188,286530,1091,62,9,2463954,4852216
11,0,3570,0,0,0,0,0,0,3570,3422,0,0,0,0,0,0,3422,6992
11,1,3790,0,0,0,0,0,0,3790,3560,0,0,0,0,0,0,3560,7350
11,2,3787,0,0,0,0,0,0,3787,3638,0,0,0,0,0,0,3638,7425
11,3,3917,0,0,0,0,0,0,3917,3809,0,0,0,0,0,0,3809,7726
11,4,4001,0,0,0,0,0,0,4001,3792,0,0,0,0,0,0,3792,7793
11,5,4211,0,0,0,0,0,0,4211,3948,0,0,0,0,0,0,3948,8159
11,6,4388,0,0,0,0,0,0,4388,4173,0,0,0,0,0,0,4173,8561
11,7,4568,0,0,0,0,0,0,4568,4347,0,0,0,0,0,0,4347,8915
11,8,4579,0,0,0,0,0,0,4579,4403,0,0,0,0,0,0,4403,8982
11,9,4921,0,0,0,0,0,0,4921,4564,0,0,0,0,0,0,4564,9485
11,10,4984,0,0,0,0,0,0,4984,4716,0,0,0,0,0,0,4716,9700
11,11,5138,0,0,0,0,0,0,5138,4922,0,0,0,0,0,0,4922,10060
11,12,5389,0,0,0,0,0,0,5389,4866,0,0,0,0,0,0,4866,10255
11,13,5523,0,0,0,0,0,0,5523,5146,0,0,0,0,0,0,5146,10669
11,14,5578,0,0,0,0,0,0,5578,5273,0,0,0,0,0,0,5273,10851
11,15,5600,0,0,0,0,0,0,5600,5208,0,0,0,0,0,0,5208,10808
11,16,5583,0,0,0,0,0,0,5583,5387,0,0,0,0,0,0,5387,10970
11,17,5596,0,0,0,0,0,0,5596,5335,0,0,0,0,0,0,5335,10931
11,18,5723,0,0,0,0,0,0,5723,5164,4,0,0,0,0,0,5168,10891
11,19,5724,2,0,0,1,0,0,5727,5347,16,0,0,0,0,0,5363,11090
11,20,5823,5,0,0,0,0,0,5828,5125,42,0,0,0,0,0,5167,10995
11,21,5754,10,0,0,0,0,0,5764,5081,88,0,0,0,0,0,5169,10933
11,22,5916,31,4,0,0,0,0,5951,5051,149,1,0,0,0,0,5201,11152
11,23,6038,38,5,0,2,0,0,6083,5258,245,2,0,2,0,0,5507,11590
11,24,5873,89,4,0,0,0,0,5966,4914,317,6,0,0,0,0,5237,11203
11,25,5958,166,6,0,2,0,0,6132,4843,438,8,1,2,0,0,5292,11424
11,26,5819,244,10,0,2,0,1,6076,4696,571,1,1,1,1,0,5271,11347
11,27,5892,306,12,1,4,1,0,6216,4559,802,16,3,4,0,0,5384,11600
11,28,5475,467,12,0,3,0,0,5957,4312,962,21,1,3,1,0,5300,11257
11,29,5346,588,12,0,5,0,0,5951,4091,1200,27,5,1,1,0,5325,11276
11,30,5157,816,21,0,6,1,0,6001,3851,1395,39,2,5,1,0,5293,11294
11,31,5188,1120,30,0,9,0,0,6347,3878,1828,70,4,4,0,0,5784,12131
11,32,4853,1331,32,3,8,0,0,6227,3657,2096,78,7,7,0,0,5845,12072
11,33,4755,1506,41,10,7,1,0,6320,3451,2367,77,8,5,1,0,5909,12229
11,34,4380,1819,54,6,8,0,0,6267,3239,2559,112,3,10,0,0,5923,12190
11,35,4197,2039,83,8,10,0,0,6337,3095,2845,135,11,10,0,0,6096,12433
11,36,3762,2193,89,7,10,1,0,6062,2760,2963,164,15,7,0,0,5909,11971
11,37,3725,2361,133,4,10,0,0,6233,2634,3141,231,23,8,0,0,6037,12270
11,38,3575,2648,119,6,2,0,0,6350,2611,3476,226,25,6,1,0,6345,12695
11,39,3606,2920,138,6,12,1,0,6683,2550,3490,292,23,10,1,0,6366,13049
11,40,3350,3047,148,9,6,2,0,6562,2385,3574,300,33,9,0,0,6301,12863
11,41,3356,3339,203,10,4,0,0,6912,2416,3921,389,43,9,0,0,6778,13690
11,42,3309,3467,232,23,3,0,0,7034,2282,3950,414,58,7,2,0,6713,13747
11,43,3269,3663,304,23,13,0,1,7273,2332,4085,476,61,2,2,0,6958,14231
11,44,3269,3902,291,24,8,0,0,7494,2278,4272,469,85,8,0,0,7112,14606
11,45,3536,4237,363,18,5,0,1,8160,2484,4536,628,116,10,1,0,7775,15935
11,46,3416,4333,425,23,9,0,0,8206,2362,4923,641,83,9,0,0,8018,16224
11,47,3465,4628,437,32,16,1,0,8579,2437,5224,747,147,7,1,0,8563,17142
11,48,3546,4941,544,48,23,0,0,9102,2418,5609,848,153,5,0,0,9033,18135
11,49,3622,5419,645,47,16,0,0,9749,2474,6097,983,204,6,1,0,9765,19514
11,50,3359,5450,673,47,5,0,0,9534,2442,6085,1021,183,12,2,1,9746,19280
11,51,3357,5699,731,44,14,0,0,9845,2167,6486,1028,230,6,0,0,9917,19762
11,52,3227,5868,743,62,13,0,0,9913,2080,6545,1101,281,6,0,0,10013,19926
11,53,3030,5865,855,54,13,0,0,9817,2131,6593,1186,307,11,0,0,10228,20045
11,54,2964,6166,908,68,11,0,0,10117,1949,6635,1127,313,9,2,0,10035,20152
11,55,2698,6365,907,85,9,0,0,10064,1834,6567,1204,394,4,0,0,10003,20067
11,56,2560,6358,970,92,9,0,0,9989,1743,6860,1308,362,5,1,0,10279,20268
11,57,2392,6494,994,114,15,0,0,10009,1717,6749,1320,485,0,0,0,10271,20280
11,58,2377,6638,1017,100,10,0,0,10142,1606,6929,1268,466,3,0,0,10272,20414
11,59,2249,6827,1054,141,12,0,0,10283,1585,6959,1328,552,6,0,0,10430,20713
11,60,1927,6526,970,143,18,0,1,9585,1327,6853,1174,632,4,0,0,9990,19575
11,61,1739,6226,960,159,8,0,0,9092,1178,6396,1117,740,3,0,0,9434,18526
11,62,1560,6293,884,173,11,0,0,8921,1049,6191,1109,749,1,0,0,9099,18020
11,63,1417,6123,861,158,9,0,0,8568,990,5926,1002,793,3,0,0,8714,17282
11,64,1274,5972,843,207,3,0,0,8299,861,5923,1008,943,2,0,0,8737,17036
11,65,1128,5522,763,211,5,0,0,7629,802,5626,888,967,1,0,0,8284,15913
11,66,1064,5347,666,228,8,0,1,7314,739,5510,860,1042,2,0,0,8153,15467
11,67,963,5447,685,274,6,0,0,7375,665,5187,796,1202,0,0,0,7850,15225
11,68,917,5281,612,295,2,0,0,7107,643,5060,751,1253,2,0,0,7709,14816
11,69,810,5180,560,298,7,0,0,6855,583,4958,722,1401,3,0,0,7667,14522
11,70,710,5157,521,326,2,0,0,6716,533,4952,592,1517,0,0,0,7594,14310
11,71,659,4983,464,353,3,0,1,6463,492,4919,601,1574,1,0,0,7587,14050
11,72,702,4877,408,365,3,0,1,6356,469,4624,541,1816,0,0,0,7450,13806
11,73,673,5179,403,458,2,0,0,6715,475,4784,530,2048,1,0,0,7838,14553
11,74,582,5137,421,484,2,0,0,6626,429,4552,497,2192,0,0,0,7670,14296
11,75,609,5435,370,541,1,0,0,6956,467,4586,528,2480,2,0,0,8063,15019
11,76,534,5250,305,591,1,0,0,6681,423,4418,462,2780,0,0,0,8083,14764
11,77,559,5424,285,669,1,0,0,6938,430,4382,424,3120,0,0,0,8356,15294
11,78,367,3539,210,490,2,0,0,4608,297,2752,300,2256,0,0,0,5605,10213
11,79,392,4010,212,653,0,0,0,5267,349,2980,298,3030,0,0,0,6657,11924
11,80,379,3783,197,667,3,0,0,5029,319,2836,298,2994,0,0,0,6447,11476
11,81,363,3620,181,643,1,0,1,4809,358,2629,279,3271,0,0,0,6537,11346
11,82,320,3452,139,790,3,0,0,4704,347,2312,225,3474,0,0,0,6358,11062
11,83,314,3327,146,857,0,0,0,4644,358,2086,217,3798,1,0,0,6460,11104
11,84,257,2980,101,734,0,0,1,4073,354,1798,185,3708,0,0,0,6045,10118
11,85,210,2596,84,766,1,0,0,3657,284,1372,168,3714,0,0,0,5538,9195
11,86,189,2132,68,701,1,0,0,3091,259,1017,141,3366,0,0,0,4783,7874
11,87,121,1653,51,616,1,0,0,2442,251,733,95,3188,0,0,0,4267,6709
11,88,122,1365,36,592,0,0,0,2115,211,608,84,2966,0,0,1,3870,5985
11,89,88,1033,36,487,0,0,0,1644,225,399,77,2681,0,0,0,3382,5026
11,90,70,819,13,469,0,0,0,1371,190,271,48,2356,0,0,0,2865,4236
11,91,46,640,13,398,0,0,0,1097,149,198,59,2138,0,0,0,2544,3641
11,92,46,481,16,348,0,0,0,891,155,140,36,1824,0,0,0,2155,3046
11,93,41,357,12,298,0,0,0,708,135,94,28,1687,0,0,0,1944,2652
11,94,21,200,5,211,0,0,0,437,99,51,26,1288,0,0,0,1464,1901
11,95,17,150,5,159,0,0,0,331,90,31,13,961,0,0,0,1095,1426
11,96,9,85,2,125,0,0,0,221,59,24,13,777,0,0,0,873,1094
11,97,6,53,0,84,0,0,0,143,46,10,3,631,0,0,0,690,833
11,98,2,36,1,58,0,0,0,97,38,9,5,421,0,0,0,473,570
11,99,3,15,0,29,0,0,0,47,28,3,5,276,0,0,0,312,359
11,100,5,26,4,64,0,0,0,99,40,4,7,484,0,0,0,535,634
11,999,281228,259116,25762,17287,419,8,9,583829,230994,260797,35504,83226,245,19,2,610787,1194616
12,0,4337,0,0,0,0,0,0,4337,4038,0,0,0,0,0,0,4038,8375
12,1,4481,0,0,0,0,0,0,4481,4137,0,0,0,0,0,0,4137,8618
12,2,4544,0,0,0,0,0,0,4544,4279,0,0,0,0,0,0,4279,8823
12,3,4680,0,0,0,0,0,0,4680,4536,0,0,0,0,0,0,4536,9216
12,4,4753,0,0,0,0,0,0,4753,4487,0,0,0,0,0,0,4487,9240
12,5,4942,0,0,0,0,0,0,4942,4665,0,0,0,0,0,0,4665,9607
12,6,5359,0,0,0,0,0,0,5359,4962,0,0,0,0,0,0,4962,10321
12,7,5448,0,0,0,0,0,0,5448,5057,0,0,0,0,0,0,5057,10505
12,8,5572,0,0,0,0,0,0,5572,5269,0,0,0,0,0,0,5269,10841
12,9,5934,0,0,0,0,0,0,5934,5476,0,0,0,0,0,0,5476,11410
12,10,5988,0,0,0,0,0,0,5988,5545,0,0,0,0,0,0,5545,11533
12,11,6237,0,0,0,0,0,0,6237,5901,0,0,0,0,0,0,5901,12138
12,12,6179,0,0,0,0,0,0,6179,5850,0,0,0,0,0,0,5850,12029
12,13,6354,0,0,0,0,0,0,6354,6152,0,0,0,0,0,0,6152,12506
12,14,6592,0,0,0,0,0,0,6592,6450,0,0,0,0,0,0,6450,13042
12,15,6777,0,0,0,0,0,0,6777,6534,0,0,0,0,0,0,6534,13311
12,16,6884,0,0,0,0,0,0,6884,6155,0,0,0,0,0,0,6155,13039
12,17,6827,0,0,0,0,0,0,6827,6449,0,0,0,0,0,0,6449,13276
12,18,7027,0,0,0,0,0,0,7027,6292,5,0,0,0,0,0,6297,13324
12,19,7087,4,1,0,0,0,0,7092,6420,19,0,0,0,0,0,6439,13531
12,20,7006,4,0,0,0,0,0,7010,6214,44,1,0,0,0,0,6259,13269
12,21,7096,12,0,0,0,0,0,7108,6323,81,0,0,0,0,0,6404,13512
12,22,7108,25,6,0,0,0,0,7139,6420,123,9,0,2,0,0,6554,13693
12,23,7323,43,4,0,1,0,0,7371,6351,280,5,1,4,0,0,6641,14012
12,24,7452,78,6,1,4,0,0,7541,6143,306,11,1,3,0,0,6464,14005
12,25,7562,116,5,1,2,0,0,7686,6122,418,6,0,6,0,0,6552,14238
12,26,7302,207,2,0,3,0,0,7514,6014,575,15,0,8,0,0,6612,14126
12,27,7475,299,18,2,3,0,0,7797,5872,815,27,1,6,0,0,6721,14518
12,28,6986,441,13,0,4,0,0,7444,5566,1036,27,1,8,0,0,6638,14082
12,29,6773,587,13,0,7,1,0,7381,5361,1366,58,4,8,0,0,6797,14178
12,30,6623,890,26,0,7,0,0,7546,5179,1724,57,4,10,1,0,6975,14521
12,31,6658,1131,32,1,7,0,0,7829,4984,2034,67,2,10,1,0,7098,14927
12,32,6161,1404,57,7,10,0,0,7639,4620,2481,97,6,14,0,0,7218,14857
12,33,5869,1799,62,8,11,0,0,7749,4337,2766,133,8,14,2,0,7260,15009
12,34,5500,2007,65,11,13,0,0,7596,4222,3013,164,13,20,0,0,7432,15028
12,35,5231,2436,106,11,14,3,0,7801,3940,3397,195,22,19,0,0,7573,15374
12,36,5016,2656,138,10,12,1,0,7833,3538,3398,209,17,17,1,0,7180,15013
12,37,4547,2871,161,6,15,0,0,7600,3333,3541,297,34,20,0,0,7225,14825
12,38,4483,3112,195,12,15,0,0,7817,3221,3881,345,55,17,1,0,7520,15337
12,39,4264,3366,203,14,5,0,0,7852,3137,3951,375,48,18,0,0,7529,15381
12,40,4083,3703,247,9,11,0,0,8053,2983,4196,435,44,17,0,0,7675,15728
12,41,3851,3869,283,16,11,0,0,8030,2823,4319,477,64,18,0,0,7701,15731
12,42,3809,3995,335,38,15,1,0,8193,2843,4606,535,74,14,1,1,8074,16267
12,43,3737,3992,327,34,15,0,0,8105,2679,4696,599,94,11,0,0,8079,16184
12,44,3595,4287,359,48,16,0,0,8305,2786,5067,623,92,19,2,0,8589,16894
12,45,3831,4550,432,61,14,0,0,8888,2881,5554,777,131,16,0,0,9359,18247
12,46,3891,4938,548,43,19,0,0,9439,2892,5830,887,139,15,0,0,9763,19202
12,47,4040,5448,571,43,19,0,0,10121,2909,6204,940,174,13,0,0,10240,20361
12,48,4147,5880,675,55,19,0,0,10776,3040,6676,1079,174,9,0,0,10978,21754
12,49,4139,6280,820,59,21,0,0,11319,3035,7296,1227,220,13,0,0,11791,23110
12,50,4137,6601,819,57,13,0,0,11627,2833,7433,1265,247,16,0,0,11794,23421
12,51,4193,6942,1015,62,24,1,1,12238,2794,7823,1515,267,15,1,0,12415,24653
12,52,3984,7215,1036,76,27,1,0,12339,2755,7866,1534,327,11,0,0,12493,24832
12,53,3645,7389,1107,92,23,0,0,12256,2605,8048,1647,389,13,1,1,12704,24960
12,54,3570,7661,1208,74,28,0,0,12541,2500,8353,1711,418,13,0,0,12995,25536
12,55,3382,7940,1257,104,21,1,0,12705,2427,8428,1687,488,9,1,0,13040,25745
12,56,3174,7695,1300,105,26,1,0,12301,2273,8568,1772,523,12,0,0,13148,25449
12,57,3088,8333,1414,136,21,0,0,12992,2192,8858,1846,615,13,0,0,13524,26516
12,58,2926,8525,1523,176,22,1,1,13174,2040,9111,1893,693,9,0,0,13746,26920
12,59,2769,8847,1552,165,18,0,0,13351,1937,9122,1908,763,13,0,0,13743,27094
12,60,2322,8297,1432,180,23,1,1,12256,1679,8780,1803,826,12,0,0,13100,25356
12,61,2153,8089,1295,215,15,0,0,11767,1572,8443,1670,914,6,0,0,12605,24372
12,62,1985,7879,1232,219,13,0,0,11328,1342,8249,1592,1002,5,1,1,12192,23520
12,63,1668,7833,1194,248,18,0,0,10961,1295,7862,1474,1093,7,0,0,11731,22692
12,64,1625,7707,1180,237,14,0,0,10763,1165,7774,1449,1204,7,0,0,11599,22362
12,65,1468,7367,1061,294,12,0,0,10202,1073,7451,1329,1309,3,0,0,11165,21367
12,66,1385,7419,1019,315,9,0,1,10148,998,7214,1251,1371,5,0,1,10840,20988
12,67,1213,7229,951,327,8,0,0,9728,908,6942,1206,1490,3,0,1,10550,20278
12,68,1091,6886,880,391,13,0,0,9261,834,6696,1080,1694,0,0,0,10304,19565
12,69,1074,6983,816,372,8,0,0,9253,798,6583,1002,1846,1,0,0,10230,19483
12,70,903,6700,670,451,9,0,0,8733,750,6284,895,1929,2,0,0,9860,18593
12,71,877,6382,676,435,10,0,0,8380,669,6031,882,1919,3,0,1,9505,17885
12,72,767,6297,626,470,4,0,0,8164,634,5966,771,2194,3,0,0,9568,17732
12,73,791,6746,597,584,8,0,0,8726,677,6092,773,2496,2,0,0,10040,18766
12,74,731,6620,535,601,8,0,1,8496,622,6097,757,2761,2,0,0,10239,18735
12,75,742,6913,540,732,6,0,0,8933,658,6194,710,3098,1,0,0,10661,19594
12,76,659,6996,492,738,4,0,0,8889,676,6055,750,3477,0,0,0,10958,19847
12,77,613,6806,441,814,5,0,1,8680,600,5956,671,3826,2,0,0,11055,19735
12,78,478,4621,286,736,4,0,1,6126,425,3830,435,3105,3,0,0,7798,13924
12,79,468,5099,316,837,4,0,0,6724,475,4105,457,3746,2,1,0,8786,15510
12,80,431,4764,258,820,2,0,1,6276,464,3682,423,3793,0,0,0,8362,14638
12,81,398,4581,246,849,3,0,0,6077,462,3407,380,4248,1,0,0,8498,14575
12,82,371,4442,225,1035,3,0,0,6076,486,3331,369,4404,0,0,0,8590,14666
12,83,388,4462,216,1073,6,0,0,6145,474,3218,337,5026,0,0,0,9055,15200
12,84,345,4042,179,1123,2,0,0,5691,482,2656,327,5099,0,0,0,8564,14255
12,85,330,3538,161,1097,3,0,0,5129,467,2199,302,5091,0,0,0,8059,13188
12,86,265,2963,119,1010,2,0,0,4359,392,1729,229,4771,0,0,0,7121,11480
12,87,197,2366,96,962,0,0,0,3621,336,1288,177,4363,0,0,0,6164,9785
12,88,190,1992,80,890,1,0,0,3153,335,1024,170,4247,0,0,0,5776,8929
12,89,155,1620,62,793,2,0,0,2632,299,763,126,3892,0,0,0,5080,7712
12,90,125,1303,42,701,0,0,0,2171,269,586,123,3395,0,0,0,4373,6544
12,91,99,1000,29,648,0,0,0,1776,277,425,93,3242,0,0,0,4037,5813
12,92,72,747,29,517,1,0,0,1366,249,333,67,2695,0,0,0,3344,4710
12,93,56,565,17,458,0,0,0,1096,209,223,54,2495,0,0,0,2981,4077
12,94,52,353,14,347,0,0,0,766,164,124,30,1892,0,0,0,2210,2976
12,95,28,256,5,269,0,0,0,558,132,76,27,1441,0,0,0,1676,2234
12,96,19,160,2,183,0,0,0,364,115,51,23,1035,0,0,0,1224,1588
12,97,16,79,3,122,0,0,0,220,71,30,17,780,0,0,0,898,1118
12,98,10,58,1,90,0,0,0,159,47,15,5,574,0,0,0,641,800
12,99,8,27,6,46,0,0,0,87,48,18,8,358,0,0,0,432,519
12,100,8,25,1,86,0,0,0,120,62,12,11,630,0,0,0,715,835
12,999,343004,325790,35971,23852,736,12,8,729373,286468,331102,50710,110924,543,14,6,779767,1509140
13,0,14781,0,0,0,0,0,0,14781,13890,0,0,0,0,0,0,13890,28671
13,1,15348,0,0,0,0,0,0,15348,14655,0,0,0,0,0,0,14655,30003
13,2,15820,0,0,0,0,0,0,15820,14759,0,0,0,0,0,0,14759,30579
13,3,15903,0,0,0,0,0,0,15903,14980,0,0,0,0,0,0,14980,30883
13,4,16360,0,0,0,0,0,0,16360,15770,0,0,0,0,0,0,15770,32130
13,5,17489,0,0,0,0,0,0,17489,16226,0,0,0,0,0,0,16226,33715
13,6,18065,0,0,0,0,0,0,18065,16635,0,0,0,0,0,0,16635,34700
13,7,18607,0,0,0,0,0,0,18607,17568,0,0,0,0,0,0,17568,36175
13,8,19190,0,0,0,0,0,0,19190,18090,0,0,0,0,0,0,18090,37280
13,9,19550,0,0,0,0,0,0,19550,18613,0,0,0,0,0,0,18613,38163
13,10,20011,0,0,0,0,0,0,20011,19072,0,0,0,0,0,0,19072,39083
13,11,20806,0,0,0,0,0,0,20806,19404,0,0,0,0,0,0,19404,40210
13,12,21065,0,0,0,0,0,0,21065,19925,0,0,0,0,0,0,19925,40990
13,13,21936,0,0,0,0,0,0,21936,20432,0,0,0,0,0,0,20432,42368
13,14,22126,0,0,0,0,0,0,22126,20891,0,0,0,0,0,0,20891,43017
13,15,22149,0,0,0,0,0,0,22149,20691,0,0,0,0,0,0,20691,42840
13,16,22161,0,0,0,0,0,0,22161,20551,0,0,0,0,0,0,20551,42712
13,17,22027,0,1,0,0,0,0,22028,20408,0,0,0,0,0,0,20408,42436
13,18,22104,1,0,0,0,0,0,22105,20062,11,0,0,0,0,0,20073,42178
13,19,22165,13,0,0,0,0,0,22178,20092,68,0,0,0,0,0,20160,42338
13,20,21867,20,0,0,0,0,0,21887,19400,173,0,0,1,0,0,19574,41461
13,21,22103,46,0,0,0,1,0,22150,19533,289,1,1,2,0,0,19826,41976
13,22,22127,96,18,0,0,0,0,22241,19494,540,7,0,0,0,0,20041,42282
13,23,22944,173,18,1,0,0,0,23136,19479,963,32,0,2,0,0,20476,43612
13,24,22660,324,27,3,2,0,0,23016,19135,1258,37,0,6,0,0,20436,43452
13,25,23088,616,35,1,3,0,0,23743,18538,1839,47,2,6,0,0,20432,44175
13,26,22720,858,36,1,5,0,0,23620,18769,2461,49,1,12,2,0,21294,44914
13,27,22284,1270,59,2,7,0,0,23622,18174,3181,71,7,12,3,0,21448,45070
13,28,21807,1908,43,0,17,1,0,23776,17259,4107,115,4,17,2,0,21504,45280
13,29,21345,2505,57,1,14,1,1,23924,16971,5123,137,4,26,4,0,22265,46189
13,30,20968,3318,95,1,12,2,0,24396,15967,6200,161,12,28,2,0,22370,46766
13,31,20713,4468,117,3,21,0,1,25323,16105,7501,207,26,26,2,0,23867,49190
13,32,19698,5338,155,26,33,0,0,25250,14910,8335,287,28,45,2,1,23608,48858
13,33,18857,6395,185,16,39,2,0,25494,14351,9580,370,48,39,4,0,24392,49886
13,34,17547,7205,215,19,36,1,2,25025,13337,10360,462,37,54,5,0,24255,49280
13,35,16713,8323,258,16,37,1,0,25348,12413,11327,519,63,59,2,1,24384,49732
13,36,15322,9012,301,19,42,3,1,24700,11740,11947,652,61,59,3,0,24462,49162
13,37,14666,9757,416,31,47,3,0,24920,10937,12772,796,122,51,1,0,24679,49599
13,38,14476,10716,472,26,42,1,0,25733,10836,13438,955,143,56,8,0,25436,51169
13,39,13881,11562,551,36,36,1,0,26067,10429,14260,1073,141,56,4,0,25963,52030
13,40,13559,12266,662,24,51,2,0,26564,10290,14730,1226,187,66,4,0,26503,53067
13,41,13230,13185,759,38,48,1,0,27261,10215,15370,1355,201,58,4,0,27203,54464
13,42,12621,13784,869,68,54,2,0,27398,9763,15783,1403,211,44,7,0,27211,54609
13,43,12808,14571,952,102,50,4,0,28487,9714,16430,1662,299,36,3,0,28144,56631
13,44,12815,15115,1148,100,54,1,1,29234,9854,17411,1846,325,42,2,0,29480,58714
13,45,13362,16413,1276,133,65,3,0,31252,10348,18343,2022,365,54,4,0,31136,62388
13,46,13514,17260,1448,126,47,5,0,32400,10320,19402,2378,413,41,8,0,32562,64962
13,47,13576,18492,1670,132,58,0,2,33930,10464,20296,2625,475,55,3,0,33918,67848
13,48,13605,19737,1965,159,62,1,0,35529,10505,21734,2935,517,42,2,0,35735,71264
13,49,14086,20770,2114,170,75,1,0,37216,10537,22579,3178,674,44,5,1,37018,74234
13,50,13048,21393,2280,165,67,3,0,36956,10102,22918,3398,694,49,2,0,37163,74119
13,51,12502,21935,2459,193,79,2,0,37170,9500,23226,3588,783,45,4,0,37146,74316
13,52,11856,22398,2746,196,78,0,0,37274,9156,23470,3748,916,48,0,0,37338,74612
13,53,10967,22300,2839,221,82,4,1,36414,8575,23421,3957,1016,35,0,0,37004,73418
13,54,10675,22929,2906,230,68,0,0,36808,8245,23954,4067,1104,36,0,0,37406,74214
13,55,9960,23287,2992,276,72,0,1,36588,7646,23819,4149,1259,38,1,1,36913,73501
13,56,9144,23113,3226,337,76,0,2,35898,7190,23661,4097,1388,20,0,1,36357,72255
13,57,8731,23685,3232,378,65,1,0,36092,6922,23840,4210,1599,21,1,2,36595,72687
13,58,7929,23819,3242,414,57,1,2,35464,6257,23926,4124,1824,24,0,0,36155,71619
13,59,7409,24569,3298,448,67,0,1,35792,6091,24583,4254,1925,21,1,0,36875,72667
13,60,6370,23161,3127,486,60,0,1,33205,5584,23087,3931,1952,25,0,0,34579,67784
13,61,5657,22405,2996,532,50,0,4,31644,4906,22798,3758,2114,15,2,0,33593,65237
13,62,5198,22019,2864,632,52,1,0,30766,4545,22275,3572,2519,22,0,2,32935,63701
13,63,4590,21570,2710,682,42,0,4,29598,4097,21443,3602,2764,9,0,0,31915,61513
13,64,4168,21180,2626,730,42,0,3,28749,3988,20815,3157,3010,16,0,1,30987,59736
13,65,3684,20334,2337,809,38,1,2,27205,3552,19671,2999,3219,12,0,0,29453,56658
13,66,3532,20140,2251,806,36,1,1,26767,3230,19742,2824,3398,11,0,0,29205,55972
13,67,3016,19974,2156,930,34,1,0,26111,2933,19225,2667,3794,9,0,0,28628,54739
13,68,2775,19123,1928,959,32,0,0,24817,2684,18178,2484,3972,7,0,0,27325,52142
13,69,2446,18496,1704,1066,21,0,0,23733,2386,17891,2278,4372,8,0,0,26935,50668
13,70,2219,17757,1517,1084,12,0,1,22590,2156,16757,2123,4457,8,0,0,25501,48091
13,71,2057,17109,1369,1219,25,0,2,21781,1970,16524,1870,4963,4,2,0,25333,47114
13,72,1931,16904,1318,1308,17,0,2,21480,1798,15901,1774,5208,6,0,0,24687,46167
13,73,1818,17562,1300,1441,15,0,1,22137,1655,16328,1777,6141,5,0,0,25906,48043
13,74,1708,17727,1231,1588,10,1,3,22268,1608,15919,1660,6757,5,0,0,25949,48217
13,75,1751,18496,1113,1825,11,1,0,23197,1557,16364,1596,7615,4,0,0,27136,50333
13,76,1679,18211,1060,1974,8,1,0,22933,1430,15280,1422,8223,1,0,0,26356,49289
13,77,1519,17762,938,2198,7,0,0,22424,1381,14890,1352,9196,2,0,0,26821,49245
13,78,1018,11859,633,1694,3,0,0,15207,917,9884,901,7153,3,0,0,18858,34065
13,79,1097,13059,595,1977,1,0,1,16730,1048,10341,874,8454,1,0,0,20718,37448
13,80,1101,12306,523,2161,4,1,0,16096,1024,9331,792,9029,0,1,0,20177,36273
13,81,1019,11382,454,2158,10,0,0,15023,1069,8453,702,9283,2,0,0,19509,34532
13,82,1041,10945,450,2350,8,1,0,14795,1016,7763,663,10065,0,0,0,19507,34302
13,83,1066,11035,359,2560,1,0,0,15021,1067,7611,616,11632,0,1,0,20927,35948
13,84,975,10085,310,2724,5,0,0,14099,995,6575,557,11836,0,0,0,19963,34062
13,85,848,9240,266,2728,1,0,0,13083,914,5446,485,12012,0,0,0,18857,31940
13,86,727,7414,194,2559,1,0,0,10895,802,3938,356,10946,1,0,0,16043,26938
13,87,572,5762,146,2267,1,0,0,8748,664,2947,304,10056,0,0,0,13971,22719
13,88,559,5308,111,2318,2,0,0,8298,655,2355,251,10322,0,0,0,13583,21881
13,89,444,4257,107,2163,1,0,0,6972,594,1790,195,9569,0,0,0,12148,19120
13,90,309,3263,70,1915,0,0,0,5557,537,1231,155,8284,0,0,0,10207,15764
13,91,283,2418,48,1544,0,0,0,4293,421,776,95,7280,0,0,0,8572,12865
13,92,235,1839,30,1391,0,0,0,3495,417,532,97,6222,0,0,0,7268,10763
13,93,173,1329,32,1179,0,0,0,2713,349,399,75,5731,0,0,0,6554,9267
13,94,109,854,14,917,0,0,0,1894,283,200,48,4321,0,0,0,4852,6746
13,95,92,518,11,664,0,0,0,1285,232,120,32,3326,0,0,0,3710,4995
13,96,39,350,9,514,0,0,0,912,167,79,27,2605,0,0,0,2878,3790
13,97,38,191,0,341,0,0,0,570,135,58,12,1876,0,0,0,2081,2651
13,98,17,113,2,221,0,0,0,353,120,20,17,1383,0,0,0,1540,1893
13,99,13,65,2,183,0,0,0,263,71,18,8,940,0,0,0,1037,1300
13,100,15,52,1,229,0,0,0,297,107,14,9,1457,0,0,0,1587,1884
13,999,1086754,948519,84054,61138,2218,57,40,2182780,927249,957598,118317,264331,1552,101,10,2269158,4451938
14,0,10763,0,0,0,0,0,0,10763,10203,0,0,0,0,0,0,10203,20966
14,1,11250,0,0,0,0,0,0,11250,10677,0,0,0,0,0,0,10677,21927
14,2,11825,0,0,0,0,0,0,11825,11277,0,0,0,0,0,0,11277,23102
14,3,11899,0,0,0,0,0,0,11899,11095,0,0,0,0,0,0,11095,22994
14,4,12234,0,0,0,0,0,0,12234,11847,0,0,0,0,0,0,11847,24081
14,5,13020,0,0,0,0,0,0,13020,12594,0,0,0,0,0,0,12594,25614
14,6,13855,0,0,0,0,0,0,13855,13039,0,0,0,0,0,0,13039,26894
14,7,14262,0,0,0,0,0,0,14262,13572,0,0,0,0,0,0,13572,27834
14,8,14737,0,0,0,0,0,0,14737,13623,0,0,0,0,0,0,13623,28360
14,9,15335,0,0,0,0,0,0,15335,14569,0,0,0,0,0,0,14569,29904
14,10,15564,0,0,0,0,0,0,15564,14687,0,0,0,0,0,0,14687,30251
14,11,16444,0,0,0,0,0,0,16444,15711,0,0,0,0,0,0,15711,32155
14,12,16667,0,0,0,0,0,0,16667,15811,0,0,0,0,0,0,15811,32478
14,13,17240,0,0,0,0,0,0,17240,16238,0,0,0,0,0,0,16238,33478
14,14,17374,0,0,0,0,0,0,17374,16344,0,0,0,0,0,0,16344,33718
14,15,18155,0,0,0,0,0,0,18155,16645,0,0,0,0,0,0,16645,34800
14,16,17962,2,0,0,0,0,0,17964,16559,0,0,0,0,0,0,16559,34523
14,17,17864,0,0,0,0,0,0,17864,16589,1,1,0,0,0,0,16591,34455
14,18,18130,0,0,0,0,0,0,18130,16468,14,1,0,0,0,0,16483,34613
14,19,18271,1,0,0,0,0,0,18272,16428,46,0,0,0,0,0,16474,34746
14,20,17807,22,0,0,0,0,0,17829,15894,115,2,0,1,0,0,16012,33841
14,21,17842,30,0,0,4,0,0,17876,15963,224,0,0,0,0,0,16187,34063
14,22,17692,62,8,0,0,0,0,17762,15918,348,10,0,0,0,0,16276,34038
14,23,18196,131,16,0,2,0,0,18345,15797,513,13,0,2,0,0,16325,34670
14,24,17838,208,24,0,3,0,0,18073,15043,754,21,2,2,0,0,15822,33895
14,25,18252,331,24,0,4,0,0,18611,15130,1042,22,1,2,0,0,16197,34808
14,26,17879,474,24,1,2,0,0,18380,14862,1414,30,1,7,0,0,16314,34694
14,27,17454,694,27,1,4,0,0,18180,14565,1827,38,3,6,2,0,16441,34621
14,28,16900,1049,33,0,12,1,1,17996,13974,2545,57,3,11,0,0,16590,34586
14,29,16519,1404,35,1,7,1,0,17967,13653,3143,80,4,13,2,0,16895,34862
14,30,16289,1974,61,2,24,0,0,18350,12968,3899,100,5,25,3,0,17000,35350
14,31,16208,2750,70,4,13,2,0,19047,12994,5092,133,14,26,3,0,18262,37309
14,32,15439,3355,69,17,28,0,0,18908,12123,5717,223,18,32,3,0,18116,37024
14,33,15448,4339,121,15,31,2,0,19956,11761,6663,272,29,38,0,1,18764,38720
14,34,14280,4868,149,20,29,1,0,19347,11250,7313,312,27,38,2,0,18942,38289
14,35,13909,5905,212,16,27,2,0,20071,10735,8438,375,45,41,1,1,19636,39707
14,36,12720,6563,220,14,31,2,0,19550,9961,8766,447,58,58,0,0,19290,38840
14,37,11784,6979,323,26,39,5,0,19156,9283,9455,660,88,47,3,0,19536,38692
14,38,11849,7914,384,16,31,5,1,20200,9362,10195,740,105,46,4,0,20452,40652
14,39,11398,8692,439,31,39,0,0,20599,8988,10799,822,87,36,3,0,20735,41334
14,40,11076,9405,498,28,38,1,1,21047,8745,11528,883,107,42,0,0,21305,42352
14,41,11065,10223,555,33,43,1,0,21920,8637,12040,1019,134,46,2,0,21878,43798
14,42,10425,10784,694,74,46,2,1,22026,8237,12529,1226,202,43,2,0,22239,44265
14,43,10368,11397,837,90,40,2,0,22734,8059,13161,1280,212,33,7,0,22752,45486
14,44,10284,12155,892,76,57,1,0,23465,8057,14159,1464,281,36,3,0,24000,47465
14,45,10583,13211,990,92,47,2,1,24926,8399,14943,1789,299,39,3,0,25472,50398
14,46,10461,14029,1204,106,49,1,1,25851,8244,15874,2034,323,35,1,1,26512,52363
14,47,10583,14648,1430,120,45,1,0,26827,8170,17086,2169,407,34,4,0,27870,54697
14,48,10721,15738,1603,132,53,2,2,28251,8131,18039,2475,443,41,4,0,29133,57384
14,49,10592,16979,1716,141,56,2,2,29488,7957,19372,2677,510,37,0,0,30553,60041
14,50,9892,17554,1936,158,47,2,0,29589,7659,19699,2861,562,39,1,1,30822,60411
14,51,9452,18404,2041,179,49,2,0,30127,7092,19969,3063,626,43,0,0,30793,60920
14,52,8721,18875,2154,168,42,1,0,29961,6789,20360,3207,798,30,4,0,31188,61149
14,53,8429,18829,2325,193,43,2,2,29823,6094,19958,3249,816,23,0,1,30141,59964
14,54,7734,19796,2528,209,49,2,1,30319,5889,21023,3337,894,29,0,0,31172,61491
14,55,7141,19553,2509,235,55,2,0,29495,5655,20851,3325,1039,28,0,1,30899,60394
14,56,6722,19920,2580,274,39,2,0,29537,5230,21214,3409,1172,28,1,2,31056,60593
14,57,6358,20532,2764,338,61,1,1,30055,4894,21425,3503,1335,26,0,0,31183,61238
14,58,5867,20837,2807,380,52,1,0,29944,4625,21640,3526,1363,20,0,0,31174,61118
14,59,5276,21385,2829,435,54,0,1,29980,4267,22005,3601,1582,24,1,1,31481,61461
14,60,4582,20206,2619,431,46,2,0,27886,3734,20668,3396,1653,19,0,0,29470,57356
14,61,4059,19648,2507,438,53,1,0,26706,3318,20026,3039,1914,11,0,0,28308,55014
14,62,3693,19273,2331,517,41,0,1,25856,3088,19592,2956,2157,22,0,0,27815,53671
14,63,3212,19049,2251,575,37,1,1,25126,2792,18996,2761,2263,19,0,0,26831,51957
14,64,2974,18734,2072,630,32,0,2,24444,2553,18335,2580,2485,13,0,0,25966,50410
14,65,2685,17750,1895,652,34,2,1,23019,2367,17911,2402,2716,10,0,1,25407,48426
14,66,2364,17624,1765,678,24,0,0,22455,2214,17333,2253,2936,9,0,0,24745,47200
14,67,2170,17256,1602,837,35,0,1,21901,1978,16880,2017,3380,7,0,2,24264,46165
14,68,2088,16758,1516,878,31,0,0,21271,1837,16530,1892,3524,6,0,1,23790,45061
14,69,1807,16631,1402,937,25,0,1,20803,1677,16251,1871,3799,6,0,1,23605,44408
14,70,1688,15875,1243,982,15,0,0,19803,1530,14947,1612,4008,5,0,0,22102,41905
14,71,1514,15659,1097,1025,23,0,0,19318,1341,14864,1453,4163,6,0,0,21827,41145
14,72,1484,15583,1032,1135,14,0,0,19248,1226,14453,1386,4527,6,0,1,21599,40847
14,73,1363,15886,1024,1246,11,0,2,19532,1229,14408,1380,5151,8,0,0,22176,41708
14,74,1338,16309,919,1402,16,0,1,19985,1249,14776,1267,5945,2,0,0,23239,43224
14,75,1327,17086,910,1647,10,0,1,20981,1218,15116,1275,6870,2,1,0,24482,45463
14,76,1221,16553,844,1781,11,1,0,20411,1133,14558,1190,7532,1,0,1,24415,44826
14,77,1164,16327,683,1967,13,0,1,20155,1126,13663,1097,8256,3,0,0,24145,44300
14,78,842,12064,527,1698,8,0,0,15139,830,10102,785,6961,0,0,0,18678,33817
14,79,769,11733,475,1699,5,0,0,14681,847,9126,691,7680,3,0,0,18347,33028
14,80,720,11234,364,1846,7,0,0,14171,800,8688,644,8045,2,0,0,18179,32350
14,81,740,10025,350,1809,12,0,0,12936,803,7558,556,8233,1,0,0,17151,30087
14,82,732,9820,309,1952,8,0,1,12822,772,7265,531,8933,1,0,0,17502,30324
14,83,754,10113,301,2325,5,0,1,13499,831,6960,509,10781,1,0,0,19082,32581
14,84,711,9180,236,2334,2,0,0,12463,752,5867,437,10584,1,0,0,17641,30104
14,85,578,8473,209,2469,1,0,0,11730,753,4939,339,10968,2,0,0,17001,28731
14,86,518,6669,187,2167,1,0,0,9542,697,3699,297,10142,1,0,0,14836,24378
14,87,405,5286,109,2053,1,0,0,7854,623,2713,233,9005,0,0,0,12574,20428
14,88,361,4843,102,1954,0,0,0,7260,574,2211,213,8895,0,0,0,11893,19153
14,89,284,3677,98,1687,2,0,0,5748,500,1567,151,7996,0,0,0,10214,15962
14,90,260,2905,42,1571,1,0,0,4779,422,1084,114,7207,0,0,0,8827,13606
14,91,202,2146,30,1316,0,0,0,3694,410,765,96,6343,0,0,0,7614,11308
14,92,146,1680,30,1176,1,0,0,3033,357,511,81,5575,0,0,0,6524,9557
14,93,126,1173,25,974,1,0,0,2299,308,368,72,4870,0,0,0,5618,7917
14,94,84,756,20,778,0,0,0,1638,231,213,38,3777,0,0,0,4259,5897
14,95,51,520,10,599,0,0,0,1180,196,140,34,3010,0,0,0,3380,4560
14,96,29,325,4,456,0,0,0,814,160,87,24,2147,1,0,0,2419,3233
14,97,26,179,2,303,0,0,0,510,108,50,16,1595,0,0,0,1769,2279
14,98,18,87,2,185,0,0,0,292,84,25,10,1111,0,0,0,1230,1522
14,99,8,53,5,138,0,0,0,204,69,22,5,803,0,0,0,899,1103
14,100,16,63,2,215,0,0,0,296,88,30,9,1220,0,0,0,1347,1643
14,999,849417,807212,68282,53087,1821,58,29,1779906,731855,818495,96168,232755,1275,60,16,1880624,3660530
15,0,2442,0,0,0,0,0,0,2442,2314,0,0,0,0,0,0,2314,4756
15,1,2537,0,0,0,0,0,0,2537,2440,0,0,0,0,0,0,2440,4977
15,2,2699,0,0,0,0,0,0,2699,2633,0,0,0,0,0,0,2633,5332
15,3,2785,0,0,0,0,0,0,2785,2605,0,0,0,0,0,0,2605,5390
15,4,2903,0,0,0,0,0,0,2903,2840,0,0,0,0,0,0,2840,5743
15,5,3074,0,0,0,0,0,0,3074,2843,0,0,0,0,0,0,2843,5917
15,6,3199,0,0,0,0,0,0,3199,2996,0,0,0,0,0,0,2996,6195
15,7,3362,0,0,0,0,0,0,3362,3212,0,0,0,0,0,0,3212,6574
15,8,3380,0,0,0,0,0,0,3380,3204,0,0,0,0,0,0,3204,6584
15,9,3603,0,0,0,0,0,0,3603,3447,0,0,0,0,0,0,3447,7050
15,10,3746,0,0,0,0,0,0,3746,3526,0,0,0,0,0,0,3526,7272
15,11,3844,0,0,0,0,0,0,3844,3795,0,0,0,0,0,0,3795,7639
15,12,3907,0,0,0,0,0,0,3907,3754,0,0,0,0,0,0,3754,7661
15,13,4058,0,0,0,0,0,0,4058,3814,0,0,0,0,0,0,3814,7872
15,14,4080,0,0,0,0,0,0,4080,3755,0,0,0,0,0,0,3755,7835
15,15,4167,0,0,0,0,0,0,4167,4078,0,0,0,0,0,0,4078,8245
15,16,4281,0,0,0,0,0,0,4281,3969,0,0,0,0,0,0,3969,8250
15,17,4225,0,0,0,0,0,0,4225,3919,0,0,0,0,0,0,3919,8144
15,18,4238,0,0,0,0,0,0,4238,3898,2,0,0,0,0,0,3900,8138
15,19,4150,2,0,0,0,0,0,4152,3868,7,0,0,0,0,0,3875,8027
15,20,4218,2,1,0,0,0,0,4221,3681,25,0,0,0,0,0,3706,7927
15,21,4076,7,0,0,0,0,0,4083,3790,48,1,0,0,0,0,3839,7922
15,22,4163,10,1,0,0,0,0,4174,3720,69,1,0,0,0,0,3790,7964
15,23,4154,26,1,0,0,0,0,4181,3763,115,0,0,1,0,0,3879,8060
15,24,4302,50,6,0,1,0,0,4359,3529,170,2,0,1,0,0,3702,8061
15,25,4240,89,4,0,0,0,0,4333,3512,244,4,0,1,0,0,3761,8094
15,26,4097,119,3,0,3,0,0,4222,3457,333,1,1,0,0,0,3792,8014
15,27,4049,171,2,0,1,0,0,4223,3305,425,13,0,2,0,0,3745,7968
15,28,3900,268,5,0,3,0,0,4176,3229,531,10,1,1,0,0,3772,7948
15,29,3747,312,6,1,1,0,0,4067,3062,744,12,1,2,0,0,3821,7888
15,30,3783,472,10,1,3,0,0,4269,3003,904,14,2,2,0,0,3925,8194
15,31,3778,631,12,0,4,0,0,4425,2894,1189,31,1,6,1,0,4122,8547
15,32,3571,752,13,1,7,0,0,4344,2700,1332,40,9,2,0,0,4083,8427
15,33,3473,904,23,2,6,2,0,4410,2694,1531,56,5,6,1,1,4294,8704
15,34,3270,1181,25,2,4,0,0,4482,2515,1749,69,13,1,0,0,4347,8829
15,35,3185,1403,43,2,7,0,0,4640,2508,2005,88,10,9,0,0,4620,9260
15,36,2929,1494,64,1,6,0,0,4494,2205,2132,98,15,5,1,0,4456,8950
15,37,2743,1650,73,6,7,0,0,4479,2185,2296,150,14,5,0,0,4650,9129
15,38,2766,1807,91,2,6,1,1,4674,2111,2512,170,21,3,0,0,4817,9491
15,39,2575,2044,91,2,7,0,1,4720,1993,2632,186,25,7,0,0,4843,9563
15,40,2673,2357,97,8,9,1,0,5145,1998,2979,224,22,7,0,0,5230,10375
15,41,2511,2442,120,9,7,1,0,5090,1915,2911,227,35,6,0,0,5094,10184
15,42,2335,2622,156,9,7,0,0,5129,1823,3186,286,41,13,0,0,5349,10478
15,43,2276,2827,159,14,7,0,0,5283,1698,3234,328,61,5,0,0,5326,10609
15,44,2274,2973,211,11,8,0,0,5477,1612,3531,344,73,6,0,0,5566,11043
15,45,2247,3141,234,19,11,0,0,5652,1744,3728,401,63,5,0,0,5941,11593
15,46,2198,3489,250,19,6,0,0,5962,1645,3961,456,76,5,0,0,6143,12105
15,47,2248,3574,307,22,4,0,0,6155,1601,4188,459,102,6,0,0,6356,12511
15,48,2169,3798,341,21,7,0,0,6336,1600,4438,536,116,3,1,0,6694,13030
15,49,2098,4172,373,18,13,0,0,6674,1553,4785,527,134,5,0,0,7004,13678
15,50,2007,4230,370,35,7,2,0,6651,1396,4751,566,139,4,1,0,6857,13508
15,51,1813,4183,446,38,9,0,0,6489,1391,4757,608,147,5,0,0,6908,13397
15,52,1736,4369,435,36,10,1,0,6587,1308,4914,625,193,4,0,0,7044,13631
15,53,1606,4472,480,42,9,0,0,6609,1166,4764,631,222,2,0,0,6785,13394
15,54,1488,4645,476,51,3,0,0,6663,1153,5050,667,210,2,0,0,7082,13745
15,55,1412,4622,486,55,7,0,0,6582,1109,5071,711,314,0,0,0,7205,13787
15,56,1314,4611,533,61,7,0,0,6526,1062,5046,662,274,3,0,0,7047,13573
15,57,1299,4717,511,77,13,0,0,6617,967,5083,640,307,2,0,0,6999,13616
15,58,1227,5034,505,107,8,0,0,6881,942,5215,666,396,4,0,0,7223,14104
15,59,1104,5112,584,95,5,0,0,6900,864,5257,719,429,2,1,0,7272,14172
15,60,928,4687,489,101,17,0,0,6222,806,5090,621,431,0,0,0,6948,13170
15,61,904,4656,486,90,6,0,1,6143,678,4976,604,456,1,0,1,6716,12859
15,62,823,4752,475,130,3,0,0,6183,641,4834,536,542,0,0,0,6553,12736
15,63,733,4723,422,134,6,0,0,6018,619,4809,556,575,1,0,0,6560,12578
15,64,670,4540,410,141,6,0,0,5767,605,4515,477,612,1,0,0,6210,11977
15,65,662,4279,332,133,10,0,0,5416,527,4237,452,634,1,0,0,5851,11267
15,66,582,4189,329,158,3,0,0,5261,499,4067,395,751,3,0,0,5715,10976
15,67,512,4304,325,189,4,0,0,5334,486,4169,389,797,1,0,0,5842,11176
15,68,519,4156,281,203,3,0,0,5162,392,4073,392,834,0,0,0,5691,10853
15,69,415,4042,290,184,3,0,0,4934,393,4001,327,917,1,0,0,5639,10573
15,70,431,3977,227,234,4,0,0,4873,383,3704,311,1043,1,0,0,5442,10315
15,71,349,3783,206,223,3,0,0,4564,349,3509,274,1036,0,0,0,5168,9732
15,72,375,3914,210,244,2,0,1,4746,308,3604,274,1153,1,0,0,5340,10086
15,73,347,3921,210,302,4,0,0,4784,326,3508,244,1295,0,0,0,5373,10157
15,74,323,4037,200,339,2,0,0,4901,309,3512,259,1439,2,0,0,5521,10422
15,75,326,4314,162,359,3,0,0,5164,303,3607,205,1671,1,0,0,5787,10951
15,76,344,3860,136,356,1,0,0,4697,280,3169,189,1736,1,0,0,5375,10072
15,77,289,3521,128,409,1,0,0,4348,229,2967,177,1833,0,0,0,5206,9554
15,78,226,2806,85,310,0,0,0,3427,193,2212,142,1588,0,0,0,4135,7562
15,79,231,2757,80,374,1,0,0,3443,233,2172,112,1857,0,0,0,4374,7817
15,80,214,2871,67,426,3,0,0,3581,199,2043,105,2113,0,0,0,4460,8041
15,81,205,2467,77,396,0,0,0,3145,165,1749,111,2002,1,0,0,4028,7173
15,82,198,2427,56,458,0,0,0,3139,189,1554,84,2172,0,0,0,3999,7138
15,83,196,2520,65,491,0,0,0,3272,203,1510,88,2531,0,0,0,4332,7604
15,84,166,2175,39,525,0,0,0,2905,213,1383,80,2557,0,0,0,4233,7138
15,85,164,2081,50,560,1,0,0,2856,164,1136,70,2672,0,0,0,4042,6898
15,86,115,1565,31,492,1,0,0,2204,139,819,60,2519,0,0,0,3537,5741
15,87,101,1300,23,439,0,0,0,1863,122,607,43,2318,0,0,0,3090,4953
15,88,88,1148,21,451,0,0,0,1708,135,475,29,2214,0,0,0,2853,4561
15,89,103,942,18,415,0,0,0,1478,123,341,16,2152,0,0,0,2632,4110
15,90,68,775,13,388,0,0,0,1244,100,244,22,1859,0,0,0,2225,3469
15,91,42,548,7,297,0,0,0,894,84,183,16,1592,0,0,0,1875,2769
15,92,39,422,6,297,0,0,0,764,75,102,16,1476,0,0,0,1669,2433
15,93,28,325,4,254,1,0,0,612,50,88,11,1280,0,0,0,1429,2041
15,94,18,204,1,174,0,0,0,397,50,40,12,990,0,0,0,1092,1489
15,95,14,123,1,131,0,0,0,269,36,28,7,739,0,0,0,810,1079
15,96,13,81,4,108,0,0,0,206,36,27,3,591,0,0,0,657,863
15,97,1,52,1,79,0,0,0,133,27,6,9,429,0,0,0,471,604
15,98,4,31,1,38,0,0,0,74,17,5,3,329,0,0,0,354,428
15,99,5,22,0,46,0,0,0,73,10,2,1,196,0,0,0,209,282
15,100,2,14,0,32,0,0,0,48,24,6,2,267,0,0,0,299,347
15,999,193507,194095,13516,11877,311,8,4,413318,166033,196927,18953,57670,159,6,2,439750,853068
16,0,4506,0,0,0,0,0,0,4506,4304,0,0,0,0,0,0,4304,8810
16,1,4556,0,0,0,0,0,0,4556,4332,0,0,0,0,0,0,4332,8888
16,2,4776,0,0,0,0,0,0,4776,4705,0,0,0,0,0,0,4705,9481
16,3,5033,0,0,0,0,0,0,5033,4723,0,0,0,0,0,0,4723,9756
16,4,5198,0,0,0,0,0,0,5198,4785,0,0,0,0,0,0,4785,9983
16,5,5337,0,0,0,0,0,0,5337,5081,0,0,0,0,0,0,5081,10418
16,6,5625,0,0,0,0,0,0,5625,5360,0,0,0,0,0,0,5360,10985
16,7,6058,0,0,0,0,0,0,6058,5625,0,0,0,0,0,0,5625,11683
16,8,6126,0,0,0,0,0,0,6126,5939,0,0,0,0,0,0,5939,12065
16,9,6393,0,0,0,0,0,0,6393,5981,0,0,0,0,0,0,5981,12374
16,10,6638,0,0,0,0,0,0,6638,6121,0,0,0,0,0,0,6121,12759
16,11,6648,0,0,0,0,0,0,6648,6325,0,0,0,0,0,0,6325,12973
16,12,6925,0,0,0,0,0,0,6925,6685,0,0,0,0,0,0,6685,13610
16,13,7094,0,0,0,0,0,0,7094,6686,0,0,0,0,0,0,6686,13780
16,14,7292,0,0,0,0,0,0,7292,6883,0,0,0,0,0,0,6883,14175
16,15,7394,0,0,0,0,0,0,7394,6877,0,0,0,0,0,0,6877,14271
16,16,7335,0,0,0,0,0,0,7335,6826,0,0,0,0,0,0,6826,14161
16,17,7212,0,0,0,0,0,0,7212,6741,2,0,0,0,0,0,6743,13955
16,18,7334,1,0,0,0,0,0,7335,6758,5,0,0,0,0,0,6763,14098
16,19,7604,0,0,0,0,0,0,7604,6683,14,0,0,0,0,0,6697,14301
16,20,7356,3,0,0,0,0,0,7359,6649,60,0,0,0,0,0,6709,14068
16,21,7540,11,0,0,0,0,0,7551,6572,84,1,0,0,0,0,6657,14208
16,22,7386,20,2,0,0,0,0,7408,6557,148,5,0,0,0,0,6710,14118
16,23,7834,61,4,1,2,0,0,7902,6648,246,7,0,1,0,0,6902,14804
16,24,7690,112,3,0,1,0,0,7806,6524,306,12,2,0,0,0,6844,14650
16,25,7892,137,5,1,2,0,0,8037,6374,486,8,0,1,1,0,6870,14907
16,26,7558,224,7,1,1,0,0,7791,6146,661,20,1,2,0,0,6830,14621
16,27,7422,331,13,0,2,0,0,7768,5879,860,25,1,2,0,0,6767,14535
16,28,7230,482,14,0,4,0,0,7730,5773,1044,24,0,7,0,0,6848,14578
16,29,6944,625,6,1,1,1,0,7578,5449,1285,35,2,4,0,0,6775,14353
16,30,6783,803,18,0,2,0,0,7606,5325,1666,35,1,6,1,0,7034,14640
16,31,6817,1135,32,2,3,0,0,7989,5042,2097,68,6,4,1,0,7218,15207
16,32,6393,1454,28,3,10,0,0,7888,4706,2417,87,7,6,0,0,7223,15111
16,33,6240,1722,43,5,4,0,0,8014,4622,2763,108,7,11,0,0,7511,15525
16,34,5695,2098,45,5,5,0,0,7848,4230,3125,137,13,8,0,0,7513,15361
16,35,5559,2355,74,5,8,0,0,8001,4076,3553,164,13,11,0,0,7817,15818
16,36,5197,2630,87,4,2,0,0,7920,3655,3803,169,23,14,1,1,7666,15586
16,37,4975,3046,120,7,3,0,0,8151,3595,4045,243,36,8,0,0,7927,16078
16,38,4832,3199,144,11,9,1,0,8196,3610,4310,285,43,6,1,1,8256,16452
16,39,4587,3661,157,11,11,0,0,8427,3323,4634,298,38,9,0,0,8302,16729
16,40,4472,3968,204,5,11,0,0,8660,3247,4976,352,46,12,1,0,8634,17294
16,41,4534,4280,229,5,5,0,1,9054,3222,5174,434,50,10,1,0,8891,17945
16,42,4312,4439,265,26,11,0,0,9053,3020,5401,468,72,9,1,0,8971,18024
16,43,4290,4869,291,21,9,0,0,9480,2955,5783,543,89,11,0,0,9381,18861
16,44,4131,5126,369,49,8,0,0,9683,2884,6201,633,125,8,1,0,9852,19535
16,45,4261,5636,455,28,17,0,0,10397,2959,6503,741,126,7,0,0,10336,20733
16,46,4157,5816,495,34,6,1,0,10509,2980,6980,738,119,7,0,0,10824,21333
16,47,4088,6250,573,43,14,2,0,10970,2758,7208,788,187,8,1,0,10950,21920
16,48,4045,6744,548,48,11,0,0,11396,2804,7774,899,162,11,1,0,11651,23047
16,49,4012,7094,645,51,15,0,0,11817,2727,7822,1016,204,6,0,0,11775,23592
16,50,3719,7078,671,43,7,1,0,11519,2570,7927,973,250,8,0,0,11728,23247
16,51,3571,7242,759,56,13,1,0,11642,2331,8133,1050,241,3,0,1,11759,23401
16,52,3400,7630,798,68,8,0,0,11904,2278,8527,1127,296,4,0,0,12232,24136
16,53,3101,7615,821,64,13,0,0,11614,1982,8255,1112,378,3,0,0,11730,23344
16,54,2988,7795,906,87,14,1,1,11792,2068,8762,1176,379,5,0,0,12390,24182
16,55,2679,8145,837,98,8,0,0,11767,1874,8601,1166,465,2,0,0,12108,23875
16,56,2522,8115,907,109,13,0,0,11666,1755,8751,1179,487,2,0,0,12174,23840
16,57,2394,8292,965,136,11,1,0,11799,1632,8931,1097,545,1,0,0,12206,24005
16,58,2113,8572,931,146,12,0,0,11774,1552,8736,1175,587,5,0,1,12056,23830
16,59,2108,8841,1012,138,8,0,0,12107,1450,9266,1096,685,3,0,0,12500,24607
16,60,1804,8376,905,167,10,0,0,11262,1289,8807,1068,697,6,0,0,11867,23129
16,61,1568,8291,862,184,6,0,0,10911,1172,8181,983,754,2,0,0,11092,22003
16,62,1469,8315,834,213,13,0,0,10844,1166,8219,1003,909,3,0,0,11300,22144
16,63,1379,7978,766,236,9,0,0,10368,1057,8105,822,981,0,0,0,10965,21333
16,64,1253,7782,688,214,9,0,0,9946,953,7953,764,1054,2,0,0,10726,20672
16,65,1132,7583,676,260,6,0,0,9657,863,7579,766,1129,2,1,0,10340,19997
16,66,1033,7363,597,287,6,0,0,9286,792,7421,759,1268,2,0,0,10242,19528
16,67,984,7450,526,316,6,0,1,9283,767,7377,675,1493,0,0,0,10312,19595
16,68,851,7093,505,373,5,0,0,8827,677,7025,612,1574,1,0,0,9889,18716
16,69,821,6982,442,369,3,0,0,8617,613,6681,539,1534,1,0,0,9368,17985
16,70,706,6762,411,398,4,0,0,8281,555,6459,488,1679,2,0,0,9183,17464
16,71,690,6730,404,449,4,0,0,8277,514,6120,467,1881,2,0,0,8984,17261
16,72,648,6723,359,427,6,0,0,8163,505,6129,392,2078,0,0,0,9104,17267
16,73,598,6815,336,512,3,0,0,8264,472,6080,412,2285,1,0,0,9250,17514
16,74,584,6501,296,514,0,0,0,7895,427,5677,357,2456,1,0,0,8918,16813
16,75,551,6630,233,587,2,0,0,8003,445,5645,279,2785,0,0,0,9154,17157
16,76,517,6246,258,597,3,0,0,7621,376,5087,307,3009,0,0,0,8779,16400
16,77,487,5864,217,717,3,0,0,7288,388,4950,297,3177,0,0,1,8813,16101
16,78,364,4774,178,620,3,0,0,5939,302,3627,233,2918,0,0,0,7080,13019
16,79,356,4447,130,580,0,0,0,5513,276,3366,190,3061,1,0,0,6894,12407
16,80,332,4541,126,660,1,0,0,5660,313,3213,141,3432,0,0,0,7099,12759
16,81,338,4012,99,667,3,0,1,5120,283,2687,129,3540,0,0,0,6639,11759
16,82,314,3797,85,644,2,0,0,4842,313,2472,114,3720,0,0,0,6619,11461
16,83,295,4089,80,770,0,0,0,5234,315,2515,133,4388,0,0,0,7351,12585
16,84,311,3921,73,844,1,0,0,5150,302,2167,95,4634,0,0,0,7198,12348
16,85,290,3464,64,903,0,0,0,4721,309,1758,92,4870,0,0,0,7029,11750
16,86,237,2964,46,777,0,0,0,4024,234,1309,55,4280,0,0,0,5878,9902
16,87,152,2335,31,693,0,0,0,3211,235,944,52,4019,0,0,0,5250,8461
16,88,164,2052,24,740,0,0,0,2980,224,753,52,4033,0,0,0,5062,8042
16,89,136,1651,19,684,0,0,0,2490,173,531,38,3585,0,0,0,4327,6817
16,90,87,1264,25,603,0,0,0,1979,175,356,38,3226,0,0,0,3795,5774
16,91,84,892,8,499,0,0,0,1483,174,230,21,2653,0,0,0,3078,4561
16,92,51,716,11,461,0,0,0,1239,147,177,21,2466,0,0,0,2811,4050
16,93,31,522,8,348,0,0,0,909,108,110,12,2071,0,0,0,2301,3210
16,94,37,326,3,291,0,0,0,657,88,64,11,1510,0,0,0,1673,2330
16,95,25,259,1,216,0,0,0,501,90,38,7,1159,0,0,0,1294,1795
16,96,7,135,1,190,0,0,0,333,68,29,6,932,0,0,0,1035,1368
16,97,7,64,1,106,0,0,0,178,58,20,3,688,0,0,0,769,947
16,98,7,45,0,73,0,0,0,125,42,12,3,470,0,0,0,527,652
16,99,3,24,1,49,0,0,0,77,22,5,2,312,0,0,0,341,418
16,100,1,26,1,62,0,0,0,90,45,5,4,482,0,0,0,536,626
16,999,348615,333461,23813,19612,392,9,4,725906,288550,337208,31936,98878,251,12,5,756840,1482746
17,0,17785,0,0,0,0,0,0,17785,16785,0,0,0,0,0,0,16785,34570
17,1,18973,0,0,0,0,0,0,18973,17964,0,0,0,0,0,0,17964,36937
17,2,19792,0,0,0,0,0,0,19792,18836,0,0,0,0,0,0,18836,38628
17,3,20037,0,0,0,0,0,0,20037,19189,0,0,0,0,0,0,19189,39226
17,4,21236,0,0,0,0,0,0,21236,19951,0,0,0,0,0,0,19951,41187
17,5,22487,0,0,0,0,0,0,22487,21312,0,0,0,0,0,0,21312,43799
17,6,23511,0,0,0,0,0,0,23511,22111,0,0,0,0,0,0,22111,45622
17,7,24540,0,0,0,0,0,0,24540,23283,0,0,0,0,0,0,23283,47823
17,8,24933,0,0,0,0,0,0,24933,24066,0,0,0,0,0,0,24066,48999
17,9,26255,0,0,0,0,0,0,26255,24518,0,0,0,0,0,0,24518,50773
17,10,26451,0,0,0,0,0,0,26451,24961,0,0,0,0,0,0,24961,51412
17,11,27895,0,0,0,0,0,0,27895,26487,0,0,0,0,0,0,26487,54382
17,12,28054,0,0,0,0,0,0,28054,26518,0,0,0,0,0,0,26518,54572
17,13,28746,0,0,0,0,0,0,28746,27012,0,0,0,0,0,0,27012,55758
17,14,28933,0,0,0,0,0,0,28933,26982,0,0,0,0,0,0,26982,55915
17,15,28889,0,0,0,0,0,0,28889,27669,0,0,0,0,0,0,27669,56558
17,16,29268,0,0,0,0,0,0,29268,27329,2,0,0,0,0,0,27331,56599
17,17,29064,1,1,0,0,0,0,29066,27357,0,0,0,0,0,0,27357,56423
17,18,28479,1,1,0,0,0,0,28481,26419,6,0,0,1,0,0,26426,54907
17,19,28858,2,0,1,0,0,0,28861,26650,34,0,0,0,0,0,26684,55545
17,20,28125,9,1,0,0,0,0,28135,26013,100,1,0,0,0,0,26114,54249
17,21,27667,25,0,0,0,0,0,27692,25500,150,0,1,0,0,0,25651,53343
17,22,27906,49,9,0,1,0,0,27965,25406,312,5,0,1,0,0,25724,53689
17,23,28575,100,7,0,3,0,0,28685,25549,473,13,1,2,0,0,26038,54723
17,24,28113,199,11,0,4,0,0,28327,25001,701,11,2,7,0,0,25722,54049
17,25,28732,340,16,0,6,0,0,29094,24961,1109,25,1,8,0,0,26104,55198
17,26,28246,598,14,1,9,0,0,28868,24471,1685,20,2,7,0,0,26185,55053
17,27,28243,879,20,0,9,0,0,29151,24288,2317,28,4,10,2,0,26649,55800
17,28,28298,1369,25,0,14,2,0,29708,23609,3155,62,4,17,4,0,26851,56559
17,29,27746,2016,42,3,30,0,0,29837,23111,4381,90,12,31,1,0,27626,57463
17,30,27135,2714,55,4,18,3,0,29929,22737,5588,128,11,32,5,0,28501,58430
17,31,27623,3854,60,7,32,1,0,31577,22487,7301,182,19,35,4,0,30028,61605
17,32,25813,5128,101,10,46,2,0,31100,21140,8537,221,26,38,3,0,29965,61065
17,33,25928,6281,135,14,46,6,0,32410,20446,10240,304,42,43,4,0,31079,63489
17,34,24216,7719,188,11,53,0,0,32187,19082,11736,382,41,46,2,0,31289,63476
17,35,23577,9378,232,27,74,1,0,33289,18413,13410,535,63,75,7,1,32504,65793
17,36,22088,10348,276,17,81,0,0,32810,17315,14587,566,67,64,8,0,32607,65417
17,37,20749,11733,330,30,63,3,0,32908,16088,15418,800,116,55,6,0,32483,65391
17,38,20427,13277,446,32,85,4,0,34271,15698,17196,871,135,65,4,0,33969,68240
17,39,19719,15046,527,41,74,1,1,35409,15294,18281,1090,161,68,5,0,34899,70308
17,40,18928,16374,655,49,88,5,0,36099,14675,19542,1187,177,62,1,0,35644,71743
17,41,18363,18000,787,51,104,5,0,37310,14599,21140,1349,213,86,2,0,37389,74699
17,42,17495,18716,863,90,79,3,0,37246,13975,21975,1588,302,68,1,0,37909,75155
17,43,16850,19882,962,94,80,2,0,37870,13466,22824,1755,337,44,4,0,38430,76300
17,44,16474,21017,1239,108,112,3,0,38953,13299,23953,2158,421,65,4,0,39900,78853
17,45,16724,22583,1377,119,83,3,0,40889,13307,25890,2339,473,53,1,0,42063,82952
17,46,16424,23413,1530,121,94,0,0,41582,12767,26771,2660,522,63,2,0,42785,84367
17,47,15883,25121,1753,144,92,3,1,42997,12957,28427,2843,635,55,2,0,44919,87916
17,48,16105,26773,2005,205,109,2,0,45199,12961,30295,3270,708,56,1,0,47291,92490
17,49,16071,28045,2261,188,107,4,3,46679,12803,32116,3623,844,69,2,0,49457,96136
17,50,14806,28856,2530,218,113,1,1,46525,12221,32262,3814,934,48,1,0,49280,95805
17,51,14155,29809,2621,255,110,2,1,46953,11340,33353,4049,1066,47,2,2,49859,96812
17,52,13183,30428,2836,272,113,1,2,46835,10609,33676,4364,1227,50,2,0,49928,96763
17,53,12304,31028,2888,330,112,0,2,46664,9837,33608,4579,1418,49,2,0,49493,96157
17,54,11576,31884,3174,366,96,1,2,47099,9532,34455,4795,1591,43,0,0,50416,97515
17,55,10736,31839,3226,430,110,3,2,46346,8884,34191,4821,1787,40,4,0,49727,96073
17,56,9850,32415,3409,457,116,4,1,46252,8536,34444,5107,1947,32,1,0,50067,96319
17,57,9332,33175,3640,560,121,0,0,46828,7903,34546,5017,2208,26,2,0,49702,96530
17,58,8533,33634,3695,562,115,0,1,46540,7523,34447,5066,2420,45,1,1,49503,96043
17,59,8056,34390,3678,688,115,0,2,46929,7017,35325,5184,2872,42,2,3,50445,97374
17,60,6776,32501,3469,756,98,4,1,43605,6206,33194,4828,3022,36,3,1,47290,90895
17,61,5981,31353,3412,721,71,2,1,41541,5757,31523,4516,3247,32,1,1,45077,86618
17,62,5339,30725,3125,838,82,0,2,40111,5245,30665,4162,3647,28,1,1,43749,83860
17,63,4822,29405,2818,950,82,1,1,38079,4790,29078,4045,4053,30,1,1,41998,80077
17,64,4334,28411,2688,953,67,1,1,36455,4441,28042,3820,4184,18,1,0,40506,76961
17,65,3771,27193,2511,1008,74,1,3,34561,4063,26549,3614,4476,20,0,0,38722,73283
17,66,3601,26609,2366,1033,59,0,1,33669,3802,26008,3262,4949,23,0,0,38044,71713
17,67,3247,26149,2211,1193,44,1,1,32846,3277,24973,3164,5305,21,0,1,36741,69587
17,68,2856,25856,2001,1253,34,0,0,32000,3297,24356,2869,5626,8,0,0,36156,68156
17,69,2505,25049,1936,1392,39,0,1,30922,3097,23405,2776,6270,7,0,0,35555,66477
17,70,2360,23416,1646,1424,30,0,0,28876,2832,21802,2385,6257,10,0,0,33286,62162
17,71,2015,22729,1536,1483,29,0,1,27793,2600,20642,2370,6733,12,0,0,32357,60150
17,72,1969,22127,1434,1523,34,1,1,27089,2425,19898,2241,7400,16,0,0,31980,59069
17,73,1792,22574,1347,1759,33,2,0,27507,2363,19777,2205,8172,7,0,0,32524,60031
17,74,1622,22095,1320,2013,25,0,2,27077,2297,19108,1994,8903,7,0,0,32309,59386
17,75,1620,22711,1172,2255,23,0,1,27782,2348,19432,1923,10197,9,0,0,33909,61691
17,76,1467,22158,1112,2462,24,0,0,27223,2151,18108,1797,10938,7,0,0,33001,60224
17,77,1349,20551,959,2469,16,0,0,25344,2066,16653,1741,11548,6,0,0,32014,57358
17,78,980,15342,697,2111,11,0,0,19141,1681,12178,1285,9609,4,0,1,24758,43899
17,79,931,14807,676,2305,13,0,2,18734,1661,11163,1188,10321,3,0,2,24338,43072
17,80,900,14758,603,2385,13,0,0,18659,1674,10984,1166,11379,2,0,0,25205,43864
17,81,833,13482,544,2538,16,0,1,17414,1571,9630,1031,11701,3,0,1,23937,41351
17,82,748,12979,456,2690,12,0,0,16885,1571,8753,935,12320,4,0,1,23584,40469
17,83,758,13045,435,3143,16,0,0,17397,1727,8480,908,14159,1,0,0,25275,42672
17,84,637,11809,340,3056,5,0,0,15847,1521,7090,734,13988,1,0,0,23334,39181
17,85,530,10279,299,2860,6,0,0,13974,1373,5844,667,13658,1,0,0,21543,35517
17,86,455,8373,239,2824,4,0,0,11895,1279,4419,504,12706,1,0,0,18909,30804
17,87,356,6774,200,2530,6,0,0,9866,1113,3433,452,11468,0,0,0,16466,26332
17,88,332,5984,164,2524,3,0,1,9008,1024,2686,348,11136,0,0,0,15194,24202
17,89,277,4637,120,2238,4,0,0,7276,930,1963,284,10166,0,0,0,13343,20619
17,90,194,3579,84,1891,1,0,1,5750,750,1414,218,8851,0,0,0,11233,16983
17,91,142,2742,60,1628,1,1,0,4574,677,1052,169,7450,0,0,0,9348,13922
17,92,127,2020,42,1498,0,0,0,3687,588,687,145,6506,0,0,0,7926,11613
17,93,96,1537,23,1272,0,0,0,2928,541,541,109,5792,0,0,0,6983,9911
17,94,78,929,15,947,0,0,0,1969,355,308,100,4197,0,0,0,4960,6929
17,95,55,605,10,631,0,0,0,1301,335,191,52,3192,0,0,0,3770,5071
17,96,45,372,4,488,1,0,0,910,213,121,33,2518,0,0,0,2885,3795
17,97,24,251,8,339,0,0,0,622,168,70,29,1775,0,0,0,2042,2664
17,98,13,122,1,211,0,0,0,347,134,66,33,1248,0,0,0,1481,1828
17,99,9,89,3,173,0,0,0,274,126,48,13,884,0,0,0,1071,1345
17,100,41,96,6,241,0,0,0,384,179,73,29,1362,0,0,0,1643,2027
17,999,1370947,1234671,89718,71513,3693,79,41,2770662,1224467,1254366,139046,324123,1965,99,17,2944083,5714745
18,0,3950,0,0,0,0,0,0,3950,3631,0,0,0,0,0,0,3631,7581
18,1,4193,0,0,0,0,0,0,4193,3870,0,0,0,0,0,0,3870,8063
18,2,4256,0,0,0,0,0,0,4256,4135,0,0,0,0,0,0,4135,8391
18,3,4412,0,0,0,0,0,0,4412,4135,0,0,0,0,0,0,4135,8547
18,4,4479,0,0,0,0,0,0,4479,4283,0,0,0,0,0,0,4283,8762
18,5,4656,0,0,0,0,0,0,4656,4460,0,0,0,0,0,0,4460,9116
18,6,5026,0,0,0,0,0,0,5026,4711,0,0,0,0,0,0,4711,9737
18,7,5263,0,0,0,0,0,0,5263,4935,0,0,0,0,0,0,4935,10198
18,8,5367,0,0,0,0,0,0,5367,5022,0,0,0,0,0,0,5022,10389
18,9,5430,0,0,0,0,0,0,5430,5142,0,0,0,0,0,0,5142,10572
18,10,5479,0,0,0,0,0,0,5479,5199,0,0,0,0,0,0,5199,10678
18,11,5761,0,0,0,0,0,0,5761,5521,0,0,0,0,0,0,5521,11282
18,12,5945,0,0,0,0,0,0,5945,5446,0,0,0,0,0,0,5446,11391
18,13,5991,0,0,0,0,0,0,5991,5689,0,0,0,0,0,0,5689,11680
18,14,5962,0,0,0,0,0,0,5962,5547,0,0,0,0,0,0,5547,11509
18,15,6135,0,0,0,0,0,0,6135,5783,0,0,0,0,0,0,5783,11918
18,16,6014,0,0,0,0,0,0,6014,5727,1,0,0,0,0,0,5728,11742
18,17,6048,1,0,0,0,0,0,6049,5594,0,0,0,0,0,0,5594,11643
18,18,6141,2,0,0,0,0,0,6143,5753,3,0,0,0,0,0,5756,11899
18,19,6377,7,0,0,0,0,0,6384,5648,16,0,0,0,0,0,5664,12048
18,20,6224,4,0,0,0,0,0,6228,5587,38,0,0,0,0,0,5625,11853
18,21,6158,17,0,0,0,0,0,6175,5454,57,1,0,0,0,0,5512,11687
18,22,6248,23,0,0,0,0,0,6271,5659,112,3,0,0,0,0,5774,12045
18,23,6519,43,1,1,0,0,0,6564,5555,172,3,0,1,0,0,5731,12295
18,24,6348,70,1,1,0,0,0,6420,5536,229,3,1,0,0,0,5769,12189
18,25,6443,111,4,0,3,0,0,6561,5561,333,2,0,2,0,0,5898,12459
18,26,6324,163,2,5,1,0,0,6495,5301,494,2,0,1,0,0,5798,12293
18,27,6192,256,2,2,1,0,0,6453,5322,612,10,2,4,1,0,5951,12404
18,28,6119,374,4,1,1,0,0,6499,4994,807,16,0,5,0,0,5822,12321
18,29,5998,498,11,5,3,0,0,6515,4930,1178,28,1,1,1,0,6139,12654
18,30,6063,672,7,6,3,0,0,6751,4805,1398,24,4,4,1,0,6236,12987
18,31,5954,983,17,3,1,0,0,6958,4638,1789,33,7,3,0,0,6470,13428
18,32,5639,1221,22,9,7,1,0,6899,4314,2154,54,2,5,1,0,6530,13429
18,33,5489,1541,24,7,2,1,0,7064,4160,2508,75,10,4,1,0,6758,13822
18,34,5296,1833,51,3,7,0,0,7190,3765,2793,98,10,6,0,0,6672,13862
18,35,5003,2180,63,11,5,0,0,7262,3615,3156,117,12,5,0,0,6905,14167
18,36,4505,2425,62,17,6,0,0,7015,3321,3387,157,14,7,0,0,6886,13901
18,37,4399,2761,79,10,7,0,0,7256,3178,3762,177,24,8,1,0,7150,14406
18,38,4270,3126,105,13,2,0,0,7516,3159,3976,232,29,14,1,0,7411,14927
18,39,4086,3474,137,12,11,0,0,7720,2856,4304,270,36,7,1,0,7474,15194
18,40,3903,3639,155,12,5,0,0,7714,2682,4505,269,29,7,0,0,7492,15206
18,41,3755,3935,201,10,7,1,0,7909,2699,4920,331,48,10,1,0,8009,15918
18,42,3624,4099,218,22,10,0,0,7973,2406,5020,344,70,3,0,0,7843,15816
18,43,3541,4473,228,17,6,0,1,8266,2392,5124,439,88,4,1,0,8048,16314
18,44,3419,4817,288,34,5,1,0,8564,2232,5599,479,108,6,0,0,8424,16988
18,45,3380,5194,323,20,9,0,0,8926,2124,5924,541,85,4,0,0,8678,17604
18,46,3366,5245,340,34,8,0,0,8993,2077,6031,537,113,7,0,0,8765,17758
18,47,3227,5594,428,28,6,0,0,9283,2096,6419,584,145,3,0,0,9247,18530
18,48,3099,5818,431,54,6,0,0,9408,2077,6703,708,164,1,0,0,9653,19061
18,49,3075,6333,490,40,5,0,0,9943,1893,7057,748,207,8,0,0,9913,19856
18,50,2791,6272,537,60,7,0,0,9667,1766,7257,759,190,4,0,0,9976,19643
18,51,2645,6697,575,60,6,0,0,9983,1755,7433,793,234,2,0,0,10217,20200
18,52,2555,6754,633,48,4,1,0,9995,1722,7743,801,284,2,0,0,10552,20547
18,53,2423,6804,581,57,8,0,0,9873,1464,7615,834,304,4,0,0,10221,20094
18,54,2312,7329,657,66,7,0,0,10371,1528,7836,908,341,3,0,0,10616,20987
18,55,2167,7334,649,92,6,0,0,10248,1387,7828,869,421,2,0,0,10507,20755
18,56,1942,7478,684,92,9,0,1,10206,1337,8096,862,438,5,0,0,10738,20944
18,57,1826,7748,691,119,7,0,0,10391,1246,8148,836,548,2,0,0,10780,21171
18,58,1702,7773,746,146,8,0,0,10375,1116,8270,818,595,4,0,0,10803,21178
18,59,1640,8003,685,155,6,0,0,10489,1082,8123,875,658,1,0,0,10739,21228
18,60,1375,7567,648,148,5,0,0,9743,984,7729,787,740,1,0,0,10241,19984
18,61,1276,7279,650,166,5,0,0,9376,904,7438,681,819,1,0,0,9843,19219
18,62,1123,7035,612,178,2,1,0,8951,913,7431,651,875,2,0,0,9872,18823
18,63,1047,7085,558,184,6,0,0,8880,835,7168,655,968,4,0,0,9630,18510
18,64,949,7036,476,218,4,0,0,8683,740,7071,577,1072,3,0,0,9463,18146
18,65,913,6732,452,234,2,0,0,8333,722,6703,535,1085,1,0,0,9046,17379
18,66,820,6718,429,252,3,0,0,8222,671,6507,484,1206,0,0,0,8868,17090
18,67,702,6775,455,249,3,0,0,8184,584,6250,426,1377,0,0,0,8637,16821
18,68,710,6536,382,307,1,0,0,7936,575,6278,451,1486,0,0,0,8790,16726
18,69,643,6414,338,318,2,0,0,7715,536,5979,387,1652,2,1,0,8557,16272
18,70,537,6034,332,293,3,0,0,7199,486,5480,366,1622,1,0,0,7955,15154
18,71,545,5919,277,363,2,0,0,7106,475,5193,347,1865,1,0,0,7881,14987
18,72,437,5810,250,367,0,0,0,6864,417,5228,319,2036,0,0,0,8000,14864
18,73,428,6118,245,404,1,0,0,7196,426,5136,280,2181,1,0,0,8024,15220
18,74,455,6041,219,457,3,0,0,7175,415,5022,257,2475,0,0,0,8169,15344
18,75,421,5965,193,457,1,0,0,7037,431,4816,245,2751,1,0,0,8244,15281
18,76,383,5551,193,520,1,0,0,6648,364,4201,220,2857,0,0,0,7642,14290
18,77,363,5299,152,525,2,0,0,6341,321,3844,189,2959,0,0,0,7313,13654
18,78,219,3784,112,385,1,0,0,4501,242,2750,144,2383,0,0,0,5519,10020
18,79,243,3955,105,468,0,0,0,4771,255,2606,141,2720,0,0,0,5722,10493
18,80,226,3602,85,489,1,0,0,4403,250,2392,112,2820,0,0,0,5574,9977
18,81,199,3254,75,538,1,0,0,4067,239,2064,103,2864,0,0,0,5270,9337
18,82,189,3098,56,583,0,0,0,3926,228,1869,99,2992,0,0,0,5188,9114
18,83,193,3288,70,666,1,0,0,4218,252,1885,96,3522,0,0,0,5755,9973
18,84,173,3092,83,665,0,0,0,4013,246,1560,70,3762,0,0,0,5638,9651
18,85,137,2509,49,684,0,0,0,3379,234,1272,67,3308,0,0,0,4881,8260
18,86,130,2259,36,682,0,0,0,3107,205,1058,53,3265,0,0,0,4581,7688
18,87,105,1790,32,595,0,0,0,2522,197,775,44,2990,0,0,0,4006,6528
18,88,93,1566,26,601,0,0,0,2286,182,652,38,2895,0,0,0,3767,6053
18,89,64,1210,8,534,0,0,0,1816,142,469,24,2689,0,0,0,3324,5140
18,90,63,1019,12,480,1,0,0,1575,144,387,28,2488,0,0,0,3047,4622
18,91,41,734,10,404,0,0,0,1189,130,252,16,1990,0,0,0,2388,3577
18,92,38,542,9,392,0,0,0,981,115,175,20,1797,0,0,0,2107,3088
18,93,33,421,6,342,0,0,0,802,116,149,17,1607,0,0,0,1889,2691
18,94,18,277,4,226,0,0,0,525,88,80,12,1154,0,0,0,1334,1859
18,95,7,157,2,191,0,0,0,357,58,70,5,863,0,0,0,996,1353
18,96,13,122,0,135,0,0,0,270,45,36,5,670,0,0,0,756,1026
18,97,7,56,0,86,0,0,0,149,27,28,2,451,0,0,0,508,657
18,98,3,34,1,66,0,0,0,104,25,20,1,362,0,0,0,408,512
18,99,0,28,0,48,0,0,0,76,23,10,1,236,0,0,0,270,346
18,100,6,32,0,61,0,0,0,99,28,30,3,415,0,0,0,476,575
18,999,291881,295867,17774,16233,246,6,2,622009,243292,296993,23598,83491,177,11,0,647562,1269571
19,0,858,0,0,0,0,0,0,858,789,0,0,0,0,0,0,789,1647
19,1,863,0,0,0,0,0,0,863,814,0,0,0,0,0,0,814,1677
19,2,843,0,0,0,0,0,0,843,832,0,0,0,0,0,0,832,1675
19,3,932,0,0,0,0,0,0,932,804,0,0,0,0,0,0,804,1736
19,4,982,0,0,0,0,0,0,982,940,0,0,0,0,0,0,940,1922
19,5,972,0,0,0,0,0,0,972,952,0,0,0,0,0,0,952,1924
19,6,1075,0,0,0,0,0,0,1075,1007,0,0,0,0,0,0,1007,2082
19,7,1046,0,0,0,0,0,0,1046,1014,0,0,0,0,0,0,1014,2060
19,8,1118,0,0,0,0,0,0,1118,1018,0,0,0,0,0,0,1018,2136
19,9,1163,0,0,0,0,0,0,1163,1008,0,0,0,0,0,0,1008,2171
19,10,1142,0,0,0,0,0,0,1142,1078,0,0,0,0,0,0,1078,2220
19,11,1189,0,0,0,0,0,0,1189,1074,0,0,0,0,0,0,1074,2263
19,12,1173,0,0,0,0,0,0,1173,1160,0,0,0,0,0,0,1160,2333
19,13,1289,0,0,0,0,0,0,1289,1172,0,0,0,0,0,0,1172,2461
19,14,1196,0,0,0,0,0,0,1196,1111,0,0,0,0,0,0,1111,2307
19,15,1322,0,0,0,0,0,0,1322,1170,0,0,0,0,0,0,1170,2492
19,16,1311,0,1,0,0,0,0,1312,1230,0,0,0,0,0,0,1230,2542
19,17,1335,0,0,0,0,0,0,1335,1203,0,0,0,0,0,0,1203,2538
19,18,1431,0,0,0,0,0,0,1431,1234,0,0,0,0,0,0,1234,2665
19,19,1480,2,0,0,0,0,0,1482,1207,0,0,0,0,0,0,1207,2689
19,20,1469,2,0,0,0,0,0,1471,1255,6,0,0,0,0,0,1261,2732
19,21,1480,6,0,0,0,0,0,1486,1308,14,0,0,0,0,0,1322,2808
19,22,1479,6,0,0,1,0,0,1486,1303,16,2,0,1,0,0,1322,2808
19,23,1525,6,0,2,1,0,0,1534,1352,24,1,0,0,0,0,1377,2911
19,24,1648,21,0,1,1,0,0,1671,1356,38,0,0,1,0,0,1395,3066
19,25,1679,21,0,0,1,0,0,1701,1304,66,1,0,1,0,0,1372,3073
19,26,1610,40,1,0,0,0,0,1651,1256,89,1,0,0,0,0,1346,2997
19,27,1479,75,1,1,2,0,0,1558,1241,154,2,0,0,0,0,1397,2955
19,28,1488,91,0,0,0,0,0,1579,1241,176,6,1,0,0,0,1424,3003
19,29,1543,104,2,2,0,0,0,1651,1143,254,5,1,2,0,0,1405,3056
19,30,1479,179,1,1,2,0,0,1662,1119,337,3,1,0,0,0,1460,3122
19,31,1485,223,4,0,2,0,0,1714,1136,406,6,0,1,0,0,1549,3263
19,32,1445,252,5,0,0,0,0,1702,984,446,11,1,0,0,0,1442,3144
19,33,1342,339,3,0,0,0,0,1684,890,607,15,5,2,0,0,1519,3203
19,34,1231,394,11,1,0,0,0,1637,869,607,17,1,0,0,0,1494,3131
19,35,1194,508,9,1,0,0,0,1712,827,682,32,6,2,0,0,1549,3261
19,36,1147,559,19,1,0,0,0,1726,687,762,33,6,1,0,0,1489,3215
19,37,1063,604,14,2,0,0,0,1683,698,749,33,7,2,0,0,1489,3172
19,38,966,705,28,1,2,0,0,1702,648,937,32,7,0,0,0,1624,3326
19,39,948,746,32,1,1,0,0,1728,569,950,55,6,2,0,0,1582,3310
19,40,885,821,32,2,0,0,0,1740,552,978,49,8,0,0,0,1587,3327
19,41,887,844,35,0,3,0,0,1769,556,1066,71,12,0,1,0,1706,3475
19,42,830,906,32,4,1,0,0,1773,517,1121,82,12,0,0,0,1732,3505
19,43,792,942,39,1,1,0,0,1775,464,1174,80,12,0,0,0,1730,3505
19,44,764,1061,52,5,1,0,0,1883,428,1280,90,26,0,0,0,1824,3707
19,45,735,1109,64,3,1,0,0,1912,450,1345,75,25,0,0,0,1895,3807
19,46,690,1176,81,6,0,0,0,1953,440,1365,86,31,1,0,0,1923,3876
19,47,686,1327,88,7,0,0,1,2109,422,1348,103,36,0,0,0,1909,4018
19,48,711,1401,88,10,2,0,0,2212,419,1524,137,33,0,0,0,2113,4325
19,49,666,1508,78,2,5,0,0,2259,384,1646,132,43,0,0,0,2205,4464
19,50,644,1369,91,15,0,0,0,2119,333,1666,138,52,0,0,0,2189,4308
19,51,555,1515,91,11,1,0,0,2173,370,1699,107,41,0,0,0,2217,4390
19,52,553,1481,117,20,2,0,0,2173,291,1726,135,55,0,0,0,2207,4380
19,53,500,1569,104,12,0,0,0,2185,300,1712,139,80,2,0,0,2233,4418
19,54,469,1641,124,20,1,0,0,2255,307,1819,149,91,0,0,0,2366,4621
19,55,498,1651,112,25,0,0,0,2286,308,1825,138,105,0,0,0,2376,4662
19,56,454,1697,125,24,0,0,0,2300,264,1917,158,110,1,0,0,2450,4750
19,57,411,1814,111,21,0,0,0,2357,291,1912,134,139,1,0,0,2477,4834
19,58,388,1847,138,26,1,0,0,2400,254,1852,130,170,0,0,0,2406,4806
19,59,404,1931,110,29,1,0,0,2475,249,1930,133,197,1,0,0,2510,4985
19,60,359,1781,123,41,1,0,0,2305,195,1809,110,170,0,0,0,2284,4589
19,61,290,1739,118,41,2,0,0,2190,204,1780,107,214,0,0,0,2305,4495
19,62,286,1796,96,52,1,0,0,2231,185,1705,101,230,0,0,0,2221,4452
19,63,288,1810,87,40,1,0,0,2226,216,1729,105,275,1,0,0,2326,4552
19,64,230,1713,86,51,0,0,0,2080,197,1701,91,273,0,0,0,2262,4342
19,65,215,1558,84,59,1,0,0,1917,171,1627,81,291,0,0,0,2170,4087
19,66,204,1653,78,57,0,0,0,1992,161,1501,74,342,0,0,0,2078,4070
19,67,184,1694,64,68,0,0,0,2010,136,1489,66,349,0,0,0,2040,4050
19,68,174,1609,60,76,1,0,1,1921,168,1463,71,351,0,0,0,2053,3974
19,69,177,1571,70,84,0,0,0,1902,139,1461,74,409,1,0,0,2084,3986
19,70,128,1481,62,83,0,0,0,1754,135,1298,46,392,0,0,0,1871,3625
19,71,144,1532,45,69,0,0,0,1790,144,1344,46,428,0,0,0,1962,3752
19,72,93,1427,46,90,0,0,0,1656,123,1161,46,448,0,0,0,1778,3434
19,73,91,1487,47,101,0,0,0,1726,114,1179,32,567,0,0,1,1893,3619
19,74,105,1517,51,119,0,0,0,1792,115,1180,37,644,0,0,0,1976,3768
19,75,99,1442,35,124,0,0,0,1700,121,1097,36,627,0,0,0,1881,3581
19,76,96,1311,38,119,0,0,0,1564,103,960,31,692,0,0,0,1786,3350
19,77,94,1248,23,134,0,0,0,1499,98,863,28,619,0,0,0,1608,3107
19,78,64,872,26,123,0,0,0,1085,68,624,12,577,0,0,0,1281,2366
19,79,41,857,14,116,0,0,0,1028,61,581,19,582,0,0,0,1243,2271
19,80,53,746,9,116,0,0,0,924,69,494,16,583,0,0,0,1162,2086
19,81,47,712,13,119,0,0,0,891,59,436,21,580,0,0,0,1096,1987
19,82,31,711,13,136,0,0,0,891,69,479,16,694,0,0,0,1258,2149
19,83,49,770,9,155,0,0,0,983,85,440,17,823,0,0,0,1365,2348
19,84,39,737,12,161,0,0,0,949,74,445,11,900,0,0,0,1430,2379
19,85,29,606,5,158,0,0,0,798,49,293,5,742,0,0,0,1089,1887
19,86,33,482,4,190,0,0,0,709,62,274,8,778,0,0,0,1122,1831
19,87,24,435,3,168,0,0,0,630,57,231,9,789,0,0,0,1086,1716
19,88,17,364,6,167,0,0,0,554,48,155,6,734,0,0,0,943,1497
19,89,26,304,2,162,0,0,0,494,61,144,9,664,0,0,0,878,1372
19,90,16,240,1,132,0,0,0,389,58,105,7,597,0,0,0,767,1156
19,91,11,157,0,124,0,0,0,292,41,87,6,492,0,0,0,626,918
19,92,6,127,0,105,0,0,0,238,35,66,5,435,0,0,0,541,779
19,93,4,98,3,88,0,0,0,193,32,36,4,381,0,0,0,453,646
19,94,2,66,0,79,0,0,0,147,22,22,1,304,0,0,0,349,496
19,95,2,41,0,52,0,0,0,95,21,18,1,221,0,0,0,261,356
19,96,4,25,0,36,0,0,0,65,10,13,0,197,0,0,0,220,285
19,97,2,20,1,23,0,0,0,46,14,11,1,135,0,0,0,161,207
19,98,0,10,0,16,0,0,0,26,4,2,1,88,0,0,0,95,121
19,99,1,5,0,10,0,0,0,16,5,6,0,71,0,0,0,82,98
19,100,1,11,1,24,0,0,0,37,11,5,2,126,0,0,0,144,181
19,999,66701,69258,3178,4125,40,0,2,143304,53342,68539,3880,20134,23,1,1,145920,289224
20,0,21956,0,0,0,0,0,0,21956,20891,0,0,0,0,0,0,20891,42847
20,1,22806,0,0,0,0,0,0,22806,21639,0,0,0,0,0,0,21639,44445
20,2,22302,0,0,0,0,0,0,22302,21160,0,0,0,0,0,0,21160,43462
20,3,23349,0,0,0,0,0,0,23349,22017,0,0,0,0,0,0,22017,45366
20,4,24087,0,0,0,0,0,0,24087,22998,0,0,0,0,0,0,22998,47085
20,5,24865,0,0,0,0,0,0,24865,23253,0,0,0,0,0,0,23253,48118
20,6,25672,0,0,0,0,0,0,25672,24513,0,0,0,0,0,0,24513,50185
20,7,25926,0,0,0,0,0,0,25926,24496,0,0,0,0,0,0,24496,50422
20,8,26234,0,0,0,0,0,0,26234,24866,0,0,0,0,0,0,24866,51100
20,9,26794,0,0,0,0,0,0,26794,25028,0,0,0,0,0,0,25028,51822
20,10,26979,0,0,0,0,0,0,26979,25895,0,0,0,0,0,0,25895,52874
20,11,28543,0,0,0,0,0,0,28543,26642,0,0,0,0,0,0,26642,55185
20,12,29195,0,0,0,0,0,0,29195,27389,0,0,0,0,0,0,27389,56584
20,13,30169,0,0,0,0,0,0,30169,28065,0,0,0,0,0,0,28065,58234
20,14,30592,0,0,0,0,0,0,30592,29117,0,0,0,0,0,0,29117,59709
20,15,30869,0,0,0,0,0,0,30869,29533,0,0,0,0,0,0,29533,60402
20,16,31703,4,1,0,0,0,0,31708,30152,1,0,0,0,0,0,30153,61861
20,17,32370,1,1,1,0,0,0,32373,30018,1,0,0,0,0,0,30019,62392
20,18,32710,2,1,0,0,0,0,32713,30479,15,0,0,0,0,0,30494,63207
20,19,33861,9,0,0,0,0,0,33870,31343,53,0,0,0,0,0,31396,65266
20,20,33266,26,2,2,0,0,0,33296,31277,119,1,0,0,0,0,31397,64693
20,21,32655,49,1,0,0,0,0,32705,30572,243,3,1,2,0,0,30821,63526
20,22,33099,108,3,0,0,0,0,33210,30346,476,1,0,2,0,0,30825,64035
20,23,33290,212,2,1,1,0,0,33506,30361,780,9,1,1,0,0,31152,64658
20,24,32971,413,8,1,3,0,0,33396,29632,1250,4,2,1,0,0,30889,64285
20,25,32496,678,11,2,1,0,0,33188,28613,2015,17,2,4,0,0,30651,63839
20,26,31525,1052,8,1,7,0,0,32593,27425,3038,24,4,3,0,0,30494,63087
20,27,30871,1705,14,0,4,0,0,32594,26305,4288,37,9,8,0,0,30647,63241
20,28,29040,2607,16,3,13,0,0,31679,24846,6128,44,5,8,1,0,31032,62711
20,29,28432,3761,25,2,14,0,0,32234,23131,7893,80,10,10,1,0,31125,63359
20,30,27151,5279,36,4,12,1,0,32483,21656,10165,114,16,12,0,0,31963,64446
20,31,26550,7278,66,5,14,0,0,33913,20493,13039,152,27,11,2,0,33724,67637
20,32,24595,8968,75,9,12,0,0,33659,18271,15022,222,37,13,1,0,33566,67225
20,33,22780,10964,127,11,13,1,0,33896,16467,16597,282,43,24,1,0,33414,67310
20,34,21061,12532,146,20,20,1,0,33780,14679,18373,368,75,14,0,0,33509,67289
20,35,20042,14180,192,21,16,0,0,34451,13579,20336,456,86,38,2,0,34497,68948
20,36,17941,15581,252,20,27,0,0,33821,11834,20846,513,116,19,2,0,33330,67151
20,37,16262,16909,291,28,25,0,0,33515,10722,21792,600,127,26,2,0,33269,66784
20,38,15467,18837,360,37,35,1,0,34737,10041,23208,678,141,15,0,0,34083,68820
20,39,14591,19767,417,42,19,0,0,34836,9488,24797,792,211,27,0,0,35315,70151
20,40,13712,21148,480,43,17,1,0,35401,8802,25746,885,199,18,2,0,35652,71053
20,41,13295,22760,533,58,16,1,0,36663,8288,26800,941,278,7,1,0,36315,72978
20,42,12125,22855,621,90,21,1,0,35713,7821,27146,1081,289,7,1,0,36345,72058
20,43,11731,24012,681,84,22,1,0,36531,7203,27863,1188,360,11,1,0,36626,73157
20,44,11147,25012,766,102,29,2,0,37058,7167,28905,1360,422,16,4,0,37874,74932
20,45,10889,26270,772,126,20,0,0,38077,6834,30096,1500,544,14,0,0,38988,77065
20,46,10488,27227,934,139,29,2,0,38819,6807,30769,1529,636,14,1,0,39756,78575
20,47,10287,28647,1017,155,24,0,0,40130,6880,32013,1661,771,5,0,0,41330,81460
20,48,10260,30059,1163,173,33,0,1,41689,6657,33186,1809,896,10,0,0,42558,84247
20,49,9736,31375,1248,226,22,0,0,42607,6721,34738,1930,1051,12,0,0,44452,87059
20,50,9037,31307,1312,244,28,0,0,41928,6312,34621,1964,1139,18,0,0,44054,85982
20,51,8520,31782,1299,289,26,1,0,41917,6079,34730,2050,1328,6,1,0,44194,86111
20,52,8069,32076,1436,336,29,1,1,41948,5903,35110,2128,1548,11,1,0,44701,86649
20,53,7363,32091,1431,371,31,1,0,41288,5702,34546,2140,1596,10,0,0,43994,85282
20,54,6988,33598,1442,403,22,0,0,42453,5542,35120,2130,1987,5,1,0,44785,87238
20,55,6488,33695,1475,471,18,2,0,42149,5353,35283,2102,2144,6,0,0,44888,87037
20,56,6153,34256,1504,512,17,0,0,42442,5319,35604,2256,2367,13,0,0,45559,88001
20,57,5734,34897,1549,661,23,0,0,42864,5238,35446,2135,2749,2,1,0,45571,88435
20,58,5339,35207,1536,672,24,0,0,42778,4991,35223,2138,3072,3,0,0,45427,88205
20,59,5169,35925,1530,803,24,0,0,43451,4899,35581,2135,3706,4,0,0,46325,89776
20,60,4474,33520,1441,865,21,0,0,40321,4531,33474,1962,3674,3,0,0,43644,83965
20,61,3989,32746,1355,891,20,0,1,39002,4321,32362,1805,4150,5,0,0,42643,81645
20,62,3602,32257,1241,999,20,0,0,38119,4014,31331,1767,4490,2,0,0,41604,79723
20,63,3345,30636,1211,1018,17,0,0,36227,3818,29559,1586,4728,1,1,0,39693,75920
20,64,2954,30545,1087,1169,12,1,0,35768,3752,28319,1534,5189,7,0,0,38801,74569
20,65,2619,28793,980,1167,13,0,0,33572,3447,26420,1452,5427,2,0,0,36748,70320
20,66,2466,28152,1002,1358,16,0,0,32994,3112,25741,1416,5787,1,0,0,36057,69051
20,67,2091,26675,878,1404,7,0,0,31055,2836,24207,1281,6201,2,0,0,34527,65582
20,68,1983,27205,841,1482,5,1,0,31517,2841,23618,1209,6817,3,0,0,34488,66005
20,69,1809,26454,735,1600,11,0,0,30609,2791,23003,1167,7344,0,1,0,34306,64915
20,70,1588,24113,680,1613,9,0,0,28003,2447,20419,952,7218,1,0,0,31037,59040
20,71,1452,22938,592,1671,10,0,0,26663,2344,18885,956,7641,3,0,0,29829,56492
20,72,1299,22674,562,1838,6,0,0,26379,2197,18280,862,8247,0,1,0,29587,55966
20,73,1220,22541,549,2002,4,0,0,26316,2263,17832,846,9045,2,0,0,29988,56304
20,74,1162,21920,471,2137,5,0,1,25696,2111,17184,769,9777,0,0,0,29841,55537
20,75,1083,21622,453,2494,3,0,0,25655,2199,16530,741,10649,4,0,0,30123,55778
20,76,945,20203,414,2480,4,0,0,24046,2060,14828,631,11241,0,0,0,28760,52806
20,77,864,19619,370,2742,5,0,1,23601,1903,13993,578,11919,1,0,0,28394,51995
20,78,662,15169,257,2433,6,0,0,18527,1602,10561,447,10104,0,0,0,22714,41241
20,79,533,12194,212,2169,2,0,1,15111,1314,8202,347,9404,0,0,0,19267,34378
20,80,530,12359,176,2346,0,0,2,15413,1528,8179,322,10631,1,0,0,20661,36074
20,81,473,11074,183,2393,1,0,0,14124,1354,7025,319,10367,0,0,0,19065,33189
20,82,412,9702,158,2408,0,0,0,12680,1277,6025,260,10484,1,0,0,18047,30727
20,83,428,9783,118,2724,1,0,0,13054,1371,5810,242,11499,0,1,0,18923,31977
20,84,337,8626,120,2742,1,0,0,11826,1232,5017,211,11426,1,0,0,17887,29713
20,85,279,7012,98,2563,2,0,1,9955,1154,3920,166,10409,0,0,0,15649,25604
20,86,272,5976,60,2336,0,0,0,8644,944,2985,178,9708,0,0,0,13815,22459
20,87,229,4582,49,2206,0,0,0,7066,850,2248,132,8838,0,0,0,12068,19134
20,88,180,3910,39,2124,1,0,0,6254,794,1865,101,8338,0,0,0,11098,17352
20,89,164,2979,26,1794,0,0,0,4963,715,1346,90,7250,0,0,0,9401,14364
20,90,128,2372,23,1671,0,0,0,4194,641,1029,73,6530,0,0,0,8273,12467
20,91,95,1735,13,1428,0,0,0,3271,476,716,63,5538,0,0,0,6793,10064
20,92,71,1264,12,1195,1,0,0,2543,447,541,48,4632,0,0,0,5668,8211
20,93,76,890,5,1031,0,0,0,2002,356,357,37,3983,0,0,0,4733,6735
20,94,49,553,4,720,0,0,0,1326,285,241,36,2859,0,0,0,3421,4747
20,95,26,364,8,484,0,0,0,882,209,162,20,2215,0,0,0,2606,3488
20,96,17,212,1,335,0,0,0,565,162,79,13,1528,0,0,0,1782,2347
20,97,10,126,1,243,0,0,0,380,116,60,9,1048,0,0,0,1233,1613
20,98,16,76,3,156,0,0,0,251,76,55,13,796,0,0,0,940,1191
20,99,12,45,1,113,0,0,0,171,54,32,5,536,0,0,0,627,798
20,100,34,76,0,167,0,0,0,277,124,80,6,872,0,0,0,1082,1359
20,999,1301575,1318813,41213,70879,914,19,9,2733422,1147818,1341521,64111,306534,470,30,0,2860484,5593906
21,0,13112,0,0,0,0,0,0,13112,12487,0,0,0,0,0,0,12487,25599
21,1,13702,0,0,0,0,0,0,13702,12697,0,0,0,0,0,0,12697,26399
21,2,13752,0,0,0,0,0,0,13752,12881,0,0,0,0,0,0,12881,26633
21,3,13904,0,0,0,0,0,0,13904,12962,0,0,0,0,0,0,12962,26866
21,4,14405,0,0,0,0,0,0,14405,13600,0,0,0,0,0,0,13600,28005
21,5,15250,0,0,0,0,0,0,15250,14060,0,0,0,0,0,0,14060,29310
21,6,15573,0,0,0,0,0,0,15573,14917,0,0,0,0,0,0,14917,30490
21,7,16217,0,0,0,0,0,0,16217,15214,0,0,0,0,0,0,15214,31431
21,8,16251,0,0,0,0,0,0,16251,15518,0,0,0,0,0,0,15518,31769
21,9,17173,0,0,0,0,0,0,17173,16006,0,0,0,0,0,0,16006,33179
21,10,17326,0,0,0,0,0,0,17326,16419,0,0,0,0,0,0,16419,33745
21,11,18107,0,0,0,0,0,0,18107,16924,0,0,0,0,0,0,16924,35031
21,12,18585,0,0,0,0,0,0,18585,17539,0,0,0,0,0,0,17539,36124
21,13,19199,0,0,0,0,0,0,19199,18220,0,0,0,0,0,0,18220,37419
21,14,19378,0,0,0,0,0,0,19378,18284,0,0,0,0,0,0,18284,37662
21,15,19696,0,0,0,0,0,0,19696,18511,0,0,0,0,0,0,18511,38207
21,16,20000,0,0,0,0,0,0,20000,18612,0,0,0,0,0,0,18612,38612
21,17,20098,0,0,0,0,0,0,20098,18987,0,1,0,0,0,0,18988,39086
21,18,20843,0,0,0,0,0,0,20843,19092,8,0,0,0,0,0,19100,39943
21,19,21291,4,1,0,0,0,0,21296,20067,29,0,0,0,0,0,20096,41392
21,20,21121,6,0,0,0,0,0,21127,19888,62,0,0,0,0,0,19950,41077
21,21,20926,19,1,0,0,0,0,20946,19816,111,1,0,1,0,0,19929,40875
21,22,21569,44,0,1,3,0,0,21617,19818,262,2,0,2,0,0,20084,41701
21,23,21882,93,0,0,3,0,0,21978,20140,386,2,0,3,1,0,20532,42510
21,24,21906,175,7,0,2,0,0,22090,19276,644,1,2,6,1,0,19930,42020
21,25,21570,310,12,0,2,0,0,21894,18804,1022,8,3,7,0,0,19844,41738
21,26,20793,545,6,0,1,0,0,21345,17985,1576,13,1,8,0,0,19583,40928
21,27,20222,870,11,1,5,1,0,21110,17246,2290,20,4,8,0,0,19568,40678
21,28,19384,1375,16,1,12,0,0,20788,16023,3223,36,5,5,1,0,19293,40081
21,29,18765,2021,17,1,6,0,0,20810,15081,4319,61,4,8,0,0,19473,40283
21,30,18490,2785,40,1,9,0,0,21325,14422,5570,108,9,14,1,0,20124,41449
21,31,18284,3787,54,4,19,0,0,22148,13802,7133,112,12,18,0,0,21077,43225
21,32,16913,4799,70,2,18,0,0,21802,12549,8213,154,24,11,0,0,20951,42753
21,33,15794,6144,77,11,14,1,0,22041,11410,9334,185,34,12,1,0,20976,43017
21,34,14582,6804,121,12,22,0,0,21541,10572,10382,290,40,12,0,0,21296,42837
21,35,13940,8342,160,11,24,0,0,22477,9740,11694,347,51,10,1,0,21843,44320
21,36,12814,9138,190,13,20,0,1,22176,8854,12323,426,48,16,2,0,21669,43845
21,37,12034,9947,246,21,15,0,0,22263,7883,12988,536,79,8,2,0,21496,43759
21,38,10966,10674,305,12,20,0,0,21977,7459,13752,627,89,15,0,0,21942,43919
21,39,10475,11724,357,23,19,1,0,22599,7377,14862,705,100,10,2,0,23056,45655
21,40,10064,12572,378,28,23,0,0,23065,6803,15382,804,110,14,0,0,23113,46178
21,41,9577,13491,470,28,29,4,0,23599,6496,16664,866,153,13,0,0,24192,47791
21,42,9161,14124,520,48,15,1,1,23870,6258,17291,996,216,13,0,0,24774,48644
21,43,8833,15328,669,59,18,0,0,24907,5856,17988,1119,225,16,0,0,25204,50111
21,44,8757,16561,764,72,27,0,1,26182,5730,19229,1271,269,13,0,0,26512,52694
21,45,8576,17500,876,76,13,0,0,27041,5581,20085,1422,285,13,1,0,27387,54428
21,46,8434,18662,983,102,21,3,0,28205,5437,21246,1490,339,15,0,0,28527,56732
21,47,8204,19666,1086,111,18,1,0,29086,5502,22199,1614,402,13,0,0,29730,58816
21,48,7884,20706,1203,128,19,0,0,29940,5264,22922,1772,513,7,0,0,30478,60418
21,49,7488,21476,1235,168,22,1,0,30390,5062,24178,1836,563,11,0,0,31650,62040
21,50,6722,21228,1352,151,13,0,0,29466,4787,23404,1846,614,12,0,0,30663,60129
21,51,6265,21405,1326,159,16,1,0,29172,4381,23123,1855,668,2,0,0,30029,59201
21,52,5934,22134,1493,175,23,0,0,29759,4313,23703,1844,877,5,0,0,30742,60501
21,53,5454,22313,1432,231,12,1,0,29443,4036,23704,1826,945,5,0,0,30516,59959
21,54,5203,22766,1483,273,20,0,0,29745,4010,24729,1962,1095,6,0,0,31802,61547
21,55,4738,23160,1610,312,20,0,0,29840,3905,24758,1864,1251,8,1,0,31787,61627
21,56,4459,24080,1565,318,17,1,0,30440,3886,24869,1869,1369,8,0,0,32001,62441
21,57,4121,24484,1564,382,15,1,2,30569,3705,25306,1836,1508,6,0,0,32361,62930
21,58,3724,24576,1494,426,11,0,0,30231,3588,25418,1864,1722,5,0,0,32597,62828
21,59,3421,25213,1533,509,19,1,0,30696,3612,25564,1769,1934,9,0,0,32888,63584
21,60,2926,23436,1368,532,11,0,0,28273,3197,23891,1631,2008,5,0,0,30732,59005
21,61,2707,23015,1265,529,9,0,0,27525,3068,22914,1489,2294,4,0,0,29769,57294
21,62,2451,22973,1132,546,8,0,0,27110,2860,22665,1445,2508,3,0,0,29481,56591
21,63,2164,22443,1219,636,11,0,0,26473,2668,21753,1370,2778,5,0,0,28574,55047
21,64,1988,21703,1128,694,8,0,0,25521,2579,21205,1273,2960,1,0,0,28018,53539
21,65,1743,20321,960,727,7,0,0,23758,2354,19966,1178,3226,1,0,0,26725,50483
21,66,1719,20636,1009,799,6,0,0,24169,2348,19785,1132,3553,1,0,1,26820,50989
21,67,1511,20255,821,789,2,0,2,23380,2297,18964,1025,3797,0,0,0,26083,49463
21,68,1370,20000,776,870,5,0,1,23022,2115,18450,984,4227,1,0,0,25777,48799
21,69,1334,19283,711,948,5,0,0,22281,2021,17653,841,4364,0,1,0,24880,47161
21,70,1158,18405,635,1055,7,0,0,21260,1862,16506,869,4757,1,0,0,23995,45255
21,71,998,17553,558,1053,6,0,0,20168,1790,15475,761,4899,2,0,0,22927,43095
21,72,980,17919,546,1204,4,0,0,20653,1827,15408,704,5464,2,0,1,23406,44059
21,73,901,18312,519,1258,3,0,0,20993,1858,15376,711,6063,0,0,0,24008,45001
21,74,824,17950,454,1395,7,0,0,20630,1918,14558,674,6532,1,0,0,23683,44313
21,75,812,18500,419,1628,2,0,0,21361,1882,14722,635,7734,0,0,0,24973,46334
21,76,743,16783,380,1718,1,0,0,19625,1789,13158,497,7716,1,0,0,23161,42786
21,77,663,15823,355,1813,4,0,0,18658,1611,12201,537,8444,0,0,0,22793,41451
21,78,493,13068,280,1633,3,0,0,15477,1502,9308,398,7401,0,0,0,18609,34086
21,79,452,11074,202,1555,1,0,0,13284,1296,7933,322,7227,0,0,0,16778,30062
21,80,409,10618,182,1655,2,0,0,12866,1284,7204,293,7603,0,0,0,16384,29250
21,81,426,10184,164,1879,2,0,0,12655,1297,6671,269,8219,0,0,0,16456,29111
21,82,350,9184,149,1874,1,0,0,11558,1209,5704,226,7962,0,0,0,15101,26659
21,83,357,9172,136,2110,0,0,0,11775,1235,5290,243,9120,0,0,0,15888,27663
21,84,320,8208,109,2211,0,0,0,10848,1207,4605,219,9252,0,0,0,15283,26131
21,85,222,7030,102,2059,0,0,0,9413,1100,3612,145,8922,0,0,0,13779,23192
21,86,210,5822,78,1925,0,0,0,8035,994,2907,122,8402,0,0,0,12425,20460
21,87,172,4598,52,1928,0,0,0,6750,836,2035,110,7648,0,0,0,10629,17379
21,88,146,4037,40,1819,0,0,0,6042,788,1723,104,7280,0,0,0,9895,15937
21,89,145,3113,27,1696,0,0,0,4981,768,1200,65,6632,0,0,0,8665,13646
21,90,94,2426,25,1489,0,0,0,4034,609,884,64,5793,0,0,0,7350,11384
21,91,84,1791,11,1293,0,0,0,3179,512,627,58,5058,0,0,0,6255,9434
21,92,67,1325,12,1074,0,0,0,2478,442,401,43,4296,1,0,0,5183,7661
21,93,42,989,7,999,0,0,0,2037,376,288,34,3870,0,0,0,4568,6605
21,94,30,650,7,664,0,0,0,1351,305,173,13,2705,0,0,0,3196,4547
21,95,16,371,6,532,0,0,0,925,247,102,14,2105,0,0,0,2468,3393
21,96,20,251,2,368,0,0,0,641,180,61,10,1613,0,0,0,1864,2505
21,97,11,147,2,266,0,0,0,426,118,47,8,1066,0,0,0,1239,1665
21,98,8,78,1,187,0,0,0,274,91,21,5,716,0,0,0,833,1107
21,99,8,56,0,127,0,0,0,191,57,19,5,462,0,0,0,543,734
21,100,14,69,2,154,0,0,0,239,103,23,2,847,0,0,0,975,1214
21,999,864399,940622,40578,51561,700,18,8,1897886,765954,947433,55888,223086,397,15,2,1992775,3890661
22,0,1577,0,0,0,0,0,0,1577,1521,0,0,0,0,0,0,1521,3098
22,1,1723,0,0,0,0,0,0,1723,1484,0,0,0,0,0,0,1484,3207
22,2,1737,0,0,0,0,0,0,1737,1605,0,0,0,0,0,0,1605,3342
22,3,1851,0,0,0,0,0,0,1851,1677,0,0,0,0,0,0,1677,3528
22,4,1924,0,0,0,0,0,0,1924,1746,0,0,0,0,0,0,1746,3670
22,5,1884,0,0,0,0,0,0,1884,1841,0,0,0,0,0,0,1841,3725
22,6,2067,0,0,0,0,0,0,2067,1873,0,0,0,0,0,0,1873,3940
22,7,2063,0,0,0,0,0,0,2063,1956,0,0,0,0,0,0,1956,4019
22,8,2080,0,0,0,0,0,0,2080,1985,0,0,0,0,0,0,1985,4065
22,9,2075,0,0,0,0,0,0,2075,2016,0,0,0,0,0,0,2016,4091
22,10,2101,0,0,0,0,0,0,2101,1956,0,0,0,0,0,0,1956,4057
22,11,2332,0,0,0,0,0,0,2332,2111,0,0,0,0,0,0,2111,4443
22,12,2277,0,0,0,0,0,0,2277,2136,0,0,0,0,0,0,2136,4413
22,13,2342,0,0,0,0,0,0,2342,2236,0,0,0,0,0,0,2236,4578
22,14,2488,0,0,0,0,0,0,2488,2279,0,0,0,0,0,0,2279,4767
22,15,2554,0,0,0,0,0,0,2554,2345,0,0,0,0,0,0,2345,4899
22,16,2580,0,0,0,0,0,0,2580,2334,1,0,0,0,0,0,2335,4915
22,17,2675,0,0,0,0,0,0,2675,2399,0,0,0,0,0,0,2399,5074
22,18,2715,1,0,0,0,0,0,2716,2402,1,0,0,0,0,0,2403,5119
22,19,2843,1,0,0,0,0,0,2844,2649,3,0,0,1,0,0,2653,5497
22,20,2923,1,0,0,0,0,0,2924,2518,14,1,0,0,0,0,2533,5457
22,21,2899,1,0,0,0,0,0,2900,2606,17,1,0,0,0,0,2624,5524
22,22,2952,3,0,0,0,0,0,2955,2530,36,0,0,0,0,0,2566,5521
22,23,3052,21,0,0,0,0,0,3073,2597,51,0,0,0,0,0,2648,5721
22,24,3027,27,1,0,0,0,0,3055,2617,69,1,0,0,0,0,2687,5742
22,25,3071,31,2,0,0,0,0,3104,2383,155,3,0,3,0,0,2544,5648
22,26,2928,71,0,0,1,0,0,3000,2387,203,2,0,0,0,0,2592,5592
22,27,2885,103,1,0,0,0,0,2989,2221,335,2,1,0,0,0,2559,5548
22,28,2769,150,3,0,0,0,0,2922,2187,431,1,1,0,0,0,2620,5542
22,29,2680,250,2,0,0,0,0,2932,2111,566,8,3,0,0,0,2688,5620
22,30,2628,350,6,0,1,0,0,2985,1979,653,14,0,2,0,0,2648,5633
22,31,2743,459,5,0,1,0,0,3208,1966,861,13,5,1,0,0,2846,6054
22,32,2396,643,10,2,0,0,0,3051,1748,1052,21,3,2,0,0,2826,5877
22,33,2401,801,12,0,2,0,0,3216,1610,1300,29,0,2,0,0,2941,6157
22,34,2279,910,15,4,2,0,0,3210,1440,1364,35,8,0,0,0,2847,6057
22,35,2057,1091,17,4,1,0,0,3170,1310,1520,58,3,1,0,0,2892,6062
22,36,1964,1178,32,2,0,0,0,3176,1198,1571,55,8,3,0,0,2835,6011
22,37,1800,1262,26,3,3,0,0,3094,1078,1683,50,8,3,0,0,2822,5916
22,38,1730,1446,32,4,2,0,0,3214,1037,1849,71,11,1,0,0,2969,6183
22,39,1620,1570,44,2,2,0,0,3238,1010,1967,79,18,1,0,0,3075,6313
22,40,1559,1614,42,4,0,0,0,3219,916,2061,108,20,0,0,0,3105,6324
22,41,1419,1735,63,2,1,0,0,3220,929,2199,95,24,0,0,0,3247,6467
22,42,1366,1820,61,10,1,0,0,3258,782,2230,120,29,1,0,0,3162,6420
22,43,1280,1911,78,7,1,0,0,3277,776,2271,111,22,0,0,0,3180,6457
22,44,1294,2052,74,8,0,0,0,3428,680,2389,141,42,3,0,0,3255,6683
22,45,1304,2231,97,4,0,0,0,3636,686,2588,137,39,0,0,0,3450,7086
22,46,1203,2230,105,13,0,0,0,3551,679,2762,194,41,0,0,0,3676,7227
22,47,1263,2548,122,11,1,0,0,3945,723,2820,211,71,0,0,0,3825,7770
22,48,1131,2543,152,16,0,0,0,3842,700,3019,201,73,0,0,0,3993,7835
22,49,1149,2723,148,19,3,0,0,4042,658,3066,192,80,0,0,0,3996,8038
22,50,1033,2786,164,20,3,0,0,4006,670,3003,239,85,2,0,0,3999,8005
22,51,963,2815,187,27,3,0,0,3995,650,3180,236,101,2,0,0,4169,8164
22,52,967,2867,173,27,0,0,0,4034,602,3237,217,129,1,0,0,4186,8220
22,53,844,3041,165,35,1,0,0,4086,578,3351,215,142,0,0,0,4286,8372
22,54,856,3241,174,36,1,0,0,4308,564,3365,202,172,0,0,0,4303,8611
22,55,805,3214,156,35,1,0,0,4211,544,3379,218,208,1,0,0,4350,8561
22,56,764,3323,186,57,2,0,0,4332,537,3541,224,224,3,0,0,4529,8861
22,57,685,3225,151,59,1,0,0,4121,531,3532,201,237,0,0,0,4501,8622
22,58,704,3366,172,59,0,0,0,4301,513,3532,190,244,0,0,0,4479,8780
22,59,618,3571,184,78,0,0,0,4451,517,3612,214,304,0,0,0,4647,9098
22,60,564,3359,196,84,0,0,0,4203,499,3370,161,325,1,0,0,4356,8559
22,61,539,3493,172,69,1,0,0,4274,433,3393,183,343,0,0,0,4352,8626
22,62,476,3287,171,82,0,0,0,4016,404,3346,168,425,0,0,0,4343,8359
22,63,399,3328,131,86,0,0,0,3944,406,3216,170,460,0,0,0,4252,8196
22,64,436,3137,129,94,0,0,0,3796,394,3039,124,479,0,0,0,4036,7832
22,65,356,3132,121,85,3,0,0,3697,377,2897,120,492,0,0,0,3886,7583
22,66,345,2896,123,88,0,0,0,3452,347,2901,113,586,0,0,0,3947,7399
22,67,309,3056,127,121,0,0,0,3613,328,2799,114,654,0,0,0,3895,7508
22,68,290,3011,100,138,1,0,0,3540,275,2661,91,604,0,0,0,3631,7171
22,69,244,2938,91,132,0,0,0,3405,295,2612,104,715,1,0,0,3727,7132
22,70,238,2708,89,153,0,0,0,3188,275,2259,73,720,0,0,0,3327,6515
22,71,192,2595,74,164,0,0,0,3025,277,2231,79,774,0,0,0,3361,6386
22,72,169,2519,73,170,0,0,0,2931,206,2163,69,862,0,0,0,3300,6231
22,73,181,2625,72,188,0,0,0,3066,229,2101,63,949,0,0,0,3342,6408
22,74,163,2638,55,201,0,0,0,3057,199,1997,71,1049,0,0,0,3316,6373
22,75,153,2604,51,213,0,0,0,3021,231,1965,49,1227,0,0,0,3472,6493
22,76,152,2243,41,231,0,0,0,2667,208,1687,39,1215,0,0,0,3149,5816
22,77,117,1996,37,215,0,0,0,2365,167,1421,35,1157,0,0,0,2780,5145
22,78,71,1465,30,160,0,0,0,1726,158,1035,26,1003,0,0,0,2222,3948
22,79,80,1470,24,169,0,0,0,1743,135,900,18,1039,0,0,0,2092,3835
22,80,68,1367,13,222,0,0,0,1670,126,815,27,1075,0,0,0,2043,3713
22,81,59,1239,14,206,0,0,0,1518,120,759,22,1144,0,0,0,2045,3563
22,82,59,1188,14,228,0,0,0,1489,112,692,16,1127,0,0,0,1947,3436
22,83,76,1322,23,282,0,0,0,1703,120,649,18,1440,0,0,0,2227,3930
22,84,48,1257,12,298,0,0,0,1615,120,674,11,1473,0,0,0,2278,3893
22,85,42,1097,16,299,0,0,0,1454,129,505,11,1460,0,0,0,2105,3559
22,86,48,906,11,305,0,0,0,1270,119,424,18,1453,0,0,0,2014,3284
22,87,44,770,11,288,0,0,0,1113,94,324,6,1366,0,0,0,1790,2903
22,88,33,642,7,248,0,0,0,930,99,264,7,1223,0,0,0,1593,2523
22,89,24,512,5,266,0,0,0,807,87,210,6,1173,0,0,0,1476,2283
22,90,16,403,4,254,0,0,0,677,61,138,9,1054,0,0,0,1262,1939
22,91,10,311,0,237,0,0,0,558,63,99,6,811,0,0,0,979,1537
22,92,15,216,0,184,0,0,0,415,45,62,5,724,0,0,0,836,1251
22,93,15,143,4,151,0,0,0,313,48,43,2,653,0,0,0,746,1059
22,94,5,114,0,121,0,0,0,240,43,32,2,480,0,0,0,557,797
22,95,6,60,2,93,0,0,0,161,28,19,1,350,0,0,0,398,559
22,96,2,57,1,74,0,0,0,134,19,16,1,270,0,0,0,306,440
22,97,2,25,1,44,0,0,0,72,11,5,1,204,0,0,0,221,293
22,98,0,11,0,34,0,0,0,45,12,8,1,129,0,0,0,150,195
22,99,2,8,0,22,0,0,0,32,4,6,0,78,0,0,0,88,120
22,100,4,9,0,41,0,0,0,54,11,8,1,141,0,0,0,161,215
22,999,121951,129383,4907,7288,39,0,0,263568,99633,128584,6151,35262,35,0,0,269665,533233
23,0,6795,0,0,0,0,0,0,6795,6476,0,0,0,0,0,0,6476,13271
23,1,6930,0,0,0,0,0,0,6930,6487,0,0,0,0,0,0,6487,13417
23,2,6773,0,0,0,0,0,0,6773,6529,0,0,0,0,0,0,6529,13302
23,3,7137,0,0,0,0,0,0,7137,6888,0,0,0,0,0,0,6888,14025
23,4,7456,0,0,0,0,0,0,7456,7114,0,0,0,0,0,0,7114,14570
23,5,7784,0,0,0,0,0,0,7784,7322,0,0,0,0,0,0,7322,15106
23,6,7977,0,0,0,0,0,0,7977,7617,0,0,0,0,0,0,7617,15594
23,7,8121,0,0,0,0,0,0,8121,7726,0,0,0,0,0,0,7726,15847
23,8,8290,0,0,0,0,0,0,8290,7870,0,0,0,0,0,0,7870,16160
23,9,8403,0,0,0,0,0,0,8403,7832,0,0,0,0,0,0,7832,16235
23,10,8294,0,0,0,0,0,0,8294,7984,0,0,0,0,0,0,7984,16278
23,11,8719,0,0,0,0,0,0,8719,8054,0,0,0,0,0,0,8054,16773
23,12,8752,0,0,0,0,0,0,8752,8230,0,0,0,0,0,0,8230,16982
23,13,8907,0,0,0,0,0,0,8907,8583,0,0,0,0,0,0,8583,17490
23,14,9178,0,0,0,0,0,0,9178,8538,0,0,0,0,0,0,8538,17716
23,15,9033,0,0,0,0,0,0,9033,8881,0,0,0,0,0,0,8881,17914
23,16,9358,0,1,0,0,0,0,9359,8717,0,0,0,0,0,0,8717,18076
23,17,9745,1,0,0,0,0,0,9746,8953,0,0,0,0,0,0,8953,18699
23,18,9647,0,0,0,0,0,0,9647,8885,3,0,0,0,0,0,8888,18535
23,19,10069,1,0,0,0,0,0,10070,9100,23,0,0,0,0,0,9123,19193
23,20,9784,8,0,0,0,0,0,9792,8986,54,0,0,0,0,0,9040,18832
23,21,9694,27,1,0,0,0,0,9722,8755,125,0,0,0,0,0,8880,18602
23,22,9797,45,2,0,0,0,0,9844,9043,217,0,0,0,0,0,9260,19104
23,23,10060,66,2,0,0,0,0,10128,9043,327,5,0,1,0,0,9376,19504
23,24,9936,106,2,1,1,0,0,10046,8752,528,4,1,0,0,0,9285,19331
23,25,9933,251,3,0,1,0,0,10188,8526,797,3,2,0,0,0,9328,19516
23,26,9410,386,7,1,0,0,0,9804,8017,1132,5,2,1,0,0,9157,18961
23,27,9471,557,3,1,0,0,0,10032,7517,1618,17,2,0,0,0,9154,19186
23,28,8971,875,9,1,4,0,0,9860,7252,2119,17,1,4,0,0,9393,19253
23,29,8816,1319,12,1,3,0,0,10151,6865,2555,40,3,3,0,0,9466,19617
23,30,8731,1717,8,2,6,0,0,10464,6449,3347,50,5,2,0,0,9853,20317
23,31,8333,2211,19,1,2,0,0,10566,6133,4092,60,4,5,0,0,10294,20860
23,32,7867,2724,27,6,1,0,0,10625,5687,4502,75,16,1,1,0,10282,20907
23,33,7578,3294,42,10,1,0,0,10925,5292,4961,115,18,5,0,0,10391,21316
23,34,7281,3870,55,0,3,0,0,11209,4805,5742,112,20,5,1,0,10685,21894
23,35,6695,4493,63,9,3,0,0,11263,4484,6244,160,25,4,0,0,10917,22180
23,36,6197,4714,89,6,6,0,0,11012,4127,6665,181,29,3,0,0,11005,22017
23,37,5790,5183,97,8,4,0,0,11082,3734,6845,241,54,4,0,0,10878,21960
23,38,5567,5515,114,7,1,0,0,11204,3551,7213,245,46,0,0,0,11055,22259
23,39,5322,6170,147,19,2,0,0,11660,3340,7342,291,63,3,0,0,11039,22699
23,40,4919,6325,153,14,3,0,0,11414,3003,7833,317,50,1,0,0,11204,22618
23,41,4701,6691,201,9,5,0,0,11607,2928,8246,364,90,0,0,0,11628,23235
23,42,4456,6941,201,20,8,0,0,11626,2804,8301,378,83,1,0,0,11567,23193
23,43,4256,7415,258,31,4,0,0,11964,2667,8639,414,116,2,0,0,11838,23802
23,44,4203,7622,253,37,3,1,0,12119,2652,8980,465,123,1,0,0,12221,24340
23,45,3997,8009,297,38,0,0,0,12341,2495,9101,497,163,2,1,0,12259,24600
23,46,3851,8199,312,34,1,0,0,12397,2484,9701,535,200,2,0,0,12922,25319
23,47,3844,8813,357,46,3,0,0,13063,2451,10172,590,240,3,0,0,13456,26519
23,48,3636,8940,397,65,3,0,0,13041,2312,10176,644,267,1,0,0,13400,26441
23,49,3526,9192,378,63,0,1,0,13160,2285,10550,583,285,1,0,1,13705,26865
23,50,3354,9196,474,78,4,0,0,13106,2141,10494,650,380,0,0,0,13665,26771
23,51,3171,9385,485,97,3,0,0,13141,2121,10709,689,433,0,0,0,13952,27093
23,52,3006,9642,478,91,0,0,0,13217,1983,10989,726,485,2,0,0,14185,27402
23,53,2767,9753,478,98,0,0,0,13096,1998,10785,687,571,1,0,0,14042,27138
23,54,2783,10189,563,118,2,0,0,13655,2007,11641,710,595,3,0,0,14956,28611
23,55,2634,10324,514,113,2,0,0,13587,1989,11247,717,655,0,0,0,14608,28195
23,56,2450,10547,553,168,5,0,0,13723,1846,11443,684,817,2,1,0,14793,28516
23,57,2310,10725,525,181,1,0,0,13742,1793,11607,633,879,1,0,0,14913,28655
23,58,2161,10780,548,204,1,0,0,13694,1702,11394,651,984,3,0,0,14734,28428
23,59,2133,11313,557,252,4,0,0,14259,1748,11841,648,1182,0,0,0,15419,29678
23,60,1850,10892,484,216,0,1,0,13443,1477,11171,599,1268,1,0,0,14516,27959
23,61,1732,10893,465,239,0,0,0,13329,1492,11168,545,1310,0,0,0,14515,27844
23,62,1634,10759,476,280,2,0,0,13151,1423,10853,505,1526,1,0,0,14308,27459
23,63,1569,10779,485,292,0,0,0,13125,1333,10456,541,1735,1,0,0,14066,27191
23,64,1403,10542,459,331,1,0,0,12736,1299,10052,473,1841,0,0,0,13665,26401
23,65,1258,9777,389,328,1,0,0,11753,1100,9235,484,1866,2,0,0,12687,24440
23,66,1140,10290,405,381,0,0,0,12216,1107,9208,432,2105,0,0,0,12852,25068
23,67,1066,9881,331,406,0,0,0,11684,990,8886,421,2199,0,0,0,12496,24180
23,68,982,9886,351,351,1,0,0,11571,968,8562,385,2443,0,0,0,12358,23929
23,69,915,9797,324,464,1,0,0,11501,914,8295,340,2597,0,0,0,12146,23647
23,70,807,9126,317,494,1,0,0,10745,902,7531,339,2650,0,0,0,11422,22167
23,71,697,8550,249,483,0,0,0,9979,765,6967,297,2779,0,0,0,10808,20787
23,72,650,8590,233,560,0,0,0,10033,793,6803,297,3119,0,0,0,11012,21045
23,73,597,8649,209,592,1,0,0,10048,797,6650,283,3367,0,0,0,11097,21145
23,74,543,8544,244,675,0,0,0,10006,757,6229,245,3734,0,0,0,10965,20971
23,75,525,8338,202,676,2,0,0,9743,700,6090,222,4095,0,0,0,11107,20850
23,76,492,7896,161,751,0,0,0,9300,659,5367,196,4296,0,0,0,10518,19818
23,77,422,6943,134,746,0,0,0,8245,636,4647,169,4189,0,0,0,9641,17886
23,78,302,5198,114,630,0,0,0,6244,491,3333,126,3389,0,0,0,7339,13583
23,79,310,5080,98,673,0,0,0,6161,455,3021,102,3537,0,0,0,7115,13276
23,80,255,4672,86,678,0,0,0,5691,492,2693,106,3739,0,0,0,7030,12721
23,81,209,4426,70,737,1,0,0,5443,411,2355,85,3923,0,0,0,6774,12217
23,82,232,4028,59,706,0,0,0,5025,396,2085,98,3895,0,0,0,6474,11499
23,83,222,4242,58,909,0,0,0,5431,424,2099,97,4448,0,0,0,7068,12499
23,84,191,3777,58,934,0,0,0,4960,412,1824,75,4409,0,0,0,6720,11680
23,85,139,3111,37,871,0,0,0,4158,375,1531,72,4218,0,0,0,6196,10354
23,86,144,2746,32,880,0,0,0,3802,345,1123,44,3960,0,0,0,5472,9274
23,87,116,2293,28,847,0,0,0,3284,315,1012,41,3813,0,0,0,5181,8465
23,88,119,1890,19,869,0,0,0,2897,320,745,36,3592,0,0,0,4693,7590
23,89,87,1614,15,762,0,0,0,2478,264,566,38,3211,0,0,0,4079,6557
23,90,69,1258,10,778,0,0,0,2115,238,427,27,2952,0,0,0,3644,5759
23,91,45,936,4,615,0,0,0,1600,213,329,16,2592,0,0,0,3150,4750
23,92,45,646,10,520,0,0,0,1221,190,225,24,2120,0,0,0,2559,3780
23,93,29,492,3,473,0,0,0,997,162,184,15,1748,0,0,0,2109,3106
23,94,23,331,5,314,0,0,0,673,118,103,21,1331,0,0,0,1573,2246
23,95,14,199,3,264,0,0,0,480,91,76,6,1001,0,0,0,1174,1654
23,96,15,146,3,200,0,0,0,364,79,49,6,740,0,0,0,874,1238
23,97,5,78,0,146,0,0,0,229,58,26,4,518,0,0,0,606,835
23,98,4,64,1,101,0,0,0,170,37,27,5,374,0,0,0,443,613
23,99,3,44,1,64,0,0,0,112,39,32,0,276,0,0,0,347,459
23,100,10,79,0,98,0,0,0,187,52,40,5,425,0,0,0,522,709
23,999,421629,441016,15317,23164,101,3,0,901230,357642,442375,21025,116219,72,4,1,937338,1838568
24,0,18132,0,0,0,0,0,0,18132,17290,0,0,0,0,0,0,17290,35422
24,1,19259,0,0,0,0,0,0,19259,17748,0,0,0,0,0,0,17748,37007
24,2,19249,0,0,0,0,0,0,19249,18308,0,0,0,0,0,0,18308,37557
24,3,19590,0,0,0,0,0,0,19590,18481,0,0,0,0,0,0,18481,38071
24,4,20159,0,0,0,0,0,0,20159,18920,0,0,0,0,0,0,18920,39079
24,5,20914,0,0,0,0,0,0,20914,19815,0,0,0,0,0,0,19815,40729
24,6,21406,0,0,0,0,0,0,21406,20141,0,0,0,0,0,0,20141,41547
24,7,21252,0,0,0,0,0,0,21252,20372,0,0,0,0,0,0,20372,41624
24,8,22046,0,0,0,0,0,0,22046,20880,0,0,0,0,0,0,20880,42926
24,9,22585,0,0,0,0,0,0,22585,21409,0,0,0,0,0,0,21409,43994
24,10,22184,0,0,0,0,0,0,22184,21100,0,0,0,0,0,0,21100,43284
24,11,23211,0,0,0,0,0,0,23211,22247,0,0,0,0,0,0,22247,45458
24,12,23456,0,0,0,0,0,0,23456,22379,0,0,0,0,0,0,22379,45835
24,13,24138,0,0,0,0,0,0,24138,23056,0,0,0,0,0,0,23056,47194
24,14,24824,0,0,0,0,0,0,24824,23402,0,0,0,0,0,0,23402,48226
24,15,25286,0,0,0,0,0,0,25286,23882,0,0,0,0,0,0,23882,49168
24,16,25257,1,1,0,0,0,0,25259,23799,0,2,0,0,0,0,23801,49060
24,17,26501,1,0,0,0,0,0,26502,23856,0,0,0,0,0,0,23856,50358
24,18,27079,3,1,1,0,0,0,27084,24581,29,0,0,0,0,0,24610,51694
24,19,27739,13,0,0,0,0,0,27752,24928,110,1,1,2,0,0,25042,52794
24,20,26539,28,1,0,0,0,0,26568,24363,207,1,2,1,0,0,24574,51142
24,21,26116,86,0,1,0,0,0,26203,24189,386,0,2,2,0,0,24579,50782
24,22,26461,152,1,1,1,0,0,26616,24007,632,5,2,6,0,0,24652,51268
24,23,26999,272,9,0,1,0,0,27281,23606,1031,8,1,2,0,0,24648,51929
24,24,26573,471,7,0,7,0,0,27058,23420,1592,13,1,7,0,0,25033,52091
24,25,25800,717,10,0,1,0,0,26528,22214,2291,23,3,8,0,0,24539,51067
24,26,25104,1182,7,2,4,1,0,26300,21066,3265,24,1,5,0,0,24361,50661
24,27,24219,1799,12,0,2,0,0,26032,20275,4397,38,3,6,0,0,24719,50751
24,28,23326,2569,19,1,3,0,0,25918,18930,5767,67,5,15,0,0,24784,50702
24,29,22797,3589,26,2,11,0,0,26425,17762,7324,86,10,8,2,0,25192,51617
24,30,21990,4895,48,3,13,0,0,26949,16955,9051,157,17,19,1,0,26200,53149
24,31,21465,6505,72,4,14,0,0,28060,16169,10873,170,20,19,0,0,27251,55311
24,32,19665,7964,105,4,14,4,0,27756,14224,12526,249,33,14,1,0,27047,54803
24,33,18676,9304,145,4,21,0,0,28150,13391,13826,321,38,18,1,0,27595,55745
24,34,17322,10622,146,8,18,0,0,28116,12254,15160,374,57,24,0,0,27869,55985
24,35,16429,12106,235,11,21,1,1,28804,11205,16308,421,77,20,1,0,28032,56836
24,36,14851,12929,263,14,14,1,0,28072,10241,16789,518,85,26,1,0,27660,55732
24,37,13844,14205,317,17,16,1,1,28401,9358,17691,619,102,23,0,2,27795,56196
24,38,12969,15059,378,21,21,0,0,28448,8797,18795,755,104,33,2,0,28486,56934
24,39,12361,16202,448,33,21,0,0,29065,8502,19641,892,150,17,2,0,29204,58269
24,40,11442,16808,543,45,30,2,0,28870,7532,20181,925,160,16,1,0,28815,57685
24,41,11158,18047,631,35,35,1,0,29907,7295,21275,1061,221,19,2,1,29874,59781
24,42,10634,18495,678,53,23,2,0,29885,6805,21902,1168,258,35,0,0,30168,60053
24,43,10112,20016,770,59,29,2,0,30988,6591,23023,1342,305,18,1,0,31280,62268
24,44,9837,20323,914,84,32,0,0,31190,6355,23651,1471,338,22,2,0,31839,63029
24,45,9702,21371,984,102,25,2,0,32186,6189,24494,1644,402,20,1,0,32750,64936
24,46,9126,22062,1130,109,30,3,1,32461,6100,25080,1695,442,20,0,0,33337,65798
24,47,9200,23465,1302,120,17,1,0,34105,5996,26555,1873,510,10,1,0,34945,69050
24,48,8884,24605,1370,151,38,3,0,35051,5860,27256,2017,610,17,0,0,35760,70811
24,49,8717,25555,1515,161,22,0,0,35970,5882,28457,2150,766,14,1,0,37270,73240
24,50,7924,25559,1541,212,34,0,1,35271,5355,28138,2242,889,16,2,0,36642,71913
24,51,7697,25931,1652,205,26,0,0,35511,5200,28418,2278,966,13,0,0,36875,72386
24,52,7106,26762,1691,270,23,1,1,35854,5190,29435,2316,1069,15,1,0,38026,73880
24,53,6523,26672,1753,264,20,0,1,35233,5021,29046,2401,1279,13,2,0,37762,72995
24,54,6342,28173,1814,324,23,0,0,36676,4805,29803,2508,1464,7,2,0,38589,75265
24,55,5854,27974,1848,382,27,0,0,36085,4689,29405,2454,1656,7,0,0,38211,74296
24,56,5592,28521,1836,451,24,0,0,36424,4498,29824,2349,1832,8,1,0,38512,74936
24,57,5176,28451,1869,445,24,0,1,35966,4481,29479,2352,2049,6,0,0,38367,74333
24,58,4780,28346,1858,449,15,0,0,35448,4366,29214,2295,2293,2,3,0,38173,73621
24,59,4649,29400,1869,586,19,0,0,36523,4201,29721,2328,2681,5,0,1,38937,75460
24,60,3972,28070,1668,628,17,1,3,34359,3980,28204,2049,2750,4,0,0,36987,71346
24,61,3643,27853,1736,662,23,1,0,33918,3835,27878,1993,3244,2,0,1,36953,70871
24,62,3477,27001,1568,759,7,0,0,32812,3593,27131,1885,3391,3,0,0,36003,68815
24,63,3154,27265,1522,758,9,1,0,32709,3604,26849,1740,3919,4,0,0,36116,68825
24,64,2945,25891,1374,887,12,0,0,31109,3257,24924,1649,4234,1,0,0,34065,65174
24,65,2714,25008,1233,898,8,0,0,29861,2997,23878,1497,4606,1,0,0,32979,62840
24,66,2510,24855,1206,956,19,2,0,29548,3011,23434,1472,5016,2,0,1,32936,62484
24,67,2234,24316,1110,1000,10,1,0,28671,2780,22602,1282,5364,3,0,0,32031,60702
24,68,2167,24194,1074,1161,7,1,1,28605,2656,21715,1264,5871,2,1,0,31509,60114
24,69,1934,23667,941,1280,9,0,0,27831,2642,21263,1258,6441,0,0,0,31604,59435
24,70,1718,21680,878,1234,12,0,0,25522,2383,18761,1136,6494,0,0,0,28774,54296
24,71,1629,21027,785,1335,6,1,0,24783,2317,18068,1018,7026,1,0,0,28430,53213
24,72,1508,20712,737,1416,7,0,0,24380,2275,17069,940,7373,0,0,0,27657,52037
24,73,1419,20820,673,1644,5,0,0,24561,2336,16820,997,8328,1,0,0,28482,53043
24,74,1281,20642,611,1702,2,0,2,24240,2132,16210,795,9349,1,0,0,28487,52727
24,75,1299,20818,565,1909,7,0,0,24598,2212,15634,787,10318,1,0,0,28952,53550
24,76,1152,19921,540,2007,2,0,0,23622,2121,14312,756,11073,0,0,0,28262,51884
24,77,1029,17350,444,2007,5,0,0,20835,1883,12157,629,10885,3,0,0,25557,46392
24,78,745,14295,324,1852,1,0,1,17218,1639,9490,473,9604,0,0,0,21206,38424
24,79,712,12938,299,1784,2,0,0,15735,1495,8212,458,9918,1,0,0,20084,35819
24,80,602,11581,261,1834,0,0,0,14278,1412,7056,390,9799,1,0,0,18658,32936
24,81,555,10803,203,1968,1,0,0,13530,1337,6131,339,10280,0,0,0,18087,31617
24,82,510,10130,173,2020,0,0,0,12833,1394,5449,341,10460,0,0,0,17644,30477
24,83,522,10509,205,2361,0,0,0,13597,1427,5257,349,12362,0,0,0,19395,32992
24,84,445,9390,161,2345,2,0,0,12343,1294,4223,277,11913,1,0,0,17708,30051
24,85,376,8007,134,2224,0,0,0,10741,1190,3425,231,11346,0,0,0,16192,26933
24,86,325,6309,89,2035,1,0,0,8759,1058,2533,188,9821,0,0,0,13600,22359
24,87,255,5434,72,1944,0,0,0,7705,1003,1848,173,9197,0,0,0,12221,19926
24,88,206,4408,69,1956,1,0,0,6640,879,1501,125,8754,0,0,0,11259,17899
24,89,186,3697,48,1908,1,0,0,5840,772,1072,128,8083,0,0,0,10055,15895
24,90,162,2902,36,1661,0,0,0,4761,696,783,87,7062,0,0,0,8628,13389
24,91,130,2036,25,1365,0,0,0,3556,577,495,81,5772,0,0,0,6925,10481
24,92,79,1483,9,1180,0,0,0,2751,535,387,60,4942,0,0,0,5924,8675
24,93,78,1166,14,972,1,0,0,2231,431,223,56,4383,0,0,0,5093,7324
24,94,51,698,10,695,0,0,0,1454,334,152,27,2966,0,0,0,3479,4933
24,95,39,428,6,504,0,0,0,977,255,95,41,2319,0,0,0,2710,3687
24,96,30,257,4,375,0,0,0,666,171,42,13,1657,0,0,0,1883,2549
24,97,16,149,4,277,0,0,0,446,158,39,14,1236,0,0,0,1447,1893
24,98,22,82,3,170,0,0,0,277,118,31,12,860,0,0,0,1021,1298
24,99,16,62,1,148,0,0,0,227,82,24,4,629,0,0,0,739,966
24,100,35,85,2,173,0,0,0,295,123,47,7,883,0,0,0,1060,1355
24,999,1084110,1145149,50636,58628,896,33,14,2339466,948327,1147472,70634,290832,590,32,6,2457893,4797359
25,0,3739,0,0,0,0,0,0,3739,3502,0,0,0,0,0,0,3502,7241
25,1,4041,0,0,0,0,0,0,4041,3693,0,0,0,0,0,0,3693,7734
25,2,4253,0,0,0,0,0,0,4253,4091,0,0,0,0,0,0,4091,8344
25,3,4363,0,0,0,0,0,0,4363,4010,0,0,0,0,0,0,4010,8373
25,4,4574,0,0,0,0,0,0,4574,4434,0,0,0,0,0,0,4434,9008
25,5,4902,0,0,0,0,0,0,4902,4573,0,0,0,0,0,0,4573,9475
25,6,5287,0,0,0,0,0,0,5287,4939,0,0,0,0,0,0,4939,10226
25,7,5491,0,0,0,0,0,0,5491,5116,0,0,0,0,0,0,5116,10607
25,8,5857,0,0,0,0,0,0,5857,5379,0,0,0,0,0,0,5379,11236
25,9,5953,0,0,0,0,0,0,5953,5544,0,0,0,0,0,0,5544,11497
25,10,6093,0,0,0,0,0,0,6093,5730,0,0,0,0,0,0,5730,11823
25,11,6448,0,0,0,0,0,0,6448,5983,0,0,0,0,0,0,5983,12431
25,12,6721,0,0,0,0,0,0,6721,6319,0,0,0,0,0,0,6319,13040
25,13,6989,0,0,0,0,0,0,6989,6510,0,0,0,0,0,0,6510,13499
25,14,7068,0,0,0,0,0,0,7068,6423,0,0,0,0,0,0,6423,13491
25,15,7004,0,0,0,0,0,0,7004,6567,0,0,0,0,0,0,6567,13571
25,16,6945,2,0,0,0,0,0,6947,6572,0,0,0,0,0,0,6572,13519
25,17,7078,0,0,0,0,0,0,7078,6549,0,0,0,0,0,0,6549,13627
25,18,7207,0,0,1,0,0,0,7208,6536,0,1,0,0,0,0,6537,13745
25,19,7093,6,1,0,0,0,0,7100,6436,7,0,0,0,0,0,6443,13543
25,20,7263,4,0,0,0,0,0,7267,6636,8,0,0,0,0,0,6644,13911
25,21,7011,6,0,0,0,0,0,7017,6586,23,0,0,0,0,0,6609,13626
25,22,7168,10,0,0,0,0,0,7178,6725,39,1,0,0,0,0,6765,13943
25,23,7500,17,0,2,1,0,0,7520,6738,61,2,0,0,0,0,6801,14321
25,24,7409,39,0,0,0,0,0,7448,6493,113,5,1,0,0,0,6612,14060
25,25,7250,50,3,0,3,0,0,7306,6235,133,2,0,0,0,0,6370,13676
25,26,7260,84,5,0,1,0,0,7350,6203,251,2,0,3,0,0,6459,13809
25,27,7267,130,3,0,1,0,0,7401,6138,377,7,0,3,0,0,6525,13926
25,28,7340,248,3,2,4,0,0,7597,6029,559,11,0,4,0,0,6603,14200
25,29,7240,360,10,1,5,1,0,7617,6024,743,16,3,1,1,0,6788,14405
25,30,7081,463,9,0,4,0,0,7557,6073,984,34,0,4,1,0,7096,14653
25,31,7260,594,22,0,7,0,0,7883,6064,1372,42,2,7,0,0,7487,15370
25,32,7340,863,28,0,8,0,0,8239,5873,1670,62,12,9,1,0,7627,15866
25,33,7110,1224,30,1,10,1,0,8376,5804,2113,82,8,9,2,0,8018,16394
25,34,7007,1442,43,2,11,0,0,8505,5402,2379,96,12,9,1,0,7899,16404
25,35,6808,1687,51,2,8,0,0,8556,5195,2783,155,22,8,1,0,8164,16720
25,36,6495,2041,58,4,9,1,0,8608,4981,3107,161,16,10,0,0,8275,16883
25,37,6240,2271,98,5,10,1,1,8626,4845,3347,209,21,9,1,0,8432,17058
25,38,6221,2656,124,2,9,0,0,9012,4675,3798,241,41,11,1,0,8767,17779
25,39,6128,3026,180,8,15,0,0,9357,4424,4104,318,27,8,2,0,8883,18240
25,40,6004,3277,168,7,9,0,0,9465,4465,4471,345,43,8,1,0,9333,18798
25,41,5996,3873,197,11,9,0,0,10086,4306,4922,429,58,5,0,0,9720,19806
25,42,5734,4018,258,12,12,0,0,10034,4133,5285,471,70,6,1,1,9967,20001
25,43,5694,4595,292,15,13,1,0,10610,4045,5499,515,68,10,1,0,10138,20748
25,44,5510,4715,372,20,15,0,0,10632,3934,5888,596,88,3,0,0,10509,21141
25,45,5763,5476,411,36,11,0,0,11697,3945,6570,671,103,13,1,0,11303,23000
25,46,5630,5835,465,26,16,1,0,11973,3797,6841,733,126,6,1,0,11504,23477
25,47,5624,6144,546,26,16,1,0,12357,3827,7291,816,157,5,0,0,12096,24453
25,48,5668,6557,647,42,16,0,0,12930,3850,7838,900,196,9,0,0,12793,25723
25,49,5631,7287,730,49,14,0,0,13711,3764,8212,923,227,9,2,0,13137,26848
25,50,5358,7472,763,49,12,0,0,13654,3545,8414,1034,260,6,0,0,13259,26913
25,51,4961,7522,790,83,16,0,0,13372,3300,8514,1082,302,3,0,0,13201,26573
25,52,4485,7651,830,72,9,0,0,13047,3179,8836,1141,328,3,0,0,13487,26534
25,53,4310,7842,922,73,8,0,0,13155,2915,8648,1091,374,8,0,0,13036,26191
25,54,4162,8103,996,101,11,0,0,13373,2799,9132,1121,475,1,0,0,13528,26901
25,55,3700,8167,918,110,9,0,0,12904,2665,9052,1164,485,3,0,0,13369,26273
25,56,3660,8680,959,134,12,0,0,13445,2560,9346,1082,583,8,0,0,13579,27024
25,57,3364,8923,1003,147,13,0,0,13450,2506,9588,1140,609,5,0,0,13848,27298
25,58,3066,9238,959,176,7,0,0,13446,2400,9479,1111,762,3,0,0,13755,27201
25,59,2968,9448,1036,171,3,1,1,13628,2214,9908,1087,846,4,0,1,14060,27688
25,60,2526,9052,995,185,5,0,0,12763,2136,9535,968,957,2,0,0,13598,26361
25,61,2338,9036,950,228,5,1,0,12558,1950,9241,982,1023,4,0,0,13200,25758
25,62,2190,8841,834,235,9,0,0,12109,1809,9208,880,1145,0,0,0,13042,25151
25,63,1989,8813,813,290,5,0,0,11910,1651,8694,795,1209,4,0,0,12353,24263
25,64,1828,8681,719,303,6,1,0,11538,1533,8561,811,1312,0,0,0,12217,23755
25,65,1692,8535,670,314,2,0,0,11213,1437,8335,751,1447,3,0,0,11973,23186
25,66,1577,8565,634,315,6,1,1,11099,1443,8262,686,1651,2,0,0,12044,23143
25,67,1470,8339,592,370,10,0,0,10781,1348,8030,645,1771,3,0,0,11797,22578
25,68,1322,8199,578,411,7,0,0,10517,1307,7605,531,1867,6,0,0,11316,21833
25,69,1307,8197,568,467,5,1,0,10545,1293,7523,578,2002,1,0,0,11397,21942
25,70,1131,7833,508,444,2,0,0,9918,1253,6916,530,2032,0,0,0,10731,20649
25,71,1100,7647,399,484,2,0,0,9632,1162,6798,456,2218,1,0,0,10635,20267
25,72,1010,7360,392,491,3,0,0,9256,1084,6474,405,2510,1,0,0,10474,19730
25,73,938,7377,376,609,2,0,0,9302,1123,6142,417,2678,0,0,0,10360,19662
25,74,875,7090,299,597,0,0,1,8862,1004,5841,341,2804,0,0,0,9990,18852
25,75,842,6968,320,645,0,0,0,8775,1072,5767,346,2959,0,0,0,10144,18919
25,76,753,6609,280,652,0,0,1,8295,997,5107,295,3215,1,0,0,9615,17910
25,77,620,6132,253,671,0,0,0,7676,937,4390,271,3184,0,0,0,8782,16458
25,78,608,5377,161,644,0,0,0,6790,916,3892,223,3280,0,0,0,8311,15101
25,79,564,4989,165,723,2,0,0,6443,907,3575,179,3389,0,0,0,8050,14493
25,80,464,4533,137,645,3,0,0,5782,844,3165,162,3609,0,0,0,7780,13562
25,81,484,4443,132,765,0,0,0,5824,801,2911,139,3863,0,0,0,7714,13538
25,82,390,3843,106,680,0,0,0,5019,785,2376,137,3788,0,0,0,7086,12105
25,83,482,3899,108,858,1,0,0,5348,876,2247,128,4357,0,0,0,7608,12956
25,84,385,3508,82,824,0,0,0,4799,803,1860,108,4023,0,0,0,6794,11593
25,85,327,2841,55,738,0,0,0,3961,735,1428,86,3761,0,0,0,6010,9971
25,86,267,2272,52,724,0,0,0,3315,662,1141,61,3470,0,0,0,5334,8649
25,87,234,1997,43,673,0,0,0,2947,629,877,53,3258,0,0,0,4817,7764
25,88,188,1532,20,592,0,0,0,2332,581,626,41,3018,0,0,0,4266,6598
25,89,182,1370,20,636,0,0,0,2208,510,506,42,2909,0,0,0,3967,6175
25,90,159,1111,16,565,0,0,0,1851,446,363,52,2650,0,0,0,3511,5362
25,91,113,861,13,447,0,0,0,1434,423,273,14,2184,0,0,0,2894,4328
25,92,82,643,7,443,0,0,0,1175,305,149,22,1833,0,0,0,2309,3484
25,93,76,478,4,364,0,0,0,922,284,122,12,1654,0,0,0,2072,2994
25,94,52,290,2,283,0,0,0,627,252,85,8,1319,0,0,1,1665,2292
25,95,36,198,2,204,0,0,0,440,193,53,10,993,0,0,0,1249,1689
25,96,23,136,2,134,0,0,0,295,117,31,4,714,0,0,0,866,1161
25,97,16,80,0,100,0,0,0,196,110,18,1,506,0,0,0,635,831
25,98,10,45,0,64,0,0,0,119,66,7,3,352,0,0,0,428,547
25,99,5,26,0,54,0,0,0,85,41,8,2,265,0,0,0,316,401
25,100,10,26,0,80,0,0,0,116,59,11,2,389,0,0,0,461,577
25,999,385457,339818,25237,20341,412,12,5,771282,330082,339858,31076,97893,241,18,3,799171,1570453
5976,0,858,0,0,0,0,0,0,858,789,0,0,0,0,0,0,789,1647
5976,1,863,0,0,0,0,0,0,863,814,0,0,0,0,0,0,814,1677
5976,2,843,0,0,0,0,0,0,843,832,0,0,0,0,0,0,832,1675
5976,3,932,0,0,0,0,0,0,932,804,0,0,0,0,0,0,804,1736
5976,4,982,0,0,0,0,0,0,982,940,0,0,0,0,0,0,940,1922
5976,5,972,0,0,0,0,0,0,972,952,0,0,0,0,0,0,952,1924
5976,6,1075,0,0,0,0,0,0,1075,1007,0,0,0,0,0,0,1007,2082
5976,7,1046,0,0,0,0,0,0,1046,1014,0,0,0,0,0,0,1014,2060
5976,8,1118,0,0,0,0,0,0,1118,1018,0,0,0,0,0,0,1018,2136
5976,9,1163,0,0,0,0,0,0,1163,1008,0,0,0,0,0,0,1008,2171
5976,10,1142,0,0,0,0,0,0,1142,1078,0,0,0,0,0,0,1078,2220
5976,11,1189,0,0,0,0,0,0,1189,1074,0,0,0,0,0,0,1074,2263
5976,12,1173,0,0,0,0,0,0,1173,1160,0,0,0,0,0,0,1160,2333
5976,13,1289,0,0,0,0,0,0,1289,1172,0,0,0,0,0,0,1172,2461
5976,14,1196,0,0,0,0,0,0,1196,1111,0,0,0,0,0,0,1111,2307
5976,15,1322,0,0,0,0,0,0,1322,1170,0,0,0,0,0,0,1170,2492
5976,16,1311,0,1,0,0,0,0,1312,1230,0,0,0,0,0,0,1230,2542
5976,17,1335,0,0,0,0,0,0,1335,1203,0,0,0,0,0,0,1203,2538
5976,18,1431,0,0,0,0,0,0,1431,1234,0,0,0,0,0,0,1234,2665
5976,19,1480,2,0,0,0,0,0,1482,1207,0,0,0,0,0,0,1207,2689
5976,20,1469,2,0,0,0,0,0,1471,1255,6,0,0,0,0,0,1261,2732
5976,21,1480,6,0,0,0,0,0,1486,1308,14,0,0,0,0,0,1322,2808
5976,22,1479,6,0,0,1,0,0,1486,1303,16,2,0,1,0,0,1322,2808
5976,23,1525,6,0,2,1,0,0,1534,1352,24,1,0,0,0,0,1377,2911
5976,24,1648,21,0,1,1,0,0,1671,1356,38,0,0,1,0,0,1395,3066
5976,25,1679,21,0,0,1,0,0,1701,1304,66,1,0,1,0,0,1372,3073
5976,26,1610,40,1,0,0,0,0,1651,1256,89,1,0,0,0,0,1346,2997
5976,27,1479,75,1,1,2,0,0,1558,1241,154,2,0,0,0,0,1397,2955
5976,28,1488,91,0,0,0,0,0,1579,1241,176,6,1,0,0,0,1424,3003
5976,29,1543,104,2,2,0,0,0,1651,1143,254,5,1,2,0,0,1405,3056
5976,30,1479,179,1,1,2,0,0,1662,1119,337,3,1,0,0,0,1460,3122
5976,31,1485,223,4,0,2,0,0,1714,1136,406,6,0,1,0,0,1549,3263
5976,32,1445,252,5,0,0,0,0,1702,984,446,11,1,0,0,0,1442,3144
5976,33,1342,339,3,0,0,0,0,1684,890,607,15,5,2,0,0,1519,3203
5976,34,1231,394,11,1,0,0,0,1637,869,607,17,1,0,0,0,1494,3131
5976,35,1194,508,9,1,0,0,0,1712,827,682,32,6,2,0,0,1549,3261
5976,36,1147,559,19,1,0,0,0,1726,687,762,33,6,1,0,0,1489,3215
5976,37,1063,604,14,2,0,0,0,1683,698,749,33,7,2,0,0,1489,3172
5976,38,966,705,28,1,2,0,0,1702,648,937,32,7,0,0,0,1624,3326
5976,39,948,746,32,1,1,0,0,1728,569,950,55,6,2,0,0,1582,3310
5976,40,885,821,32,2,0,0,0,1740,552,978,49,8,0,0,0,1587,3327
5976,41,887,844,35,0,3,0,0,1769,556,1066,71,12,0,1,0,1706,3475
5976,42,830,906,32,4,1,0,0,1773,517,1121,82,12,0,0,0,1732,3505
5976,43,792,942,39,1,1,0,0,1775,464,1174,80,12,0,0,0,1730,3505
5976,44,764,1061,52,5,1,0,0,1883,428,1280,90,26,0,0,0,1824,3707
5976,45,735,1109,64,3,1,0,0,1912,450,1345,75,25,0,0,0,1895,3807
5976,46,690,1176,81,6,0,0,0,1953,440,1365,86,31,1,0,0,1923,3876
5976,47,686,1327,88,7,0,0,1,2109,422,1348,103,36,0,0,0,1909,4018
5976,48,711,1401,88,10,2,0,0,2212,419,1524,137,33,0,0,0,2113,4325
5976,49,666,1508,78,2,5,0,0,2259,384,1646,132,43,0,0,0,2205,4464
5976,50,644,1369,91,15,0,0,0,2119,333,1666,138,52,0,0,0,2189,4308
5976,51,555,1515,91,11,1,0,0,2173,370,1699,107,41,0,0,0,2217,4390
5976,52,553,1481,117,20,2,0,0,2173,291,1726,135,55,0,0,0,2207,4380
5976,53,500,1569,104,12,0,0,0,2185,300,1712,139,80,2,0,0,2233,4418
5976,54,469,1641,124,20,1,0,0,2255,307,1819,149,91,0,0,0,2366,4621
5976,55,498,1651,112,25,0,0,0,2286,308,1825,138,105,0,0,0,2376,4662
5976,56,454,1697,125,24,0,0,0,2300,264,1917,158,110,1,0,0,2450,4750
5976,57,411,1814,111,21,0,0,0,2357,291,1912,134,139,1,0,0,2477,4834
5976,58,388,1847,138,26,1,0,0,2400,254,1852,130,170,0,0,0,2406,4806
5976,59,404,1931,110,29,1,0,0,2475,249,1930,133,197,1,0,0,2510,4985
5976,60,359,1781,123,41,1,0,0,2305,195,1809,110,170,0,0,0,2284,4589
5976,61,290,1739,118,41,2,0,0,2190,204,1780,107,214,0,0,0,2305,4495
5976,62,286,1796,96,52,1,0,0,2231,185,1705,101,230,0,0,0,2221,4452
5976,63,288,1810,87,40,1,0,0,2226,216,1729,105,275,1,0,0,2326,4552
5976,64,230,1713,86,51,0,0,0,2080,197,1701,91,273,0,0,0,2262,4342
5976,65,215,1558,84,59,1,0,0,1917,171,1627,81,291,0,0,0,2170,4087
5976,66,204,1653,78,57,0,0,0,1992,161,1501,74,342,0,0,0,2078,4070
5976,67,184,1694,64,68,0,0,0,2010,136,1489,66,349,0,0,0,2040,4050
5976,68,174,1609,60,76,1,0,1,1921,168,1463,71,351,0,0,0,2053,3974
5976,69,177,1571,70,84,0,0,0,1902,139,1461,74,409,1,0,0,2084,3986
5976,70,128,1481,62,83,0,0,0,1754,135,1298,46,392,0,0,0,1871,3625
5976,71,144,1532,45,69,0,0,0,1790,144,1344,46,428,0,0,0,1962,3752
5976,72,93,1427,46,90,0,0,0,1656,123,1161,46,448,0,0,0,1778,3434
5976,73,91,1487,47,101,0,0,0,1726,114,1179,32,567,0,0,1,1893,3619
5976,74,105,1517,51,119,0,0,0,1792,115,1180,37,644,0,0,0,1976,3768
5976,75,99,1442,35,124,0,0,0,1700,121,1097,36,627,0,0,0,1881,3581
5976,76,96,1311,38,119,0,0,0,1564,103,960,31,692,0,0,0,1786,3350
5976,77,94,1248,23,134,0,0,0,1499,98,863,28,619,0,0,0,1608,3107
5976,78,64,872,26,123,0,0,0,1085,68,624,12,577,0,0,0,1281,2366
5976,79,41,857,14,116,0,0,0,1028,61,581,19,582,0,0,0,1243,2271
5976,80,53,746,9,116,0,0,0,924,69,494,16,583,0,0,0,1162,2086
5976,81,47,712,13,119,0,0,0,891,59,436,21,580,0,0,0,1096,1987
5976,82,31,711,13,136,0,0,0,891,69,479,16,694,0,0,0,1258,2149
5976,83,49,770,9,155,0,0,0,983,85,440,17,823,0,0,0,1365,2348
5976,84,39,737,12,161,0,0,0,949,74,445,11,900,0,0,0,1430,2379
5976,85,29,606,5,158,0,0,0,798,49,293,5,742,0,0,0,1089,1887
5976,86,33,482,4,190,0,0,0,709,62,274,8,778,0,0,0,1122,1831
5976,87,24,435,3,168,0,0,0,630,57,231,9,789,0,0,0,1086,1716
5976,88,17,364,6,167,0,0,0,554,48,155,6,734,0,0,0,943,1497
5976,89,26,304,2,162,0,0,0,494,61,144,9,664,0,0,0,878,1372
5976,90,16,240,1,132,0,0,0,389,58,105,7,597,0,0,0,767,1156
5976,91,11,157,0,124,0,0,0,292,41,87,6,492,0,0,0,626,918
5976,92,6,127,0,105,0,0,0,238,35,66,5,435,0,0,0,541,779
5976,93,4,98,3,88,0,0,0,193,32,36,4,381,0,0,0,453,646
5976,94,2,66,0,79,0,0,0,147,22,22,1,304,0,0,0,349,496
5976,95,2,41,0,52,0,0,0,95,21,18,1,221,0,0,0,261,356
5976,96,4,25,0,36,0,0,0,65,10,13,0,197,0,0,0,220,285
5976,97,2,20,1,23,0,0,0,46,14,11,1,135,0,0,0,161,207
5976,98,0,10,0,16,0,0,0,26,4,2,1,88,0,0,0,95,121
5976,99,1,5,0,10,0,0,0,16,5,6,0,71,0,0,0,82,98
5976,100,1,11,1,24,0,0,0,37,11,5,2,126,0,0,0,144,181
5976,999,66701,69258,3178,4125,40,0,2,143304,53342,68539,3880,20134,23,1,1,145920,289224
