Età,Celibi,Coniugati,Divorziati,Vedovi,Uniti civilmente,Maschi già in unione civile (per scioglimento unione),Maschi già in unione civile (per decesso del partner),Totale maschi,Nubili,Coniugate,Divorziate,Vedove,Unite civilmente,Femmine già in unione civile (per scioglimento unione),Femmine già in unione civile (per decesso del partner),Totale femmine,Totale,Anno
0,221685,0,0,0,0,0,0,221685,209322,0,0,0,0,0,0,209322,431007,2019
1,234386,0,0,0,0,0,0,234386,221360,0,0,0,0,0,0,221360,455746,2019
2,241671,0,0,0,0,0,0,241671,229142,0,0,0,0,0,0,229142,470813,2019
3,248155,0,0,0,0,0,0,248155,234791,0,0,0,0,0,0,234791,482946,2019
4,256257,0,0,0,0,0,0,256257,241983,0,0,0,0,0,0,241983,498240,2019
5,260616,0,0,0,0,0,0,260616,246502,0,0,0,0,0,0,246502,507118,2019
6,272398,0,0,0,0,0,0,272398,257211,0,0,0,0,0,0,257211,529609,2019
7,276672,0,0,0,0,0,0,276672,261137,0,0,0,0,0,0,261137,537809,2019
8,285251,0,0,0,0,0,0,285251,268440,0,0,0,0,0,0,268440,553691,2019
9,289719,0,0,0,0,0,0,289719,273327,0,0,0,0,0,0,273327,563046,2019
10,292417,0,0,0,0,0,0,292417,276854,0,0,0,0,0,0,276854,569271,2019
11,292452,0,0,0,0,0,0,292452,275360,0,0,0,0,0,0,275360,567812,2019
12,293239,0,0,0,0,0,0,293239,275337,0,0,0,0,0,0,275337,568576,2019
13,291565,0,0,0,0,0,0,291565,273470,0,0,0,0,0,0,273470,565035,2019
14,293836,0,0,0,0,0,0,293836,277332,0,0,0,0,0,0,277332,571168,2019
15,292016,0,0,0,0,0,0,292016,274845,0,0,0,0,0,0,274845,566861,2019
16,290455,12,7,2,0,0,0,290476,273110,21,8,2,0,0,0,273141,563617,2019
17,295097,17,10,3,0,0,0,295127,275611,47,4,1,0,0,0,275663,570790,2019
18,306015,43,8,2,0,0,0,306068,280379,415,7,4,0,0,0,280805,586873,2019
19,307317,190,25,21,1,0,0,307554,276333,1626,10,5,7,0,0,277981,585535,2019
20,313057,469,14,12,5,2,0,313559,274819,3705,21,9,5,0,0,278559,592118,2019
21,309390,928,16,20,11,1,1,310367,273257,6454,37,6,6,0,0,279760,590127,2019
22,307996,1996,25,28,20,1,0,310066,271245,10193,60,12,19,0,0,281529,591595,2019
23,304434,3743,45,24,36,0,0,308282,266591,15466,120,19,26,0,0,282222,590504,2019
24,303847,6047,74,25,39,1,1,310034,265122,22566,181,33,25,2,0,287929,597963,2019
25,304249,10134,85,30,52,2,0,314552,263130,32228,364,46,44,1,0,295813,610365,2019
26,310791,16317,159,49,61,0,0,327377,262651,45721,510,67,62,1,1,309013,636390,2019
27,300291,24506,257,35,69,2,0,325160,248331,60208,770,82,47,1,0,309439,634599,2019
28,295804,35412,364,35,120,2,0,331737,236642,77982,1129,141,81,0,1,315976,647713,2019
29,279225,48606,564,68,114,2,1,328580,219584,96407,1663,189,106,3,0,317952,646532,2019
30,270451,64677,787,66,157,2,0,336140,204597,118408,2130,261,144,1,1,325542,661682,2019
31,247613,79604,1039,79,183,1,0,328519,183336,133748,2862,349,140,4,0,320439,648958,2019
32,231760,96152,1397,84,229,2,1,329625,168402,150110,3707,436,147,2,1,322805,652430,2019
33,223361,112954,1978,96,210,2,0,338601,160187,168284,4751,534,176,2,1,333935,672536,2019
34,210671,131222,2481,130,180,3,1,344688,150103,183464,5771,698,168,2,0,340206,684894,2019
35,200052,146974,3205,157,266,0,0,350654,141131,197366,6814,812,185,2,1,346311,696965,2019
36,192608,164801,3998,180,227,1,1,361816,135575,213955,8169,1099,200,7,0,359005,720821,2019
37,181684,176423,4759,227,257,2,1,363353,127974,223610,9454,1326,171,2,0,362537,725890,2019
38,175424,192259,5736,291,256,1,1,373968,121796,235513,10983,1561,164,3,1,370021,743989,2019
39,169914,206031,6938,383,294,4,1,383565,118800,249609,13048,1859,182,5,0,383503,767068,2019
40,171447,224022,8386,472,269,3,3,404602,118947,266768,15255,2353,162,3,1,403489,808091,2019
41,167591,238204,9700,535,339,4,0,416373,116727,280663,17258,2763,188,5,2,417606,833979,2019
42,165901,255874,11634,634,298,4,2,434347,115758,297310,19619,3355,191,5,0,436238,870585,2019
43,164921,274220,13520,841,367,1,1,453871,115043,315429,22545,3969,210,1,0,457197,911068,2019
44,162910,292552,15405,991,405,2,2,472267,113473,332498,25061,4801,203,2,3,476041,948308,2019
45,151835,297829,17106,1197,340,3,0,468310,107011,334744,26869,5390,201,0,1,474216,942526,2019
46,144629,308276,18616,1389,360,2,1,473273,101062,341757,29109,6259,184,0,0,478371,951644,2019
47,136587,316814,20515,1622,368,3,6,475915,96205,350290,30979,7298,181,3,2,484958,960873,2019
48,126114,321890,21726,1852,375,4,3,471964,89851,349650,32510,8253,161,3,0,480428,952392,2019
49,120659,336274,24146,2110,331,2,2,483524,87513,362624,34368,9661,149,5,1,494321,977845,2019
50,112390,339788,24522,2450,379,7,2,479538,82199,362454,35388,11214,151,4,4,491414,970952,2019
51,105133,345398,25932,2834,356,2,4,479659,78908,366705,36374,12611,161,4,4,494767,974426,2019
52,100285,353879,27454,3403,374,2,2,485399,75087,371139,36998,14248,128,1,2,497603,983002,2019
53,92283,358676,28309,3739,373,2,4,483386,71284,371494,37685,16248,129,2,3,496845,980231,2019
54,86754,367451,29554,4313,343,1,6,488422,68054,378425,38589,18736,129,4,4,503941,992363,2019
55,75078,347282,27708,4697,365,3,4,455137,60911,358297,36101,19794,121,1,2,475227,930364,2019
56,67414,338351,26885,5027,306,2,2,437987,56044,347370,34288,22318,103,2,0,460125,898112,2019
57,62423,333766,25792,5383,293,0,4,427661,52581,341174,33222,24590,101,1,4,451673,879334,2019
58,55922,326450,24475,5904,286,0,3,413040,48698,330018,31823,27006,91,1,2,437639,850679,2019
59,51643,320037,23655,6403,236,2,4,401980,45832,321358,29889,29781,84,1,3,426948,828928,2019
60,46734,306194,21508,6961,257,3,2,381659,41672,307312,27994,32069,68,2,4,409121,790780,2019
61,43649,304365,21217,7432,227,0,1,376891,39580,303054,26715,35271,63,2,1,404686,781577,2019
62,39832,300065,19550,8266,194,5,1,367913,36615,295704,25063,38830,65,0,2,396279,764192,2019
63,36887,294938,18264,8961,166,4,0,359220,34701,288849,23390,41661,51,3,6,388661,747881,2019
64,34174,290378,16990,9877,164,0,0,351583,32679,281972,22036,46305,44,3,2,383041,734624,2019
65,30916,278282,15334,10410,132,1,4,335079,29649,265467,20247,48205,38,0,2,363608,698687,2019
66,29034,272321,14349,11296,122,1,2,327125,28340,258981,18667,52297,45,0,4,358334,685459,2019
67,27316,270922,13387,12292,122,0,5,324044,26497,254329,17715,57801,40,1,3,356386,680430,2019
68,26655,279720,13126,13930,118,1,3,333553,26774,258512,17605,65334,39,1,3,368268,701821,2019
69,25144,280023,12325,15471,113,1,5,333082,25784,254295,16473,72648,24,1,5,369230,702312,2019
70,25233,288817,11526,17809,119,2,5,343511,26252,259228,16032,83042,21,0,4,384579,728090,2019
71,23172,279606,10932,18871,93,1,2,332677,24732,244542,15055,89614,19,1,3,373966,706643,2019
72,22044,274534,9957,20779,92,2,3,327411,23877,237105,14208,97824,15,0,2,373031,700442,2019
73,16208,207432,7202,17604,57,0,0,248503,18937,174391,10228,83369,10,0,1,286936,535439,2019
74,16451,208155,6753,19302,65,0,3,250729,19127,171718,9692,93520,18,0,2,294077,544806,2019
75,15789,203582,6060,20979,61,0,2,246473,19453,165796,9150,101692,8,0,0,296099,542572,2019
76,15646,195836,5631,22171,68,0,3,239355,19219,155719,8564,108633,12,2,1,292150,531505,2019
77,15285,189640,5176,23949,60,0,0,234110,19313,146792,7860,117674,11,0,3,291653,525763,2019
78,15912,200731,5009,28402,46,0,2,250102,20936,149188,7809,139590,9,0,2,317534,567636,2019
79,14612,189733,4271,29609,28,0,1,238254,20250,134974,6898,144937,8,0,1,307068,545322,2019
80,12897,173668,3835,30324,23,0,0,220747,19358,118500,6143,149675,4,1,1,293682,514429,2019
81,11271,150332,3040,29537,26,1,1,194208,17989,97272,5102,145588,3,0,1,265955,460163,2019
82,9689,129901,2390,28551,14,0,2,170547,16941,80009,4390,142821,1,1,3,244166,414713,2019
83,9155,122017,2197,29801,19,0,0,163189,16657,70070,3897,149857,2,1,1,240485,403674,2019
84,8176,105920,1740,29542,20,0,0,145398,15981,57351,3236,147762,3,0,5,224338,369736,2019
85,7087,91025,1414,28850,16,0,1,128393,15191,45765,2915,142915,1,0,3,206790,335183,2019
86,6088,76141,1104,27303,3,0,1,110640,14370,36388,2385,136439,2,0,5,189589,300229,2019
87,5194,65309,897,26370,15,0,3,97788,13591,28663,2105,131224,2,0,2,175587,273375,2019
88,4706,55366,755,25905,14,0,1,86747,13394,22919,1986,129190,1,0,0,167490,254237,2019
89,3575,41366,557,21701,2,0,1,67202,11414,15655,1449,109050,3,0,3,137574,204776,2019
90,2812,31511,417,19197,4,0,0,53941,10204,11253,1211,97259,5,0,2,119934,173875,2019
91,2177,23607,300,16717,3,0,1,42805,8822,7945,944,84754,0,0,0,102465,145270,2019
92,1681,16626,223,13802,2,0,0,32334,7404,5366,759,70616,0,0,2,84147,116481,2019
93,1261,11572,137,11089,0,0,0,24059,6203,3533,653,57871,2,0,2,68264,92323,2019
94,948,7658,100,9027,1,0,0,17734,5082,2355,481,45843,0,0,1,53762,71496,2019
95,661,5150,78,7120,0,0,0,13009,3843,1501,337,36193,0,0,0,41874,54883,2019
96,447,3176,41,5097,0,0,0,8761,2827,937,270,27040,0,0,1,31075,39836,2019
97,342,2013,38,3548,0,0,0,5941,2139,523,182,20057,0,0,0,22901,28842,2019
98,234,1172,22,2401,0,0,0,3829,1446,349,118,13908,0,0,0,15821,19650,2019
99,78,459,11,1068,0,0,0,1616,752,148,46,6422,0,0,1,7369,8985,2019
100,163,519,9,1484,0,0,0,2175,1376,241,96,10243,0,0,1,11957,14132,2019
0,212756,0,0,0,0,0,0,212756,202218,0,0,0,0,0,0,202218,414974,2020
1,224617,0,0,0,0,0,0,224617,212168,0,0,0,0,0,0,212168,436785,2020
2,235153,0,0,0,0,0,0,235153,222161,0,0,0,0,0,0,222161,457314,2020
3,242107,0,0,0,0,0,0,242107,229589,0,0,0,0,0,0,229589,471696,2020
4,248565,0,0,0,0,0,0,248565,235204,0,0,0,0,0,0,235204,483769,2020
5,256796,0,0,0,0,0,0,256796,242348,0,0,0,0,0,0,242348,499144,2020
6,260833,0,0,0,0,0,0,260833,246458,0,0,0,0,0,0,246458,507291,2020
7,272305,0,0,0,0,0,0,272305,257168,0,0,0,0,0,0,257168,529473,2020
8,276769,0,0,0,0,0,0,276769,261133,0,0,0,0,0,0,261133,537902,2020
9,285537,0,0,0,0,0,0,285537,268609,0,0,0,0,0,0,268609,554146,2020
10,289596,0,0,0,0,0,0,289596,273168,0,0,0,0,0,0,273168,562764,2020
11,292556,0,0,0,0,0,0,292556,276781,0,0,0,0,0,0,276781,569337,2020
12,292641,0,0,0,0,0,0,292641,275384,0,0,0,0,0,0,275384,568025,2020
13,293544,0,0,0,0,0,0,293544,275519,0,0,0,0,0,0,275519,569063,2020
14,292112,0,0,0,0,0,0,292112,273759,0,0,0,0,0,0,273759,565871,2020
15,294493,5,7,1,0,0,0,294506,277691,8,3,2,0,0,0,277704,572210,2020
16,292757,4,9,1,0,0,0,292771,275226,4,4,1,0,0,0,275235,568006,2020
17,291790,7,6,4,0,0,0,291807,273535,34,10,3,0,0,0,273582,565389,2020
18,297955,30,13,1,1,0,0,298000,276398,300,7,1,1,0,0,276707,574707,2020
19,308229,128,18,5,1,0,0,308381,280874,1480,6,2,1,0,0,282363,590744,2020
20,307735,407,26,17,4,0,0,308189,276062,3160,30,8,8,1,0,279269,587458,2020
21,312256,873,25,15,12,1,0,313182,273896,5882,41,8,7,1,0,279835,593017,2020
22,308226,1681,33,12,16,1,1,309970,271737,9200,68,5,16,3,0,281029,590999,2020
23,306402,3173,58,14,39,2,0,309688,269072,13872,103,19,26,2,0,283094,592782,2020
24,302233,5631,69,6,52,0,0,307991,263221,20163,199,22,31,5,0,283641,591632,2020
25,300405,8792,104,14,62,0,1,309378,260014,28832,307,48,39,2,0,289242,598620,2020
26,299398,14110,140,22,85,3,0,313758,255852,40010,562,69,73,2,0,296568,610326,2020
27,304378,21905,237,25,90,0,0,326635,253626,55573,725,98,78,6,1,310107,636742,2020
28,292275,31808,370,32,102,3,0,324590,237709,71458,1067,115,71,3,0,310423,635013,2020
29,285875,44462,549,28,162,6,1,331083,225149,89738,1539,175,105,3,1,316710,647793,2020
30,268207,58803,817,44,159,3,1,328034,207812,108344,2166,232,159,5,0,318718,646752,2020
31,258607,75540,1083,51,209,3,0,335493,193061,129747,2844,310,190,5,1,326158,661651,2020
32,236137,90125,1384,65,233,3,0,327947,173599,143417,3521,402,200,9,0,321148,649095,2020
33,220938,105925,1877,94,269,6,0,329109,160053,158023,4531,505,177,3,1,323293,652402,2020
34,213066,122259,2478,97,263,3,0,338166,152833,174966,5744,614,213,4,1,334375,672541,2020
35,201728,139303,3160,133,227,5,1,344557,143610,189052,6783,796,211,4,1,340457,685014,2020
36,191613,154381,3904,174,297,3,0,350372,135919,201469,8060,943,209,5,1,346606,696978,2020
37,185088,171021,4885,203,275,3,1,361476,131066,217247,9509,1228,245,5,0,359300,720776,2020
38,175455,181318,5646,274,302,4,1,363000,124174,225918,10916,1471,212,2,0,362693,725693,2020
39,170081,196155,6728,311,297,4,0,373576,118555,237146,12503,1743,202,4,1,370154,743730,2020
40,165211,209138,8049,417,346,7,2,383170,115885,250926,14577,2082,226,5,0,383701,766871,2020
41,167051,226343,9643,526,311,3,4,403881,116470,267264,17070,2595,203,8,1,403611,807492,2020
42,163358,240101,11095,596,371,4,1,415526,114423,280727,19235,3058,230,5,2,417680,833206,2020
43,162268,256836,13168,745,340,5,2,433364,113752,296768,21679,3667,228,6,0,436100,869464,2020
44,161778,274898,15184,963,425,7,2,453257,113141,314620,24866,4294,251,2,0,457174,910431,2020
45,160121,292398,17271,1107,453,4,4,471358,111809,331300,27218,5269,230,4,3,475833,947191,2020
46,149204,297265,19036,1321,416,5,0,467247,105474,333312,29235,5872,239,4,1,474137,941384,2020
47,142286,307674,20506,1561,411,6,1,472445,99755,339744,31425,6837,209,2,0,477972,950417,2020
48,134483,315812,22499,1768,417,4,7,474990,95181,348082,33339,7895,216,3,2,484718,959708,2020
49,124302,320277,23728,2023,421,4,5,470760,88869,347337,34990,8915,187,6,1,480305,951065,2020
50,118837,334535,26187,2339,396,3,2,482299,86539,360236,36617,10453,174,6,1,494026,976325,2020
51,110790,337661,26463,2699,429,7,2,478051,81423,359567,37668,12089,173,6,4,490930,968981,2020
52,103687,343117,27991,3080,405,2,7,478289,78196,363736,38566,13557,174,4,6,494239,972528,2020
53,98801,351478,29315,3711,427,3,1,483736,74399,368041,39195,15296,144,2,2,497079,980815,2020
54,91079,356009,30189,4061,424,2,5,481769,70630,368412,39686,17398,154,2,4,496286,978055,2020
55,85468,364826,31406,4685,390,1,7,486783,67599,375004,40538,20088,148,5,6,503388,990171,2020
56,73992,344700,29240,5072,402,4,5,453415,60470,354868,37733,21203,131,3,2,474410,927825,2020
57,66441,335489,28369,5469,342,2,4,436116,55599,344059,35665,23910,115,3,2,459353,895469,2020
58,61417,330956,27178,5778,335,0,4,425668,52187,337433,34617,26358,110,2,4,450711,876379,2020
59,55000,323684,25692,6338,307,0,5,411026,48280,326264,32991,28983,99,1,3,436621,847647,2020
60,50749,317265,24550,6933,264,3,8,399772,45460,317654,30782,31779,87,1,4,425767,825539,2020
61,45931,303271,22423,7480,273,3,4,379385,41428,303360,28880,34198,72,1,7,407946,787331,2020
62,42902,301276,21770,8074,248,1,1,374272,39250,298925,27363,37600,78,2,1,403219,777491,2020
63,39117,296816,20172,8874,212,4,2,365197,36379,291077,25660,41352,63,1,2,394534,759731,2020
64,36120,291635,18753,9590,194,4,0,356296,34395,284159,23871,44473,56,3,5,386962,743258,2020
65,33386,286780,17449,10578,184,0,1,348378,32308,277054,22522,49273,43,4,2,381206,729584,2020
66,30244,274653,15667,11171,137,1,5,331878,29346,260309,20540,51372,42,0,1,361610,693488,2020
67,28307,268201,14710,12039,144,1,2,323404,28078,253389,19111,55467,50,0,3,356098,679502,2020
68,26628,266666,13584,13029,142,0,8,320057,26132,248500,18008,61212,43,1,3,353899,673956,2020
69,25946,274932,13190,14817,132,2,4,329023,26432,252101,17799,69082,40,2,5,365461,694484,2020
70,24387,274828,12370,16341,124,2,6,328058,25418,247360,16549,76723,26,1,5,366082,694140,2020
71,24336,282833,11647,18811,124,2,5,337758,25835,251403,16151,87638,30,0,4,381061,718819,2020
72,22413,273185,10855,19960,98,1,4,326516,24383,236107,15080,94465,22,1,3,370061,696577,2020
73,21215,267243,9942,21906,100,2,3,320411,23436,228032,14260,102920,16,0,4,368668,689079,2020
74,15532,201279,7129,18562,61,0,0,242563,18629,166991,10209,87340,12,0,1,283182,525745,2020
75,15674,201550,6691,20289,70,0,3,244277,18728,163520,9671,97668,17,0,2,289606,533883,2020
76,15038,196333,5936,22006,62,0,3,239378,18981,157211,9074,105972,8,0,0,291246,530624,2020
77,14826,188173,5471,23208,69,0,3,231750,18696,146603,8503,112780,12,2,0,286596,518346,2020
78,14417,181309,5055,24960,67,0,0,225808,18793,137156,7747,121799,9,0,4,285508,511316,2020
79,14902,190835,4877,29362,42,0,2,240020,20245,138371,7655,143542,8,0,3,309824,549844,2020
80,13645,179206,4058,30577,30,0,1,227517,19551,123956,6681,148370,6,0,3,298567,526084,2020
81,12020,162959,3636,31080,25,0,0,209720,18628,107525,5957,152038,2,0,1,284151,493871,2020
82,10374,139685,2881,30141,21,1,1,183104,17230,87067,4907,146759,2,0,1,255966,439070,2020
83,8844,119351,2248,28921,13,0,3,159380,16042,70460,4182,142867,1,1,1,233554,392934,2020
84,8285,110879,2031,29853,18,0,0,151066,15784,60915,3699,148109,2,1,1,228511,379577,2020
85,7338,94710,1602,29274,20,0,1,132945,14941,49005,3060,144299,3,0,4,211312,344257,2020
86,6213,80353,1275,28109,16,0,1,115967,14073,38317,2713,137724,1,0,2,192830,308797,2020
87,5252,65931,971,26412,3,1,0,98570,13167,29723,2212,129728,1,0,5,174836,273406,2020
88,4464,55563,774,24934,13,0,3,85751,12229,23070,1932,122517,2,0,2,159752,245503,2020
89,3916,46062,651,23933,12,0,2,74576,11852,17891,1792,118550,0,0,0,150085,224661,2020
90,2905,33565,453,19615,1,0,1,56540,10005,11917,1267,98286,3,0,2,121480,178020,2020
91,2303,24755,345,16979,3,0,0,44385,8829,8414,1038,85561,5,0,1,103848,148233,2020
92,1732,18196,251,14422,2,0,0,34603,7476,5720,827,72747,0,0,0,86770,121373,2020
93,1281,12303,162,11646,1,0,0,25393,6087,3795,637,59369,0,0,2,69890,95283,2020
94,930,8275,112,8892,0,0,0,18209,4986,2483,523,47246,1,0,3,55242,73451,2020
95,704,5237,80,7148,2,0,0,13171,4000,1619,379,36480,0,0,0,42478,55649,2020
96,490,3354,59,5408,0,0,0,9311,2970,1001,246,27919,0,0,0,32136,41447,2020
97,323,2045,29,3726,0,0,0,6123,2091,618,207,20262,0,0,1,23179,29302,2020
98,230,1237,25,2515,0,0,0,4007,1584,374,125,14470,0,0,0,16553,20560,2020
99,155,723,17,1634,0,0,0,2529,1005,227,71,9589,0,0,0,10892,13421,2020
100,168,570,13,1581,0,0,0,2332,1388,266,92,10725,0,0,1,12472,14804,2020
0,208412,0,0,0,0,0,0,208412,196544,0,0,0,0,0,0,196544,404956,2021
1,216969,0,0,0,0,0,0,216969,206300,0,0,0,0,0,0,206300,423269,2021
2,228106,0,0,0,0,0,0,228106,215465,0,0,0,0,0,0,215465,443571,2021
3,238741,0,0,0,0,0,0,238741,225498,0,0,0,0,0,0,225498,464239,2021
4,246617,0,0,0,0,0,0,246617,233858,0,0,0,0,0,0,233858,480475,2021
5,253592,0,0,0,0,0,0,253592,239726,0,0,0,0,0,0,239726,493318,2021
6,257712,0,0,0,0,0,0,257712,243319,0,0,0,0,0,0,243319,501031,2021
7,262489,0,0,0,0,0,0,262489,247948,0,0,0,0,0,0,247948,510437,2021
8,273619,0,0,0,0,0,0,273619,258440,0,0,0,0,0,0,258440,532059,2021
9,278649,0,0,0,0,0,0,278649,262846,0,0,0,0,0,0,262846,541495,2021
10,287198,0,0,0,0,0,0,287198,269994,0,0,0,0,0,0,269994,557192,2021
11,291582,0,0,0,0,0,0,291582,274675,0,0,0,0,0,0,274675,566257,2021
12,294561,0,0,0,0,0,0,294561,278502,0,0,0,0,0,0,278502,573063,2021
13,294772,0,0,0,0,0,0,294772,277231,0,0,0,0,0,0,277231,572003,2021
14,295760,0,0,0,0,0,0,295760,277420,0,0,0,0,0,0,277420,573180,2021
15,294449,0,0,0,0,0,0,294449,275666,0,0,0,0,0,0,275666,570115,2021
16,296070,11,3,1,0,0,0,296085,278661,27,5,2,0,0,0,278695,574780,2021
17,294136,6,6,1,0,0,0,294149,275489,30,4,1,0,0,0,275524,569673,2021
18,292748,18,4,4,0,0,0,292774,273176,202,10,1,0,0,0,273389,566163,2021
19,299268,76,12,1,1,0,0,299358,276027,886,9,1,1,0,0,276924,576282,2021
20,309666,259,15,5,3,1,0,309949,280489,2451,17,2,0,1,0,282960,592909,2021
21,307660,763,24,18,6,0,0,308471,274498,4997,51,16,11,1,0,279574,588045,2021
22,311556,1443,31,9,13,0,0,313052,272381,8239,62,11,10,2,0,280705,593757,2021
23,306742,2536,28,15,19,1,1,309342,269356,12008,102,9,21,3,0,281499,590841,2021
24,304184,4372,64,14,50,2,0,308686,265632,17247,161,27,32,3,0,283102,591788,2021
25,298200,7875,89,7,62,0,1,306234,257522,25052,294,38,35,6,0,282947,589181,2021
26,294858,11642,140,14,72,3,0,306729,252702,34250,431,55,50,5,0,287493,594222,2021
27,292140,17652,198,27,107,5,0,310129,247303,45986,750,76,91,5,0,294211,604340,2021
28,296160,26420,305,22,116,2,0,323025,243734,62120,973,109,99,10,1,307046,630071,2021
29,282636,36822,521,34,132,3,0,320148,227910,78145,1319,147,87,9,0,307617,627765,2021
30,274725,51265,775,39,196,8,1,327009,214699,96540,1964,220,133,7,1,313564,640573,2021
31,257120,65430,1047,54,205,3,1,323860,197659,114858,2658,273,180,14,0,315642,639502,2021
32,248165,82078,1395,75,240,6,1,331960,183826,135618,3381,376,235,11,1,323448,655408,2021
33,226638,96251,1745,72,278,4,0,324988,165431,148343,4155,475,247,13,0,318664,643652,2021
34,211712,111603,2326,102,314,12,1,326070,152781,162113,5249,584,206,6,2,320941,647011,2021
35,203597,128166,3052,115,309,6,0,335245,145952,178557,6541,716,253,13,1,332033,667278,2021
36,193426,144693,3724,169,270,6,1,342289,137784,192246,7639,904,256,9,1,338839,681128,2021
37,184248,159264,4518,202,337,8,2,348579,130641,204076,8973,1081,249,6,1,345027,693606,2021
38,178524,175333,5483,236,316,8,1,359901,126510,219517,10489,1418,283,11,1,358229,718130,2021
39,169243,185253,6350,315,345,8,1,361515,120026,227711,11944,1670,238,6,0,361595,723110,2021
40,163996,200012,7504,363,330,8,2,372215,114782,238454,13761,1964,230,10,1,369202,741417,2021
41,159399,212364,8888,457,392,11,3,381514,112489,251940,15772,2363,252,8,0,382824,764338,2021
42,161620,229089,10576,613,356,6,5,402265,113207,267868,18431,2905,243,9,1,402664,804929,2021
43,158274,242397,12160,693,429,11,3,413967,111401,281378,20611,3425,262,9,2,417088,831055,2021
44,157398,258642,14256,843,393,6,3,431541,110765,297113,23087,4068,246,10,1,435290,866831,2021
45,156836,276950,16421,1087,475,8,2,451779,110243,314549,26409,4808,286,6,0,456301,908080,2021
46,155373,293662,18677,1249,500,10,6,469477,109002,330726,28810,5841,263,7,4,474653,944130,2021
47,144635,298285,20311,1469,467,7,2,465176,102877,332385,30785,6505,280,4,1,472837,938013,2021
48,138111,308233,21823,1733,451,7,3,470361,97314,338393,32925,7516,235,3,0,476386,946747,2021
49,130485,315732,23978,1978,475,9,7,472664,92766,346320,34867,8675,227,9,3,482867,955531,2021
50,120384,320081,24960,2260,473,6,7,468171,86591,345238,36296,9730,218,8,1,478082,946253,2021
51,114965,333917,27496,2592,452,4,3,479429,84112,357485,37906,11449,191,7,1,491151,970580,2021
52,107028,336515,27627,3001,476,10,2,474659,79252,356236,38762,13139,195,8,3,487595,962254,2021
53,100235,341742,29189,3380,459,3,7,475015,75944,360012,39607,14832,192,4,6,490597,965612,2021
54,95257,349501,30444,4081,478,5,1,479767,72357,363958,40148,16584,156,3,3,493209,972976,2021
55,87733,353531,31361,4479,480,2,6,477592,68684,364065,40499,18920,172,3,4,492347,969939,2021
56,82184,362391,32175,5101,440,2,7,482300,65542,370204,41268,21772,167,5,6,498964,981264,2021
57,71211,341887,30130,5506,434,7,8,449183,58565,350260,38231,23072,148,2,2,470280,919463,2021
58,63734,332577,28844,5908,380,4,5,431452,53913,339092,35880,25894,120,4,2,454905,886357,2021
59,58739,327576,27612,6265,383,0,6,420581,50636,332148,34882,28572,117,2,4,446361,866942,2021
60,52505,320241,25925,6922,334,1,6,405934,46731,320776,33121,31455,113,2,2,432200,838134,2021
61,48416,313385,24680,7515,288,3,9,394296,43972,311873,30739,34371,94,1,4,421054,815350,2021
62,43701,299271,22460,8081,302,4,5,373824,39889,297336,28723,36930,78,1,6,402963,776787,2021
63,40631,296858,21708,8625,266,2,1,368091,37883,292827,27177,40593,87,1,2,398570,766661,2021
64,37073,292182,20066,9511,223,4,5,359064,34992,285245,25371,44424,66,0,2,390100,749164,2021
65,34239,286892,18581,10269,214,3,2,350200,33050,278019,23589,48006,60,3,5,382732,732932,2021
66,31599,281842,17244,11292,198,0,3,342178,31043,270711,22248,52885,52,4,3,376946,719124,2021
67,28597,269286,15424,11945,152,1,6,325411,28180,253826,20194,54947,48,0,1,357196,682607,2021
68,27256,264271,14699,12972,158,1,4,319361,27337,247130,19054,59692,54,0,3,353270,672631,2021
69,25658,262416,13568,13994,153,0,9,315798,25525,241870,18023,65771,48,1,3,351241,667039,2021
70,24934,270033,13135,15885,138,3,6,324134,25796,244703,17734,74107,45,2,5,362392,686526,2021
71,23260,269332,12170,17532,133,2,7,322436,24727,239313,16389,82067,31,1,5,362533,684969,2021
72,23205,276335,11485,20093,131,2,4,331255,25139,241954,16017,93944,33,1,4,377092,708347,2021
73,21234,265865,10662,21389,110,1,4,319265,23727,226337,14885,100795,23,1,4,365772,685037,2021
74,20037,259106,9723,23443,105,2,4,312420,22806,217374,14097,109572,20,0,3,363872,676292,2021
75,14621,194398,6936,19625,68,0,0,235648,18041,158298,10001,92407,12,0,1,278760,514408,2021
76,14716,193807,6441,21413,70,0,3,236450,18110,153924,9463,103038,16,0,2,284553,521003,2021
77,14044,187716,5685,23107,61,0,2,230615,18347,146945,8852,111180,9,0,0,285333,515948,2021
78,13755,178804,5211,24369,73,0,3,222215,17980,135781,8284,117910,13,2,2,279972,502187,2021
79,13266,171515,4757,26104,62,0,2,215706,18001,125879,7521,126544,9,0,4,277958,493664,2021
80,13642,178843,4560,30412,44,0,2,227503,19298,125386,7330,148229,11,0,3,300257,527760,2021
81,12399,166935,3752,31441,30,0,3,214560,18545,111180,6386,151977,7,0,3,288098,502658,2021
82,10760,150142,3326,31728,25,0,1,195982,17629,94931,5661,154356,2,0,0,272579,468561,2021
83,9164,127026,2645,30462,22,1,1,169321,16115,75605,4618,147360,2,0,1,243701,413022,2021
84,7749,107018,2023,28945,14,0,3,145752,14879,60081,3878,141369,2,0,1,220210,365962,2021
85,7175,97748,1827,29548,14,0,3,136315,14514,50921,3385,144716,2,1,1,213540,349855,2021
86,6229,82229,1389,28489,19,0,1,118356,13550,40128,2817,138762,3,0,1,195261,313617,2021
87,5180,68523,1110,26828,15,0,1,101657,12614,30727,2429,129999,1,0,2,175772,277429,2021
88,4298,54809,830,24777,3,1,0,84718,11578,23279,1958,120449,0,0,3,157267,241985,2021
89,3539,45044,629,22941,11,0,3,72167,10637,17498,1664,111247,2,0,1,141049,213216,2021
90,3022,36504,540,21279,11,0,3,61359,10096,13268,1524,105245,0,0,0,130133,191492,2021
91,2215,25791,351,17103,1,0,1,45462,8307,8414,1073,85227,1,0,2,103024,148486,2021
92,1666,18372,265,14219,3,0,0,34525,7122,5911,851,71772,4,0,0,85660,120185,2021
93,1248,13045,180,11804,1,0,0,26278,5933,3793,679,59599,0,0,0,70004,96282,2021
94,873,8377,118,9202,0,0,0,18570,4687,2439,497,47019,0,0,1,54643,73213,2021
95,630,5482,73,6728,0,0,0,12913,3705,1602,385,36255,0,0,0,41947,54860,2021
96,465,3338,55,5206,2,0,0,9066,2884,1008,281,27054,0,0,0,31227,40293,2021
97,286,2059,34,3788,0,0,0,6167,2075,602,177,19995,0,0,0,22849,29016,2021
98,204,1225,20,2549,0,0,0,3998,1448,415,145,14107,0,0,0,16115,20113,2021
99,134,704,15,1673,0,0,0,2526,1079,229,91,9710,0,0,0,11109,13635,2021
100,185,762,21,1879,0,0,0,2847,1484,306,94,12446,0,0,0,14330,17177,2021
0,205371,0,0,0,0,0,0,205371,195255,0,0,0,0,0,0,195255,400626,2022
1,209824,0,0,0,0,0,0,209824,197810,0,0,0,0,0,0,197810,407634,2022
2,217987,0,0,0,0,0,0,217987,207196,0,0,0,0,0,0,207196,425183,2022
3,228694,0,0,0,0,0,0,228694,215944,0,0,0,0,0,0,215944,444638,2022
4,239183,0,0,0,0,0,0,239183,225570,0,0,0,0,0,0,225570,464753,2022
5,245640,0,0,0,0,0,0,245640,233044,0,0,0,0,0,0,233044,478684,2022
6,252296,0,0,0,0,0,0,252296,238523,0,0,0,0,0,0,238523,490819,2022
7,260055,0,0,0,0,0,0,260055,245536,0,0,0,0,0,0,245536,505591,2022
8,263845,0,0,0,0,0,0,263845,249119,0,0,0,0,0,0,249119,512964,2022
9,275299,0,0,0,0,0,0,275299,259960,0,0,0,0,0,0,259960,535259,2022
10,280091,0,0,0,0,0,0,280091,264218,0,0,0,0,0,0,264218,544309,2022
11,288645,0,0,0,0,0,0,288645,271368,0,0,0,0,0,0,271368,560013,2022
12,292919,0,0,0,0,0,0,292919,275957,0,0,0,0,0,0,275957,568876,2022
13,295957,0,0,0,0,0,0,295957,279801,0,0,0,0,0,0,279801,575758,2022
14,296180,0,0,0,0,0,0,296180,278508,0,0,0,0,0,0,278508,574688,2022
15,297220,0,0,0,0,0,0,297220,278674,0,0,0,0,0,0,278674,575894,2022
16,295953,4,3,3,0,0,0,295963,276827,13,4,1,0,0,0,276845,572808,2022
17,299464,10,4,0,0,0,0,299478,280915,19,5,0,0,0,0,280939,580417,2022
18,295135,13,8,1,1,0,0,295158,274391,155,4,0,0,0,0,274550,569708,2022
19,294146,64,5,2,1,0,0,294218,272368,693,10,0,1,0,0,273072,567290,2022
20,299273,199,9,1,1,0,0,299483,274204,1935,10,1,3,0,0,276153,575636,2022
21,307424,543,16,4,7,1,0,307995,276324,4142,30,2,9,1,0,280508,588503,2022
22,305282,1247,29,14,13,0,0,306585,270239,6583,72,13,14,2,0,276923,583508,2022
23,308492,2314,38,6,20,1,0,310871,267351,10421,103,14,13,2,0,277904,588775,2022
24,303471,3891,43,11,31,2,1,307450,263969,15306,146,9,37,2,0,279469,586919,2022
25,300427,6635,95,12,54,3,0,307226,259105,21872,265,31,42,7,0,281322,588548,2022
26,293971,10628,134,10,73,1,1,304818,250444,30672,408,39,59,7,0,281629,586447,2022
27,289845,15887,209,14,96,5,0,306056,244087,41887,616,70,74,10,0,286744,592800,2022
28,285712,23620,291,25,126,7,0,309781,237122,55620,941,87,131,8,0,293909,603690,2022
29,287845,34217,486,25,159,5,0,322737,232200,73337,1286,144,142,14,0,307123,629860,2022
30,272815,46730,697,39,176,5,0,320462,215651,90082,1730,171,161,10,0,307805,628267,2022
31,264754,61327,1011,42,235,15,1,327385,203222,107894,2421,249,203,13,1,314003,641388,2022
32,246961,75890,1336,57,247,9,1,324501,187092,125017,3219,336,231,21,0,315916,640417,2022
33,237931,93030,1802,88,292,10,1,333154,174531,144308,4093,461,303,13,0,323709,656863,2022
34,217131,106158,2217,80,322,15,0,325923,157697,155369,4829,555,323,18,0,318791,644714,2022
35,203123,120799,2784,132,360,14,2,327214,146134,167891,6102,685,266,16,2,321096,648310,2022
36,196261,136091,3666,128,372,8,0,336526,140652,182927,7435,849,327,15,1,332206,668732,2022
37,186911,151339,4410,205,310,7,1,343183,133526,195409,8728,1002,307,19,1,338992,682175,2022
38,178762,164875,5257,240,399,13,2,349548,127056,206481,10056,1206,296,10,0,345105,694653,2022
39,173773,180280,6314,262,372,16,1,361018,123469,220884,11660,1623,329,18,1,357984,719002,2022
40,164860,189297,7331,353,381,16,3,362241,117541,228230,13268,1865,292,11,0,361207,723448,2022
41,160609,203081,8437,413,373,13,2,372928,112709,238639,15153,2225,274,15,1,369016,741944,2022
42,156773,214669,9994,542,446,15,2,382441,110663,251838,17177,2663,290,13,0,382644,765085,2022
43,159084,231038,11817,691,401,9,5,403045,111746,267270,19967,3249,275,13,0,402520,805565,2022
44,156311,243747,13520,771,488,15,3,414855,110088,280649,22331,3796,312,10,1,417187,832042,2022
45,155741,259813,15749,943,445,10,5,432706,109532,295995,24870,4549,268,14,1,435229,867935,2022
46,155541,277360,18096,1242,548,8,5,452800,109168,313230,28325,5300,317,7,0,456347,909147,2022
47,154180,294015,20357,1425,574,11,5,470567,107940,329109,30840,6431,307,10,4,474641,945208,2022
48,143787,298394,22096,1635,511,9,3,466435,102125,330689,32791,7154,307,9,0,473075,939510,2022
49,137360,307640,23867,1965,511,9,3,471355,96538,336705,34954,8250,263,5,0,476715,948070,2022
50,129464,315618,25802,2207,536,12,7,473646,91997,344380,36983,9551,248,10,2,483171,956817,2022
51,119867,319546,26811,2530,530,7,9,469300,85924,343127,38345,10759,243,8,1,478407,947707,2022
52,114549,333083,29489,2891,517,6,5,480540,83560,355219,40007,12545,217,5,0,491553,972093,2022
53,106752,335624,29524,3323,539,10,3,475775,78708,354058,40575,14386,214,10,1,487952,963727,2022
54,100139,340441,31149,3752,505,5,9,476000,75482,357585,41455,16152,211,4,4,490893,966893,2022
55,95093,348712,32196,4523,540,4,1,481069,71921,361649,41901,18156,176,4,1,493808,974877,2022
56,87493,352554,33152,4922,533,5,3,478662,68346,361510,42093,20629,183,4,3,492768,971430,2022
57,82065,361286,33792,5672,477,2,6,483300,65124,367357,42871,23795,170,4,4,499325,982625,2022
58,70857,340817,31615,6035,470,6,9,449809,58099,347340,39518,25052,163,2,2,470176,919985,2022
59,63362,331427,30134,6445,422,5,6,431801,53395,335786,36991,28114,125,3,3,454417,886218,2022
60,58253,326403,28645,6887,408,1,8,420605,49966,328665,35731,30957,126,2,3,445450,866055,2022
61,52214,318780,26935,7532,357,3,6,405827,46070,316724,33826,34083,120,3,2,430828,836655,2022
62,47997,311838,25455,8235,319,3,8,393855,43203,307458,31422,37128,100,2,2,419315,813170,2022
63,43304,297575,23171,8767,318,4,5,373144,39171,292552,29201,39854,88,1,6,400873,774017,2022
64,40188,294835,22322,9458,278,2,3,367086,37159,287739,27603,43694,104,1,1,396301,763387,2022
65,36574,289926,20539,10386,237,2,10,357674,34290,279558,25724,47857,72,0,2,387503,745177,2022
66,33742,284200,18999,11133,222,6,3,348305,32338,271962,23955,51639,61,2,3,379960,728265,2022
67,31051,278626,17622,12277,199,1,4,339780,30198,263823,22544,56727,55,4,3,373354,713134,2022
68,28198,266114,15845,12975,169,0,6,323307,27849,247068,20572,59036,44,0,1,354570,677877,2022
69,26376,259009,14691,13889,175,2,4,314146,26546,239483,19075,63682,53,1,3,348843,662989,2022
70,24785,256584,13456,15009,155,1,9,309999,24777,233845,17945,69892,48,1,3,346511,656510,2022
71,23948,263533,13020,17048,146,3,6,317704,24995,235776,17644,78863,46,1,3,357328,675032,2022
72,22319,262177,12054,18717,138,1,10,315416,23992,229549,16278,87292,29,0,0,357140,672556,2022
73,22197,268236,11356,21381,139,0,4,323313,24341,231244,15904,99576,37,1,1,371104,694417,2022
74,20281,257272,10445,22730,119,2,4,310853,22995,215240,14725,106566,23,0,2,359551,670404,2022
75,19070,249673,9481,24952,110,1,4,303291,21997,205661,13885,115381,23,0,1,356948,660239,2022
76,13825,186252,6724,20739,76,0,0,227616,17412,148813,9840,96814,15,0,0,272894,500510,2022
77,13859,185095,6238,22504,67,0,4,227767,17447,143722,9251,107618,16,0,2,278056,505823,2022
78,13145,178224,5439,24149,66,1,1,221025,17600,136209,8664,115592,10,0,0,278075,499100,2022
79,12793,168688,5036,25399,74,0,4,211994,17191,124625,8062,121958,14,0,1,271851,483845,2022
80,12318,161027,4496,27016,64,0,2,204923,17182,114552,7286,130059,8,0,3,269090,474013,2022
81,12554,166639,4325,31431,41,0,4,214994,18266,112729,7108,151276,10,1,1,289391,504385,2022
82,11285,154053,3560,32230,31,0,4,201163,17501,98720,6097,153940,8,0,2,276268,477431,2022
83,9758,137101,3090,32200,24,0,1,182174,16508,83057,5385,154594,2,0,0,259546,441720,2022
84,8265,114710,2421,30716,22,1,1,156136,14988,64938,4339,145970,3,0,0,230238,386374,2022
85,6862,95023,1841,28891,15,0,0,132632,13657,50804,3641,137969,3,0,0,206074,338706,2022
86,6293,85406,1623,29045,14,0,2,122383,13240,42210,3132,139276,0,1,1,197860,320243,2022
87,5389,70419,1248,27577,19,0,1,104653,12266,32338,2583,131553,3,0,0,178743,283396,2022
88,4377,57538,956,25291,13,0,0,88175,11236,24303,2191,120929,0,0,1,158660,246835,2022
89,3532,45092,711,22802,4,1,0,72142,10115,17893,1759,110162,0,0,1,139930,212072,2022
90,2856,36249,508,20740,7,0,1,60361,9222,13174,1447,99541,2,0,0,123386,183747,2022
91,2419,28380,436,18778,8,0,3,50024,8579,9643,1294,91957,0,0,0,111473,161497,2022
92,1700,19441,274,14682,1,0,0,36098,6872,5984,922,72773,1,0,0,86552,122650,2022
93,1270,13450,204,11801,2,0,0,26727,5766,4100,695,59649,3,0,0,70213,96940,2022
94,915,9204,139,9464,1,0,0,19723,4690,2588,536,47968,0,0,0,55782,75505,2022
95,623,5673,87,7090,0,0,0,13473,3605,1597,399,36981,0,0,0,42582,56055,2022
96,423,3527,59,5074,0,0,0,9083,2786,1026,287,27620,0,0,0,31719,40802,2022
97,314,2071,39,3770,1,0,1,6196,2118,667,214,19976,0,0,0,22975,29171,2022
98,209,1311,24,2573,0,0,0,4117,1491,466,127,14327,0,0,0,16411,20528,2022
99,136,734,12,1689,0,0,0,2571,1006,275,98,9792,0,0,0,11171,13742,2022
100,232,847,21,2187,0,0,0,3287,1674,396,130,14227,0,0,0,16427,19714,2022
0,203086,0,0,0,0,0,0,203086,190834,0,0,0,0,0,0,190834,393920,2023
1,207218,0,0,0,0,0,0,207218,197034,0,0,0,0,0,0,197034,404252,2023
2,211696,0,0,0,0,0,0,211696,199551,0,0,0,0,0,0,199551,411247,2023
3,219719,0,0,0,0,0,0,219719,208732,0,0,0,0,0,0,208732,428451,2023
4,230081,0,0,0,0,0,0,230081,217293,0,0,0,0,0,0,217293,447374,2023
5,240388,0,0,0,0,0,0,240388,226752,0,0,0,0,0,0,226752,467140,2023
6,247005,0,0,0,0,0,0,247005,234312,0,0,0,0,0,0,234312,481317,2023
7,253577,0,0,0,0,0,0,253577,239574,0,0,0,0,0,0,239574,493151,2023
8,261164,0,0,0,0,0,0,261164,246566,0,0,0,0,0,0,246566,507730,2023
9,264925,0,0,0,0,0,0,264925,250184,0,0,0,0,0,0,250184,515109,2023
10,276385,0,0,0,0,0,0,276385,260983,0,0,0,0,0,0,260983,537368,2023
11,281120,0,0,0,0,0,0,281120,265099,0,0,0,0,0,0,265099,546219,2023
12,289714,0,0,0,0,0,0,289714,272242,0,0,0,0,0,0,272242,561956,2023
13,294025,0,0,0,0,0,0,294025,276869,0,0,0,0,0,0,276869,570894,2023
14,297185,0,0,0,0,0,0,297185,280786,0,0,0,0,0,0,280786,577971,2023
15,297394,0,0,0,0,0,0,297394,279486,0,0,0,0,0,0,279486,576880,2023
16,298832,9,3,1,0,0,0,298845,279533,11,3,0,0,0,0,279547,578392,2023
17,298631,5,2,3,0,0,0,298641,277682,15,4,0,0,0,0,277701,576342,2023
18,304160,26,6,1,0,0,0,304193,281986,156,4,0,0,0,0,282146,586339,2023
19,299975,65,8,3,1,0,0,300052,276343,750,7,0,3,0,0,277103,577155,2023
20,297897,208,4,3,4,0,0,298116,273927,1714,17,5,3,0,0,275666,573782,2023
21,302367,525,103,2,7,0,0,303004,275161,3575,97,2,9,0,0,278844,581848,2023
22,310607,1096,123,4,16,1,0,311847,277197,6508,143,3,22,1,0,283874,595721,2023
23,308009,2200,171,7,25,0,0,310412,270360,9771,219,18,27,4,0,280399,590811,2023
24,310542,3860,252,4,44,2,0,314704,266450,14717,250,18,41,2,0,281478,596182,2023
25,304378,6325,232,11,57,4,1,311008,261370,21195,295,14,60,6,0,282940,593948,2023
26,300477,10049,293,9,79,4,0,310911,255049,29169,480,47,90,11,0,284846,595757,2023
27,292600,15605,315,12,124,3,1,308660,244588,39840,696,50,118,10,0,285302,593962,2023
28,287079,22257,447,19,154,7,0,309963,236142,53184,979,96,141,13,0,290555,600518,2023
29,280825,32099,595,28,190,9,0,313746,227947,68088,1364,103,224,13,0,297739,611485,2023
30,280726,44982,816,31,221,11,1,326788,221822,87123,1831,175,228,19,1,311199,637987,2023
31,264514,58240,1070,180,275,7,1,324287,205183,103356,2483,331,279,13,1,311646,635933,2023
32,255869,73389,1478,178,331,22,1,331268,193411,120164,3346,421,311,23,2,317678,648946,2023
33,238026,87488,1859,222,363,13,2,327973,178935,135498,4217,491,345,28,0,319514,647487,2023
34,229036,104348,2454,244,427,16,3,336528,167988,152907,5236,672,414,23,2,327242,663770,2023
35,209452,116062,2929,229,439,21,1,329133,152412,162412,6127,755,436,25,0,322167,651300,2023
36,196369,128845,3819,307,466,25,4,329835,141463,173157,8156,1212,393,18,2,324401,654236,2023
37,190454,143003,4733,284,465,18,3,338960,136844,187041,9599,1412,413,26,1,335336,674296,2023
38,181878,157313,5451,374,399,14,2,345431,130770,198272,10928,1542,395,25,1,341933,687364,2023
39,174536,169611,6489,396,489,19,2,351542,125164,208329,12258,1772,386,16,0,347925,699467,2023
40,169821,184486,7557,427,483,23,1,362798,122019,222019,13988,2222,397,22,1,360668,723466,2023
41,161521,191818,8951,961,481,20,3,363755,115969,228596,15791,2977,377,21,1,363732,727487,2023
42,158064,204594,10140,1045,462,18,3,374326,111568,238249,17806,3357,339,21,2,371342,745668,2023
43,154406,215486,11767,1159,557,21,3,383399,109951,250881,19900,3903,347,22,0,385004,768403,2023
44,157195,231331,13563,1274,487,13,6,403869,111236,265662,22983,4439,335,16,0,404671,808540,2023
45,154821,243293,15420,1321,565,22,3,415445,109760,278615,25374,5032,379,10,1,419171,834616,2023
46,154349,258907,17824,1526,541,12,5,433164,108865,293775,27865,6227,324,15,1,437072,870236,2023
47,154345,275921,20295,1803,646,9,7,453026,108628,310380,31567,7075,371,11,1,458033,911059,2023
48,153217,291974,22682,1987,676,15,7,470558,107531,326133,34045,8226,367,16,4,476322,946880,2023
49,143250,295886,24533,2171,601,12,5,466458,102078,327430,35894,8960,353,13,0,474728,941186,2023
50,136482,305391,26071,2542,595,16,6,471103,96454,333389,37911,10063,305,7,3,478132,949235,2023
51,129289,312628,28023,2655,621,13,8,473237,91731,340698,39599,12125,302,14,2,484471,957708,2023
52,119954,316155,28900,2926,617,9,10,468571,85886,338929,41103,13416,277,9,1,479621,948192,2023
53,114890,329441,31485,3362,601,10,5,479794,83675,350873,42617,15234,247,7,1,492654,972448,2023
54,107228,331700,31488,3836,632,17,7,474908,78750,349675,43037,17255,243,11,3,488974,963882,2023
55,100303,336731,32912,4274,591,9,12,474832,75552,353186,43748,19103,250,6,4,491849,966681,2023
56,94874,344823,34108,5265,629,10,7,479716,71700,357371,43664,21473,198,6,1,494413,974129,2023
57,87485,348479,34913,5582,617,5,8,477089,68183,356803,43859,24060,207,7,5,493124,970213,2023
58,81883,357278,35418,6428,550,6,10,481573,65048,362696,44365,27429,197,7,6,499748,981321,2023
59,70782,336934,32757,6765,530,8,11,447787,58137,342500,40892,28758,178,3,2,470470,918257,2023
60,63161,327618,31313,7171,480,6,9,429758,53541,330700,38137,32058,148,3,4,454591,884349,2023
61,57803,322367,29484,8147,465,3,10,418279,49503,323317,36384,35978,149,2,4,445337,863616,2023
62,51988,314754,27601,8762,401,4,13,403523,45669,311039,34351,39375,143,4,3,430584,834107,2023
63,47603,307693,26065,9435,372,4,10,391182,42755,301549,31885,42288,115,2,3,418597,809779,2023
64,42905,293321,23602,9983,357,6,6,370180,38889,286351,29647,45260,104,2,6,400259,770439,2023
65,39736,290597,22604,10672,314,4,4,363931,36879,281261,27875,49317,112,1,1,395446,759377,2023
66,35723,285428,20817,12019,268,2,12,354269,33605,272641,25933,53988,76,0,5,386248,740517,2023
67,32917,279512,19203,12770,249,6,5,344662,31696,264257,24117,58108,70,2,2,378252,722914,2023
68,30270,273719,17713,14001,222,3,6,335934,29559,256399,22698,62904,61,4,3,371628,707562,2023
69,27428,260854,15866,14612,187,0,8,318955,27233,239064,20537,65302,50,0,1,352187,671142,2023
70,25535,253374,14598,15472,202,3,4,309188,25888,231297,19032,70042,60,1,3,346323,655511,2023
71,23907,250482,13426,16604,177,2,9,304607,24150,225159,17843,76152,52,1,4,343361,647968,2023
72,23068,256548,12919,18730,157,3,9,311434,24324,226286,17511,85589,49,1,4,353764,665198,2023
73,21489,254668,11915,20460,142,2,15,308691,23324,219342,16156,94289,32,0,0,353143,661834,2023
74,21232,259895,11179,23142,145,1,6,315600,23699,220010,15721,106599,38,1,1,366069,681669,2023
75,19321,248371,10229,24424,123,2,6,302476,22271,203676,14473,113575,26,0,2,354023,656499,2023
76,18180,239987,9250,26614,120,1,5,294157,21294,193271,13637,122483,25,0,1,350711,644868,2023
77,13040,177869,6478,22096,76,0,3,219562,16798,138763,9638,102108,16,0,1,267324,486886,2023
78,13022,175979,6043,23854,68,0,6,218972,16746,133232,8991,112665,18,1,2,271655,490627,2023
79,12314,168515,5158,25409,68,2,2,211468,16889,124893,8408,120389,7,1,0,270587,482055,2023
80,11918,158333,4812,26608,79,0,4,201754,16411,112916,7803,126453,13,0,1,263597,465351,2023
81,11362,150018,4244,28201,65,1,1,193892,16384,102897,6988,133597,8,0,3,259877,453769,2023
82,11494,153616,4047,32550,41,0,4,201752,17331,99897,6741,153850,11,1,1,277832,479584,2023
83,10210,140957,3295,32880,33,0,4,187379,16446,86019,5833,155292,7,0,2,263599,450978,2023
84,8716,123769,2852,32540,27,0,2,167906,15420,71280,5059,153876,1,0,0,245636,413542,2023
85,7347,102122,2203,30661,23,0,1,142357,13893,54479,4053,143523,3,0,0,215951,358308,2023
86,5968,83018,1646,28471,15,0,0,119118,12507,41502,3374,133515,2,0,0,190900,310018,2023
87,5417,73081,1412,28189,15,0,1,108115,11965,33785,2877,132323,0,1,1,180952,289067,2023
88,4596,59152,1092,26130,19,0,0,90989,10922,25118,2315,122487,2,0,0,160844,251833,2023
89,3577,46996,800,23447,10,0,1,74831,9793,18379,1926,110320,1,0,0,140419,215250,2023
90,2871,35706,562,20613,4,0,0,59756,8679,13314,1508,98272,0,0,0,121773,181529,2023
91,2267,27878,401,18301,7,0,1,48855,7786,9418,1234,86479,1,0,1,104919,153774,2023
92,1878,21052,344,16050,6,0,2,39332,7041,6739,1075,77977,0,0,0,92832,132164,2023
93,1278,13849,208,12129,0,0,0,27464,5560,4041,733,59922,1,0,0,70257,97721,2023
94,924,9186,157,9305,2,0,0,19574,4504,2678,543,47293,1,0,1,55020,74594,2023
95,641,6013,92,7205,1,0,0,13952,3476,1661,416,36946,1,0,0,42500,56452,2023
96,428,3484,50,5218,0,0,0,9180,2629,990,283,27550,0,0,0,31452,40632,2023
97,282,2055,36,3506,0,0,0,5879,2015,615,211,19700,0,0,0,22541,28420,2023
98,196,1205,29,2569,1,0,0,4000,1478,399,141,13818,0,0,0,15836,19836,2023
99,140,737,16,1635,0,0,0,2528,998,283,85,9509,0,0,0,10875,13403,2023
100,266,906,24,2258,0,0,0,3454,1675,466,145,14705,0,0,0,16991,20445,2023
0,195688,0,0,0,0,0,0,195688,184942,0,0,0,0,0,0,184942,380630,2024
1,204738,0,0,0,0,0,0,204738,192455,0,0,0,0,0,0,192455,397193,2024
2,208930,0,0,0,0,0,0,208930,198642,0,0,0,0,0,0,198642,407572,2024
3,213459,0,0,0,0,0,0,213459,201122,0,0,0,0,0,0,201122,414581,2024
4,221288,0,0,0,0,0,0,221288,210212,0,0,0,0,0,0,210212,431500,2024
5,231752,0,0,0,0,0,0,231752,218688,0,0,0,0,0,0,218688,450440,2024
6,241613,0,0,0,0,0,0,241613,227751,0,0,0,0,0,0,227751,469364,2024
7,248294,0,0,0,0,0,0,248294,235369,0,0,0,0,0,0,235369,483663,2024
8,255000,0,0,0,0,0,0,255000,240818,0,0,0,0,0,0,240818,495818,2024
9,262545,0,0,0,0,0,0,262545,247842,0,0,0,0,0,0,247842,510387,2024
10,266331,0,0,0,0,0,0,266331,251495,0,0,0,0,0,0,251495,517826,2024
11,277888,0,0,0,0,0,0,277888,262271,0,0,0,0,0,0,262271,540159,2024
12,282542,0,0,0,0,0,0,282542,266330,0,0,0,0,0,0,266330,548872,2024
13,291214,0,0,0,0,0,0,291214,273403,0,0,0,0,0,0,273403,564617,2024
14,295569,0,0,0,0,0,0,295569,278076,0,0,0,0,0,0,278076,573645,2024
15,298883,0,0,0,0,0,0,298883,282062,0,0,0,0,0,0,282062,580945,2024
16,299683,10,6,1,0,0,0,299700,280530,7,3,0,0,0,0,280540,580240,2024
17,302283,8,5,1,0,0,0,302297,280717,10,2,0,0,0,0,280729,583026,2024
18,304307,19,4,3,0,0,0,304333,278962,160,4,0,1,0,0,279127,583460,2024
19,309859,96,6,1,1,0,0,309963,282932,686,4,1,4,0,0,283627,593590,2024
20,304769,210,10,4,2,1,0,304996,277223,1748,11,2,7,0,0,278991,583987,2024
21,302149,506,7,2,8,1,0,302673,274416,3170,24,5,11,0,0,277626,580299,2024
22,305348,1100,107,3,16,0,0,306574,274473,5737,116,3,18,1,0,280348,586922,2024
23,313742,2024,125,9,25,0,0,315925,276259,9276,201,6,34,2,0,285778,601703,2024
24,310667,3730,190,9,40,0,0,314636,268972,13495,261,26,54,4,0,282812,597448,2024
25,312354,6320,269,7,62,1,0,319013,263717,19625,328,24,74,3,0,283771,602784,2024
26,304909,9613,262,15,79,2,1,314881,256832,27621,422,21,94,12,0,285002,599883,2024
27,299970,14491,366,14,107,7,0,314955,248909,37388,656,62,138,13,0,287166,602121,2024
28,290025,21885,422,13,180,8,1,312534,236720,49832,905,64,175,17,0,287713,600247,2024
29,283043,30229,554,27,203,14,1,314071,227042,64395,1308,117,225,18,0,293105,607176,2024
30,275075,41648,790,30,248,16,0,317807,217857,80156,1757,132,300,26,0,300228,618035,2024
31,273375,56056,1048,43,288,13,1,330824,210805,100170,2287,216,324,27,1,313830,644654,2024
32,256206,69694,1387,175,361,12,0,327835,195160,115035,3076,371,371,24,1,314038,641873,2024
33,247580,85087,1872,179,398,31,1,335148,184344,130856,4078,475,423,27,2,320205,655353,2024
34,230205,98491,2291,221,446,19,2,331675,171265,144440,5018,547,447,30,0,321747,653422,2024
35,221339,115045,3052,255,530,26,3,340250,161067,161063,6139,761,528,34,3,329595,669845,2024
36,202670,125183,3567,247,526,24,2,332219,146883,169056,7191,854,541,33,1,324559,656778,2024
37,190390,137026,4531,323,544,33,6,332853,136855,178699,9230,1313,478,27,2,326604,659457,2024
38,185013,150332,5534,316,546,26,3,341770,133081,191605,10795,1541,506,38,2,337568,679338,2024
39,176944,163633,6368,399,498,15,2,347859,127407,201903,12302,1695,478,38,1,343824,691683,2024
40,169768,175358,7474,437,558,25,3,353623,121957,211642,13720,1956,478,19,1,349773,703396,2024
41,165850,189155,8680,467,562,30,2,364746,119265,224620,15556,2406,463,25,1,362336,727082,2024
42,158118,195637,10168,983,553,28,6,365493,113726,230358,17523,3175,440,28,4,365254,730747,2024
43,154819,207948,11376,1063,539,30,3,375778,109579,239636,19655,3582,399,27,2,372880,748658,2024
44,151447,218084,13145,1216,660,21,5,384578,108020,251822,21923,4187,410,30,0,386392,770970,2024
45,154286,233801,15037,1359,586,19,6,405094,109457,266405,25073,4769,394,23,1,406122,811216,2024
46,152171,245161,17032,1413,634,23,5,416439,108047,278787,27588,5421,418,23,1,420285,836724,2024
47,151864,259971,19657,1615,595,18,7,433727,107455,293596,30288,6634,353,24,1,438351,872078,2024
48,151934,276730,22189,1936,728,14,7,453538,107283,309755,34081,7566,411,20,1,459117,912655,2024
49,150853,292502,24732,2105,756,16,10,470974,106073,325351,36517,8829,402,21,4,477197,948171,2024
50,140822,296045,26698,2344,695,15,7,466626,100548,326418,38480,9642,400,18,2,475508,942134,2024
51,134441,305039,28178,2721,710,20,7,471116,95201,332104,40399,10830,343,15,4,478896,950012,2024
52,127323,311949,30215,2885,687,18,11,473088,90547,339235,42024,12921,346,16,1,485090,958178,2024
53,118185,315050,31062,3225,682,12,14,468230,84830,336946,43420,14325,318,13,2,479854,948084,2024
54,113193,328142,33534,3629,670,12,7,479187,82627,348794,44880,16347,273,10,1,492932,972119,2024
55,105516,330191,33493,4160,699,19,9,474087,77820,347396,45076,18464,261,13,4,489034,963121,2024
56,98681,334954,34898,4684,643,9,14,473883,74590,350637,45718,20439,278,10,4,491676,965559,2024
57,93382,342892,35994,5667,694,11,9,478649,70923,354660,45472,23006,206,9,2,494278,972927,2024
58,86045,346317,36667,6068,655,7,11,475770,67285,353806,45597,25788,235,6,5,492722,968492,2024
59,80379,354828,36951,6963,611,5,14,479751,64135,359598,45806,29369,214,9,7,499138,978889,2024
60,69324,334588,34033,7311,579,13,13,445861,57296,339414,42005,30743,196,3,5,469662,915523,2024
61,61879,325164,32349,7788,534,6,10,427730,52721,327150,39214,34294,164,5,5,453553,881283,2024
62,56708,319798,30354,8687,499,4,11,416061,48845,319624,37255,38235,162,3,4,444128,860189,2024
63,50819,312066,28444,9384,447,4,16,401180,45035,306997,35107,41831,160,4,2,429136,830316,2024
64,46394,304715,26704,10146,394,3,14,388370,42066,297327,32521,45023,125,1,2,417065,805435,2024
65,41805,290160,24127,10687,378,5,10,367172,38302,281704,30115,48177,108,2,5,398413,765585,2024
66,38820,287120,22972,11436,325,6,6,360685,36250,276029,28350,52574,119,1,4,393327,754012,2024
67,34833,281768,21198,12693,289,3,15,350799,32963,266802,26441,57419,80,0,6,383711,734510,2024
68,31985,275599,19396,13519,260,4,7,340770,31129,258426,24444,61674,72,2,2,375749,716519,2024
69,29579,269432,17953,14817,234,4,6,332025,29297,250299,23047,66712,60,3,2,369420,701445,2024
70,26555,256195,15910,15447,201,1,9,314318,26747,232845,20659,68987,52,0,2,349292,663610,2024
71,24610,248341,14497,16410,217,3,5,304083,25303,224371,19117,74116,60,2,3,342972,647055,2024
72,23013,244837,13416,17519,182,1,12,298980,23621,217802,17814,80396,58,1,5,339697,638677,2024
73,22154,250141,12783,19789,158,3,9,305037,23721,218049,17427,90202,47,0,4,349450,654487,2024
74,20557,247817,11723,21606,144,3,18,301868,22711,210434,16045,99227,36,0,0,348453,650321,2024
75,20273,252040,10998,24376,142,1,10,307840,23059,209933,15593,111907,43,1,1,360537,668377,2024
76,18364,239791,10034,25742,124,2,7,294064,21608,193128,14264,118899,26,0,2,347927,641991,2024
77,17205,230668,8976,27867,109,1,8,284834,20603,182190,13445,127634,27,0,1,343900,628734,2024
78,12264,170142,6287,23159,73,0,6,211931,16223,129599,9430,105901,18,0,2,261173,473104,2024
79,12266,167312,5821,24868,66,0,9,210342,16144,123422,8789,116469,18,1,2,264845,475187,2024
80,11444,159269,4940,26291,67,2,8,202021,16187,114632,8193,123629,8,1,0,262650,464671,2024
81,11064,148476,4582,27400,81,0,5,191608,15682,102413,7551,129226,14,0,1,254887,446495,2024
82,10423,139525,4007,28909,66,1,2,182933,15546,92302,6746,135529,7,0,2,250132,433065,2024
83,10427,141420,3788,33147,44,0,3,188829,16369,88311,6470,154512,9,2,2,265675,454504,2024
84,9207,128400,3057,33355,34,1,3,174057,15456,74943,5543,154590,9,0,2,250543,424600,2024
85,7754,111290,2594,32652,27,0,1,154318,14357,60999,4797,151410,5,0,0,231568,385886,2024
86,6504,90502,2002,30280,21,0,1,129310,12784,45722,3753,139128,4,0,0,201391,330701,2024
87,5171,72137,1484,27771,17,0,0,106580,11333,34005,3086,127370,1,0,0,175795,282375,2024
88,4649,62201,1249,27062,13,0,1,95175,10732,27097,2606,123964,0,0,1,164400,259575,2024
89,3854,49288,966,24479,15,0,0,78602,9682,19683,2055,113013,0,0,0,144433,223035,2024
90,2916,38152,661,21480,8,0,1,63218,8448,13989,1695,99311,1,0,0,123444,186662,2024
91,2338,28268,445,18488,3,1,0,49543,7409,9854,1298,86493,0,0,0,105054,154597,2024
92,1783,21188,329,15918,6,0,0,39224,6530,6779,1053,74447,1,0,1,88811,128035,2024
93,1409,15537,257,13492,5,0,1,30701,5746,4745,861,65417,0,0,0,76769,107470,2024
94,976,9851,158,9869,0,0,0,20854,4461,2792,607,48621,0,0,1,56482,77336,2024
95,678,6312,105,7325,1,0,0,14421,3517,1808,412,37284,1,0,0,43022,57443,2024
96,443,3977,61,5451,1,0,0,9933,2623,1085,306,28089,1,0,0,32104,42037,2024
97,290,2241,39,3770,0,0,0,6340,1935,642,211,20243,0,0,0,23031,29371,2024
98,190,1300,26,2434,0,0,0,3950,1459,435,165,14205,0,0,0,16264,20214,2024
99,145,752,29,1732,1,0,0,2659,1051,315,95,9719,0,0,0,11180,13839,2024
100,268,902,26,2404,0,0,0,3600,1687,471,141,15312,0,0,0,17611,21211,2024
