"Età","Celibi","Coniugati","Divorziati","Vedovi","Uniti civilmente","Maschi già in unione civile (per scioglimento unione)","Maschi già in unione civile (per decesso del partner)","Totale maschi","Nubili","Coniugate","Divorziate","Vedove","Unite civilmente","Femmine già in unione civile (per scioglimento unione)","Femmine già in unione civile (per decesso del partner)","Totale femmine","Totale"
"0","195688","0","0","0","0","0","0","195688","184942","0","0","0","0","0","0","184942","380630"
"1","204738","0","0","0","0","0","0","204738","192455","0","0","0","0","0","0","192455","397193"
"2","208930","0","0","0","0","0","0","208930","198642","0","0","0","0","0","0","198642","407572"
"3","213459","0","0","0","0","0","0","213459","201122","0","0","0","0","0","0","201122","414581"
"4","221288","0","0","0","0","0","0","221288","210212","0","0","0","0","0","0","210212","431500"
"5","231752","0","0","0","0","0","0","231752","218688","0","0","0","0","0","0","218688","450440"
"6","241613","0","0","0","0","0","0","241613","227751","0","0","0","0","0","0","227751","469364"
"7","248294","0","0","0","0","0","0","248294","235369","0","0","0","0","0","0","235369","483663"
"8","255000","0","0","0","0","0","0","255000","240818","0","0","0","0","0","0","240818","495818"
"9","262545","0","0","0","0","0","0","262545","247842","0","0","0","0","0","0","247842","510387"
"10","266331","0","0","0","0","0","0","266331","251495","0","0","0","0","0","0","251495","517826"
"11","277888","0","0","0","0","0","0","277888","262271","0","0","0","0","0","0","262271","540159"
"12","282542","0","0","0","0","0","0","282542","266330","0","0","0","0","0","0","266330","548872"
"13","291214","0","0","0","0","0","0","291214","273403","0","0","0","0","0","0","273403","564617"
"14","295569","0","0","0","0","0","0","295569","278076","0","0","0","0","0","0","278076","573645"
"15","298883","0","0","0","0","0","0","298883","282062","0","0","0","0","0","0","282062","580945"
"16","299683","10","6","1","0","0","0","299700","280530","7","3","0","0","0","0","280540","580240"
"17","302283","8","5","1","0","0","0","302297","280717","10","2","0","0","0","0","280729","583026"
"18","304307","19","4","3","0","0","0","304333","278962","160","4","0","1","0","0","279127","583460"
"19","309859","96","6","1","1","0","0","309963","282932","686","4","1","4","0","0","283627","593590"
"20","304769","210","10","4","2","1","0","304996","277223","1748","11","2","7","0","0","278991","583987"
"21","302149","506","7","2","8","1","0","302673","274416","3170","24","5","11","0","0","277626","580299"
"22","305348","1100","107","3","16","0","0","306574","274473","5737","116","3","18","1","0","280348","586922"
"23","313742","2024","125","9","25","0","0","315925","276259","9276","201","6","34","2","0","285778","601703"
"24","310667","3730","190","9","40","0","0","314636","268972","13495","261","26","54","4","0","282812","597448"
"25","312354","6320","269","7","62","1","0","319013","263717","19625","328","24","74","3","0","283771","602784"
"26","304909","9613","262","15","79","2","1","314881","256832","27621","422","21","94","12","0","285002","599883"
"27","299970","14491","366","14","107","7","0","314955","248909","37388","656","62","138","13","0","287166","602121"
"28","290025","21885","422","13","180","8","1","312534","236720","49832","905","64","175","17","0","287713","600247"
"29","283043","30229","554","27","203","14","1","314071","227042","64395","1308","117","225","18","0","293105","607176"
"30","275075","41648","790","30","248","16","0","317807","217857","80156","1757","132","300","26","0","300228","618035"
"31","273375","56056","1048","43","288","13","1","330824","210805","100170","2287","216","324","27","1","313830","644654"
"32","256206","69694","1387","175","361","12","0","327835","195160","115035","3076","371","371","24","1","314038","641873"
"33","247580","85087","1872","179","398","31","1","335148","184344","130856","4078","475","423","27","2","320205","655353"
"34","230205","98491","2291","221","446","19","2","331675","171265","144440","5018","547","447","30","0","321747","653422"
"35","221339","115045","3052","255","530","26","3","340250","161067","161063","6139","761","528","34","3","329595","669845"
"36","202670","125183","3567","247","526","24","2","332219","146883","169056","7191","854","541","33","1","324559","656778"
"37","190390","137026","4531","323","544","33","6","332853","136855","178699","9230","1313","478","27","2","326604","659457"
"38","185013","150332","5534","316","546","26","3","341770","133081","191605","10795","1541","506","38","2","337568","679338"
"39","176944","163633","6368","399","498","15","2","347859","127407","201903","12302","1695","478","38","1","343824","691683"
"40","169768","175358","7474","437","558","25","3","353623","121957","211642","13720","1956","478","19","1","349773","703396"
"41","165850","189155","8680","467","562","30","2","364746","119265","224620","15556","2406","463","25","1","362336","727082"
"42","158118","195637","10168","983","553","28","6","365493","113726","230358","17523","3175","440","28","4","365254","730747"
"43","154819","207948","11376","1063","539","30","3","375778","109579","239636","19655","3582","399","27","2","372880","748658"
"44","151447","218084","13145","1216","660","21","5","384578","108020","251822","21923","4187","410","30","0","386392","770970"
"45","154286","233801","15037","1359","586","19","6","405094","109457","266405","25073","4769","394","23","1","406122","811216"
"46","152171","245161","17032","1413","634","23","5","416439","108047","278787","27588","5421","418","23","1","420285","836724"
"47","151864","259971","19657","1615","595","18","7","433727","107455","293596","30288","6634","353","24","1","438351","872078"
"48","151934","276730","22189","1936","728","14","7","453538","107283","309755","34081","7566","411","20","1","459117","912655"
"49","150853","292502","24732","2105","756","16","10","470974","106073","325351","36517","8829","402","21","4","477197","948171"
"50","140822","296045","26698","2344","695","15","7","466626","100548","326418","38480","9642","400","18","2","475508","942134"
"51","134441","305039","28178","2721","710","20","7","471116","95201","332104","40399","10830","343","15","4","478896","950012"
"52","127323","311949","30215","2885","687","18","11","473088","90547","339235","42024","12921","346","16","1","485090","958178"
"53","118185","315050","31062","3225","682","12","14","468230","84830","336946","43420","14325","318","13","2","479854","948084"
"54","113193","328142","33534","3629","670","12","7","479187","82627","348794","44880","16347","273","10","1","492932","972119"
"55","105516","330191","33493","4160","699","19","9","474087","77820","347396","45076","18464","261","13","4","489034","963121"
"56","98681","334954","34898","4684","643","9","14","473883","74590","350637","45718","20439","278","10","4","491676","965559"
"57","93382","342892","35994","5667","694","11","9","478649","70923","354660","45472","23006","206","9","2","494278","972927"
"58","86045","346317","36667","6068","655","7","11","475770","67285","353806","45597","25788","235","6","5","492722","968492"
"59","80379","354828","36951","6963","611","5","14","479751","64135","359598","45806","29369","214","9","7","499138","978889"
"60","69324","334588","34033","7311","579","13","13","445861","57296","339414","42005","30743","196","3","5","469662","915523"
"61","61879","325164","32349","7788","534","6","10","427730","52721","327150","39214","34294","164","5","5","453553","881283"
"62","56708","319798","30354","8687","499","4","11","416061","48845","319624","37255","38235","162","3","4","444128","860189"
"63","50819","312066","28444","9384","447","4","16","401180","45035","306997","35107","41831","160","4","2","429136","830316"
"64","46394","304715","26704","10146","394","3","14","388370","42066","297327","32521","45023","125","1","2","417065","805435"
"65","41805","290160","24127","10687","378","5","10","367172","38302","281704","30115","48177","108","2","5","398413","765585"
"66","38820","287120","22972","11436","325","6","6","360685","36250","276029","28350","52574","119","1","4","393327","754012"
"67","34833","281768","21198","12693","289","3","15","350799","32963","266802","26441","57419","80","0","6","383711","734510"
"68","31985","275599","19396","13519","260","4","7","340770","31129","258426","24444","61674","72","2","2","375749","716519"
"69","29579","269432","17953","14817","234","4","6","332025","29297","250299","23047","66712","60","3","2","369420","701445"
"70","26555","256195","15910","15447","201","1","9","314318","26747","232845","20659","68987","52","0","2","349292","663610"
"71","24610","248341","14497","16410","217","3","5","304083","25303","224371","19117","74116","60","2","3","342972","647055"
"72","23013","244837","13416","17519","182","1","12","298980","23621","217802","17814","80396","58","1","5","339697","638677"
"73","22154","250141","12783","19789","158","3","9","305037","23721","218049","17427","90202","47","0","4","349450","654487"
"74","20557","247817","11723","21606","144","3","18","301868","22711","210434","16045","99227","36","0","0","348453","650321"
"75","20273","252040","10998","24376","142","1","10","307840","23059","209933","15593","111907","43","1","1","360537","668377"
"76","18364","239791","10034","25742","124","2","7","294064","21608","193128","14264","118899","26","0","2","347927","641991"
"77","17205","230668","8976","27867","109","1","8","284834","20603","182190","13445","127634","27","0","1","343900","628734"
"78","12264","170142","6287","23159","73","0","6","211931","16223","129599","9430","105901","18","0","2","261173","473104"
"79","12266","167312","5821","24868","66","0","9","210342","16144","123422","8789","116469","18","1","2","264845","475187"
"80","11444","159269","4940","26291","67","2","8","202021","16187","114632","8193","123629","8","1","0","262650","464671"
"81","11064","148476","4582","27400","81","0","5","191608","15682","102413","7551","129226","14","0","1","254887","446495"
"82","10423","139525","4007","28909","66","1","2","182933","15546","92302","6746","135529","7","0","2","250132","433065"
"83","10427","141420","3788","33147","44","0","3","188829","16369","88311","6470","154512","9","2","2","265675","454504"
"84","9207","128400","3057","33355","34","1","3","174057","15456","74943","5543","154590","9","0","2","250543","424600"
"85","7754","111290","2594","32652","27","0","1","154318","14357","60999","4797","151410","5","0","0","231568","385886"
"86","6504","90502","2002","30280","21","0","1","129310","12784","45722","3753","139128","4","0","0","201391","330701"
"87","5171","72137","1484","27771","17","0","0","106580","11333","34005","3086","127370","1","0","0","175795","282375"
"88","4649","62201","1249","27062","13","0","1","95175","10732","27097","2606","123964","0","0","1","164400","259575"
"89","3854","49288","966","24479","15","0","0","78602","9682","19683","2055","113013","0","0","0","144433","223035"
"90","2916","38152","661","21480","8","0","1","63218","8448","13989","1695","99311","1","0","0","123444","186662"
"91","2338","28268","445","18488","3","1","0","49543","7409","9854","1298","86493","0","0","0","105054","154597"
"92","1783","21188","329","15918","6","0","0","39224","6530","6779","1053","74447","1","0","1","88811","128035"
"93","1409","15537","257","13492","5","0","1","30701","5746","4745","861","65417","0","0","0","76769","107470"
"94","976","9851","158","9869","0","0","0","20854","4461","2792","607","48621","0","0","1","56482","77336"
"95","678","6312","105","7325","1","0","0","14421","3517","1808","412","37284","1","0","0","43022","57443"
"96","443","3977","61","5451","1","0","0","9933","2623","1085","306","28089","1","0","0","32104","42037"
"97","290","2241","39","3770","0","0","0","6340","1935","642","211","20243","0","0","0","23031","29371"
"98","190","1300","26","2434","0","0","0","3950","1459","435","165","14205","0","0","0","16264","20214"
"99","145","752","29","1732","1","0","0","2659","1051","315","95","9719","0","0","0","11180","13839"
"100 e oltre","268","902","26","2404","0","0","0","3600","1687","471","141","15312","0","0","0","17611","21211"
"Totale","13908056","13230872","908733","774197","23790","673","407","28846728","11919912","13356266","1273640","3559824","13965","765","130","30124502","58971230"