cod_geografico,Provincia,Età,Celibi,Coniugati,Divorziati,Vedovi,Uniti civilmente,Maschi già in unione civile (per scioglimento unione),Maschi già in unione civile (per decesso del partner),Totale maschi,Nubili,Coniugate,Divorziate,Vedove,Unite civilmente,Femmine già in unione civile (per scioglimento unione),Femmine già in unione civile (per decesso del partner),Totale femmine,Totale
IT-AG,Agrigento,0,1483,0,0,0,0,0,0,1483,1463,0,0,0,0,0,0,1463,2946
IT-AG,Agrigento,1,1587,0,0,0,0,0,0,1587,1508,0,0,0,0,0,0,1508,3095
IT-AG,Agrigento,2,1570,0,0,0,0,0,0,1570,1442,0,0,0,0,0,0,1442,3012
IT-AG,Agrigento,3,1525,0,0,0,0,0,0,1525,1532,0,0,0,0,0,0,1532,3057
IT-AG,Agrigento,4,1620,0,0,0,0,0,0,1620,1532,0,0,0,0,0,0,1532,3152
IT-AG,Agrigento,5,1735,0,0,0,0,0,0,1735,1557,0,0,0,0,0,0,1557,3292
IT-AG,Agrigento,6,1649,0,0,0,0,0,0,1649,1693,0,0,0,0,0,0,1693,3342
IT-AG,Agrigento,7,1704,0,0,0,0,0,0,1704,1599,0,0,0,0,0,0,1599,3303
IT-AG,Agrigento,8,1771,0,0,0,0,0,0,1771,1593,0,0,0,0,0,0,1593,3364
IT-AG,Agrigento,9,1821,0,0,0,0,0,0,1821,1727,0,0,0,0,0,0,1727,3548
IT-AG,Agrigento,10,1813,0,0,0,0,0,0,1813,1643,0,0,0,0,0,0,1643,3456
IT-AG,Agrigento,11,1919,0,0,0,0,0,0,1919,1819,0,0,0,0,0,0,1819,3738
IT-AG,Agrigento,12,1911,0,0,0,0,0,0,1911,1914,0,0,0,0,0,0,1914,3825
IT-AG,Agrigento,13,2075,0,0,0,0,0,0,2075,1882,0,0,0,0,0,0,1882,3957
IT-AG,Agrigento,14,2057,0,0,0,0,0,0,2057,1970,0,0,0,0,0,0,1970,4027
IT-AG,Agrigento,15,2184,0,0,0,0,0,0,2184,1949,0,0,0,0,0,0,1949,4133
IT-AG,Agrigento,16,2233,0,0,0,0,0,0,2233,2043,0,0,0,0,0,0,2043,4276
IT-AG,Agrigento,17,2331,0,0,0,0,0,0,2331,2085,0,0,0,0,0,0,2085,4416
IT-AG,Agrigento,18,2475,0,0,0,0,0,0,2475,2176,3,0,0,0,0,0,2179,4654
IT-AG,Agrigento,19,2480,0,0,0,0,0,0,2480,2184,13,0,0,0,0,0,2197,4677
IT-AG,Agrigento,20,2290,5,0,0,0,0,0,2295,2151,29,0,0,0,0,0,2180,4475
IT-AG,Agrigento,21,2299,13,0,0,0,0,0,2312,2147,53,0,0,0,0,0,2200,4512
IT-AG,Agrigento,22,2377,21,0,0,1,0,0,2399,2155,63,0,0,0,0,0,2218,4617
IT-AG,Agrigento,23,2497,27,0,0,0,0,0,2524,2136,108,2,0,0,0,0,2246,4770
IT-AG,Agrigento,24,2357,45,2,0,0,0,0,2404,2131,188,0,0,0,0,0,2319,4723
IT-AG,Agrigento,25,2361,79,1,0,0,0,0,2441,2025,239,1,0,0,0,0,2265,4706
IT-AG,Agrigento,26,2227,122,1,0,0,0,0,2350,1769,332,0,0,1,0,0,2102,4452
IT-AG,Agrigento,27,2190,182,1,0,0,0,0,2373,1668,454,3,0,0,0,0,2125,4498
IT-AG,Agrigento,28,2005,252,3,0,2,0,0,2262,1495,598,5,1,1,0,0,2100,4362
IT-AG,Agrigento,29,1928,327,0,0,0,0,0,2255,1387,712,5,2,0,0,0,2106,4361
IT-AG,Agrigento,30,1844,466,4,0,1,0,0,2315,1211,882,13,1,0,0,0,2107,4422
IT-AG,Agrigento,31,1682,638,3,0,2,0,0,2325,1128,1128,28,2,1,0,0,2287,4612
IT-AG,Agrigento,32,1561,698,7,0,0,0,0,2266,1000,1193,16,3,0,0,0,2212,4478
IT-AG,Agrigento,33,1461,932,7,0,0,0,0,2400,972,1338,33,1,2,0,0,2346,4746
IT-AG,Agrigento,34,1347,964,10,0,2,0,0,2323,800,1443,18,4,1,0,0,2266,4589
IT-AG,Agrigento,35,1292,1180,17,2,0,0,0,2491,724,1552,38,7,0,0,0,2321,4812
IT-AG,Agrigento,36,1095,1168,14,0,0,0,0,2277,637,1531,37,1,0,0,0,2206,4483
IT-AG,Agrigento,37,1065,1267,23,1,0,0,0,2356,623,1605,53,11,0,0,0,2292,4648
IT-AG,Agrigento,38,997,1305,26,2,0,0,0,2330,571,1705,49,8,1,0,0,2334,4664
IT-AG,Agrigento,39,887,1456,33,3,0,0,0,2379,536,1733,63,9,1,0,0,2342,4721
IT-AG,Agrigento,40,794,1502,37,4,0,0,0,2337,449,1806,70,18,1,0,0,2344,4681
IT-AG,Agrigento,41,781,1497,34,1,2,0,0,2315,436,1860,55,18,0,0,0,2369,4684
IT-AG,Agrigento,42,795,1719,46,2,2,0,0,2564,418,1974,75,25,4,0,0,2496,5060
IT-AG,Agrigento,43,751,1813,59,4,1,0,0,2628,424,2002,100,30,0,0,0,2556,5184
IT-AG,Agrigento,44,761,1841,58,7,2,0,0,2669,363,2045,113,23,0,0,0,2544,5213
IT-AG,Agrigento,45,688,1861,63,6,1,0,0,2619,351,2153,105,35,1,0,0,2645,5264
IT-AG,Agrigento,46,668,1965,76,15,3,0,0,2727,374,2246,120,33,1,0,0,2774,5501
IT-AG,Agrigento,47,681,2141,91,5,1,0,0,2919,404,2219,137,59,0,0,0,2819,5738
IT-AG,Agrigento,48,697,2113,82,15,1,0,0,2908,387,2480,121,63,0,0,0,3051,5959
IT-AG,Agrigento,49,639,2156,98,10,3,0,0,2906,428,2517,153,66,0,0,0,3164,6070
IT-AG,Agrigento,50,567,2185,85,15,2,0,0,2854,423,2488,135,85,1,0,0,3132,5986
IT-AG,Agrigento,51,627,2241,110,14,2,0,0,2994,377,2417,140,83,0,0,0,3017,6011
IT-AG,Agrigento,52,557,2356,127,18,2,0,0,3060,369,2645,141,108,2,0,0,3265,6325
IT-AG,Agrigento,53,542,2324,119,33,3,0,0,3021,396,2671,160,97,1,1,0,3326,6347
IT-AG,Agrigento,54,530,2610,119,25,1,0,0,3285,415,2665,150,134,0,0,0,3364,6649
IT-AG,Agrigento,55,516,2483,130,28,1,0,0,3158,392,2684,136,172,0,0,0,3384,6542
IT-AG,Agrigento,56,479,2561,120,43,1,0,0,3204,397,2828,131,174,0,0,0,3530,6734
IT-AG,Agrigento,57,441,2481,120,27,3,0,0,3072,408,2633,130,190,1,0,0,3362,6434
IT-AG,Agrigento,58,397,2549,118,32,0,0,0,3096,388,2615,141,243,0,0,0,3387,6483
IT-AG,Agrigento,59,397,2707,127,46,1,0,0,3278,376,2668,125,261,0,0,0,3430,6708
IT-AG,Agrigento,60,327,2429,92,60,1,0,1,2910,325,2432,106,235,0,0,0,3098,6008
IT-AG,Agrigento,61,312,2322,102,61,1,0,0,2798,324,2332,109,289,0,0,0,3054,5852
IT-AG,Agrigento,62,315,2338,109,66,0,0,0,2828,290,2319,83,303,0,0,0,2995,5823
IT-AG,Agrigento,63,259,2405,106,64,1,0,0,2835,342,2384,100,384,0,0,0,3210,6045
IT-AG,Agrigento,64,254,2256,86,61,2,0,0,2659,292,2178,91,403,0,0,0,2964,5623
IT-AG,Agrigento,65,251,2134,81,66,0,0,0,2532,281,2061,69,395,0,0,0,2806,5338
IT-AG,Agrigento,66,231,2263,85,69,2,0,0,2650,245,2054,71,476,0,0,0,2846,5496
IT-AG,Agrigento,67,197,2130,65,72,2,0,0,2466,239,2033,71,458,0,0,0,2801,5267
IT-AG,Agrigento,68,188,2059,56,89,0,0,0,2392,268,1914,63,567,0,0,0,2812,5204
IT-AG,Agrigento,69,164,2142,53,97,1,0,0,2457,238,1778,68,602,0,0,0,2686,5143
IT-AG,Agrigento,70,145,1809,59,105,1,0,0,2119,188,1608,60,604,0,0,0,2460,4579
IT-AG,Agrigento,71,144,1869,51,86,0,0,0,2150,167,1538,56,661,0,0,0,2422,4572
IT-AG,Agrigento,72,114,1788,49,113,0,0,0,2064,202,1501,64,685,0,0,0,2452,4516
IT-AG,Agrigento,73,110,1761,44,140,0,0,0,2055,193,1439,39,782,0,0,0,2453,4508
IT-AG,Agrigento,74,120,1942,43,129,1,0,0,2235,183,1427,41,898,0,0,0,2549,4784
IT-AG,Agrigento,75,112,1819,38,141,0,0,0,2110,197,1317,36,911,0,0,0,2461,4571
IT-AG,Agrigento,76,107,1795,29,167,0,0,0,2098,172,1233,46,1111,0,0,0,2562,4660
IT-AG,Agrigento,77,104,1521,23,174,1,0,0,1823,137,979,27,1057,0,0,0,2200,4023
IT-AG,Agrigento,78,52,1330,14,159,0,0,0,1555,119,786,24,943,0,0,0,1872,3427
IT-AG,Agrigento,79,63,1210,24,131,0,0,0,1428,131,703,22,939,0,0,0,1795,3223
IT-AG,Agrigento,80,57,1033,10,154,0,0,0,1254,124,586,25,878,0,0,0,1613,2867
IT-AG,Agrigento,81,53,944,8,138,1,0,0,1144,110,496,15,914,0,0,0,1535,2679
IT-AG,Agrigento,82,45,892,13,143,0,0,0,1093,141,474,16,954,0,0,0,1585,2678
IT-AG,Agrigento,83,54,1029,14,197,0,0,0,1294,136,430,16,1176,0,0,0,1758,3052
IT-AG,Agrigento,84,36,938,8,193,0,0,0,1175,120,386,13,1173,0,0,0,1692,2867
IT-AG,Agrigento,85,27,799,8,211,0,0,0,1045,113,319,8,1113,0,0,0,1553,2598
IT-AG,Agrigento,86,31,671,9,187,0,0,0,898,107,230,7,1034,0,0,0,1378,2276
IT-AG,Agrigento,87,27,518,3,161,0,0,0,709,85,139,8,915,0,0,0,1147,1856
IT-AG,Agrigento,88,15,433,5,186,0,0,0,639,82,109,4,822,0,0,0,1017,1656
IT-AG,Agrigento,89,12,368,3,206,0,0,0,589,72,87,6,733,0,0,0,898,1487
IT-AG,Agrigento,90,11,284,2,134,0,0,0,431,50,69,4,653,0,0,0,776,1207
IT-AG,Agrigento,91,6,203,1,129,0,0,0,339,58,52,5,550,0,0,0,665,1004
IT-AG,Agrigento,92,7,165,1,137,0,0,0,310,64,22,2,452,0,0,0,540,850
IT-AG,Agrigento,93,7,123,1,100,0,0,0,231,47,21,5,411,0,0,0,484,715
IT-AG,Agrigento,94,2,77,0,61,0,0,0,140,40,10,0,242,0,0,0,292,432
IT-AG,Agrigento,95,1,57,0,46,0,0,0,104,24,7,2,231,0,0,0,264,368
IT-AG,Agrigento,96,3,38,0,39,0,0,0,80,10,2,0,163,0,0,0,175,255
IT-AG,Agrigento,97,1,16,0,32,0,0,0,49,9,2,0,120,0,0,0,131,180
IT-AG,Agrigento,98,0,10,0,15,0,0,0,25,11,4,0,75,0,0,0,90,115
IT-AG,Agrigento,99,0,8,0,20,0,0,0,28,6,0,1,61,0,0,0,68,96
IT-AG,Agrigento,100,1,8,1,23,0,0,0,33,7,3,0,71,0,0,0,81,114
IT-AG,Agrigento,999,89978,102188,3267,4920,54,0,1,200408,76501,101982,4185,27411,20,1,0,210100,410508
IT-AL,Alessandria,0,1158,0,0,0,0,0,0,1158,1060,0,0,0,0,0,0,1060,2218
IT-AL,Alessandria,1,1178,0,0,0,0,0,0,1178,1139,0,0,0,0,0,0,1139,2317
IT-AL,Alessandria,2,1191,0,0,0,0,0,0,1191,1065,0,0,0,0,0,0,1065,2256
IT-AL,Alessandria,3,1250,0,0,0,0,0,0,1250,1158,0,0,0,0,0,0,1158,2408
IT-AL,Alessandria,4,1267,0,0,0,0,0,0,1267,1197,0,0,0,0,0,0,1197,2464
IT-AL,Alessandria,5,1339,0,0,0,0,0,0,1339,1284,0,0,0,0,0,0,1284,2623
IT-AL,Alessandria,6,1400,0,0,0,0,0,0,1400,1396,0,0,0,0,0,0,1396,2796
IT-AL,Alessandria,7,1441,0,0,0,0,0,0,1441,1423,0,0,0,0,0,0,1423,2864
IT-AL,Alessandria,8,1565,0,0,0,0,0,0,1565,1392,0,0,0,0,0,0,1392,2957
IT-AL,Alessandria,9,1546,0,0,0,0,0,0,1546,1486,0,0,0,0,0,0,1486,3032
IT-AL,Alessandria,10,1624,0,0,0,0,0,0,1624,1485,0,0,0,0,0,0,1485,3109
IT-AL,Alessandria,11,1707,0,0,0,0,0,0,1707,1568,0,0,0,0,0,0,1568,3275
IT-AL,Alessandria,12,1707,0,0,0,0,0,0,1707,1631,0,0,0,0,0,0,1631,3338
IT-AL,Alessandria,13,1771,0,0,0,0,0,0,1771,1651,0,0,0,0,0,0,1651,3422
IT-AL,Alessandria,14,1796,0,0,0,0,0,0,1796,1702,0,0,0,0,0,0,1702,3498
IT-AL,Alessandria,15,1826,0,0,0,0,0,0,1826,1719,0,0,0,0,0,0,1719,3545
IT-AL,Alessandria,16,1818,0,0,0,0,0,0,1818,1718,0,0,0,0,0,0,1718,3536
IT-AL,Alessandria,17,1839,0,0,0,0,0,0,1839,1717,0,0,0,0,0,0,1717,3556
IT-AL,Alessandria,18,1835,1,0,0,0,0,0,1836,1624,1,0,0,0,0,0,1625,3461
IT-AL,Alessandria,19,1855,1,0,0,0,0,0,1856,1709,11,0,0,0,0,0,1720,3576
IT-AL,Alessandria,20,1868,2,0,0,0,0,0,1870,1630,13,0,0,0,0,0,1643,3513
IT-AL,Alessandria,21,1816,3,0,0,0,0,0,1819,1694,30,0,0,0,0,0,1724,3543
IT-AL,Alessandria,22,1860,13,1,0,0,0,0,1874,1643,44,2,0,0,0,0,1689,3563
IT-AL,Alessandria,23,1885,17,1,0,1,0,0,1904,1661,68,2,0,0,0,0,1731,3635
IT-AL,Alessandria,24,2039,35,1,0,0,0,0,2075,1638,108,0,0,0,0,0,1746,3821
IT-AL,Alessandria,25,1901,61,5,0,1,0,0,1968,1551,159,2,0,0,0,0,1712,3680
IT-AL,Alessandria,26,1928,71,4,0,1,0,0,2004,1536,234,8,1,0,0,0,1779,3783
IT-AL,Alessandria,27,1914,75,4,0,2,0,0,1995,1454,280,6,1,3,0,0,1744,3739
IT-AL,Alessandria,28,1869,146,2,0,1,0,0,2018,1422,333,7,1,0,0,0,1763,3781
IT-AL,Alessandria,29,1800,185,5,0,5,0,0,1995,1333,453,12,2,3,0,0,1803,3798
IT-AL,Alessandria,30,1801,252,9,0,2,0,0,2064,1352,522,7,0,0,0,0,1881,3945
IT-AL,Alessandria,31,1735,351,9,0,5,0,0,2100,1237,615,17,2,2,1,0,1874,3974
IT-AL,Alessandria,32,1633,407,5,1,0,0,0,2046,1225,660,32,2,2,0,0,1921,3967
IT-AL,Alessandria,33,1580,500,19,3,5,1,0,2108,1107,710,39,5,4,1,0,1866,3974
IT-AL,Alessandria,34,1438,575,31,3,2,1,0,2050,1057,844,43,4,1,0,0,1949,3999
IT-AL,Alessandria,35,1377,631,26,1,4,0,0,2039,982,981,45,3,2,0,0,2013,4052
IT-AL,Alessandria,36,1254,795,35,3,2,1,0,2090,799,999,65,9,4,1,0,1877,3967
IT-AL,Alessandria,37,1236,804,39,3,5,0,0,2087,850,1040,56,13,5,0,0,1964,4051
IT-AL,Alessandria,38,1196,896,42,2,5,2,0,2143,824,1127,94,20,4,1,0,2070,4213
IT-AL,Alessandria,39,1135,900,35,2,2,0,0,2074,773,1274,105,13,5,0,0,2170,4244
IT-AL,Alessandria,40,1072,1071,67,0,3,0,0,2213,804,1215,134,14,2,0,0,2169,4382
IT-AL,Alessandria,41,1106,1073,80,2,4,1,0,2266,744,1322,158,12,4,0,0,2240,4506
IT-AL,Alessandria,42,1028,1167,82,7,4,0,0,2288,719,1385,148,22,2,0,0,2276,4564
IT-AL,Alessandria,43,1070,1206,107,4,3,0,0,2390,705,1349,193,31,2,0,0,2280,4670
IT-AL,Alessandria,44,997,1259,107,12,0,0,0,2375,702,1473,160,32,1,1,0,2369,4744
IT-AL,Alessandria,45,1077,1424,115,10,7,0,0,2633,717,1649,207,40,1,0,0,2614,5247
IT-AL,Alessandria,46,1129,1508,159,12,2,0,1,2811,759,1774,244,39,6,0,0,2822,5633
IT-AL,Alessandria,47,1207,1586,163,17,2,0,0,2975,760,1909,243,58,4,0,0,2974,5949
IT-AL,Alessandria,48,1150,1688,185,11,3,0,0,3037,766,1943,324,52,0,4,0,3089,6126
IT-AL,Alessandria,49,1164,1763,232,15,5,1,0,3180,722,1960,319,57,4,1,0,3063,6243
IT-AL,Alessandria,50,1106,1792,224,11,4,0,0,3137,715,2014,306,89,3,0,0,3127,6264
IT-AL,Alessandria,51,1110,1905,284,14,6,0,0,3319,722,2089,362,92,0,0,0,3265,6584
IT-AL,Alessandria,52,1066,1933,294,22,5,0,0,3320,671,2276,387,88,2,0,0,3424,6744
IT-AL,Alessandria,53,951,2109,277,35,5,0,0,3377,563,2253,361,123,1,1,0,3302,6679
IT-AL,Alessandria,54,951,2135,329,27,9,0,0,3451,665,2352,459,163,2,0,0,3641,7092
IT-AL,Alessandria,55,880,2174,325,39,5,0,0,3423,539,2313,413,153,4,0,0,3422,6845
IT-AL,Alessandria,56,908,2278,340,42,3,0,0,3571,503,2411,453,174,3,1,0,3545,7116
IT-AL,Alessandria,57,848,2329,341,39,8,0,0,3565,484,2407,450,176,0,0,0,3517,7082
IT-AL,Alessandria,58,789,2379,372,49,6,0,0,3595,478,2416,455,207,1,0,0,3557,7152
IT-AL,Alessandria,59,726,2440,389,39,5,0,0,3599,467,2543,466,231,0,0,0,3707,7306
IT-AL,Alessandria,60,564,2398,362,60,4,0,0,3388,399,2349,395,242,0,0,0,3385,6773
IT-AL,Alessandria,61,564,2201,332,57,3,0,0,3157,366,2278,379,298,2,0,0,3323,6480
IT-AL,Alessandria,62,515,2262,332,72,7,0,0,3188,355,2135,409,363,0,0,0,3262,6450
IT-AL,Alessandria,63,490,2162,303,62,6,0,0,3023,305,2079,322,371,1,0,0,3078,6101
IT-AL,Alessandria,64,426,2132,277,80,3,0,0,2918,278,2024,355,346,3,0,0,3006,5924
IT-AL,Alessandria,65,376,2092,293,109,1,0,0,2871,247,2084,321,406,0,0,0,3058,5929
IT-AL,Alessandria,66,377,2164,264,107,2,0,0,2914,246,1950,278,382,1,0,0,2857,5771
IT-AL,Alessandria,67,319,2110,236,93,0,0,0,2758,186,1982,286,472,2,0,0,2928,5686
IT-AL,Alessandria,68,280,2015,227,105,5,0,0,2632,191,1845,254,475,1,0,0,2766,5398
IT-AL,Alessandria,69,274,1985,211,120,1,0,0,2591,167,1858,246,525,2,0,0,2798,5389
IT-AL,Alessandria,70,250,1903,197,127,4,0,0,2481,192,1682,196,589,1,0,0,2660,5141
IT-AL,Alessandria,71,259,1869,161,157,1,0,0,2447,174,1618,187,597,0,0,0,2576,5023
IT-AL,Alessandria,72,221,1875,150,165,1,0,0,2412,182,1680,159,615,0,0,0,2636,5048
IT-AL,Alessandria,73,210,1867,146,187,2,0,0,2412,160,1727,193,726,1,0,0,2807,5219
IT-AL,Alessandria,74,210,1883,134,164,3,0,0,2394,140,1569,166,788,1,0,0,2664,5058
IT-AL,Alessandria,75,204,1870,125,206,1,0,0,2406,153,1591,174,925,0,0,0,2843,5249
IT-AL,Alessandria,76,219,1773,115,266,1,0,0,2374,140,1579,157,982,0,0,0,2858,5232
IT-AL,Alessandria,77,162,1764,112,269,0,0,1,2308,137,1471,137,1038,1,0,0,2784,5092
IT-AL,Alessandria,78,118,1262,80,204,2,0,0,1666,112,1029,66,808,0,0,0,2015,3681
IT-AL,Alessandria,79,131,1353,62,224,0,0,0,1770,117,950,103,1027,0,0,0,2197,3967
IT-AL,Alessandria,80,118,1261,49,226,0,0,0,1654,124,909,76,1080,1,0,0,2190,3844
IT-AL,Alessandria,81,111,1158,52,256,0,0,0,1577,121,848,95,1143,1,0,0,2208,3785
IT-AL,Alessandria,82,131,1117,48,270,0,0,0,1566,108,782,68,1216,0,0,0,2174,3740
IT-AL,Alessandria,83,102,1110,49,296,0,0,0,1557,117,711,79,1355,0,0,0,2262,3819
IT-AL,Alessandria,84,111,1026,46,300,0,0,0,1483,104,674,49,1402,0,0,0,2229,3712
IT-AL,Alessandria,85,93,923,42,302,0,0,0,1360,93,491,60,1400,0,0,0,2044,3404
IT-AL,Alessandria,86,64,736,22,277,1,0,0,1100,79,377,38,1227,0,0,0,1721,2821
IT-AL,Alessandria,87,63,602,19,246,0,0,0,930,79,304,32,1114,0,0,0,1529,2459
IT-AL,Alessandria,88,71,464,23,246,1,0,0,805,106,224,32,1100,0,0,0,1462,2267
IT-AL,Alessandria,89,31,367,14,225,0,0,0,637,90,169,17,1018,0,0,0,1294,1931
IT-AL,Alessandria,90,36,306,8,170,0,0,0,520,89,111,15,943,0,0,0,1158,1678
IT-AL,Alessandria,91,25,234,6,138,0,0,0,403,76,81,7,813,0,0,0,977,1380
IT-AL,Alessandria,92,26,161,3,129,0,0,0,319,55,61,11,676,0,0,0,803,1122
IT-AL,Alessandria,93,16,118,5,112,0,0,0,251,56,46,6,676,0,0,0,784,1035
IT-AL,Alessandria,94,9,70,2,92,0,0,0,173,33,29,5,464,0,0,0,531,704
IT-AL,Alessandria,95,9,43,1,59,0,0,0,112,34,19,6,338,0,0,0,397,509
IT-AL,Alessandria,96,1,27,0,44,0,0,0,72,19,15,4,260,0,0,0,298,370
IT-AL,Alessandria,97,3,21,1,27,0,0,0,52,18,5,1,187,0,0,0,211,263
IT-AL,Alessandria,98,4,19,1,16,0,0,0,40,11,6,1,126,0,0,0,144,184
IT-AL,Alessandria,99,4,5,0,15,0,0,0,24,10,3,1,84,0,0,0,98,122
IT-AL,Alessandria,100,1,9,0,26,0,0,0,36,16,4,3,145,0,0,0,168,204
IT-AL,Alessandria,999,91911,90657,9255,6731,181,7,2,198744,73782,90908,12173,30671,95,12,0,207641,406385
IT-AN,Ancona,0,1397,0,0,0,0,0,0,1397,1333,0,0,0,0,0,0,1333,2730
IT-AN,Ancona,1,1361,0,0,0,0,0,0,1361,1323,0,0,0,0,0,0,1323,2684
IT-AN,Ancona,2,1445,0,0,0,0,0,0,1445,1456,0,0,0,0,0,0,1456,2901
IT-AN,Ancona,3,1534,0,0,0,0,0,0,1534,1475,0,0,0,0,0,0,1475,3009
IT-AN,Ancona,4,1650,0,0,0,0,0,0,1650,1459,0,0,0,0,0,0,1459,3109
IT-AN,Ancona,5,1680,0,0,0,0,0,0,1680,1554,0,0,0,0,0,0,1554,3234
IT-AN,Ancona,6,1730,0,0,0,0,0,0,1730,1624,0,0,0,0,0,0,1624,3354
IT-AN,Ancona,7,1864,0,0,0,0,0,0,1864,1729,0,0,0,0,0,0,1729,3593
IT-AN,Ancona,8,1949,0,0,0,0,0,0,1949,1827,0,0,0,0,0,0,1827,3776
IT-AN,Ancona,9,1955,0,0,0,0,0,0,1955,1873,0,0,0,0,0,0,1873,3828
IT-AN,Ancona,10,2079,0,0,0,0,0,0,2079,1892,0,0,0,0,0,0,1892,3971
IT-AN,Ancona,11,2115,0,0,0,0,0,0,2115,2000,0,0,0,0,0,0,2000,4115
IT-AN,Ancona,12,2150,0,0,0,0,0,0,2150,2088,0,0,0,0,0,0,2088,4238
IT-AN,Ancona,13,2225,0,0,0,0,0,0,2225,2175,0,0,0,0,0,0,2175,4400
IT-AN,Ancona,14,2397,0,0,0,0,0,0,2397,2178,0,0,0,0,0,0,2178,4575
IT-AN,Ancona,15,2367,0,0,0,0,0,0,2367,2257,0,0,0,0,0,0,2257,4624
IT-AN,Ancona,16,2317,0,0,0,0,0,0,2317,2176,0,0,0,0,0,0,2176,4493
IT-AN,Ancona,17,2249,0,0,0,0,0,0,2249,2116,1,0,0,0,0,0,2117,4366
IT-AN,Ancona,18,2283,0,0,0,0,0,0,2283,2086,0,0,0,0,0,0,2086,4369
IT-AN,Ancona,19,2418,0,0,0,0,0,0,2418,2102,5,0,0,0,0,0,2107,4525
IT-AN,Ancona,20,2268,1,0,0,0,0,0,2269,2061,21,0,0,0,0,0,2082,4351
IT-AN,Ancona,21,2423,1,0,0,0,0,0,2424,2085,30,0,0,0,0,0,2115,4539
IT-AN,Ancona,22,2328,2,0,0,0,0,0,2330,2025,54,3,0,0,0,0,2082,4412
IT-AN,Ancona,23,2398,25,3,0,1,0,0,2427,2001,86,3,0,1,0,0,2091,4518
IT-AN,Ancona,24,2403,44,1,0,0,0,0,2448,2041,104,5,0,0,0,0,2150,4598
IT-AN,Ancona,25,2475,46,2,0,2,0,0,2525,1948,171,5,0,1,0,0,2125,4650
IT-AN,Ancona,26,2386,77,0,0,1,0,0,2464,1972,190,7,1,0,0,0,2170,4634
IT-AN,Ancona,27,2317,118,4,0,1,0,0,2440,1790,280,7,0,1,0,0,2078,4518
IT-AN,Ancona,28,2278,156,4,0,2,0,0,2440,1793,328,6,0,2,0,0,2129,4569
IT-AN,Ancona,29,2165,192,2,0,1,0,0,2360,1697,385,9,0,3,0,0,2094,4454
IT-AN,Ancona,30,2128,231,6,0,2,0,0,2367,1655,516,12,0,3,0,0,2186,4553
IT-AN,Ancona,31,2122,332,9,0,1,0,0,2464,1578,642,18,3,2,0,0,2243,4707
IT-AN,Ancona,32,2018,453,8,1,6,0,0,2486,1439,665,25,5,3,0,0,2137,4623
IT-AN,Ancona,33,1982,550,12,2,1,0,0,2547,1445,802,35,2,3,0,0,2287,4834
IT-AN,Ancona,34,1711,620,14,0,2,0,0,2347,1357,942,37,3,1,0,0,2340,4687
IT-AN,Ancona,35,1648,697,23,2,4,0,0,2374,1213,1020,48,5,5,0,0,2291,4665
IT-AN,Ancona,36,1609,760,29,1,0,0,0,2399,1126,1125,51,9,3,0,0,2314,4713
IT-AN,Ancona,37,1544,919,36,2,2,0,0,2503,1108,1256,79,10,4,0,0,2457,4960
IT-AN,Ancona,38,1506,952,48,1,2,1,0,2510,1111,1294,98,15,2,0,1,2521,5031
IT-AN,Ancona,39,1440,1175,47,4,4,0,0,2670,1101,1417,96,12,3,0,0,2629,5299
IT-AN,Ancona,40,1332,1226,56,0,5,0,0,2619,1084,1500,96,10,4,0,0,2694,5313
IT-AN,Ancona,41,1482,1296,78,1,2,0,1,2860,998,1611,145,11,8,0,0,2773,5633
IT-AN,Ancona,42,1357,1363,94,8,4,0,0,2826,972,1612,150,21,4,0,0,2759,5585
IT-AN,Ancona,43,1415,1544,101,9,3,0,0,3072,1024,1790,159,29,2,0,0,3004,6076
IT-AN,Ancona,44,1308,1638,137,17,5,0,0,3105,934,1873,222,42,3,1,0,3075,6180
IT-AN,Ancona,45,1335,1786,150,11,10,0,0,3292,963,2013,224,48,4,0,0,3252,6544
IT-AN,Ancona,46,1417,1828,162,16,1,0,0,3424,986,2094,224,30,3,0,0,3337,6761
IT-AN,Ancona,47,1293,1888,190,14,7,1,0,3393,935,2256,247,61,3,0,0,3502,6895
IT-AN,Ancona,48,1344,2218,171,17,6,0,0,3756,944,2467,308,46,7,0,0,3772,7528
IT-AN,Ancona,49,1386,2217,219,20,5,0,0,3847,864,2440,328,53,4,0,0,3689,7536
IT-AN,Ancona,50,1222,2229,213,14,2,0,0,3680,820,2480,320,73,5,0,0,3698,7378
IT-AN,Ancona,51,1148,2275,231,21,7,0,0,3682,798,2544,338,78,2,0,0,3760,7442
IT-AN,Ancona,52,1122,2431,266,19,5,0,0,3843,757,2598,379,79,2,0,0,3815,7658
IT-AN,Ancona,53,971,2404,276,20,5,0,0,3676,654,2586,363,130,1,0,0,3734,7410
IT-AN,Ancona,54,923,2420,265,23,8,0,0,3639,678,2676,388,127,4,0,0,3873,7512
IT-AN,Ancona,55,835,2449,270,33,4,0,0,3591,614,2684,422,134,1,0,0,3855,7446
IT-AN,Ancona,56,789,2434,267,35,6,0,0,3531,585,2624,375,150,0,0,0,3734,7265
IT-AN,Ancona,57,732,2598,315,43,4,0,0,3692,547,2755,354,154,0,0,0,3810,7502
IT-AN,Ancona,58,662,2604,289,56,4,0,0,3615,527,2602,377,171,3,0,0,3680,7295
IT-AN,Ancona,59,644,2640,324,46,4,0,0,3658,472,2853,372,210,2,0,0,3909,7567
IT-AN,Ancona,60,566,2517,278,51,3,0,0,3415,436,2658,378,229,1,0,0,3702,7117
IT-AN,Ancona,61,501,2479,306,64,4,0,0,3354,383,2447,321,217,1,0,0,3369,6723
IT-AN,Ancona,62,428,2525,250,68,5,0,0,3276,354,2466,332,281,2,0,0,3435,6711
IT-AN,Ancona,63,406,2326,254,70,1,0,0,3057,354,2357,263,277,0,0,0,3251,6308
IT-AN,Ancona,64,377,2286,211,70,4,0,0,2948,289,2397,232,333,0,0,0,3251,6199
IT-AN,Ancona,65,360,2244,233,87,1,0,0,2925,283,2259,217,341,1,0,0,3101,6026
IT-AN,Ancona,66,315,2230,176,98,4,0,0,2823,239,2291,231,378,1,0,0,3140,5963
IT-AN,Ancona,67,295,2296,175,106,2,0,1,2875,236,2274,250,470,0,0,0,3230,6105
IT-AN,Ancona,68,253,2164,182,105,1,0,0,2705,195,2171,214,472,0,0,0,3052,5757
IT-AN,Ancona,69,242,2148,128,111,1,0,0,2630,196,2017,183,461,0,0,0,2857,5487
IT-AN,Ancona,70,198,1987,125,130,4,0,0,2444,171,2060,162,511,1,0,0,2905,5349
IT-AN,Ancona,71,201,2057,131,140,2,0,0,2531,149,1922,179,562,0,0,0,2812,5343
IT-AN,Ancona,72,198,2072,123,133,4,0,0,2530,167,1893,121,605,0,0,0,2786,5316
IT-AN,Ancona,73,183,2108,122,172,2,0,0,2587,155,1870,145,693,1,0,0,2864,5451
IT-AN,Ancona,74,149,1970,85,159,0,0,0,2363,141,1723,129,764,0,0,0,2757,5120
IT-AN,Ancona,75,179,2070,58,192,1,0,0,2500,135,1756,101,768,0,0,0,2760,5260
IT-AN,Ancona,76,153,1935,72,198,1,0,0,2359,126,1599,102,905,0,0,0,2732,5091
IT-AN,Ancona,77,158,1843,75,249,0,0,0,2325,133,1573,88,1031,0,0,0,2825,5150
IT-AN,Ancona,78,114,1548,55,203,1,0,0,1921,85,1160,67,868,0,0,0,2180,4101
IT-AN,Ancona,79,99,1398,46,187,0,0,0,1730,90,1098,60,931,1,0,0,2180,3910
IT-AN,Ancona,80,101,1422,39,211,0,0,0,1773,99,1074,38,1079,0,0,0,2290,4063
IT-AN,Ancona,81,114,1221,28,235,2,0,0,1600,104,904,46,1092,0,0,0,2146,3746
IT-AN,Ancona,82,95,1220,28,217,1,0,0,1561,102,773,37,1171,0,0,0,2083,3644
IT-AN,Ancona,83,79,1236,19,237,0,0,0,1571,101,823,44,1380,0,0,0,2348,3919
IT-AN,Ancona,84,80,1213,26,250,1,0,0,1570,101,675,30,1470,0,0,0,2276,3846
IT-AN,Ancona,85,88,1011,17,259,0,0,0,1375,116,545,30,1459,0,0,0,2150,3525
IT-AN,Ancona,86,66,953,18,228,0,0,0,1265,72,407,19,1374,0,0,0,1872,3137
IT-AN,Ancona,87,38,699,9,224,0,0,0,970,73,304,14,1309,0,0,0,1700,2670
IT-AN,Ancona,88,48,639,5,229,0,0,0,921,82,239,22,1258,0,0,0,1601,2522
IT-AN,Ancona,89,45,508,6,187,0,0,0,746,56,173,10,1141,0,0,0,1380,2126
IT-AN,Ancona,90,19,402,10,180,0,0,0,611,58,108,13,982,0,0,0,1161,1772
IT-AN,Ancona,91,18,290,4,157,0,0,0,469,61,72,6,812,0,0,0,951,1420
IT-AN,Ancona,92,12,224,2,130,0,0,0,368,53,64,10,820,0,0,0,947,1315
IT-AN,Ancona,93,6,178,4,110,0,0,0,298,43,33,3,663,0,0,0,742,1040
IT-AN,Ancona,94,7,106,1,94,0,0,0,208,41,18,3,514,0,0,0,576,784
IT-AN,Ancona,95,5,78,0,61,0,0,0,144,40,10,1,394,0,0,0,445,589
IT-AN,Ancona,96,2,47,0,65,0,0,0,114,25,4,1,288,0,0,0,318,432
IT-AN,Ancona,97,0,11,0,40,0,0,0,51,18,3,1,213,0,0,0,235,286
IT-AN,Ancona,98,2,16,0,22,0,0,0,40,9,5,1,159,0,0,0,174,214
IT-AN,Ancona,99,1,7,1,21,0,0,0,30,6,2,1,115,0,0,0,124,154
IT-AN,Ancona,100,0,5,0,13,0,0,0,18,17,2,3,163,0,0,0,185,203
IT-AN,Ancona,999,109232,102528,7624,6199,174,2,2,225761,91019,103621,10443,30675,108,1,1,235868,461629
IT-AR,Arezzo,0,1026,0,0,0,0,0,0,1026,920,0,0,0,0,0,0,920,1946
IT-AR,Arezzo,1,1038,0,0,0,0,0,0,1038,985,0,0,0,0,0,0,985,2023
IT-AR,Arezzo,2,1110,0,0,0,0,0,0,1110,1121,0,0,0,0,0,0,1121,2231
IT-AR,Arezzo,3,1150,0,0,0,0,0,0,1150,1059,0,0,0,0,0,0,1059,2209
IT-AR,Arezzo,4,1174,0,0,0,0,0,0,1174,1071,0,0,0,0,0,0,1071,2245
IT-AR,Arezzo,5,1149,0,0,0,0,0,0,1149,1126,0,0,0,0,0,0,1126,2275
IT-AR,Arezzo,6,1272,0,0,0,0,0,0,1272,1177,0,0,0,0,0,0,1177,2449
IT-AR,Arezzo,7,1323,0,0,0,0,0,0,1323,1279,0,0,0,0,0,0,1279,2602
IT-AR,Arezzo,8,1323,0,0,0,0,0,0,1323,1233,0,0,0,0,0,0,1233,2556
IT-AR,Arezzo,9,1413,0,0,0,0,0,0,1413,1314,0,0,0,0,0,0,1314,2727
IT-AR,Arezzo,10,1471,0,0,0,0,0,0,1471,1221,0,0,0,0,0,0,1221,2692
IT-AR,Arezzo,11,1465,0,0,0,0,0,0,1465,1429,0,0,0,0,0,0,1429,2894
IT-AR,Arezzo,12,1508,0,0,0,0,0,0,1508,1463,0,0,0,0,0,0,1463,2971
IT-AR,Arezzo,13,1539,0,0,0,0,0,0,1539,1430,0,0,0,0,0,0,1430,2969
IT-AR,Arezzo,14,1571,0,0,0,0,0,0,1571,1435,0,0,0,0,0,0,1435,3006
IT-AR,Arezzo,15,1580,0,0,0,0,0,0,1580,1510,0,0,0,0,0,0,1510,3090
IT-AR,Arezzo,16,1628,0,0,0,0,0,0,1628,1510,0,0,0,0,0,0,1510,3138
IT-AR,Arezzo,17,1568,0,0,0,0,0,0,1568,1515,0,0,0,0,0,0,1515,3083
IT-AR,Arezzo,18,1580,0,0,0,0,0,0,1580,1507,0,1,0,0,0,0,1508,3088
IT-AR,Arezzo,19,1665,0,0,0,0,0,0,1665,1545,2,0,0,0,0,0,1547,3212
IT-AR,Arezzo,20,1559,2,0,0,0,0,0,1561,1433,8,1,0,0,0,0,1442,3003
IT-AR,Arezzo,21,1612,3,0,0,0,0,0,1615,1486,27,0,0,0,0,0,1513,3128
IT-AR,Arezzo,22,1635,3,2,0,0,0,0,1640,1454,35,0,0,0,0,0,1489,3129
IT-AR,Arezzo,23,1621,10,3,0,0,0,0,1634,1416,62,4,0,0,0,0,1482,3116
IT-AR,Arezzo,24,1649,24,3,0,0,0,0,1676,1358,89,1,0,0,0,0,1448,3124
IT-AR,Arezzo,25,1790,32,3,0,0,0,0,1825,1314,123,2,0,0,0,0,1439,3264
IT-AR,Arezzo,26,1668,58,0,0,0,0,0,1726,1323,150,3,0,1,0,0,1477,3203
IT-AR,Arezzo,27,1685,86,4,0,0,0,0,1775,1349,192,9,0,0,0,0,1550,3325
IT-AR,Arezzo,28,1542,117,2,0,0,1,0,1662,1240,258,2,0,0,0,0,1500,3162
IT-AR,Arezzo,29,1561,157,1,0,0,0,0,1719,1216,329,9,0,2,0,0,1556,3275
IT-AR,Arezzo,30,1488,197,5,0,3,0,0,1693,1107,400,7,0,0,0,0,1514,3207
IT-AR,Arezzo,31,1532,276,4,0,0,0,0,1812,1144,484,8,2,2,0,0,1640,3452
IT-AR,Arezzo,32,1447,355,4,3,1,0,0,1810,1061,538,21,1,3,0,0,1624,3434
IT-AR,Arezzo,33,1403,417,15,1,1,1,0,1838,978,726,27,5,2,0,0,1738,3576
IT-AR,Arezzo,34,1267,494,18,1,3,0,0,1783,1005,662,34,1,5,0,0,1707,3490
IT-AR,Arezzo,35,1311,588,14,1,1,1,0,1916,991,742,33,6,3,0,0,1775,3691
IT-AR,Arezzo,36,1227,679,20,1,0,0,0,1927,876,865,34,6,4,0,0,1785,3712
IT-AR,Arezzo,37,1087,678,33,3,1,0,0,1802,831,894,61,10,3,0,0,1799,3601
IT-AR,Arezzo,38,1091,752,31,2,1,1,1,1879,877,974,79,11,1,0,0,1942,3821
IT-AR,Arezzo,39,1070,818,37,3,2,0,0,1930,807,982,85,8,3,0,0,1885,3815
IT-AR,Arezzo,40,993,927,47,2,0,0,0,1969,731,1041,82,6,0,0,0,1860,3829
IT-AR,Arezzo,41,980,962,49,1,0,0,0,1992,730,1119,87,13,3,0,0,1952,3944
IT-AR,Arezzo,42,904,975,68,10,5,0,1,1963,685,1181,111,22,2,0,0,2001,3964
IT-AR,Arezzo,43,840,1124,90,5,1,0,0,2060,632,1268,133,26,0,0,0,2059,4119
IT-AR,Arezzo,44,891,1151,90,10,3,0,0,2145,623,1378,141,33,3,0,0,2178,4323
IT-AR,Arezzo,45,940,1211,92,8,3,0,0,2254,677,1375,194,31,1,0,0,2278,4532
IT-AR,Arezzo,46,845,1254,132,9,0,0,0,2240,650,1523,213,33,4,0,0,2423,4663
IT-AR,Arezzo,47,892,1428,158,4,1,1,0,2484,597,1648,230,40,2,0,0,2517,5001
IT-AR,Arezzo,48,844,1458,181,10,4,0,0,2497,629,1739,270,39,3,0,0,2680,5177
IT-AR,Arezzo,49,806,1614,169,17,0,0,0,2606,585,1737,275,57,0,0,0,2654,5260
IT-AR,Arezzo,50,752,1707,163,13,2,0,0,2637,515,1878,285,57,2,0,0,2737,5374
IT-AR,Arezzo,51,716,1781,204,17,2,0,0,2720,519,1865,247,71,4,0,0,2706,5426
IT-AR,Arezzo,52,698,1754,195,12,4,0,0,2663,507,1899,286,66,0,0,0,2758,5421
IT-AR,Arezzo,53,647,1766,225,20,0,0,0,2658,423,1894,273,70,1,0,0,2661,5319
IT-AR,Arezzo,54,558,1874,220,19,6,0,0,2677,423,2017,279,98,1,0,0,2818,5495
IT-AR,Arezzo,55,563,1794,219,33,0,0,0,2609,446,1999,313,101,0,0,0,2859,5468
IT-AR,Arezzo,56,545,1916,209,23,1,0,0,2694,397,1973,315,127,1,0,0,2813,5507
IT-AR,Arezzo,57,540,1921,243,33,7,1,0,2745,380,2000,286,150,0,0,0,2816,5561
IT-AR,Arezzo,58,472,1930,259,40,4,0,0,2705,351,2038,304,157,0,0,0,2850,5555
IT-AR,Arezzo,59,442,1997,244,46,1,0,0,2730,314,1978,276,145,3,0,0,2716,5446
IT-AR,Arezzo,60,380,1799,202,36,1,0,0,2418,249,1918,263,168,1,0,0,2599,5017
IT-AR,Arezzo,61,335,1838,204,39,3,0,0,2419,222,1924,262,185,0,0,0,2593,5012
IT-AR,Arezzo,62,286,1872,185,56,2,0,0,2401,205,1835,256,224,1,0,0,2521,4922
IT-AR,Arezzo,63,260,1799,176,58,1,0,1,2295,192,1892,219,219,0,0,0,2522,4817
IT-AR,Arezzo,64,252,1797,174,61,1,0,0,2285,175,1735,203,237,0,0,0,2350,4635
IT-AR,Arezzo,65,222,1675,163,60,1,0,0,2121,166,1716,170,265,0,0,0,2317,4438
IT-AR,Arezzo,66,199,1718,166,73,2,0,0,2158,135,1661,164,266,0,0,0,2226,4384
IT-AR,Arezzo,67,194,1607,142,81,0,0,0,2024,131,1632,152,328,0,0,0,2243,4267
IT-AR,Arezzo,68,168,1594,106,90,3,0,0,1961,127,1519,137,338,0,0,0,2121,4082
IT-AR,Arezzo,69,153,1586,125,104,4,0,0,1972,112,1580,155,380,0,0,0,2227,4199
IT-AR,Arezzo,70,146,1496,110,95,3,0,0,1850,113,1429,119,405,0,0,0,2066,3916
IT-AR,Arezzo,71,145,1509,101,91,2,0,0,1848,97,1347,103,347,0,0,0,1894,3742
IT-AR,Arezzo,72,161,1554,89,113,2,0,0,1919,100,1459,93,469,0,0,0,2121,4040
IT-AR,Arezzo,73,139,1508,87,132,1,0,0,1867,91,1353,108,510,0,0,0,2062,3929
IT-AR,Arezzo,74,123,1589,59,139,1,0,0,1911,83,1479,103,549,0,0,0,2214,4125
IT-AR,Arezzo,75,138,1714,70,154,0,0,0,2076,100,1534,77,674,0,0,0,2385,4461
IT-AR,Arezzo,76,115,1597,60,169,0,0,0,1941,88,1348,81,699,0,0,0,2216,4157
IT-AR,Arezzo,77,103,1508,42,176,1,0,0,1830,101,1189,82,694,0,0,0,2066,3896
IT-AR,Arezzo,78,76,1168,49,179,1,0,0,1473,61,914,50,614,0,0,0,1639,3112
IT-AR,Arezzo,79,62,1054,25,144,0,0,0,1285,65,750,45,643,0,0,0,1503,2788
IT-AR,Arezzo,80,84,1025,27,179,0,0,0,1315,63,772,40,741,0,0,0,1616,2931
IT-AR,Arezzo,81,70,917,30,144,0,0,0,1161,65,648,36,699,1,0,0,1449,2610
IT-AR,Arezzo,82,70,889,22,182,0,0,0,1163,64,630,28,747,0,0,0,1469,2632
IT-AR,Arezzo,83,77,903,20,218,0,0,0,1218,71,583,26,997,0,0,0,1677,2895
IT-AR,Arezzo,84,70,804,23,190,0,0,0,1087,71,495,30,908,0,0,0,1504,2591
IT-AR,Arezzo,85,60,776,16,220,0,0,0,1072,49,434,26,1004,0,0,0,1513,2585
IT-AR,Arezzo,86,63,576,10,178,0,0,0,827,64,345,12,909,0,0,0,1330,2157
IT-AR,Arezzo,87,53,502,7,197,0,0,0,759,49,229,14,780,0,0,0,1072,1831
IT-AR,Arezzo,88,39,441,9,192,0,0,0,681,39,209,15,804,0,0,0,1067,1748
IT-AR,Arezzo,89,32,340,6,167,0,0,0,545,38,158,11,710,0,0,0,917,1462
IT-AR,Arezzo,90,32,286,1,177,0,0,0,496,41,92,8,642,0,0,0,783,1279
IT-AR,Arezzo,91,23,183,4,95,0,0,0,305,25,63,2,577,0,0,0,667,972
IT-AR,Arezzo,92,25,148,1,133,0,0,0,307,26,39,3,546,0,0,0,614,921
IT-AR,Arezzo,93,17,120,1,85,0,0,0,223,24,25,2,445,0,0,0,496,719
IT-AR,Arezzo,94,12,70,0,80,0,0,0,162,9,19,0,295,0,0,0,323,485
IT-AR,Arezzo,95,6,53,2,50,0,0,0,111,16,10,2,254,0,0,0,282,393
IT-AR,Arezzo,96,2,30,0,44,0,0,0,76,11,10,2,224,0,0,0,247,323
IT-AR,Arezzo,97,3,16,0,19,0,0,0,38,5,3,1,151,0,0,0,160,198
IT-AR,Arezzo,98,3,7,0,19,0,0,0,29,6,1,0,93,0,0,0,100,129
IT-AR,Arezzo,99,0,3,2,10,0,0,0,15,3,4,0,71,0,0,0,78,93
IT-AR,Arezzo,100,2,1,0,18,0,0,0,21,8,3,0,101,0,0,0,112,133
IT-AR,Arezzo,999,76066,76362,5972,4994,86,6,3,163489,63290,77078,8121,21304,62,0,0,169855,333344
IT-AP,Ascoli Piceno,0,627,0,0,0,0,0,0,627,565,0,0,0,0,0,0,565,1192
IT-AP,Ascoli Piceno,1,622,0,0,0,0,0,0,622,564,0,0,0,0,0,0,564,1186
IT-AP,Ascoli Piceno,2,620,0,0,0,0,0,0,620,619,0,0,0,0,0,0,619,1239
IT-AP,Ascoli Piceno,3,659,0,0,0,0,0,0,659,627,0,0,0,0,0,0,627,1286
IT-AP,Ascoli Piceno,4,633,0,0,0,0,0,0,633,638,0,0,0,0,0,0,638,1271
IT-AP,Ascoli Piceno,5,672,0,0,0,0,0,0,672,666,0,0,0,0,0,0,666,1338
IT-AP,Ascoli Piceno,6,696,0,0,0,0,0,0,696,724,0,0,0,0,0,0,724,1420
IT-AP,Ascoli Piceno,7,813,0,0,0,0,0,0,813,719,0,0,0,0,0,0,719,1532
IT-AP,Ascoli Piceno,8,774,0,0,0,0,0,0,774,787,0,0,0,0,0,0,787,1561
IT-AP,Ascoli Piceno,9,889,0,0,0,0,0,0,889,780,0,0,0,0,0,0,780,1669
IT-AP,Ascoli Piceno,10,854,0,0,0,0,0,0,854,834,0,0,0,0,0,0,834,1688
IT-AP,Ascoli Piceno,11,837,0,0,0,0,0,0,837,827,0,0,0,0,0,0,827,1664
IT-AP,Ascoli Piceno,12,875,0,0,0,0,0,0,875,823,0,0,0,0,0,0,823,1698
IT-AP,Ascoli Piceno,13,889,0,0,0,0,0,0,889,879,0,0,0,0,0,0,879,1768
IT-AP,Ascoli Piceno,14,913,0,0,0,0,0,0,913,868,0,0,0,0,0,0,868,1781
IT-AP,Ascoli Piceno,15,977,0,0,0,0,0,0,977,894,0,0,0,0,0,0,894,1871
IT-AP,Ascoli Piceno,16,940,0,0,0,0,0,0,940,840,0,0,0,0,0,0,840,1780
IT-AP,Ascoli Piceno,17,952,0,0,0,0,0,0,952,855,0,0,0,0,0,0,855,1807
IT-AP,Ascoli Piceno,18,924,0,0,0,0,0,0,924,894,0,0,0,0,0,0,894,1818
IT-AP,Ascoli Piceno,19,1014,0,0,0,0,0,0,1014,927,1,0,0,0,0,0,928,1942
IT-AP,Ascoli Piceno,20,975,2,0,0,0,0,0,977,833,4,0,0,0,0,0,837,1814
IT-AP,Ascoli Piceno,21,978,0,0,0,0,0,0,978,801,9,0,0,0,0,0,810,1788
IT-AP,Ascoli Piceno,22,983,2,0,0,0,0,0,985,844,19,0,0,0,0,0,863,1848
IT-AP,Ascoli Piceno,23,1064,4,1,0,0,0,0,1069,910,22,0,0,0,0,0,932,2001
IT-AP,Ascoli Piceno,24,1046,10,0,0,0,0,0,1056,902,31,0,0,0,0,0,933,1989
IT-AP,Ascoli Piceno,25,1107,13,1,0,0,0,0,1121,941,41,0,0,0,0,0,982,2103
IT-AP,Ascoli Piceno,26,961,21,0,0,0,0,0,982,873,71,1,0,0,0,0,945,1927
IT-AP,Ascoli Piceno,27,1038,32,0,0,0,0,0,1070,783,99,4,0,0,0,0,886,1956
IT-AP,Ascoli Piceno,28,1009,53,1,0,0,0,0,1063,797,118,3,0,1,0,0,919,1982
IT-AP,Ascoli Piceno,29,961,79,0,0,0,0,0,1040,772,166,2,2,0,0,0,942,1982
IT-AP,Ascoli Piceno,30,989,97,0,0,0,0,0,1086,774,207,6,0,0,0,0,987,2073
IT-AP,Ascoli Piceno,31,959,148,3,0,0,0,0,1110,708,260,10,2,0,0,0,980,2090
IT-AP,Ascoli Piceno,32,884,202,5,1,1,0,0,1093,653,346,11,0,1,0,0,1011,2104
IT-AP,Ascoli Piceno,33,884,247,8,0,0,0,0,1139,613,339,14,1,1,0,0,968,2107
IT-AP,Ascoli Piceno,34,785,304,8,2,1,0,0,1100,587,437,18,2,2,0,0,1046,2146
IT-AP,Ascoli Piceno,35,772,329,12,0,0,0,0,1113,585,489,23,2,0,0,0,1099,2212
IT-AP,Ascoli Piceno,36,744,355,17,0,1,0,0,1117,499,541,20,3,0,0,0,1063,2180
IT-AP,Ascoli Piceno,37,689,381,21,0,0,0,0,1091,493,556,27,3,1,0,0,1080,2171
IT-AP,Ascoli Piceno,38,676,426,22,0,1,0,0,1125,474,615,36,6,1,0,0,1132,2257
IT-AP,Ascoli Piceno,39,635,516,24,0,1,0,0,1176,409,657,34,5,0,0,0,1105,2281
IT-AP,Ascoli Piceno,40,613,533,26,1,2,0,0,1175,407,721,48,4,0,0,0,1180,2355
IT-AP,Ascoli Piceno,41,580,588,32,1,0,0,0,1201,407,661,61,8,0,0,0,1137,2338
IT-AP,Ascoli Piceno,42,570,596,29,7,1,0,0,1203,394,702,64,4,0,0,0,1164,2367
IT-AP,Ascoli Piceno,43,573,669,32,2,2,0,0,1278,353,764,68,16,0,0,0,1201,2479
IT-AP,Ascoli Piceno,44,517,700,46,13,0,0,0,1276,364,825,79,9,1,0,0,1278,2554
IT-AP,Ascoli Piceno,45,539,686,63,3,1,0,0,1292,377,895,108,11,0,0,0,1391,2683
IT-AP,Ascoli Piceno,46,498,734,45,4,2,0,0,1283,360,989,88,16,0,0,0,1453,2736
IT-AP,Ascoli Piceno,47,486,799,72,5,3,0,0,1365,310,950,105,24,1,0,0,1390,2755
IT-AP,Ascoli Piceno,48,472,916,77,1,0,0,0,1466,335,1008,112,14,1,0,0,1470,2936
IT-AP,Ascoli Piceno,49,506,944,69,7,2,0,0,1528,358,1024,121,29,0,0,0,1532,3060
IT-AP,Ascoli Piceno,50,492,938,91,4,2,0,0,1527,287,1071,121,26,1,0,0,1506,3033
IT-AP,Ascoli Piceno,51,504,976,93,6,0,0,0,1579,330,1165,132,30,1,0,0,1658,3237
IT-AP,Ascoli Piceno,52,419,1029,102,7,1,0,0,1558,275,1155,133,43,0,0,0,1606,3164
IT-AP,Ascoli Piceno,53,423,987,94,10,0,0,0,1514,242,1209,159,54,0,0,0,1664,3178
IT-AP,Ascoli Piceno,54,394,1054,108,8,2,0,0,1566,257,1210,174,45,0,0,0,1686,3252
IT-AP,Ascoli Piceno,55,364,1144,117,17,3,0,0,1645,245,1236,156,67,0,0,0,1704,3349
IT-AP,Ascoli Piceno,56,336,1123,127,11,3,0,0,1600,194,1266,155,67,0,0,0,1682,3282
IT-AP,Ascoli Piceno,57,300,1094,107,22,3,0,0,1526,199,1238,145,87,1,0,0,1670,3196
IT-AP,Ascoli Piceno,58,274,1236,131,16,2,0,0,1659,205,1284,143,85,0,0,0,1717,3376
IT-AP,Ascoli Piceno,59,257,1286,125,19,0,0,0,1687,210,1358,154,97,0,0,0,1819,3506
IT-AP,Ascoli Piceno,60,241,1164,132,19,2,0,0,1558,161,1309,140,113,0,0,0,1723,3281
IT-AP,Ascoli Piceno,61,205,1162,107,22,0,0,0,1496,147,1168,135,125,0,0,0,1575,3071
IT-AP,Ascoli Piceno,62,177,1147,116,31,1,0,0,1472,160,1123,130,130,1,0,0,1544,3016
IT-AP,Ascoli Piceno,63,177,1157,104,31,4,0,0,1473,147,1170,108,133,0,0,0,1558,3031
IT-AP,Ascoli Piceno,64,163,1100,92,20,2,0,0,1377,138,1112,96,158,1,0,0,1505,2882
IT-AP,Ascoli Piceno,65,157,1055,78,35,1,0,0,1326,131,1138,109,178,0,0,0,1556,2882
IT-AP,Ascoli Piceno,66,126,1040,72,33,0,0,0,1271,116,1103,95,165,0,0,0,1479,2750
IT-AP,Ascoli Piceno,67,137,1044,75,37,0,0,0,1293,96,1056,69,236,0,0,0,1457,2750
IT-AP,Ascoli Piceno,68,112,1028,54,39,0,0,0,1233,104,992,70,246,0,0,0,1412,2645
IT-AP,Ascoli Piceno,69,113,946,62,54,1,0,0,1176,94,995,59,211,0,0,0,1359,2535
IT-AP,Ascoli Piceno,70,88,990,47,44,0,0,0,1169,89,899,64,268,1,0,0,1321,2490
IT-AP,Ascoli Piceno,71,99,932,35,56,0,0,0,1122,72,883,51,281,1,0,0,1288,2410
IT-AP,Ascoli Piceno,72,74,921,52,53,0,0,0,1100,56,812,34,331,0,0,0,1233,2333
IT-AP,Ascoli Piceno,73,67,970,40,73,0,0,0,1150,58,854,41,324,0,0,0,1277,2427
IT-AP,Ascoli Piceno,74,75,924,37,62,0,0,0,1098,61,828,41,327,0,0,0,1257,2355
IT-AP,Ascoli Piceno,75,56,949,20,68,0,0,0,1093,66,781,26,450,0,0,0,1323,2416
IT-AP,Ascoli Piceno,76,58,873,38,80,0,0,0,1049,65,691,42,459,0,0,0,1257,2306
IT-AP,Ascoli Piceno,77,53,809,21,83,0,0,0,966,71,619,42,455,0,0,0,1187,2153
IT-AP,Ascoli Piceno,78,49,663,21,72,1,0,0,806,38,497,27,454,0,0,0,1016,1822
IT-AP,Ascoli Piceno,79,44,584,15,74,0,0,0,717,40,401,20,414,0,0,0,875,1592
IT-AP,Ascoli Piceno,80,44,673,19,92,0,0,0,828,41,395,18,517,0,0,0,971,1799
IT-AP,Ascoli Piceno,81,33,609,14,75,0,0,0,731,32,346,14,529,0,0,0,921,1652
IT-AP,Ascoli Piceno,82,38,555,13,81,0,0,0,687,63,324,10,553,0,0,0,950,1637
IT-AP,Ascoli Piceno,83,37,601,17,115,0,0,0,770,58,335,18,631,0,0,0,1042,1812
IT-AP,Ascoli Piceno,84,40,538,7,117,0,0,0,702,41,302,11,640,0,0,0,994,1696
IT-AP,Ascoli Piceno,85,28,501,6,114,0,0,0,649,47,258,17,653,0,0,0,975,1624
IT-AP,Ascoli Piceno,86,27,438,4,103,0,0,0,572,33,185,6,599,0,0,0,823,1395
IT-AP,Ascoli Piceno,87,26,342,3,91,0,0,0,462,39,142,8,550,0,0,0,739,1201
IT-AP,Ascoli Piceno,88,17,313,4,100,0,0,0,434,26,100,7,528,0,0,0,661,1095
IT-AP,Ascoli Piceno,89,14,253,0,93,0,0,0,360,28,61,4,481,0,0,0,574,934
IT-AP,Ascoli Piceno,90,10,196,3,95,0,0,0,304,33,46,3,464,0,0,0,546,850
IT-AP,Ascoli Piceno,91,14,119,2,74,0,0,0,209,23,32,2,347,0,0,0,404,613
IT-AP,Ascoli Piceno,92,5,89,3,63,0,0,0,160,23,19,4,346,0,0,0,392,552
IT-AP,Ascoli Piceno,93,5,67,1,39,0,0,0,112,13,20,0,289,0,0,0,322,434
IT-AP,Ascoli Piceno,94,9,44,0,43,0,0,0,96,10,8,2,210,0,0,0,230,326
IT-AP,Ascoli Piceno,95,2,40,0,33,0,0,0,75,15,4,0,142,0,0,0,161,236
IT-AP,Ascoli Piceno,96,2,18,0,27,0,0,0,47,12,7,2,117,0,0,0,138,185
IT-AP,Ascoli Piceno,97,1,13,1,16,0,0,0,31,9,5,0,83,0,0,0,97,128
IT-AP,Ascoli Piceno,98,0,7,0,12,0,0,0,19,8,2,0,63,0,0,0,73,92
IT-AP,Ascoli Piceno,99,0,2,0,2,0,0,0,4,3,1,0,34,0,0,0,38,42
IT-AP,Ascoli Piceno,100,1,2,0,10,0,0,0,13,5,1,0,70,0,0,0,76,89
IT-AP,Ascoli Piceno,999,46060,46131,3024,2548,46,0,0,97809,38162,46783,4060,14066,17,0,0,103088,200897
IT-AT,Asti,0,603,0,0,0,0,0,0,603,581,0,0,0,0,0,0,581,1184
IT-AT,Asti,1,627,0,0,0,0,0,0,627,614,0,0,0,0,0,0,614,1241
IT-AT,Asti,2,691,0,0,0,0,0,0,691,632,0,0,0,0,0,0,632,1323
IT-AT,Asti,3,706,0,0,0,0,0,0,706,625,0,0,0,0,0,0,625,1331
IT-AT,Asti,4,741,0,0,0,0,0,0,741,650,0,0,0,0,0,0,650,1391
IT-AT,Asti,5,693,0,0,0,0,0,0,693,699,0,0,0,0,0,0,699,1392
IT-AT,Asti,6,778,0,0,0,0,0,0,778,776,0,0,0,0,0,0,776,1554
IT-AT,Asti,7,819,0,0,0,0,0,0,819,807,0,0,0,0,0,0,807,1626
IT-AT,Asti,8,856,0,0,0,0,0,0,856,781,0,0,0,0,0,0,781,1637
IT-AT,Asti,9,840,0,0,0,0,0,0,840,829,0,0,0,0,0,0,829,1669
IT-AT,Asti,10,882,0,0,0,0,0,0,882,863,0,0,0,0,0,0,863,1745
IT-AT,Asti,11,956,0,0,0,0,0,0,956,872,0,0,0,0,0,0,872,1828
IT-AT,Asti,12,945,0,0,0,0,0,0,945,846,0,0,0,0,0,0,846,1791
IT-AT,Asti,13,925,0,0,0,0,0,0,925,871,0,0,0,0,0,0,871,1796
IT-AT,Asti,14,976,0,0,0,0,0,0,976,916,0,0,0,0,0,0,916,1892
IT-AT,Asti,15,1003,0,0,0,0,0,0,1003,925,0,0,0,0,0,0,925,1928
IT-AT,Asti,16,1044,0,0,0,0,0,0,1044,873,0,0,0,0,0,0,873,1917
IT-AT,Asti,17,942,0,0,0,0,0,0,942,963,0,0,0,0,0,0,963,1905
IT-AT,Asti,18,1032,0,0,0,0,0,0,1032,950,0,0,0,0,0,0,950,1982
IT-AT,Asti,19,1016,1,0,0,0,0,0,1017,922,4,0,0,0,0,0,926,1943
IT-AT,Asti,20,1033,3,2,0,0,0,0,1038,905,14,0,0,1,0,0,920,1958
IT-AT,Asti,21,1019,2,0,0,0,0,0,1021,960,12,0,0,0,0,0,972,1993
IT-AT,Asti,22,998,9,0,0,0,0,0,1007,911,25,0,0,0,0,0,936,1943
IT-AT,Asti,23,1059,13,0,0,0,0,0,1072,873,47,0,1,1,0,0,922,1994
IT-AT,Asti,24,1049,21,2,0,0,0,0,1072,859,70,1,0,0,0,0,930,2002
IT-AT,Asti,25,1145,31,2,0,0,0,0,1178,853,81,0,1,0,0,0,935,2113
IT-AT,Asti,26,995,33,4,0,0,0,0,1032,807,124,4,0,1,0,0,936,1968
IT-AT,Asti,27,1042,63,5,0,0,1,0,1111,755,152,8,1,1,0,0,917,2028
IT-AT,Asti,28,998,78,3,0,1,0,0,1080,758,190,6,1,1,0,0,956,2036
IT-AT,Asti,29,927,108,3,0,0,0,0,1038,657,250,8,0,1,0,0,916,1954
IT-AT,Asti,30,891,185,6,0,1,0,0,1083,650,280,13,1,2,1,0,947,2030
IT-AT,Asti,31,850,214,3,0,2,0,0,1069,623,363,14,0,3,1,0,1004,2073
IT-AT,Asti,32,756,246,14,0,3,0,0,1019,559,369,13,6,2,0,0,949,1968
IT-AT,Asti,33,753,264,9,0,2,0,0,1028,570,444,23,2,4,0,0,1043,2071
IT-AT,Asti,34,705,345,14,0,1,0,0,1065,478,472,20,8,1,1,0,980,2045
IT-AT,Asti,35,700,429,15,1,2,0,0,1147,503,518,19,6,0,0,0,1046,2193
IT-AT,Asti,36,605,420,20,0,4,0,0,1049,404,593,38,4,2,0,0,1041,2090
IT-AT,Asti,37,590,474,27,1,4,0,0,1096,412,548,34,11,0,0,0,1005,2101
IT-AT,Asti,38,573,465,20,1,1,0,0,1060,423,645,57,8,1,0,0,1134,2194
IT-AT,Asti,39,555,509,24,4,1,0,0,1093,391,589,64,7,1,1,0,1053,2146
IT-AT,Asti,40,485,523,41,1,1,0,0,1051,377,679,54,7,5,1,0,1123,2174
IT-AT,Asti,41,513,574,31,1,1,0,0,1120,376,710,60,12,2,0,0,1160,2280
IT-AT,Asti,42,479,626,49,0,0,0,0,1154,361,729,85,11,0,0,0,1186,2340
IT-AT,Asti,43,526,656,47,2,2,0,0,1233,360,735,92,14,2,0,0,1203,2436
IT-AT,Asti,44,514,682,61,2,6,1,0,1266,341,795,85,12,0,0,0,1233,2499
IT-AT,Asti,45,511,757,71,1,4,0,0,1344,359,852,109,19,2,1,0,1342,2686
IT-AT,Asti,46,504,804,75,7,2,0,0,1392,391,938,106,21,3,0,0,1459,2851
IT-AT,Asti,47,535,866,97,6,4,0,0,1508,342,934,153,23,3,0,0,1455,2963
IT-AT,Asti,48,518,931,109,6,1,0,0,1565,359,1060,162,26,3,0,0,1610,3175
IT-AT,Asti,49,552,971,126,6,6,0,0,1661,358,1061,165,47,5,1,0,1637,3298
IT-AT,Asti,50,543,957,120,8,4,0,0,1632,291,1015,177,30,2,0,0,1515,3147
IT-AT,Asti,51,490,1064,125,15,3,0,0,1697,329,1132,185,49,5,0,0,1700,3397
IT-AT,Asti,52,444,1061,146,12,4,0,0,1667,289,1188,169,51,2,0,0,1699,3366
IT-AT,Asti,53,430,1078,156,14,0,1,0,1679,259,1116,196,52,1,1,0,1625,3304
IT-AT,Asti,54,446,1189,155,10,2,0,0,1802,290,1191,226,53,1,0,0,1761,3563
IT-AT,Asti,55,383,1120,176,17,3,0,0,1699,256,1197,210,60,2,0,0,1725,3424
IT-AT,Asti,56,394,1179,158,11,9,0,0,1751,248,1204,226,64,1,0,0,1743,3494
IT-AT,Asti,57,372,1174,168,28,1,0,0,1743,249,1242,224,80,0,0,0,1795,3538
IT-AT,Asti,58,318,1233,184,27,3,0,0,1765,241,1200,212,82,1,0,0,1736,3501
IT-AT,Asti,59,333,1204,150,21,6,0,0,1714,236,1220,208,95,1,0,0,1760,3474
IT-AT,Asti,60,268,1164,171,31,2,0,0,1636,189,1190,209,146,1,0,0,1735,3371
IT-AT,Asti,61,244,1167,143,26,2,0,0,1582,178,1116,178,111,1,0,0,1584,3166
IT-AT,Asti,62,232,1138,146,35,0,0,0,1551,143,1158,164,135,1,0,0,1601,3152
IT-AT,Asti,63,218,1106,163,41,1,0,0,1529,132,1133,163,149,1,0,0,1578,3107
IT-AT,Asti,64,200,1121,144,38,2,0,0,1505,115,1032,156,148,1,0,0,1452,2957
IT-AT,Asti,65,200,1090,118,33,1,0,0,1442,99,991,123,181,1,0,0,1395,2837
IT-AT,Asti,66,169,1021,133,45,0,0,0,1368,111,1055,147,198,1,0,0,1512,2880
IT-AT,Asti,67,167,1055,109,56,0,0,0,1387,112,1009,114,218,0,0,0,1453,2840
IT-AT,Asti,68,154,1007,96,52,3,0,0,1312,94,968,116,233,1,0,0,1412,2724
IT-AT,Asti,69,138,1002,108,62,0,0,0,1310,65,917,118,250,2,0,0,1352,2662
IT-AT,Asti,70,124,956,100,56,0,0,0,1236,67,922,75,272,0,0,0,1336,2572
IT-AT,Asti,71,126,978,77,62,0,0,0,1243,62,901,79,278,0,0,0,1320,2563
IT-AT,Asti,72,108,937,58,55,3,0,0,1161,75,802,85,313,0,0,0,1275,2436
IT-AT,Asti,73,100,1023,80,90,3,0,0,1296,68,861,86,343,0,0,0,1358,2654
IT-AT,Asti,74,87,946,65,77,0,0,0,1175,56,882,76,376,0,0,0,1390,2565
IT-AT,Asti,75,107,1025,49,110,1,0,0,1292,64,880,73,457,0,0,0,1474,2766
IT-AT,Asti,76,87,996,65,118,0,0,0,1266,65,776,65,431,1,0,0,1338,2604
IT-AT,Asti,77,65,881,50,125,0,0,0,1121,58,717,62,487,0,0,0,1324,2445
IT-AT,Asti,78,58,611,39,84,0,0,0,792,49,453,37,383,1,0,0,923,1715
IT-AT,Asti,79,64,627,25,92,0,0,0,808,40,440,42,458,0,0,0,980,1788
IT-AT,Asti,80,60,630,17,99,0,0,0,806,47,474,37,502,0,0,0,1060,1866
IT-AT,Asti,81,42,596,24,103,0,0,0,765,29,402,35,510,0,0,0,976,1741
IT-AT,Asti,82,64,518,12,122,0,0,0,716,40,353,24,498,0,0,0,915,1631
IT-AT,Asti,83,47,529,18,131,0,0,0,725,38,354,21,611,0,0,0,1024,1749
IT-AT,Asti,84,62,480,13,112,0,1,0,668,41,317,31,669,0,0,0,1058,1726
IT-AT,Asti,85,39,476,15,136,0,0,0,666,30,243,16,662,0,0,0,951,1617
IT-AT,Asti,86,35,369,8,134,0,0,0,546,36,189,20,592,0,0,0,837,1383
IT-AT,Asti,87,29,282,8,128,0,0,0,447,39,110,10,548,0,0,0,707,1154
IT-AT,Asti,88,28,242,7,115,0,0,0,392,27,110,13,557,0,0,0,707,1099
IT-AT,Asti,89,23,203,7,122,0,0,0,355,18,78,8,477,0,0,0,581,936
IT-AT,Asti,90,10,150,3,105,0,0,0,268,28,53,5,390,0,0,0,476,744
IT-AT,Asti,91,11,109,1,91,0,0,0,212,20,54,5,393,0,0,0,472,684
IT-AT,Asti,92,12,79,0,47,0,0,0,138,22,32,5,346,0,0,0,405,543
IT-AT,Asti,93,7,62,4,55,0,0,0,128,17,15,5,328,0,0,0,365,493
IT-AT,Asti,94,5,41,1,47,0,0,0,94,18,16,3,245,0,0,0,282,376
IT-AT,Asti,95,7,29,0,33,0,0,0,69,18,15,2,170,0,0,0,205,274
IT-AT,Asti,96,3,9,0,22,0,0,0,34,9,4,1,119,0,0,0,133,167
IT-AT,Asti,97,2,12,0,17,0,0,0,31,11,3,1,86,0,0,0,101,132
IT-AT,Asti,98,1,8,0,8,0,0,0,17,5,2,1,63,0,0,0,71,88
IT-AT,Asti,99,2,2,0,7,0,0,0,11,3,0,0,43,0,0,0,46,57
IT-AT,Asti,100,0,2,0,10,0,0,0,12,4,1,2,71,0,0,0,78,90
IT-AT,Asti,999,47013,47241,4495,3134,102,4,0,101989,38000,47016,5839,14312,75,8,0,105250,207239
IT-AV,Avellino,0,1310,0,0,0,0,0,0,1310,1257,0,0,0,0,0,0,1257,2567
IT-AV,Avellino,1,1345,0,0,0,0,0,0,1345,1270,0,0,0,0,0,0,1270,2615
IT-AV,Avellino,2,1352,0,0,0,0,0,0,1352,1231,0,0,0,0,0,0,1231,2583
IT-AV,Avellino,3,1366,0,0,0,0,0,0,1366,1273,0,0,0,0,0,0,1273,2639
IT-AV,Avellino,4,1398,0,0,0,0,0,0,1398,1406,0,0,0,0,0,0,1406,2804
IT-AV,Avellino,5,1452,0,0,0,0,0,0,1452,1447,0,0,0,0,0,0,1447,2899
IT-AV,Avellino,6,1563,0,0,0,0,0,0,1563,1540,0,0,0,0,0,0,1540,3103
IT-AV,Avellino,7,1592,0,0,0,0,0,0,1592,1514,0,0,0,0,0,0,1514,3106
IT-AV,Avellino,8,1545,0,0,0,0,0,0,1545,1444,0,0,0,0,0,0,1444,2989
IT-AV,Avellino,9,1611,0,0,0,0,0,0,1611,1470,0,0,0,0,0,0,1470,3081
IT-AV,Avellino,10,1614,0,0,0,0,0,0,1614,1611,0,0,0,0,0,0,1611,3225
IT-AV,Avellino,11,1704,0,0,0,0,0,0,1704,1611,0,0,0,0,0,0,1611,3315
IT-AV,Avellino,12,1708,0,0,0,0,0,0,1708,1636,0,0,0,0,0,0,1636,3344
IT-AV,Avellino,13,1857,0,0,0,0,0,0,1857,1703,0,0,0,0,0,0,1703,3560
IT-AV,Avellino,14,1886,0,0,0,0,0,0,1886,1786,0,0,0,0,0,0,1786,3672
IT-AV,Avellino,15,1867,0,0,0,0,0,0,1867,1840,0,0,0,0,0,0,1840,3707
IT-AV,Avellino,16,1969,0,0,0,0,0,0,1969,1808,0,0,0,0,0,0,1808,3777
IT-AV,Avellino,17,2002,0,0,0,0,0,0,2002,1851,0,0,0,0,0,0,1851,3853
IT-AV,Avellino,18,2126,0,0,0,0,0,0,2126,1811,0,0,0,0,0,0,1811,3937
IT-AV,Avellino,19,2146,1,0,0,0,0,0,2147,1968,2,0,0,0,0,0,1970,4117
IT-AV,Avellino,20,2148,1,0,0,0,0,0,2149,1981,7,0,0,0,0,0,1988,4137
IT-AV,Avellino,21,2154,1,0,0,0,0,0,2155,1941,13,0,0,0,0,0,1954,4109
IT-AV,Avellino,22,2116,3,0,0,0,0,0,2119,1929,20,0,0,0,0,0,1949,4068
IT-AV,Avellino,23,2163,8,1,0,0,0,0,2172,1980,41,4,0,0,0,0,2025,4197
IT-AV,Avellino,24,2266,15,1,0,0,0,0,2282,1972,49,0,0,0,0,0,2021,4303
IT-AV,Avellino,25,2257,37,1,0,0,0,0,2295,1986,90,1,0,2,0,0,2079,4374
IT-AV,Avellino,26,2207,54,1,0,1,0,0,2263,1889,147,3,2,1,0,0,2042,4305
IT-AV,Avellino,27,2243,77,0,0,0,0,0,2320,1861,215,2,0,2,0,0,2080,4400
IT-AV,Avellino,28,2036,111,1,0,0,0,0,2148,1755,295,1,2,0,0,0,2053,4201
IT-AV,Avellino,29,2011,151,1,0,0,0,0,2163,1650,428,4,0,0,0,0,2082,4245
IT-AV,Avellino,30,2111,263,1,1,0,0,0,2376,1560,541,9,2,0,0,0,2112,4488
IT-AV,Avellino,31,2060,378,5,0,0,0,0,2443,1559,764,16,0,0,0,0,2339,4782
IT-AV,Avellino,32,1909,471,5,1,0,0,0,2386,1326,877,19,2,1,0,0,2225,4611
IT-AV,Avellino,33,1784,628,10,0,0,0,0,2422,1292,1000,15,0,0,0,0,2307,4729
IT-AV,Avellino,34,1683,733,10,1,1,0,0,2428,1148,1098,36,10,1,0,0,2293,4721
IT-AV,Avellino,35,1618,823,11,1,1,0,0,2454,1062,1210,35,3,3,0,0,2313,4767
IT-AV,Avellino,36,1387,923,22,1,0,0,0,2333,884,1329,48,6,0,0,0,2267,4600
IT-AV,Avellino,37,1290,1049,24,1,1,0,0,2365,821,1347,44,9,1,0,0,2222,4587
IT-AV,Avellino,38,1287,1220,29,3,1,0,0,2540,836,1466,45,13,0,0,0,2360,4900
IT-AV,Avellino,39,1155,1219,42,1,0,0,0,2417,744,1597,52,9,1,0,0,2403,4820
IT-AV,Avellino,40,1054,1262,36,2,0,0,0,2354,689,1643,55,14,1,0,0,2402,4756
IT-AV,Avellino,41,1049,1434,42,1,0,0,0,2526,648,1625,71,15,0,1,0,2360,4886
IT-AV,Avellino,42,1005,1471,57,4,0,0,0,2537,579,1808,90,23,0,0,0,2500,5037
IT-AV,Avellino,43,952,1497,50,3,1,0,0,2503,508,1721,91,23,0,0,0,2343,4846
IT-AV,Avellino,44,904,1651,57,1,2,0,0,2615,554,1874,108,24,0,1,0,2561,5176
IT-AV,Avellino,45,819,1685,61,11,2,0,0,2578,501,2125,127,44,0,0,0,2797,5375
IT-AV,Avellino,46,846,1806,74,12,1,0,0,2739,532,2090,101,36,1,0,0,2760,5499
IT-AV,Avellino,47,816,1916,75,12,2,0,0,2821,492,2213,125,51,0,0,0,2881,5702
IT-AV,Avellino,48,779,1955,98,11,0,0,0,2843,506,2328,147,62,1,0,0,3044,5887
IT-AV,Avellino,49,733,2068,91,16,1,0,0,2909,462,2319,134,72,0,0,0,2987,5896
IT-AV,Avellino,50,667,2035,108,13,2,0,0,2825,435,2367,144,74,0,0,0,3020,5845
IT-AV,Avellino,51,699,2212,91,19,0,0,0,3021,408,2426,152,92,0,0,0,3078,6099
IT-AV,Avellino,52,629,2285,103,18,1,0,0,3036,429,2520,144,112,0,0,0,3205,6241
IT-AV,Avellino,53,554,2244,124,30,0,0,0,2952,399,2527,162,120,0,0,0,3208,6160
IT-AV,Avellino,54,580,2417,123,29,0,0,0,3149,371,2541,170,146,0,0,0,3228,6377
IT-AV,Avellino,55,533,2515,119,30,1,0,0,3198,407,2669,173,154,0,0,0,3403,6601
IT-AV,Avellino,56,498,2543,99,29,1,0,0,3170,369,2653,145,173,0,0,0,3340,6510
IT-AV,Avellino,57,497,2579,118,56,0,0,0,3250,378,2641,141,170,0,0,0,3330,6580
IT-AV,Avellino,58,446,2743,120,47,1,0,0,3357,339,2633,131,216,0,0,0,3319,6676
IT-AV,Avellino,59,443,2790,126,49,1,0,0,3409,348,2795,143,275,0,0,0,3561,6970
IT-AV,Avellino,60,410,2661,113,65,0,0,0,3249,330,2510,143,268,0,0,0,3251,6500
IT-AV,Avellino,61,381,2491,110,50,1,0,0,3033,308,2467,117,303,0,0,0,3195,6228
IT-AV,Avellino,62,313,2573,104,76,0,0,0,3066,288,2417,119,320,0,0,0,3144,6210
IT-AV,Avellino,63,297,2466,99,73,0,0,0,2935,313,2322,96,380,0,1,0,3112,6047
IT-AV,Avellino,64,303,2382,82,86,0,0,0,2853,294,2280,103,350,0,0,0,3027,5880
IT-AV,Avellino,65,234,2278,72,85,0,0,0,2669,221,2083,101,359,0,0,0,2764,5433
IT-AV,Avellino,66,231,2210,66,112,1,0,0,2620,236,1972,77,446,0,0,0,2731,5351
IT-AV,Avellino,67,179,2111,63,81,0,0,0,2434,215,1922,81,471,0,0,0,2689,5123
IT-AV,Avellino,68,172,2133,82,108,0,0,0,2495,178,1732,83,494,0,0,0,2487,4982
IT-AV,Avellino,69,148,2035,53,106,0,0,0,2342,187,1754,75,517,0,0,0,2533,4875
IT-AV,Avellino,70,151,1942,50,120,0,0,0,2263,163,1609,41,545,0,0,0,2358,4621
IT-AV,Avellino,71,136,1856,61,100,0,0,0,2153,172,1547,57,582,0,0,0,2358,4511
IT-AV,Avellino,72,136,1818,48,148,0,0,0,2150,163,1440,45,581,0,0,0,2229,4379
IT-AV,Avellino,73,129,1766,44,148,0,0,0,2087,151,1430,53,668,0,0,0,2302,4389
IT-AV,Avellino,74,105,1737,39,148,0,0,1,2030,148,1301,35,727,0,0,0,2211,4241
IT-AV,Avellino,75,103,1735,41,186,0,0,0,2065,146,1261,43,822,0,0,0,2272,4337
IT-AV,Avellino,76,75,1615,35,167,0,0,0,1892,145,1168,43,875,0,0,0,2231,4123
IT-AV,Avellino,77,79,1632,38,183,0,0,0,1932,135,1072,41,877,0,0,0,2125,4057
IT-AV,Avellino,78,63,1084,22,157,1,0,0,1327,91,757,18,686,0,0,0,1552,2879
IT-AV,Avellino,79,51,1085,17,161,0,0,0,1314,87,691,18,708,0,0,0,1504,2818
IT-AV,Avellino,80,58,968,8,151,0,0,0,1185,93,673,21,812,0,0,0,1599,2784
IT-AV,Avellino,81,41,883,15,202,0,0,0,1141,91,592,18,814,0,0,0,1515,2656
IT-AV,Avellino,82,36,826,13,177,0,0,0,1052,80,460,20,789,0,0,0,1349,2401
IT-AV,Avellino,83,52,856,18,215,0,0,0,1141,89,559,18,939,0,0,0,1605,2746
IT-AV,Avellino,84,35,828,7,220,0,0,0,1090,99,501,15,1010,1,0,0,1626,2716
IT-AV,Avellino,85,33,694,5,219,0,0,0,951,76,370,12,909,0,0,0,1367,2318
IT-AV,Avellino,86,25,575,7,222,0,0,0,829,74,285,13,943,0,0,0,1315,2144
IT-AV,Avellino,87,28,480,4,227,0,0,0,739,72,264,5,809,0,0,0,1150,1889
IT-AV,Avellino,88,21,392,7,200,0,0,0,620,49,207,3,825,0,0,0,1084,1704
IT-AV,Avellino,89,15,327,6,190,0,0,0,538,51,151,2,717,0,0,0,921,1459
IT-AV,Avellino,90,15,267,3,179,0,0,0,464,46,130,6,670,0,0,0,852,1316
IT-AV,Avellino,91,10,173,2,149,0,0,0,334,35,83,5,583,0,0,0,706,1040
IT-AV,Avellino,92,9,139,2,117,0,0,0,267,35,72,4,506,0,0,0,617,884
IT-AV,Avellino,93,8,94,0,115,0,0,0,217,35,39,2,472,0,0,0,548,765
IT-AV,Avellino,94,5,62,0,79,0,0,0,146,23,33,3,292,0,0,0,351,497
IT-AV,Avellino,95,1,46,1,52,0,0,0,100,20,17,0,245,0,0,0,282,382
IT-AV,Avellino,96,0,24,0,43,0,0,0,67,14,8,2,188,0,0,0,212,279
IT-AV,Avellino,97,0,23,0,33,0,0,0,56,9,7,2,137,0,0,0,155,211
IT-AV,Avellino,98,3,6,1,19,0,0,0,29,4,9,1,108,0,0,0,122,151
IT-AV,Avellino,99,2,8,0,17,0,0,0,27,5,3,1,69,0,0,0,78,105
IT-AV,Avellino,100,4,16,0,27,0,0,0,47,5,23,0,111,0,0,0,139,186
IT-AV,Avellino,999,89898,96571,3275,5616,24,0,1,195385,75983,96275,4430,24881,16,3,0,201588,396973
IT-BA,Bari,0,4224,0,0,0,0,0,0,4224,4131,0,0,0,0,0,0,4131,8355
IT-BA,Bari,1,4452,0,0,0,0,0,0,4452,4181,0,0,0,0,0,0,4181,8633
IT-BA,Bari,2,4429,0,0,0,0,0,0,4429,4209,0,0,0,0,0,0,4209,8638
IT-BA,Bari,3,4480,0,0,0,0,0,0,4480,4110,0,0,0,0,0,0,4110,8590
IT-BA,Bari,4,4637,0,0,0,0,0,0,4637,4465,0,0,0,0,0,0,4465,9102
IT-BA,Bari,5,4959,0,0,0,0,0,0,4959,4623,0,0,0,0,0,0,4623,9582
IT-BA,Bari,6,5115,0,0,0,0,0,0,5115,4789,0,0,0,0,0,0,4789,9904
IT-BA,Bari,7,5287,0,0,0,0,0,0,5287,4859,0,0,0,0,0,0,4859,10146
IT-BA,Bari,8,5217,0,0,0,0,0,0,5217,4942,0,0,0,0,0,0,4942,10159
IT-BA,Bari,9,5430,0,0,0,0,0,0,5430,5110,0,0,0,0,0,0,5110,10540
IT-BA,Bari,10,5445,0,0,0,0,0,0,5445,5129,0,0,0,0,0,0,5129,10574
IT-BA,Bari,11,5692,0,0,0,0,0,0,5692,5287,0,0,0,0,0,0,5287,10979
IT-BA,Bari,12,5905,0,0,0,0,0,0,5905,5537,0,0,0,0,0,0,5537,11442
IT-BA,Bari,13,5896,0,0,0,0,0,0,5896,5799,0,0,0,0,0,0,5799,11695
IT-BA,Bari,14,5989,0,0,0,0,0,0,5989,5601,0,0,0,0,0,0,5601,11590
IT-BA,Bari,15,6076,0,0,0,0,0,0,6076,5745,0,0,0,0,0,0,5745,11821
IT-BA,Bari,16,6100,0,0,0,0,0,0,6100,5809,0,0,0,0,0,0,5809,11909
IT-BA,Bari,17,6222,0,0,0,0,0,0,6222,5854,0,0,0,0,0,0,5854,12076
IT-BA,Bari,18,6520,0,0,0,0,0,0,6520,5811,0,0,0,0,0,0,5811,12331
IT-BA,Bari,19,6406,3,0,0,0,0,0,6409,6204,12,0,0,0,0,0,6216,12625
IT-BA,Bari,20,6490,5,0,0,0,0,0,6495,6200,23,0,0,0,0,0,6223,12718
IT-BA,Bari,21,6371,6,1,0,0,0,0,6378,6052,42,0,0,1,0,0,6095,12473
IT-BA,Bari,22,6691,18,0,0,1,0,0,6710,6110,92,1,0,1,0,0,6204,12914
IT-BA,Bari,23,6798,38,0,0,0,0,0,6836,6214,137,1,0,2,0,0,6354,13190
IT-BA,Bari,24,6673,63,0,0,0,0,0,6736,6058,217,0,0,4,1,0,6280,13016
IT-BA,Bari,25,6555,112,1,0,0,0,0,6668,5954,360,4,0,1,0,0,6319,12987
IT-BA,Bari,26,6527,183,0,0,0,0,0,6710,5611,505,3,0,3,0,0,6122,12832
IT-BA,Bari,27,6490,285,2,0,0,1,0,6778,5622,731,5,1,2,0,0,6361,13139
IT-BA,Bari,28,6122,453,6,0,3,0,0,6584,5145,1112,12,1,4,0,0,6274,12858
IT-BA,Bari,29,5852,672,3,1,1,0,0,6529,4776,1472,18,0,2,0,0,6268,12797
IT-BA,Bari,30,5766,971,13,0,5,0,0,6755,4560,1902,24,3,6,0,0,6495,13250
IT-BA,Bari,31,5554,1276,15,0,10,0,0,6855,4366,2415,36,3,7,0,0,6827,13682
IT-BA,Bari,32,5305,1685,27,1,8,0,0,7026,3911,2805,52,6,3,0,0,6777,13803
IT-BA,Bari,33,4788,2182,13,3,4,0,0,6990,3415,3268,50,9,5,0,0,6747,13737
IT-BA,Bari,34,4395,2376,43,4,11,0,0,6829,3152,3544,89,13,5,0,0,6803,13632
IT-BA,Bari,35,4259,2989,64,2,12,0,0,7326,2956,4079,103,16,6,0,0,7160,14486
IT-BA,Bari,36,3882,3104,54,3,7,0,0,7050,2610,4251,127,13,3,0,0,7004,14054
IT-BA,Bari,37,3489,3399,83,4,9,0,0,6984,2345,4440,168,25,2,1,0,6981,13965
IT-BA,Bari,38,3281,3648,78,2,7,0,0,7016,2195,4552,185,31,10,0,0,6973,13989
IT-BA,Bari,39,3074,4066,119,4,9,1,0,7273,2150,4962,214,38,6,0,0,7370,14643
IT-BA,Bari,40,2907,4355,124,4,11,0,0,7401,1989,5107,257,36,6,0,0,7395,14796
IT-BA,Bari,41,2785,4535,128,13,9,3,0,7473,1965,5664,233,43,6,0,0,7911,15384
IT-BA,Bari,42,2698,4780,126,17,5,0,0,7626,1848,5617,289,73,9,0,0,7836,15462
IT-BA,Bari,43,2518,4895,193,12,4,0,0,7622,1720,5942,321,67,9,0,0,8059,15681
IT-BA,Bari,44,2480,5410,212,13,7,0,0,8122,1704,6095,406,88,6,0,0,8299,16421
IT-BA,Bari,45,2551,5705,264,22,4,0,0,8546,1594,6422,415,88,5,0,0,8524,17070
IT-BA,Bari,46,2466,6013,287,36,8,2,0,8812,1608,6718,462,91,7,0,0,8886,17698
IT-BA,Bari,47,2362,6236,336,29,6,1,0,8970,1666,7149,489,116,9,0,0,9429,18399
IT-BA,Bari,48,2331,6631,368,28,10,0,0,9368,1562,7540,564,143,3,0,0,9812,19180
IT-BA,Bari,49,2236,6878,360,53,6,1,0,9534,1530,7833,594,158,3,0,0,10118,19652
IT-BA,Bari,50,1989,6953,405,43,1,0,0,9391,1424,7635,580,170,9,0,0,9818,19209
IT-BA,Bari,51,1924,6910,431,50,6,1,0,9322,1331,7430,599,199,1,0,0,9560,18882
IT-BA,Bari,52,1782,7029,473,54,4,0,0,9342,1312,7570,594,251,3,0,0,9730,19072
IT-BA,Bari,53,1665,7234,474,68,4,1,0,9446,1158,7624,594,249,3,0,0,9628,19074
IT-BA,Bari,54,1563,7206,439,86,5,0,0,9299,1160,7846,667,318,0,0,0,9991,19290
IT-BA,Bari,55,1392,7387,531,101,7,0,0,9418,1172,7849,610,363,4,0,0,9998,19416
IT-BA,Bari,56,1335,7694,501,99,3,0,0,9632,1113,7972,597,423,0,0,0,10105,19737
IT-BA,Bari,57,1181,7994,475,114,5,0,2,9771,1047,8181,593,440,3,0,0,10264,20035
IT-BA,Bari,58,1157,7923,501,118,2,0,0,9701,1062,8212,654,535,0,0,0,10463,20164
IT-BA,Bari,59,1072,8091,495,161,8,0,0,9827,1029,8134,585,604,6,0,0,10358,20185
IT-BA,Bari,60,888,7396,420,160,1,0,0,8865,917,7606,552,608,2,0,0,9685,18550
IT-BA,Bari,61,812,7328,386,166,7,0,0,8699,890,7306,518,705,2,0,0,9421,18120
IT-BA,Bari,62,706,7432,372,148,4,0,0,8662,834,7195,526,754,1,0,0,9310,17972
IT-BA,Bari,63,671,7108,386,208,3,0,0,8376,761,6820,473,851,4,0,0,8909,17285
IT-BA,Bari,64,581,6867,365,187,1,0,0,8001,716,6931,449,878,0,0,0,8974,16975
IT-BA,Bari,65,489,6492,311,217,1,0,0,7510,669,6356,404,920,0,0,0,8349,15859
IT-BA,Bari,66,519,6573,317,270,2,0,0,7681,652,6229,403,1068,0,0,1,8353,16034
IT-BA,Bari,67,448,6353,274,252,1,0,1,7329,660,6060,353,1132,0,0,0,8205,15534
IT-BA,Bari,68,392,6154,246,259,2,0,1,7054,561,5716,338,1229,0,0,0,7844,14898
IT-BA,Bari,69,384,6096,231,319,1,0,0,7031,595,5630,302,1340,0,1,0,7868,14899
IT-BA,Bari,70,325,5700,222,300,1,0,0,6548,534,5146,302,1418,0,0,0,7400,13948
IT-BA,Bari,71,298,5547,190,298,2,0,0,6335,502,4949,269,1399,0,0,0,7119,13454
IT-BA,Bari,72,303,5503,167,382,3,0,0,6358,542,4591,235,1565,1,0,0,6934,13292
IT-BA,Bari,73,254,5716,176,377,0,0,0,6523,528,4838,265,1780,0,0,0,7411,13934
IT-BA,Bari,74,267,5474,160,414,1,0,0,6316,589,4458,252,1903,0,0,0,7202,13518
IT-BA,Bari,75,230,5738,133,504,1,0,0,6606,524,4553,234,2276,0,0,0,7587,14193
IT-BA,Bari,76,204,5071,129,508,1,0,0,5913,515,4058,177,2319,1,0,0,7070,12983
IT-BA,Bari,77,197,4894,118,581,2,0,0,5792,452,3763,192,2449,0,0,0,6856,12648
IT-BA,Bari,78,158,4122,98,515,2,0,0,4895,442,2906,136,2285,0,0,0,5769,10664
IT-BA,Bari,79,144,3369,64,468,1,0,0,4046,380,2468,102,2137,0,0,0,5087,9133
IT-BA,Bari,80,121,3216,60,476,0,0,0,3873,341,2190,99,2186,0,0,0,4816,8689
IT-BA,Bari,81,126,3064,48,549,0,0,0,3787,373,2009,99,2484,0,0,0,4965,8752
IT-BA,Bari,82,94,2800,46,592,0,0,0,3532,353,1789,81,2364,0,0,0,4587,8119
IT-BA,Bari,83,118,2861,41,626,0,0,0,3646,338,1604,84,2660,0,0,0,4686,8332
IT-BA,Bari,84,106,2407,38,641,0,0,0,3192,312,1366,82,2545,0,0,0,4305,7497
IT-BA,Bari,85,68,2104,38,611,0,0,0,2821,271,1095,48,2638,0,0,0,4052,6873
IT-BA,Bari,86,64,1810,29,594,0,0,0,2497,277,878,39,2550,0,0,0,3744,6241
IT-BA,Bari,87,48,1417,20,578,0,0,0,2063,247,652,31,2254,0,0,0,3184,5247
IT-BA,Bari,88,37,1259,15,556,0,0,0,1867,215,534,36,2180,0,0,0,2965,4832
IT-BA,Bari,89,52,979,9,546,0,0,0,1586,202,376,27,1955,0,0,0,2560,4146
IT-BA,Bari,90,28,816,5,464,0,0,0,1313,164,272,27,1754,0,0,0,2217,3530
IT-BA,Bari,91,25,559,5,405,0,0,0,994,144,186,18,1508,0,0,0,1856,2850
IT-BA,Bari,92,18,393,5,347,0,0,0,763,129,104,19,1302,1,0,0,1555,2318
IT-BA,Bari,93,18,321,1,324,0,0,0,664,110,95,10,1113,0,0,0,1328,1992
IT-BA,Bari,94,10,204,0,216,0,0,0,430,100,63,1,787,0,0,0,951,1381
IT-BA,Bari,95,5,128,1,149,0,0,0,283,63,34,3,672,0,0,0,772,1055
IT-BA,Bari,96,3,87,1,124,0,0,0,215,64,19,4,500,0,0,0,587,802
IT-BA,Bari,97,3,60,1,81,0,0,0,145,34,15,3,317,0,0,0,369,514
IT-BA,Bari,98,4,27,1,52,0,0,0,84,29,3,0,226,0,0,0,258,342
IT-BA,Bari,99,4,22,0,37,0,0,0,63,13,5,5,132,0,0,0,155,218
IT-BA,Bari,100,1,22,0,53,0,0,0,76,37,5,1,277,0,0,0,320,396
IT-BA,Bari,999,266460,300882,12774,15699,239,11,4,596069,236670,304334,18394,66034,177,3,1,625613,1221682
IT-BT,Barletta-Andria-Trani,0,1360,0,0,0,0,0,0,1360,1305,0,0,0,0,0,0,1305,2665
IT-BT,Barletta-Andria-Trani,1,1391,0,0,0,0,0,0,1391,1321,0,0,0,0,0,0,1321,2712
IT-BT,Barletta-Andria-Trani,2,1494,0,0,0,0,0,0,1494,1368,0,0,0,0,0,0,1368,2862
IT-BT,Barletta-Andria-Trani,3,1400,0,0,0,0,0,0,1400,1400,0,0,0,0,0,0,1400,2800
IT-BT,Barletta-Andria-Trani,4,1488,0,0,0,0,0,0,1488,1418,0,0,0,0,0,0,1418,2906
IT-BT,Barletta-Andria-Trani,5,1639,0,0,0,0,0,0,1639,1407,0,0,0,0,0,0,1407,3046
IT-BT,Barletta-Andria-Trani,6,1621,0,0,0,0,0,0,1621,1521,0,0,0,0,0,0,1521,3142
IT-BT,Barletta-Andria-Trani,7,1687,0,0,0,0,0,0,1687,1584,0,0,0,0,0,0,1584,3271
IT-BT,Barletta-Andria-Trani,8,1654,0,0,0,0,0,0,1654,1488,0,0,0,0,0,0,1488,3142
IT-BT,Barletta-Andria-Trani,9,1704,0,0,0,0,0,0,1704,1616,0,0,0,0,0,0,1616,3320
IT-BT,Barletta-Andria-Trani,10,1704,0,0,0,0,0,0,1704,1693,0,0,0,0,0,0,1693,3397
IT-BT,Barletta-Andria-Trani,11,1814,0,0,0,0,0,0,1814,1727,0,0,0,0,0,0,1727,3541
IT-BT,Barletta-Andria-Trani,12,1905,0,0,0,0,0,0,1905,1753,0,0,0,0,0,0,1753,3658
IT-BT,Barletta-Andria-Trani,13,1982,0,0,0,0,0,0,1982,1897,0,0,0,0,0,0,1897,3879
IT-BT,Barletta-Andria-Trani,14,2017,0,0,0,0,0,0,2017,1929,0,0,0,0,0,0,1929,3946
IT-BT,Barletta-Andria-Trani,15,2042,0,0,0,0,0,0,2042,1915,0,0,0,0,0,0,1915,3957
IT-BT,Barletta-Andria-Trani,16,2119,0,0,0,0,0,0,2119,1987,0,0,0,0,0,0,1987,4106
IT-BT,Barletta-Andria-Trani,17,2165,0,0,0,0,0,0,2165,2016,0,0,0,0,0,0,2016,4181
IT-BT,Barletta-Andria-Trani,18,2185,0,0,0,0,0,0,2185,2008,2,0,0,0,0,0,2010,4195
IT-BT,Barletta-Andria-Trani,19,2296,0,0,0,0,0,0,2296,2076,2,0,0,0,0,0,2078,4374
IT-BT,Barletta-Andria-Trani,20,2273,0,0,0,0,0,0,2273,2071,3,0,0,0,0,0,2074,4347
IT-BT,Barletta-Andria-Trani,21,2261,2,0,0,0,0,0,2263,2200,10,0,0,0,0,0,2210,4473
IT-BT,Barletta-Andria-Trani,22,2229,3,0,0,0,0,0,2232,2154,25,1,0,0,0,0,2180,4412
IT-BT,Barletta-Andria-Trani,23,2278,13,0,0,0,0,0,2291,2242,43,0,0,0,0,0,2285,4576
IT-BT,Barletta-Andria-Trani,24,2337,15,1,0,0,0,0,2353,2060,79,0,0,0,0,0,2139,4492
IT-BT,Barletta-Andria-Trani,25,2172,31,1,0,1,0,0,2205,1919,119,0,0,0,0,0,2038,4243
IT-BT,Barletta-Andria-Trani,26,2145,74,2,0,0,0,0,2221,1930,198,2,0,0,0,0,2130,4351
IT-BT,Barletta-Andria-Trani,27,2063,124,2,0,0,0,0,2189,1651,313,2,1,1,0,0,1968,4157
IT-BT,Barletta-Andria-Trani,28,1939,161,0,0,0,0,0,2100,1574,438,5,1,0,0,0,2018,4118
IT-BT,Barletta-Andria-Trani,29,1896,288,1,0,0,0,0,2185,1437,625,11,1,1,0,0,2075,4260
IT-BT,Barletta-Andria-Trani,30,1724,354,5,0,0,0,0,2083,1264,757,7,2,0,0,0,2030,4113
IT-BT,Barletta-Andria-Trani,31,1691,543,8,0,2,0,0,2244,1164,900,12,2,5,0,0,2083,4327
IT-BT,Barletta-Andria-Trani,32,1495,669,8,0,2,0,0,2174,1012,1055,18,4,0,0,0,2089,4263
IT-BT,Barletta-Andria-Trani,33,1381,839,10,0,2,0,0,2232,963,1123,23,5,1,0,0,2115,4347
IT-BT,Barletta-Andria-Trani,34,1259,927,14,0,2,0,0,2202,834,1324,28,4,0,0,0,2190,4392
IT-BT,Barletta-Andria-Trani,35,1127,1012,20,0,1,0,0,2160,758,1340,35,4,0,0,0,2137,4297
IT-BT,Barletta-Andria-Trani,36,1075,1116,18,1,3,0,1,2214,709,1419,37,5,1,0,0,2171,4385
IT-BT,Barletta-Andria-Trani,37,993,1182,23,4,1,0,0,2203,599,1485,56,10,1,0,0,2151,4354
IT-BT,Barletta-Andria-Trani,38,828,1227,27,3,1,0,0,2086,521,1460,62,5,1,0,0,2049,4135
IT-BT,Barletta-Andria-Trani,39,825,1332,31,4,1,0,0,2193,509,1668,69,6,2,0,0,2254,4447
IT-BT,Barletta-Andria-Trani,40,843,1388,40,5,2,0,0,2278,506,1678,63,7,1,0,0,2255,4533
IT-BT,Barletta-Andria-Trani,41,733,1492,40,1,2,0,0,2268,508,1778,102,11,1,0,0,2400,4668
IT-BT,Barletta-Andria-Trani,42,733,1514,63,6,2,0,0,2318,461,1816,92,23,0,0,0,2392,4710
IT-BT,Barletta-Andria-Trani,43,743,1639,56,9,1,0,0,2448,431,1933,114,26,1,0,0,2505,4953
IT-BT,Barletta-Andria-Trani,44,704,1749,64,4,2,0,0,2523,406,2031,114,32,1,0,0,2584,5107
IT-BT,Barletta-Andria-Trani,45,725,1876,92,9,0,0,0,2702,426,2110,130,32,0,0,0,2698,5400
IT-BT,Barletta-Andria-Trani,46,707,2006,105,7,2,0,0,2827,392,2278,154,27,2,0,0,2853,5680
IT-BT,Barletta-Andria-Trani,47,657,2051,113,14,0,0,0,2835,381,2321,157,41,1,0,0,2901,5736
IT-BT,Barletta-Andria-Trani,48,629,2159,120,11,0,0,0,2919,356,2374,147,44,0,0,0,2921,5840
IT-BT,Barletta-Andria-Trani,49,629,2273,105,12,3,0,0,3022,384,2540,171,53,1,0,0,3149,6171
IT-BT,Barletta-Andria-Trani,50,581,2182,127,25,1,0,0,2916,357,2444,170,60,1,0,0,3032,5948
IT-BT,Barletta-Andria-Trani,51,519,2272,130,21,1,0,0,2943,335,2418,169,68,0,0,0,2990,5933
IT-BT,Barletta-Andria-Trani,52,515,2452,139,15,1,0,0,3122,333,2492,175,85,0,0,0,3085,6207
IT-BT,Barletta-Andria-Trani,53,470,2445,124,30,0,0,0,3069,282,2530,162,100,0,0,0,3074,6143
IT-BT,Barletta-Andria-Trani,54,441,2432,131,22,1,0,0,3027,305,2705,157,127,1,0,0,3295,6322
IT-BT,Barletta-Andria-Trani,55,399,2520,153,30,2,0,0,3104,288,2455,147,135,0,0,0,3025,6129
IT-BT,Barletta-Andria-Trani,56,379,2555,143,34,1,0,0,3112,267,2458,139,139,1,0,0,3004,6116
IT-BT,Barletta-Andria-Trani,57,333,2475,134,44,3,0,0,2989,262,2671,155,155,1,0,0,3244,6233
IT-BT,Barletta-Andria-Trani,58,289,2462,109,32,0,0,0,2892,264,2480,155,143,0,0,0,3042,5934
IT-BT,Barletta-Andria-Trani,59,259,2531,127,50,1,0,0,2968,261,2596,121,185,0,0,0,3163,6131
IT-BT,Barletta-Andria-Trani,60,245,2448,114,62,0,0,0,2869,198,2382,129,174,0,0,0,2883,5752
IT-BT,Barletta-Andria-Trani,61,209,2360,103,50,0,0,0,2722,232,2291,110,209,0,0,0,2842,5564
IT-BT,Barletta-Andria-Trani,62,203,2292,97,73,0,0,0,2665,215,2166,97,235,1,0,0,2714,5379
IT-BT,Barletta-Andria-Trani,63,173,2193,85,64,1,0,0,2516,201,2022,86,245,0,0,0,2554,5070
IT-BT,Barletta-Andria-Trani,64,155,2150,90,60,2,0,0,2457,209,1994,99,272,1,0,0,2575,5032
IT-BT,Barletta-Andria-Trani,65,142,1940,72,76,0,0,0,2230,165,1907,81,302,0,0,0,2455,4685
IT-BT,Barletta-Andria-Trani,66,139,2039,84,75,2,0,0,2339,169,1891,72,321,1,0,0,2454,4793
IT-BT,Barletta-Andria-Trani,67,125,1848,62,70,0,0,0,2105,177,1683,62,327,0,0,0,2249,4354
IT-BT,Barletta-Andria-Trani,68,110,1851,44,84,0,0,0,2089,134,1654,65,386,0,0,0,2239,4328
IT-BT,Barletta-Andria-Trani,69,105,1733,45,92,0,0,0,1975,143,1670,68,391,0,0,0,2272,4247
IT-BT,Barletta-Andria-Trani,70,86,1651,46,105,0,0,0,1888,148,1454,66,411,0,0,0,2079,3967
IT-BT,Barletta-Andria-Trani,71,81,1597,38,100,0,0,0,1816,133,1350,61,440,0,0,0,1984,3800
IT-BT,Barletta-Andria-Trani,72,78,1609,31,111,0,0,0,1829,129,1430,43,469,0,0,0,2071,3900
IT-BT,Barletta-Andria-Trani,73,80,1619,39,108,0,0,0,1846,140,1344,41,502,0,0,0,2027,3873
IT-BT,Barletta-Andria-Trani,74,58,1610,31,129,1,0,0,1829,129,1273,46,579,0,0,0,2027,3856
IT-BT,Barletta-Andria-Trani,75,76,1695,25,163,0,0,0,1959,140,1325,40,650,0,0,0,2155,4114
IT-BT,Barletta-Andria-Trani,76,53,1500,27,163,0,0,0,1743,136,1183,31,656,0,0,0,2006,3749
IT-BT,Barletta-Andria-Trani,77,61,1510,25,156,0,0,0,1752,120,1107,36,714,0,0,0,1977,3729
IT-BT,Barletta-Andria-Trani,78,41,1122,21,149,0,0,0,1333,108,785,18,641,0,0,0,1552,2885
IT-BT,Barletta-Andria-Trani,79,41,996,14,158,0,0,0,1209,91,680,29,635,0,0,0,1435,2644
IT-BT,Barletta-Andria-Trani,80,43,950,12,185,0,0,0,1190,91,602,16,641,0,0,0,1350,2540
IT-BT,Barletta-Andria-Trani,81,41,883,11,194,0,0,0,1129,98,574,14,691,0,0,0,1377,2506
IT-BT,Barletta-Andria-Trani,82,25,811,11,174,0,0,0,1021,81,463,12,694,0,0,0,1250,2271
IT-BT,Barletta-Andria-Trani,83,28,828,13,217,0,0,0,1086,80,458,18,767,0,0,0,1323,2409
IT-BT,Barletta-Andria-Trani,84,24,673,11,200,0,0,0,908,64,360,12,756,0,0,0,1192,2100
IT-BT,Barletta-Andria-Trani,85,24,536,4,185,0,0,0,749,76,266,14,697,0,0,0,1053,1802
IT-BT,Barletta-Andria-Trani,86,20,514,8,178,0,0,0,720,69,240,6,671,0,0,0,986,1706
IT-BT,Barletta-Andria-Trani,87,8,353,8,171,0,0,0,540,53,138,9,617,0,0,0,817,1357
IT-BT,Barletta-Andria-Trani,88,9,329,4,177,0,0,0,519,52,129,4,593,0,0,0,778,1297
IT-BT,Barletta-Andria-Trani,89,11,247,1,138,0,0,0,397,56,99,3,485,0,0,0,643,1040
IT-BT,Barletta-Andria-Trani,90,6,171,6,135,0,0,0,318,42,55,4,445,0,0,0,546,864
IT-BT,Barletta-Andria-Trani,91,4,149,2,113,0,0,0,268,35,40,5,379,0,0,0,459,727
IT-BT,Barletta-Andria-Trani,92,4,120,0,105,0,0,0,229,28,29,1,309,0,0,0,367,596
IT-BT,Barletta-Andria-Trani,93,1,69,0,73,0,0,0,143,27,17,1,273,0,0,0,318,461
IT-BT,Barletta-Andria-Trani,94,4,34,0,55,0,0,0,93,19,6,3,200,0,0,0,228,321
IT-BT,Barletta-Andria-Trani,95,0,32,0,50,0,0,0,82,21,7,1,142,0,0,0,171,253
IT-BT,Barletta-Andria-Trani,96,2,18,0,27,0,0,0,47,15,3,0,95,0,0,0,113,160
IT-BT,Barletta-Andria-Trani,97,0,12,1,15,0,0,0,28,3,5,1,80,0,0,0,89,117
IT-BT,Barletta-Andria-Trani,98,0,6,0,9,0,0,0,15,7,2,0,56,0,0,0,65,80
IT-BT,Barletta-Andria-Trani,99,0,2,0,11,0,0,0,13,3,1,0,32,0,0,0,36,49
IT-BT,Barletta-Andria-Trani,100,0,2,0,13,0,0,0,15,1,1,0,52,0,0,0,54,69
IT-BT,Barletta-Andria-Trani,999,83461,94887,3471,4866,47,0,1,186733,72243,95582,4566,18777,28,0,0,191196,377929
IT-BL,Belluno,0,561,0,0,0,0,0,0,561,503,0,0,0,0,0,0,503,1064
IT-BL,Belluno,1,582,0,0,0,0,0,0,582,546,0,0,0,0,0,0,546,1128
IT-BL,Belluno,2,608,0,0,0,0,0,0,608,601,0,0,0,0,0,0,601,1209
IT-BL,Belluno,3,654,0,0,0,0,0,0,654,573,0,0,0,0,0,0,573,1227
IT-BL,Belluno,4,640,0,0,0,0,0,0,640,564,0,0,0,0,0,0,564,1204
IT-BL,Belluno,5,666,0,0,0,0,0,0,666,661,0,0,0,0,0,0,661,1327
IT-BL,Belluno,6,707,0,0,0,0,0,0,707,618,0,0,0,0,0,0,618,1325
IT-BL,Belluno,7,695,0,0,0,0,0,0,695,663,0,0,0,0,0,0,663,1358
IT-BL,Belluno,8,732,0,0,0,0,0,0,732,700,0,0,0,0,0,0,700,1432
IT-BL,Belluno,9,739,0,0,0,0,0,0,739,722,0,0,0,0,0,0,722,1461
IT-BL,Belluno,10,774,0,0,0,0,0,0,774,713,0,0,0,0,0,0,713,1487
IT-BL,Belluno,11,832,0,0,0,0,0,0,832,764,0,0,0,0,0,0,764,1596
IT-BL,Belluno,12,882,0,0,0,0,0,0,882,817,0,0,0,0,0,0,817,1699
IT-BL,Belluno,13,885,0,0,0,0,0,0,885,842,0,0,0,0,0,0,842,1727
IT-BL,Belluno,14,870,0,0,0,0,0,0,870,836,0,0,0,0,0,0,836,1706
IT-BL,Belluno,15,932,0,0,0,0,0,0,932,864,0,0,0,0,0,0,864,1796
IT-BL,Belluno,16,919,0,0,0,0,0,0,919,801,0,0,0,0,0,0,801,1720
IT-BL,Belluno,17,917,0,0,0,0,0,0,917,887,0,0,0,0,0,0,887,1804
IT-BL,Belluno,18,933,0,0,0,0,0,0,933,841,0,0,0,0,0,0,841,1774
IT-BL,Belluno,19,971,0,1,0,0,0,0,972,878,0,0,0,0,0,0,878,1850
IT-BL,Belluno,20,966,2,0,0,0,0,0,968,855,4,0,0,0,0,0,859,1827
IT-BL,Belluno,21,1004,2,0,0,0,0,0,1006,909,5,0,0,0,0,0,914,1920
IT-BL,Belluno,22,939,3,0,0,0,0,0,942,838,18,0,0,0,0,0,856,1798
IT-BL,Belluno,23,1025,13,0,0,0,0,0,1038,943,24,0,0,0,0,0,967,2005
IT-BL,Belluno,24,997,7,0,0,0,0,0,1004,869,42,0,1,0,0,0,912,1916
IT-BL,Belluno,25,1008,24,1,0,0,0,0,1033,870,80,3,0,0,0,0,953,1986
IT-BL,Belluno,26,973,30,1,0,1,0,0,1005,786,83,0,0,0,0,0,869,1874
IT-BL,Belluno,27,969,54,1,0,0,0,0,1024,808,109,4,0,1,0,0,922,1946
IT-BL,Belluno,28,892,70,4,0,0,0,0,966,715,151,6,2,0,0,0,874,1840
IT-BL,Belluno,29,908,101,3,1,1,0,0,1014,712,167,7,0,0,0,0,886,1900
IT-BL,Belluno,30,873,115,5,0,3,0,0,996,690,218,6,0,1,0,0,915,1911
IT-BL,Belluno,31,858,154,3,0,0,0,0,1015,706,241,6,0,0,0,0,953,1968
IT-BL,Belluno,32,831,170,8,2,2,0,0,1013,625,280,7,1,0,0,0,913,1926
IT-BL,Belluno,33,820,221,3,0,0,1,0,1045,599,316,15,1,0,0,0,931,1976
IT-BL,Belluno,34,785,225,6,1,2,0,0,1019,565,359,19,3,1,0,0,947,1966
IT-BL,Belluno,35,711,242,17,0,1,1,0,972,568,334,17,0,0,0,0,919,1891
IT-BL,Belluno,36,681,307,16,1,1,0,0,1006,495,388,35,2,1,0,0,921,1927
IT-BL,Belluno,37,625,329,7,1,1,0,0,963,528,429,31,2,1,0,0,991,1954
IT-BL,Belluno,38,638,352,21,2,1,0,0,1014,470,467,31,3,1,0,0,972,1986
IT-BL,Belluno,39,641,360,12,2,5,0,0,1020,476,488,27,2,0,0,0,993,2013
IT-BL,Belluno,40,684,410,26,1,1,0,0,1122,465,502,37,5,1,0,0,1010,2132
IT-BL,Belluno,41,581,412,36,0,0,0,0,1029,483,533,48,5,3,0,0,1072,2101
IT-BL,Belluno,42,616,466,24,1,2,0,0,1109,478,523,54,8,4,0,0,1067,2176
IT-BL,Belluno,43,600,452,31,0,1,1,0,1085,427,574,74,17,2,0,0,1094,2179
IT-BL,Belluno,44,607,520,32,4,1,0,0,1164,443,550,78,10,2,0,0,1083,2247
IT-BL,Belluno,45,642,548,44,2,1,0,0,1237,423,695,98,11,2,0,0,1229,2466
IT-BL,Belluno,46,605,581,62,4,1,0,0,1253,430,755,110,16,0,0,0,1311,2564
IT-BL,Belluno,47,604,671,78,3,3,0,0,1359,452,793,105,20,0,0,0,1370,2729
IT-BL,Belluno,48,609,724,81,2,2,0,0,1418,438,897,129,19,2,0,0,1485,2903
IT-BL,Belluno,49,645,786,102,8,0,0,0,1541,453,934,122,36,2,0,0,1547,3088
IT-BL,Belluno,50,666,806,112,6,1,1,0,1592,402,1039,138,27,1,0,0,1607,3199
IT-BL,Belluno,51,544,908,116,4,1,0,1,1574,419,1056,154,39,0,0,0,1668,3242
IT-BL,Belluno,52,567,940,138,6,1,0,0,1652,394,1075,170,35,1,0,0,1675,3327
IT-BL,Belluno,53,515,945,139,11,3,0,0,1613,388,1057,229,42,1,0,0,1717,3330
IT-BL,Belluno,54,496,996,143,9,0,0,0,1644,331,1129,197,55,0,0,0,1712,3356
IT-BL,Belluno,55,479,1019,157,11,2,0,0,1668,341,1128,180,73,0,0,0,1722,3390
IT-BL,Belluno,56,424,1046,150,14,3,0,0,1637,328,1185,196,66,0,0,0,1775,3412
IT-BL,Belluno,57,404,1060,153,19,0,0,0,1636,315,1177,196,74,0,0,0,1762,3398
IT-BL,Belluno,58,429,1097,179,19,2,0,0,1726,249,1172,193,81,0,0,0,1695,3421
IT-BL,Belluno,59,391,1106,169,25,1,0,0,1692,286,1204,193,94,0,0,0,1777,3469
IT-BL,Belluno,60,323,1111,164,27,1,0,0,1626,247,1138,177,99,0,0,0,1661,3287
IT-BL,Belluno,61,290,1073,169,26,2,0,0,1560,219,1111,154,109,0,0,0,1593,3153
IT-BL,Belluno,62,301,1080,120,38,2,0,0,1541,218,1086,152,145,0,0,0,1601,3142
IT-BL,Belluno,63,260,1060,125,31,1,0,0,1477,178,1048,132,155,1,0,0,1514,2991
IT-BL,Belluno,64,254,1127,116,41,4,0,0,1542,192,1034,147,161,0,0,0,1534,3076
IT-BL,Belluno,65,242,969,114,34,0,0,0,1359,167,980,101,174,0,0,0,1422,2781
IT-BL,Belluno,66,220,977,100,31,1,0,0,1329,143,960,116,197,1,0,0,1417,2746
IT-BL,Belluno,67,190,965,89,38,0,0,0,1282,129,995,99,183,0,0,0,1406,2688
IT-BL,Belluno,68,179,956,91,57,1,0,0,1284,138,976,73,211,0,0,0,1398,2682
IT-BL,Belluno,69,177,1018,76,53,0,0,0,1324,113,926,96,247,0,0,0,1382,2706
IT-BL,Belluno,70,164,1027,68,60,0,0,0,1319,111,793,73,286,0,0,0,1263,2582
IT-BL,Belluno,71,142,930,54,63,1,0,0,1190,112,841,81,298,0,0,0,1332,2522
IT-BL,Belluno,72,126,950,51,77,0,0,0,1204,94,847,61,299,0,0,0,1301,2505
IT-BL,Belluno,73,134,919,71,78,0,0,0,1202,114,918,77,362,0,0,0,1471,2673
IT-BL,Belluno,74,137,946,62,87,0,0,0,1232,86,758,63,368,0,0,0,1275,2507
IT-BL,Belluno,75,129,934,43,81,0,0,1,1188,109,759,62,452,0,0,0,1382,2570
IT-BL,Belluno,76,105,917,43,123,0,0,0,1188,106,759,55,465,0,0,0,1385,2573
IT-BL,Belluno,77,126,920,38,141,1,0,0,1226,90,719,41,529,0,0,0,1379,2605
IT-BL,Belluno,78,77,599,37,91,0,0,0,804,73,471,24,401,0,0,0,969,1773
IT-BL,Belluno,79,74,656,19,89,0,0,0,838,54,503,33,492,0,0,0,1082,1920
IT-BL,Belluno,80,62,636,22,116,0,0,0,836,66,478,27,478,0,0,0,1049,1885
IT-BL,Belluno,81,73,578,23,100,0,0,0,774,74,416,21,519,0,0,0,1030,1804
IT-BL,Belluno,82,67,565,20,130,0,0,0,782,67,336,24,577,0,0,0,1004,1786
IT-BL,Belluno,83,82,548,20,112,0,0,0,762,71,321,20,590,0,0,0,1002,1764
IT-BL,Belluno,84,53,552,12,129,0,0,0,746,68,252,14,656,0,0,0,990,1736
IT-BL,Belluno,85,49,404,13,117,0,0,0,583,65,213,11,591,0,0,0,880,1463
IT-BL,Belluno,86,41,323,4,123,0,0,0,491,67,155,8,540,0,0,0,770,1261
IT-BL,Belluno,87,29,263,3,88,0,0,0,383,57,113,7,502,0,0,0,679,1062
IT-BL,Belluno,88,20,180,4,92,0,0,0,296,47,76,7,462,0,0,0,592,888
IT-BL,Belluno,89,20,171,3,86,0,0,0,280,39,76,9,446,0,0,0,570,850
IT-BL,Belluno,90,14,124,4,62,0,0,0,204,41,38,8,388,0,0,0,475,679
IT-BL,Belluno,91,9,83,5,56,0,0,0,153,42,32,7,385,0,0,0,466,619
IT-BL,Belluno,92,10,80,2,54,0,0,0,146,26,11,2,301,0,0,0,340,486
IT-BL,Belluno,93,16,53,1,53,0,0,0,123,27,11,2,276,0,0,0,316,439
IT-BL,Belluno,94,9,39,1,29,0,0,0,78,19,5,1,192,0,0,0,217,295
IT-BL,Belluno,95,0,20,1,20,0,0,0,41,15,3,0,163,0,0,0,181,222
IT-BL,Belluno,96,3,12,0,16,0,0,0,31,7,4,0,128,0,0,0,139,170
IT-BL,Belluno,97,0,7,0,9,0,0,0,16,13,2,0,88,0,0,0,103,119
IT-BL,Belluno,98,0,2,0,10,0,0,0,12,7,0,1,63,0,0,0,71,83
IT-BL,Belluno,99,0,3,0,4,0,0,0,7,4,0,0,42,0,0,0,46,53
IT-BL,Belluno,100,0,3,0,6,0,0,0,9,7,1,1,71,0,0,0,80,89
IT-BL,Belluno,999,47958,42054,3869,2837,58,4,2,96782,39888,42346,4902,13841,29,0,0,101006,197788
IT-BN,Benevento,0,850,0,0,0,0,0,0,850,820,0,0,0,0,0,0,820,1670
IT-BN,Benevento,1,919,0,0,0,0,0,0,919,874,0,0,0,0,0,0,874,1793
IT-BN,Benevento,2,865,0,0,0,0,0,0,865,780,0,0,0,0,0,0,780,1645
IT-BN,Benevento,3,943,0,0,0,0,0,0,943,866,0,0,0,0,0,0,866,1809
IT-BN,Benevento,4,989,0,0,0,0,0,0,989,990,0,0,0,0,0,0,990,1979
IT-BN,Benevento,5,962,0,0,0,0,0,0,962,942,0,0,0,0,0,0,942,1904
IT-BN,Benevento,6,1023,0,0,0,0,0,0,1023,1013,0,0,0,0,0,0,1013,2036
IT-BN,Benevento,7,1046,0,0,0,0,0,0,1046,1019,0,0,0,0,0,0,1019,2065
IT-BN,Benevento,8,1059,0,0,0,0,0,0,1059,969,0,0,0,0,0,0,969,2028
IT-BN,Benevento,9,1046,0,0,0,0,0,0,1046,970,0,0,0,0,0,0,970,2016
IT-BN,Benevento,10,1119,0,0,0,0,0,0,1119,1047,0,0,0,0,0,0,1047,2166
IT-BN,Benevento,11,1118,0,0,0,0,0,0,1118,1024,0,0,0,0,0,0,1024,2142
IT-BN,Benevento,12,1216,0,0,0,0,0,0,1216,1063,0,0,0,0,0,0,1063,2279
IT-BN,Benevento,13,1157,0,0,0,0,0,0,1157,1163,0,0,0,0,0,0,1163,2320
IT-BN,Benevento,14,1224,0,0,0,0,0,0,1224,1171,0,0,0,0,0,0,1171,2395
IT-BN,Benevento,15,1231,0,0,0,0,0,0,1231,1151,0,0,0,0,0,0,1151,2382
IT-BN,Benevento,16,1258,0,0,0,0,0,0,1258,1254,0,0,0,0,0,0,1254,2512
IT-BN,Benevento,17,1314,0,0,0,0,0,0,1314,1184,0,0,0,0,0,0,1184,2498
IT-BN,Benevento,18,1376,0,0,0,0,0,0,1376,1200,0,0,0,0,0,0,1200,2576
IT-BN,Benevento,19,1466,0,0,0,0,0,0,1466,1214,2,0,0,0,0,0,1216,2682
IT-BN,Benevento,20,1431,0,0,0,0,0,0,1431,1233,7,0,0,0,0,0,1240,2671
IT-BN,Benevento,21,1433,3,0,0,0,0,0,1436,1302,13,0,0,0,0,0,1315,2751
IT-BN,Benevento,22,1406,8,0,0,0,0,0,1414,1273,18,0,0,0,0,0,1291,2705
IT-BN,Benevento,23,1546,6,0,0,0,0,0,1552,1313,22,0,0,0,0,0,1335,2887
IT-BN,Benevento,24,1411,17,1,1,0,0,0,1430,1286,54,0,0,0,0,0,1340,2770
IT-BN,Benevento,25,1429,15,0,0,0,0,0,1444,1275,76,0,0,0,0,0,1351,2795
IT-BN,Benevento,26,1444,36,0,0,1,0,0,1481,1272,101,0,0,0,0,0,1373,2854
IT-BN,Benevento,27,1460,51,0,0,0,0,0,1511,1184,150,2,0,0,0,0,1336,2847
IT-BN,Benevento,28,1393,83,1,0,1,0,0,1478,1113,211,4,0,0,0,0,1328,2806
IT-BN,Benevento,29,1405,134,2,0,0,0,0,1541,1059,292,0,1,1,0,0,1353,2894
IT-BN,Benevento,30,1272,205,2,1,1,0,0,1481,1067,367,5,1,0,0,0,1440,2921
IT-BN,Benevento,31,1329,270,6,0,0,0,0,1605,946,494,3,2,0,0,0,1445,3050
IT-BN,Benevento,32,1231,353,2,1,0,0,0,1587,897,533,5,1,1,0,0,1437,3024
IT-BN,Benevento,33,1178,396,8,0,0,0,0,1582,822,673,21,2,2,0,0,1520,3102
IT-BN,Benevento,34,1054,491,11,0,0,0,0,1556,716,721,13,3,1,0,0,1454,3010
IT-BN,Benevento,35,1047,580,4,0,0,0,0,1631,666,813,28,5,1,0,0,1513,3144
IT-BN,Benevento,36,924,585,6,0,0,0,0,1515,561,846,26,3,0,0,0,1436,2951
IT-BN,Benevento,37,843,646,15,1,0,0,0,1505,495,869,36,5,0,0,0,1405,2910
IT-BN,Benevento,38,779,746,17,0,0,0,0,1542,512,923,35,6,2,0,0,1478,3020
IT-BN,Benevento,39,757,823,15,1,0,0,0,1596,486,992,47,8,1,0,0,1534,3130
IT-BN,Benevento,40,684,832,22,2,0,0,0,1540,431,1047,62,12,1,0,0,1553,3093
IT-BN,Benevento,41,680,891,23,1,0,0,0,1595,398,1061,49,13,0,0,0,1521,3116
IT-BN,Benevento,42,646,935,25,5,0,0,0,1611,403,1140,42,12,0,0,0,1597,3208
IT-BN,Benevento,43,608,942,26,4,0,0,0,1580,365,1167,47,8,0,0,0,1587,3167
IT-BN,Benevento,44,553,1040,31,3,0,0,0,1627,323,1239,65,25,0,0,0,1652,3279
IT-BN,Benevento,45,580,1042,27,4,0,0,0,1653,336,1278,70,14,0,0,0,1698,3351
IT-BN,Benevento,46,528,1076,48,5,0,0,0,1657,357,1345,68,22,1,0,0,1793,3450
IT-BN,Benevento,47,527,1295,44,4,0,0,0,1870,330,1373,77,40,0,0,0,1820,3690
IT-BN,Benevento,48,515,1233,65,7,1,0,0,1821,285,1490,92,39,0,0,0,1906,3727
IT-BN,Benevento,49,493,1303,70,4,0,0,0,1870,307,1522,91,43,0,0,0,1963,3833
IT-BN,Benevento,50,502,1365,75,12,0,0,0,1954,290,1509,97,49,0,0,0,1945,3899
IT-BN,Benevento,51,450,1355,67,10,2,0,0,1884,272,1586,104,49,1,0,0,2012,3896
IT-BN,Benevento,52,421,1420,80,20,0,0,0,1941,256,1617,103,67,0,0,0,2043,3984
IT-BN,Benevento,53,395,1495,91,18,1,0,0,2000,252,1681,96,81,0,0,0,2110,4110
IT-BN,Benevento,54,398,1552,80,17,0,0,0,2047,292,1711,114,98,0,0,0,2215,4262
IT-BN,Benevento,55,354,1627,76,22,0,1,0,2080,265,1682,104,98,1,0,0,2150,4230
IT-BN,Benevento,56,354,1609,90,19,0,0,0,2072,251,1761,99,122,0,0,0,2233,4305
IT-BN,Benevento,57,320,1700,89,22,0,0,0,2131,241,1747,115,136,0,0,0,2239,4370
IT-BN,Benevento,58,275,1759,81,34,0,0,0,2149,218,1743,91,155,0,0,0,2207,4356
IT-BN,Benevento,59,308,1757,83,39,2,0,0,2189,251,1818,99,202,0,0,0,2370,4559
IT-BN,Benevento,60,249,1715,95,43,0,0,0,2102,217,1689,89,171,2,0,0,2168,4270
IT-BN,Benevento,61,218,1666,66,44,0,0,0,1994,177,1587,80,188,0,0,0,2032,4026
IT-BN,Benevento,62,200,1685,68,35,1,0,0,1989,185,1621,70,209,0,0,0,2085,4074
IT-BN,Benevento,63,189,1615,73,40,0,0,0,1917,155,1562,54,215,0,0,0,1986,3903
IT-BN,Benevento,64,189,1571,37,66,0,0,0,1863,158,1483,60,265,1,0,0,1967,3830
IT-BN,Benevento,65,163,1440,53,36,0,0,0,1692,151,1314,60,288,0,0,0,1813,3505
IT-BN,Benevento,66,140,1423,55,46,0,0,0,1664,135,1279,61,294,0,0,0,1769,3433
IT-BN,Benevento,67,119,1336,51,74,0,0,0,1580,120,1235,40,292,0,0,0,1687,3267
IT-BN,Benevento,68,138,1399,52,75,0,0,0,1664,118,1174,47,308,1,0,0,1648,3312
IT-BN,Benevento,69,115,1320,45,70,0,0,0,1550,116,1177,45,349,0,0,0,1687,3237
IT-BN,Benevento,70,93,1238,34,70,0,0,0,1435,98,1073,25,361,0,0,0,1557,2992
IT-BN,Benevento,71,77,1205,27,71,1,0,0,1381,94,1055,36,367,0,0,0,1552,2933
IT-BN,Benevento,72,85,1216,20,83,0,0,0,1404,88,953,26,398,0,0,0,1465,2869
IT-BN,Benevento,73,78,1203,39,91,0,0,0,1411,95,908,33,494,1,0,0,1531,2942
IT-BN,Benevento,74,72,1217,25,94,0,0,0,1408,69,936,36,547,0,0,0,1588,2996
IT-BN,Benevento,75,67,1166,32,113,0,0,0,1378,91,954,28,583,0,0,0,1656,3034
IT-BN,Benevento,76,73,1154,20,124,0,0,0,1371,94,810,19,604,0,0,0,1527,2898
IT-BN,Benevento,77,56,1038,16,121,0,0,0,1231,75,726,19,577,0,0,0,1397,2628
IT-BN,Benevento,78,44,740,12,94,0,0,0,890,56,536,10,474,0,0,0,1076,1966
IT-BN,Benevento,79,26,683,9,100,0,0,0,818,57,489,14,532,0,0,0,1092,1910
IT-BN,Benevento,80,34,752,6,106,0,0,0,898,71,443,10,581,0,0,0,1105,2003
IT-BN,Benevento,81,35,597,10,98,0,0,0,740,52,385,13,497,0,0,0,947,1687
IT-BN,Benevento,82,29,553,9,102,0,0,0,693,48,363,7,577,0,0,0,995,1688
IT-BN,Benevento,83,42,634,7,171,0,0,0,854,69,381,11,700,0,0,0,1161,2015
IT-BN,Benevento,84,22,565,11,154,0,0,0,752,71,331,11,750,0,0,0,1163,1915
IT-BN,Benevento,85,14,501,4,148,0,0,0,667,57,275,6,620,0,0,0,958,1625
IT-BN,Benevento,86,31,443,5,167,0,0,0,646,56,213,7,663,0,0,0,939,1585
IT-BN,Benevento,87,18,347,3,146,0,0,0,514,52,160,5,601,0,0,0,818,1332
IT-BN,Benevento,88,10,273,2,144,0,0,0,429,47,138,6,589,0,0,0,780,1209
IT-BN,Benevento,89,14,214,3,135,0,0,0,366,41,92,4,527,0,0,0,664,1030
IT-BN,Benevento,90,8,172,0,108,0,0,0,288,38,80,7,517,0,0,0,642,930
IT-BN,Benevento,91,4,147,1,119,0,0,0,271,32,61,2,405,0,0,0,500,771
IT-BN,Benevento,92,10,99,0,80,0,0,0,189,36,56,2,404,0,0,0,498,687
IT-BN,Benevento,93,4,80,0,90,0,0,0,174,28,31,1,344,0,0,0,404,578
IT-BN,Benevento,94,3,49,0,56,0,0,0,108,17,23,1,229,0,0,0,270,378
IT-BN,Benevento,95,1,31,0,38,0,0,0,70,15,14,1,191,0,0,0,221,291
IT-BN,Benevento,96,2,16,0,28,0,0,0,46,18,9,1,143,0,0,0,171,217
IT-BN,Benevento,97,1,17,0,20,0,0,0,38,4,4,1,85,0,0,0,94,132
IT-BN,Benevento,98,1,9,0,12,0,0,0,22,7,2,1,84,0,0,0,94,116
IT-BN,Benevento,99,0,2,0,8,0,0,0,10,2,0,0,52,0,0,0,54,64
IT-BN,Benevento,100,1,1,0,19,0,0,0,21,14,5,0,77,0,0,0,96,117
IT-BN,Benevento,999,59219,63208,2173,3696,11,1,0,128308,49439,63321,2859,17474,18,0,0,133111,261419
IT-BG,Bergamo,0,3835,0,0,0,0,0,0,3835,3549,0,0,0,0,0,0,3549,7384
IT-BG,Bergamo,1,3955,0,0,0,0,0,0,3955,3671,0,0,0,0,0,0,3671,7626
IT-BG,Bergamo,2,4141,0,0,0,0,0,0,4141,3755,0,0,0,0,0,0,3755,7896
IT-BG,Bergamo,3,4129,0,0,0,0,0,0,4129,3852,0,0,0,0,0,0,3852,7981
IT-BG,Bergamo,4,4297,0,0,0,0,0,0,4297,4276,0,0,0,0,0,0,4276,8573
IT-BG,Bergamo,5,4558,0,0,0,0,0,0,4558,4307,0,0,0,0,0,0,4307,8865
IT-BG,Bergamo,6,4840,0,0,0,0,0,0,4840,4614,0,0,0,0,0,0,4614,9454
IT-BG,Bergamo,7,5019,0,0,0,0,0,0,5019,4700,0,0,0,0,0,0,4700,9719
IT-BG,Bergamo,8,5104,0,0,0,0,0,0,5104,4764,0,0,0,0,0,0,4764,9868
IT-BG,Bergamo,9,5331,0,0,0,0,0,0,5331,5099,0,0,0,0,0,0,5099,10430
IT-BG,Bergamo,10,5594,0,0,0,0,0,0,5594,4978,0,0,0,0,0,0,4978,10572
IT-BG,Bergamo,11,5707,0,0,0,0,0,0,5707,5324,0,0,0,0,0,0,5324,11031
IT-BG,Bergamo,12,5851,0,0,0,0,0,0,5851,5595,0,0,0,0,0,0,5595,11446
IT-BG,Bergamo,13,5991,0,0,0,0,0,0,5991,5672,0,0,0,0,0,0,5672,11663
IT-BG,Bergamo,14,6104,0,0,0,0,0,0,6104,5920,0,0,0,0,0,0,5920,12024
IT-BG,Bergamo,15,6128,0,0,0,0,0,0,6128,5779,0,0,0,0,0,0,5779,11907
IT-BG,Bergamo,16,6049,0,0,0,0,0,0,6049,5798,0,0,0,0,0,0,5798,11847
IT-BG,Bergamo,17,6222,0,0,0,0,0,0,6222,5657,1,0,0,0,0,0,5658,11880
IT-BG,Bergamo,18,6098,0,1,0,0,0,0,6099,5608,2,0,0,0,0,0,5610,11709
IT-BG,Bergamo,19,6082,2,0,0,0,0,0,6084,5673,10,0,0,0,0,0,5683,11767
IT-BG,Bergamo,20,6109,4,0,0,0,0,0,6113,5698,36,2,0,1,0,0,5737,11850
IT-BG,Bergamo,21,6170,15,1,0,0,0,0,6186,5493,78,1,0,1,0,0,5573,11759
IT-BG,Bergamo,22,6289,23,1,0,0,0,0,6313,5436,144,3,0,1,0,0,5584,11897
IT-BG,Bergamo,23,6265,41,0,0,2,0,0,6308,5596,217,10,0,1,0,0,5824,12132
IT-BG,Bergamo,24,6018,74,7,0,0,0,0,6099,5347,306,11,0,1,0,0,5665,11764
IT-BG,Bergamo,25,6166,124,14,0,0,0,0,6304,5179,419,12,0,1,1,0,5612,11916
IT-BG,Bergamo,26,6118,174,12,0,3,0,0,6307,4983,585,11,0,3,3,0,5585,11892
IT-BG,Bergamo,27,5599,274,7,0,3,0,0,5883,4751,803,17,0,3,1,0,5575,11458
IT-BG,Bergamo,28,5532,442,11,0,4,1,0,5990,4502,1115,22,0,1,1,0,5641,11631
IT-BG,Bergamo,29,5276,583,13,0,1,0,0,5873,4122,1326,29,2,4,0,0,5483,11356
IT-BG,Bergamo,30,5141,819,18,0,8,0,0,5986,3852,1645,43,2,5,2,0,5549,11535
IT-BG,Bergamo,31,5106,1083,32,1,5,0,0,6227,3680,2027,43,2,6,0,0,5758,11985
IT-BG,Bergamo,32,4609,1373,34,4,5,1,0,6026,3491,2348,65,7,16,0,0,5927,11953
IT-BG,Bergamo,33,4608,1550,50,3,8,1,0,6220,3227,2672,86,8,15,0,0,6008,12228
IT-BG,Bergamo,34,4153,1830,49,10,14,1,0,6057,3016,2746,117,15,10,2,0,5906,11963
IT-BG,Bergamo,35,4089,2255,76,9,13,0,0,6442,2878,3176,144,18,6,0,0,6222,12664
IT-BG,Bergamo,36,3843,2393,68,5,15,0,0,6324,2517,3382,188,19,8,1,0,6115,12439
IT-BG,Bergamo,37,3419,2616,90,11,7,2,1,6146,2350,3419,210,23,12,1,0,6015,12161
IT-BG,Bergamo,38,3377,2866,124,6,10,0,0,6383,2336,3753,252,29,10,2,0,6382,12765
IT-BG,Bergamo,39,3395,3095,137,9,8,0,0,6644,2236,3994,281,27,11,0,0,6549,13193
IT-BG,Bergamo,40,3140,3365,172,16,10,1,0,6704,2096,4216,326,44,8,0,0,6690,13394
IT-BG,Bergamo,41,3157,3588,188,5,12,0,0,6950,1975,4346,339,44,5,2,0,6711,13661
IT-BG,Bergamo,42,3100,3795,231,31,11,2,2,7172,1917,4442,370,66,7,1,0,6803,13975
IT-BG,Bergamo,43,2962,4049,232,28,18,0,0,7289,1880,4676,422,81,7,0,0,7066,14355
IT-BG,Bergamo,44,2792,4171,308,23,18,0,0,7312,1849,4830,518,72,5,0,0,7274,14586
IT-BG,Bergamo,45,3023,4596,356,21,8,1,0,8005,1886,5181,582,101,4,0,0,7754,15759
IT-BG,Bergamo,46,2915,4818,376,28,15,0,0,8152,1828,5330,635,107,9,0,0,7909,16061
IT-BG,Bergamo,47,2895,5110,491,36,13,0,0,8545,1719,5569,625,132,6,1,0,8052,16597
IT-BG,Bergamo,48,3025,5556,497,44,22,0,0,9144,1794,6053,728,146,9,0,0,8730,17874
IT-BG,Bergamo,49,2914,5756,591,44,23,1,0,9329,1729,6083,777,140,9,1,1,8740,18069
IT-BG,Bergamo,50,2693,5774,649,59,14,0,0,9189,1629,6244,849,161,13,0,0,8896,18085
IT-BG,Bergamo,51,2655,6081,633,63,11,0,0,9443,1548,6162,822,189,7,0,0,8728,18171
IT-BG,Bergamo,52,2334,6110,661,64,21,1,0,9191,1404,6253,798,225,8,0,0,8688,17879
IT-BG,Bergamo,53,2327,6255,724,55,15,1,0,9377,1327,6338,854,237,6,0,0,8762,18139
IT-BG,Bergamo,54,2239,6347,705,58,17,0,0,9366,1320,6354,881,298,6,0,0,8859,18225
IT-BG,Bergamo,55,2104,6432,682,80,18,0,0,9316,1181,6500,896,316,3,1,0,8897,18213
IT-BG,Bergamo,56,1923,6409,726,81,16,0,0,9155,1258,6636,795,387,3,0,0,9079,18234
IT-BG,Bergamo,57,1917,6849,754,120,23,0,0,9663,1149,6781,828,410,9,0,0,9177,18840
IT-BG,Bergamo,58,1785,6779,750,133,10,1,0,9458,1146,6693,785,505,7,1,0,9137,18595
IT-BG,Bergamo,59,1613,6996,756,135,15,0,1,9516,1061,6722,850,550,2,0,0,9185,18701
IT-BG,Bergamo,60,1375,6409,678,143,10,0,0,8615,951,6336,793,547,2,0,1,8630,17245
IT-BG,Bergamo,61,1178,6175,637,139,23,1,0,8153,851,6040,692,623,6,0,0,8212,16365
IT-BG,Bergamo,62,1072,5903,585,154,4,1,0,7719,777,5722,624,687,5,0,0,7815,15534
IT-BG,Bergamo,63,1034,5892,567,190,6,0,0,7689,710,5586,584,773,3,0,0,7656,15345
IT-BG,Bergamo,64,854,5776,531,192,10,0,0,7363,713,5388,534,787,4,0,0,7426,14789
IT-BG,Bergamo,65,876,5472,446,212,7,0,0,7013,589,5156,501,900,2,0,0,7148,14161
IT-BG,Bergamo,66,728,5231,405,227,5,0,0,6596,546,4833,437,928,1,0,0,6745,13341
IT-BG,Bergamo,67,635,5114,352,264,6,0,0,6371,528,4796,455,1011,1,0,0,6791,13162
IT-BG,Bergamo,68,661,4947,321,257,2,0,0,6188,464,4604,352,1128,0,0,0,6548,12736
IT-BG,Bergamo,69,578,4927,305,268,4,1,0,6083,426,4308,375,1213,1,0,0,6323,12406
IT-BG,Bergamo,70,561,4711,273,311,3,0,0,5859,404,4169,316,1269,1,0,0,6159,12018
IT-BG,Bergamo,71,537,4569,237,320,0,0,0,5663,420,3948,308,1366,0,0,0,6042,11705
IT-BG,Bergamo,72,511,4381,214,331,5,0,1,5443,380,3965,294,1464,1,0,0,6104,11547
IT-BG,Bergamo,73,559,4635,205,418,6,0,0,5823,399,3971,250,1659,1,0,0,6280,12103
IT-BG,Bergamo,74,469,4574,180,431,3,0,0,5657,355,3777,225,1840,0,0,0,6197,11854
IT-BG,Bergamo,75,444,4427,194,447,0,0,0,5512,378,3649,206,2036,3,0,0,6272,11784
IT-BG,Bergamo,76,346,4057,176,425,2,0,0,5006,332,3223,198,1958,0,0,0,5711,10717
IT-BG,Bergamo,77,345,4065,128,519,1,0,1,5059,335,3022,172,2207,0,0,0,5736,10795
IT-BG,Bergamo,78,269,2875,84,410,0,0,0,3638,276,2079,94,1925,0,0,0,4374,8012
IT-BG,Bergamo,79,271,2893,83,450,3,0,1,3701,253,2113,90,2142,0,0,0,4598,8299
IT-BG,Bergamo,80,253,2636,68,465,2,0,0,3424,281,1932,110,2166,0,0,0,4489,7913
IT-BG,Bergamo,81,244,2543,84,522,0,0,0,3393,246,1795,89,2341,0,0,0,4471,7864
IT-BG,Bergamo,82,227,2350,52,509,0,0,0,3138,291,1483,86,2446,0,0,0,4306,7444
IT-BG,Bergamo,83,200,2424,50,629,0,0,0,3303,310,1471,69,2807,0,0,0,4657,7960
IT-BG,Bergamo,84,198,2045,50,623,0,0,0,2916,320,1130,67,2641,0,0,0,4158,7074
IT-BG,Bergamo,85,150,1797,34,585,0,0,0,2566,266,929,54,2591,0,0,0,3840,6406
IT-BG,Bergamo,86,127,1444,37,504,0,0,0,2112,230,712,47,2305,0,0,0,3294,5406
IT-BG,Bergamo,87,96,1022,14,467,0,0,0,1599,228,481,27,2057,0,0,0,2793,4392
IT-BG,Bergamo,88,85,934,25,430,1,0,0,1475,249,382,31,2042,0,0,0,2704,4179
IT-BG,Bergamo,89,59,689,6,377,0,0,0,1131,202,269,18,1808,0,0,0,2297,3428
IT-BG,Bergamo,90,51,524,4,332,0,0,0,911,168,176,11,1586,0,0,0,1941,2852
IT-BG,Bergamo,91,45,361,5,305,0,0,0,716,167,118,12,1412,0,0,0,1709,2425
IT-BG,Bergamo,92,33,253,2,214,0,0,0,502,146,101,11,1236,0,0,0,1494,1996
IT-BG,Bergamo,93,26,218,4,200,0,0,0,448,150,41,7,1043,0,0,0,1241,1689
IT-BG,Bergamo,94,13,126,4,126,0,0,0,269,112,20,2,766,0,0,0,900,1169
IT-BG,Bergamo,95,11,84,1,88,0,0,0,184,78,25,2,597,1,0,0,703,887
IT-BG,Bergamo,96,6,49,0,69,0,0,0,124,55,10,4,426,0,0,0,495,619
IT-BG,Bergamo,97,6,25,0,55,0,0,0,86,46,4,0,307,0,0,0,357,443
IT-BG,Bergamo,98,2,12,0,30,0,0,0,44,31,6,2,209,0,0,0,248,292
IT-BG,Bergamo,99,5,5,2,20,0,0,0,32,14,5,1,158,0,0,0,178,210
IT-BG,Bergamo,100,4,6,0,23,0,0,0,33,32,1,1,198,0,0,0,232,265
IT-BG,Bergamo,999,272974,247052,18270,13863,519,17,7,552702,224686,247389,23378,61968,281,21,2,557725,1110427
IT-BI,Biella,0,452,0,0,0,0,0,0,452,405,0,0,0,0,0,0,405,857
IT-BI,Biella,1,450,0,0,0,0,0,0,450,409,0,0,0,0,0,0,409,859
IT-BI,Biella,2,439,0,0,0,0,0,0,439,455,0,0,0,0,0,0,455,894
IT-BI,Biella,3,481,0,0,0,0,0,0,481,446,0,0,0,0,0,0,446,927
IT-BI,Biella,4,485,0,0,0,0,0,0,485,490,0,0,0,0,0,0,490,975
IT-BI,Biella,5,504,0,0,0,0,0,0,504,536,0,0,0,0,0,0,536,1040
IT-BI,Biella,6,539,0,0,0,0,0,0,539,454,0,0,0,0,0,0,454,993
IT-BI,Biella,7,596,0,0,0,0,0,0,596,560,0,0,0,0,0,0,560,1156
IT-BI,Biella,8,575,0,0,0,0,0,0,575,544,0,0,0,0,0,0,544,1119
IT-BI,Biella,9,621,0,0,0,0,0,0,621,576,0,0,0,0,0,0,576,1197
IT-BI,Biella,10,640,0,0,0,0,0,0,640,562,0,0,0,0,0,0,562,1202
IT-BI,Biella,11,690,0,0,0,0,0,0,690,621,0,0,0,0,0,0,621,1311
IT-BI,Biella,12,617,0,0,0,0,0,0,617,662,0,0,0,0,0,0,662,1279
IT-BI,Biella,13,686,0,0,0,0,0,0,686,681,0,0,0,0,0,0,681,1367
IT-BI,Biella,14,668,0,0,0,0,0,0,668,724,0,0,0,0,0,0,724,1392
IT-BI,Biella,15,733,0,0,0,0,0,0,733,696,0,0,0,0,0,0,696,1429
IT-BI,Biella,16,772,0,0,0,0,0,0,772,713,0,0,0,0,0,0,713,1485
IT-BI,Biella,17,781,0,0,0,0,0,0,781,691,0,0,0,0,0,0,691,1472
IT-BI,Biella,18,784,0,0,0,0,0,0,784,699,1,0,0,0,0,0,700,1484
IT-BI,Biella,19,781,0,0,0,0,0,0,781,683,2,1,0,0,0,0,686,1467
IT-BI,Biella,20,813,1,1,0,0,0,0,815,726,4,0,0,0,0,0,730,1545
IT-BI,Biella,21,794,2,0,0,0,0,0,796,716,6,0,0,0,0,0,722,1518
IT-BI,Biella,22,764,2,0,0,0,0,0,766,735,15,0,0,0,0,0,750,1516
IT-BI,Biella,23,843,3,2,0,1,0,0,849,719,22,1,0,0,1,0,743,1592
IT-BI,Biella,24,852,9,1,0,0,0,0,862,711,23,2,1,1,0,0,738,1600
IT-BI,Biella,25,831,14,1,0,0,0,0,846,674,40,3,0,0,0,0,717,1563
IT-BI,Biella,26,789,27,2,0,0,0,0,818,640,59,2,0,1,0,0,702,1520
IT-BI,Biella,27,726,38,0,0,1,1,0,766,626,61,2,0,1,1,0,691,1457
IT-BI,Biella,28,703,48,3,0,0,0,0,754,598,124,2,0,0,0,0,724,1478
IT-BI,Biella,29,661,62,3,0,0,0,0,726,599,139,5,0,0,0,0,743,1469
IT-BI,Biella,30,697,91,4,0,0,0,0,792,535,193,7,0,0,0,0,735,1527
IT-BI,Biella,31,698,139,8,0,1,0,0,846,538,203,6,1,1,0,0,749,1595
IT-BI,Biella,32,697,165,9,1,1,0,0,873,523,228,6,1,1,0,0,759,1632
IT-BI,Biella,33,600,194,7,0,1,1,0,803,470,259,13,3,0,0,0,745,1548
IT-BI,Biella,34,585,209,2,0,3,0,0,799,420,278,13,4,1,0,0,716,1515
IT-BI,Biella,35,616,229,11,0,2,0,0,858,447,349,15,1,5,1,0,818,1676
IT-BI,Biella,36,495,233,10,1,3,0,0,742,356,325,24,3,3,0,0,711,1453
IT-BI,Biella,37,496,306,12,1,4,0,0,819,336,370,33,2,1,0,0,742,1561
IT-BI,Biella,38,479,286,18,2,3,0,0,788,346,403,41,6,1,0,0,797,1585
IT-BI,Biella,39,491,311,27,0,4,0,0,833,320,421,34,5,3,0,0,783,1616
IT-BI,Biella,40,454,352,26,1,1,0,0,834,307,401,41,11,2,0,0,762,1596
IT-BI,Biella,41,452,374,28,2,1,0,0,857,387,473,51,4,1,0,0,916,1773
IT-BI,Biella,42,406,388,42,2,2,0,0,840,327,521,58,6,3,0,0,915,1755
IT-BI,Biella,43,451,423,31,4,1,0,0,910,364,547,73,8,2,0,0,994,1904
IT-BI,Biella,44,435,409,51,3,2,0,0,900,329,526,74,6,0,0,0,935,1835
IT-BI,Biella,45,483,548,52,3,4,0,0,1090,364,626,97,13,0,0,0,1100,2190
IT-BI,Biella,46,472,579,53,7,3,0,0,1114,341,660,92,15,2,0,0,1110,2224
IT-BI,Biella,47,492,584,76,7,1,0,0,1160,317,743,117,28,0,0,0,1205,2365
IT-BI,Biella,48,485,642,74,4,2,0,0,1207,357,764,127,28,6,0,0,1282,2489
IT-BI,Biella,49,507,701,101,4,3,0,0,1316,327,843,126,25,1,0,0,1322,2638
IT-BI,Biella,50,534,724,86,4,4,0,0,1352,287,830,135,26,0,0,0,1278,2630
IT-BI,Biella,51,466,781,102,7,1,0,0,1357,307,861,183,28,3,0,0,1382,2739
IT-BI,Biella,52,453,803,121,9,6,0,0,1392,275,937,176,31,1,0,0,1420,2812
IT-BI,Biella,53,432,838,139,7,1,0,0,1417,265,946,176,51,1,0,0,1439,2856
IT-BI,Biella,54,395,900,125,10,2,0,0,1432,256,961,172,41,1,0,0,1431,2863
IT-BI,Biella,55,406,873,154,13,4,0,0,1450,252,1019,195,55,1,1,0,1523,2973
IT-BI,Biella,56,360,919,144,16,0,0,0,1439,253,994,198,84,2,0,0,1531,2970
IT-BI,Biella,57,340,998,144,17,5,0,0,1504,225,968,175,56,0,0,0,1424,2928
IT-BI,Biella,58,328,983,147,23,1,0,0,1482,204,1082,219,78,0,0,0,1583,3065
IT-BI,Biella,59,322,997,190,23,5,0,0,1537,202,1072,202,82,1,0,0,1559,3096
IT-BI,Biella,60,256,988,136,21,0,0,0,1401,148,984,184,78,0,0,0,1394,2795
IT-BI,Biella,61,245,892,144,29,3,0,0,1313,139,927,167,91,1,0,0,1325,2638
IT-BI,Biella,62,201,952,145,27,0,0,0,1325,136,941,192,128,2,0,0,1399,2724
IT-BI,Biella,63,201,896,119,37,1,0,0,1254,127,923,167,130,0,0,0,1347,2601
IT-BI,Biella,64,179,864,135,31,1,0,0,1210,119,826,134,161,0,0,0,1240,2450
IT-BI,Biella,65,165,836,105,43,0,0,0,1149,102,835,144,145,0,0,0,1226,2375
IT-BI,Biella,66,136,892,128,39,1,0,0,1196,107,848,118,181,0,0,0,1254,2450
IT-BI,Biella,67,144,857,103,45,2,0,0,1151,103,792,122,177,0,0,0,1194,2345
IT-BI,Biella,68,121,853,95,39,1,0,0,1109,100,848,135,196,0,0,0,1279,2388
IT-BI,Biella,69,118,851,77,43,0,0,0,1089,81,838,123,211,0,0,1,1254,2343
IT-BI,Biella,70,99,857,85,46,0,0,1,1088,81,765,87,234,0,0,0,1167,2255
IT-BI,Biella,71,108,837,85,70,0,0,0,1100,80,789,93,244,0,0,0,1206,2306
IT-BI,Biella,72,80,814,63,77,0,0,0,1034,61,743,99,284,0,0,0,1187,2221
IT-BI,Biella,73,76,806,68,71,0,0,0,1021,76,829,61,335,0,0,0,1301,2322
IT-BI,Biella,74,90,869,69,89,0,0,0,1117,65,730,77,324,0,0,0,1196,2313
IT-BI,Biella,75,93,875,67,101,0,0,0,1136,78,747,65,377,1,0,0,1268,2404
IT-BI,Biella,76,81,786,52,83,0,0,0,1002,58,671,62,390,0,0,0,1181,2183
IT-BI,Biella,77,70,732,42,112,1,0,0,957,62,641,58,412,0,0,0,1173,2130
IT-BI,Biella,78,53,556,30,99,0,0,0,738,52,413,53,348,0,0,0,866,1604
IT-BI,Biella,79,67,590,27,97,0,0,0,781,55,446,30,420,0,0,0,951,1732
IT-BI,Biella,80,52,527,28,103,0,0,0,710,44,380,30,446,0,0,0,900,1610
IT-BI,Biella,81,49,530,20,102,0,0,0,701,41,397,43,489,0,0,0,970,1671
IT-BI,Biella,82,51,482,27,113,1,0,0,674,63,359,41,511,0,0,0,974,1648
IT-BI,Biella,83,49,511,16,130,0,0,0,706,51,348,40,600,0,0,0,1039,1745
IT-BI,Biella,84,31,461,11,125,0,0,0,628,52,312,41,588,0,0,0,993,1621
IT-BI,Biella,85,41,369,11,141,0,0,0,562,55,251,22,621,0,0,0,949,1511
IT-BI,Biella,86,26,313,16,121,0,0,0,476,48,180,20,518,0,0,0,766,1242
IT-BI,Biella,87,22,276,8,117,0,0,0,423,30,135,15,494,0,0,0,674,1097
IT-BI,Biella,88,23,219,8,92,0,0,0,342,35,110,15,511,0,0,0,671,1013
IT-BI,Biella,89,10,190,9,90,0,0,0,299,51,70,14,462,0,0,0,597,896
IT-BI,Biella,90,7,119,3,73,0,0,0,202,40,57,10,429,0,0,0,536,738
IT-BI,Biella,91,14,96,0,68,0,0,0,178,25,35,7,378,0,0,0,445,623
IT-BI,Biella,92,8,69,1,62,0,0,0,140,24,24,3,328,0,0,0,379,519
IT-BI,Biella,93,5,68,1,60,0,0,0,134,20,23,2,262,0,0,0,307,441
IT-BI,Biella,94,4,27,0,37,0,0,0,68,20,4,3,228,0,0,0,255,323
IT-BI,Biella,95,1,18,0,26,0,0,0,45,10,5,4,152,0,0,0,171,216
IT-BI,Biella,96,2,13,0,21,0,0,0,36,9,4,4,141,0,0,0,158,194
IT-BI,Biella,97,2,8,0,12,0,0,0,22,10,4,0,81,0,0,0,95,117
IT-BI,Biella,98,1,2,0,9,0,0,0,12,4,0,0,50,0,0,0,54,66
IT-BI,Biella,99,0,3,0,2,0,0,0,5,4,1,1,42,0,0,0,48,53
IT-BI,Biella,100,2,0,0,7,0,0,0,9,12,2,1,64,0,0,0,79,88
IT-BI,Biella,999,37580,37089,3941,2881,84,2,1,81578,31066,37536,5384,12964,50,4,1,87005,168583
IT-BO,Bologna,0,3399,0,0,0,0,0,0,3399,3134,0,0,0,0,0,0,3134,6533
IT-BO,Bologna,1,3572,0,0,0,0,0,0,3572,3336,0,0,0,0,0,0,3336,6908
IT-BO,Bologna,2,3630,0,0,0,0,0,0,3630,3436,0,0,0,0,0,0,3436,7066
IT-BO,Bologna,3,3561,0,0,0,0,0,0,3561,3498,0,0,0,0,0,0,3498,7059
IT-BO,Bologna,4,3678,0,0,0,0,0,0,3678,3616,0,0,0,0,0,0,3616,7294
IT-BO,Bologna,5,3933,0,0,0,0,0,0,3933,3773,0,0,0,0,0,0,3773,7706
IT-BO,Bologna,6,3994,0,0,0,0,0,0,3994,3775,0,0,0,0,0,0,3775,7769
IT-BO,Bologna,7,4205,0,0,0,0,0,0,4205,3896,0,0,0,0,0,0,3896,8101
IT-BO,Bologna,8,4306,0,0,0,0,0,0,4306,4086,0,0,0,0,0,0,4086,8392
IT-BO,Bologna,9,4355,0,0,0,0,0,0,4355,4210,0,0,0,0,0,0,4210,8565
IT-BO,Bologna,10,4349,0,0,0,0,0,0,4349,4267,0,0,0,0,0,0,4267,8616
IT-BO,Bologna,11,4535,0,0,0,0,0,0,4535,4279,0,0,0,0,0,0,4279,8814
IT-BO,Bologna,12,4591,0,0,0,0,0,0,4591,4358,0,0,0,0,0,0,4358,8949
IT-BO,Bologna,13,4726,0,0,0,0,0,0,4726,4288,0,0,0,0,0,0,4288,9014
IT-BO,Bologna,14,4878,0,0,0,0,0,0,4878,4617,0,0,0,0,0,0,4617,9495
IT-BO,Bologna,15,4755,0,0,0,0,0,0,4755,4491,0,0,0,0,0,0,4491,9246
IT-BO,Bologna,16,4782,0,0,0,0,0,0,4782,4533,0,0,0,0,0,0,4533,9315
IT-BO,Bologna,17,4927,0,1,0,0,0,0,4928,4445,0,0,0,0,0,0,4445,9373
IT-BO,Bologna,18,4931,1,0,0,0,0,0,4932,4378,1,0,0,0,0,0,4379,9311
IT-BO,Bologna,19,5034,5,0,0,0,0,0,5039,4449,16,0,0,0,0,0,4465,9504
IT-BO,Bologna,20,4858,8,0,0,0,0,0,4866,4274,41,0,0,0,0,0,4315,9181
IT-BO,Bologna,21,4930,16,0,0,0,1,0,4947,4369,59,0,1,0,0,0,4429,9376
IT-BO,Bologna,22,4967,14,3,0,0,0,0,4984,4382,111,1,0,0,0,0,4494,9478
IT-BO,Bologna,23,5091,31,6,0,0,0,0,5128,4435,204,4,0,0,0,0,4643,9771
IT-BO,Bologna,24,5098,72,5,2,0,0,0,5177,4412,251,7,0,1,0,0,4671,9848
IT-BO,Bologna,25,5098,119,6,0,1,0,0,5224,4289,353,11,0,2,0,0,4655,9879
IT-BO,Bologna,26,5141,195,7,1,1,0,0,5345,4469,473,10,0,3,1,0,4956,10301
IT-BO,Bologna,27,5214,256,12,1,3,0,0,5486,4511,641,12,1,5,1,0,5171,10657
IT-BO,Bologna,28,5180,401,8,0,4,0,0,5593,4401,820,19,0,4,0,0,5244,10837
IT-BO,Bologna,29,5206,512,8,1,7,1,0,5735,4358,1058,32,2,11,0,0,5461,11196
IT-BO,Bologna,30,5198,660,12,0,3,2,0,5875,4195,1286,28,4,5,1,0,5519,11394
IT-BO,Bologna,31,5100,959,25,2,7,0,0,6093,4298,1703,54,7,8,0,0,6070,12163
IT-BO,Bologna,32,4914,1106,29,4,8,0,0,6061,3878,1788,56,8,11,1,1,5743,11804
IT-BO,Bologna,33,4801,1394,41,4,13,0,0,6253,3777,2064,69,9,16,3,0,5938,12191
IT-BO,Bologna,34,4289,1581,35,2,10,0,0,5917,3478,2246,89,4,19,3,0,5839,11756
IT-BO,Bologna,35,4098,1850,42,3,12,0,0,6005,3324,2480,118,8,13,1,1,5945,11950
IT-BO,Bologna,36,3899,2011,63,8,11,1,0,5993,3028,2671,136,17,20,1,0,5873,11866
IT-BO,Bologna,37,3555,2209,72,8,15,3,0,5862,2954,2918,155,25,16,0,0,6068,11930
IT-BO,Bologna,38,3519,2450,114,3,14,0,0,6100,2838,3032,209,27,25,1,0,6132,12232
IT-BO,Bologna,39,3443,2621,109,6,13,1,0,6193,2781,3242,230,18,27,1,0,6299,12492
IT-BO,Bologna,40,3378,2843,144,7,17,2,0,6391,2741,3271,260,39,26,1,0,6338,12729
IT-BO,Bologna,41,3195,2923,167,8,16,1,0,6310,2631,3373,270,49,23,0,0,6346,12656
IT-BO,Bologna,42,3026,3144,179,12,25,0,0,6386,2477,3446,298,47,20,2,0,6290,12676
IT-BO,Bologna,43,3107,3313,180,23,16,2,0,6641,2498,3582,389,58,13,2,0,6542,13183
IT-BO,Bologna,44,3009,3301,226,21,21,1,0,6579,2539,3928,369,72,13,1,0,6922,13501
IT-BO,Bologna,45,3068,3748,275,28,24,0,0,7143,2557,3995,406,77,19,0,0,7054,14197
IT-BO,Bologna,46,3210,3701,274,25,8,3,0,7221,2645,4119,481,93,22,3,0,7363,14584
IT-BO,Bologna,47,3285,4015,320,13,22,0,2,7657,2611,4393,545,111,23,0,0,7683,15340
IT-BO,Bologna,48,3224,4167,376,39,27,1,0,7834,2711,4718,592,101,19,1,0,8142,15976
IT-BO,Bologna,49,3297,4336,384,31,36,1,0,8085,2683,4851,608,143,14,1,1,8301,16386
IT-BO,Bologna,50,3146,4622,480,35,32,0,0,8315,2682,4950,704,135,16,0,0,8487,16802
IT-BO,Bologna,51,3017,4651,488,47,23,0,0,8226,2557,4899,786,159,15,1,0,8417,16643
IT-BO,Bologna,52,2926,4947,561,42,24,0,0,8500,2473,5206,784,152,26,0,0,8641,17141
IT-BO,Bologna,53,2660,4889,603,53,29,4,0,8238,2301,5163,865,204,12,0,0,8545,16783
IT-BO,Bologna,54,2590,4995,603,49,30,0,0,8267,2237,5230,874,226,18,0,0,8585,16852
IT-BO,Bologna,55,2418,4894,624,63,21,0,0,8020,2068,5169,920,289,18,0,1,8465,16485
IT-BO,Bologna,56,2204,4914,692,75,35,0,0,7920,2006,5190,957,277,5,0,0,8435,16355
IT-BO,Bologna,57,2166,5002,664,81,24,1,0,7938,1930,5113,957,303,9,1,0,8313,16251
IT-BO,Bologna,58,1931,5127,748,85,16,0,1,7908,1758,5252,943,369,6,0,0,8328,16236
IT-BO,Bologna,59,1864,5321,729,106,22,0,1,8043,1716,5364,994,402,10,1,0,8487,16530
IT-BO,Bologna,60,1564,4982,686,91,24,0,1,7348,1526,4819,947,378,13,0,0,7683,15031
IT-BO,Bologna,61,1396,4864,665,111,16,0,2,7054,1320,4942,908,462,5,1,0,7638,14692
IT-BO,Bologna,62,1309,4674,593,138,22,0,0,6736,1253,4887,828,487,4,0,1,7460,14196
IT-BO,Bologna,63,1090,4540,608,139,17,0,1,6395,1165,4595,884,548,3,0,0,7195,13590
IT-BO,Bologna,64,1024,4644,620,175,17,0,0,6480,1110,4455,751,655,5,0,1,6977,13457
IT-BO,Bologna,65,949,4413,554,171,16,1,2,6106,950,4455,755,632,4,0,0,6796,12902
IT-BO,Bologna,66,848,4426,550,165,13,0,0,6002,904,4262,727,675,8,0,0,6576,12578
IT-BO,Bologna,67,714,4320,504,192,10,1,0,5741,861,4148,656,760,5,0,0,6430,12171
IT-BO,Bologna,68,668,3998,478,222,8,0,0,5374,727,3964,643,814,3,0,0,6151,11525
IT-BO,Bologna,69,612,4086,372,213,9,0,0,5292,666,3929,614,909,6,0,0,6124,11416
IT-BO,Bologna,70,532,3908,354,255,6,0,0,5055,552,3720,547,948,3,0,0,5770,10825
IT-BO,Bologna,71,478,3690,361,244,13,0,0,4786,543,3651,516,1016,3,0,0,5729,10515
IT-BO,Bologna,72,464,3628,354,270,4,0,0,4720,503,3516,476,1086,2,0,0,5583,10303
IT-BO,Bologna,73,417,3794,305,314,4,0,0,4834,472,3600,463,1218,3,0,0,5756,10590
IT-BO,Bologna,74,360,3902,280,336,2,0,0,4880,427,3534,459,1402,1,0,0,5823,10703
IT-BO,Bologna,75,393,4125,289,412,6,1,0,5226,392,3761,470,1684,1,0,0,6308,11534
IT-BO,Bologna,76,364,4120,282,434,0,0,0,5200,357,3639,393,1835,0,0,0,6224,11424
IT-BO,Bologna,77,341,4135,250,509,1,0,0,5236,341,3505,437,2094,0,0,0,6377,11613
IT-BO,Bologna,78,203,2609,160,387,0,0,0,3359,216,2202,255,1511,3,0,0,4187,7546
IT-BO,Bologna,79,268,2960,135,460,1,0,0,3824,280,2417,253,1794,1,0,0,4745,8569
IT-BO,Bologna,80,219,2814,152,508,1,0,0,3694,246,2208,223,1996,0,0,0,4673,8367
IT-BO,Bologna,81,195,2632,109,505,1,0,0,3442,279,2086,223,2063,1,0,0,4652,8094
IT-BO,Bologna,82,226,2521,111,534,1,0,0,3393,257,1884,206,2316,0,0,0,4663,8056
IT-BO,Bologna,83,236,2602,96,634,1,0,0,3569,255,1882,202,2665,0,0,0,5004,8573
IT-BO,Bologna,84,212,2425,86,676,3,0,0,3402,238,1601,170,2780,0,0,0,4789,8191
IT-BO,Bologna,85,152,2127,67,651,1,0,0,2998,215,1352,150,2705,0,0,0,4422,7420
IT-BO,Bologna,86,141,1746,60,559,0,0,0,2506,171,1017,110,2464,1,0,0,3763,6269
IT-BO,Bologna,87,102,1398,35,601,1,0,0,2137,176,754,79,2275,0,0,0,3284,5421
IT-BO,Bologna,88,98,1246,26,552,1,0,0,1923,160,615,79,2368,0,0,0,3222,5145
IT-BO,Bologna,89,85,962,32,516,0,0,0,1595,131,457,57,2157,0,0,0,2802,4397
IT-BO,Bologna,90,65,809,25,478,0,0,0,1377,133,320,47,1965,0,0,0,2465,3842
IT-BO,Bologna,91,64,609,15,403,0,0,0,1091,101,209,27,1724,0,0,0,2061,3152
IT-BO,Bologna,92,45,463,11,360,0,0,0,879,112,124,35,1478,0,0,0,1749,2628
IT-BO,Bologna,93,38,325,7,294,0,0,0,664,84,107,24,1383,0,0,0,1598,2262
IT-BO,Bologna,94,18,215,1,241,0,0,0,475,65,61,15,1122,0,0,0,1263,1738
IT-BO,Bologna,95,17,115,4,173,0,0,0,309,55,35,7,797,0,0,0,894,1203
IT-BO,Bologna,96,10,105,3,145,0,0,0,263,40,25,9,646,0,0,0,720,983
IT-BO,Bologna,97,9,46,0,103,0,0,0,158,35,9,2,455,0,0,0,501,659
IT-BO,Bologna,98,7,30,1,50,0,0,0,88,33,4,9,352,0,0,0,398,486
IT-BO,Bologna,99,1,19,1,49,0,0,0,70,19,7,2,239,0,0,0,267,337
IT-BO,Bologna,100,3,15,1,55,0,0,0,74,35,3,3,380,0,0,0,421,495
IT-BO,Bologna,999,252398,208366,18558,14213,789,28,10,494362,224542,211431,27903,58675,588,29,6,523174,1017536
IT-BZ,Bolzano/Bozen,0,2423,0,0,0,0,0,0,2423,2273,0,0,0,0,0,0,2273,4696
IT-BZ,Bolzano/Bozen,1,2475,0,0,0,0,0,0,2475,2488,0,0,0,0,0,0,2488,4963
IT-BZ,Bolzano/Bozen,2,2678,0,0,0,0,0,0,2678,2551,0,0,0,0,0,0,2551,5229
IT-BZ,Bolzano/Bozen,3,2656,0,0,0,0,0,0,2656,2577,0,0,0,0,0,0,2577,5233
IT-BZ,Bolzano/Bozen,4,2775,0,0,0,0,0,0,2775,2577,0,0,0,0,0,0,2577,5352
IT-BZ,Bolzano/Bozen,5,2832,0,0,0,0,0,0,2832,2611,0,0,0,0,0,0,2611,5443
IT-BZ,Bolzano/Bozen,6,2828,0,0,0,0,0,0,2828,2687,0,0,0,0,0,0,2687,5515
IT-BZ,Bolzano/Bozen,7,2825,0,0,0,0,0,0,2825,2764,0,0,0,0,0,0,2764,5589
IT-BZ,Bolzano/Bozen,8,2850,0,0,0,0,0,0,2850,2758,0,0,0,0,0,0,2758,5608
IT-BZ,Bolzano/Bozen,9,2925,0,0,0,0,0,0,2925,2805,0,0,0,0,0,0,2805,5730
IT-BZ,Bolzano/Bozen,10,2884,0,0,0,0,0,0,2884,2617,0,0,0,0,0,0,2617,5501
IT-BZ,Bolzano/Bozen,11,2953,0,0,0,0,0,0,2953,2761,0,0,0,0,0,0,2761,5714
IT-BZ,Bolzano/Bozen,12,2896,0,0,0,0,0,0,2896,2747,0,0,0,0,0,0,2747,5643
IT-BZ,Bolzano/Bozen,13,2922,0,0,0,0,0,0,2922,2680,0,0,0,0,0,0,2680,5602
IT-BZ,Bolzano/Bozen,14,2926,0,0,0,0,0,0,2926,2711,0,0,0,0,0,0,2711,5637
IT-BZ,Bolzano/Bozen,15,2984,0,0,0,0,0,0,2984,2808,0,0,0,0,0,0,2808,5792
IT-BZ,Bolzano/Bozen,16,3098,0,0,0,0,0,0,3098,2734,0,0,0,0,0,0,2734,5832
IT-BZ,Bolzano/Bozen,17,2985,1,0,0,0,0,0,2986,2826,0,0,0,0,0,0,2826,5812
IT-BZ,Bolzano/Bozen,18,3120,0,0,0,0,0,0,3120,2820,3,0,0,0,0,0,2823,5943
IT-BZ,Bolzano/Bozen,19,3114,1,0,0,0,0,0,3115,2837,18,0,0,0,0,0,2855,5970
IT-BZ,Bolzano/Bozen,20,3085,2,0,0,0,0,0,3087,2776,43,0,0,0,0,0,2819,5906
IT-BZ,Bolzano/Bozen,21,3001,8,0,0,0,0,0,3009,2716,52,1,0,0,0,0,2769,5778
IT-BZ,Bolzano/Bozen,22,3163,19,5,0,0,0,0,3187,2796,86,4,0,0,0,0,2886,6073
IT-BZ,Bolzano/Bozen,23,3133,39,1,0,0,0,0,3173,2784,130,4,0,1,0,0,2919,6092
IT-BZ,Bolzano/Bozen,24,3136,55,3,0,0,0,0,3194,2766,193,4,0,2,0,0,2965,6159
IT-BZ,Bolzano/Bozen,25,3100,123,2,0,0,0,0,3225,2684,287,9,0,0,0,0,2980,6205
IT-BZ,Bolzano/Bozen,26,3144,169,8,0,2,0,0,3323,2572,384,3,0,2,0,0,2961,6284
IT-BZ,Bolzano/Bozen,27,2964,244,3,0,3,0,0,3214,2418,530,12,4,0,0,0,2964,6178
IT-BZ,Bolzano/Bozen,28,2788,305,6,0,2,0,0,3101,2145,598,13,1,5,0,0,2762,5863
IT-BZ,Bolzano/Bozen,29,2713,417,17,1,2,0,0,3150,2142,779,14,0,4,0,0,2939,6089
IT-BZ,Bolzano/Bozen,30,2545,516,15,0,2,0,0,3078,1948,914,30,0,3,0,0,2895,5973
IT-BZ,Bolzano/Bozen,31,2507,685,13,0,5,0,0,3210,1817,1108,35,2,8,1,0,2971,6181
IT-BZ,Bolzano/Bozen,32,2397,813,26,3,2,0,0,3241,1810,1240,36,8,3,0,0,3097,6338
IT-BZ,Bolzano/Bozen,33,2326,959,26,3,5,0,0,3319,1642,1327,40,1,9,0,0,3019,6338
IT-BZ,Bolzano/Bozen,34,2133,1117,23,2,1,0,0,3276,1577,1424,63,6,8,0,0,3078,6354
IT-BZ,Bolzano/Bozen,35,2005,1189,43,5,2,2,0,3246,1533,1486,59,3,8,1,0,3090,6336
IT-BZ,Bolzano/Bozen,36,1859,1210,38,4,6,0,0,3117,1409,1523,68,6,5,0,0,3011,6128
IT-BZ,Bolzano/Bozen,37,1765,1341,52,3,5,0,0,3166,1287,1623,85,18,7,1,0,3021,6187
IT-BZ,Bolzano/Bozen,38,1683,1484,51,3,2,2,0,3225,1264,1730,102,17,8,0,0,3121,6346
IT-BZ,Bolzano/Bozen,39,1648,1484,48,3,7,0,0,3190,1238,1698,113,18,5,1,0,3073,6263
IT-BZ,Bolzano/Bozen,40,1582,1612,51,3,5,1,0,3254,1248,1870,117,16,4,0,0,3255,6509
IT-BZ,Bolzano/Bozen,41,1587,1746,71,2,4,0,0,3410,1264,2022,132,17,4,1,0,3440,6850
IT-BZ,Bolzano/Bozen,42,1573,1792,83,13,1,0,0,3462,1200,2031,151,39,5,0,0,3426,6888
IT-BZ,Bolzano/Bozen,43,1531,1842,83,14,3,1,0,3474,1109,2093,161,49,4,0,0,3416,6890
IT-BZ,Bolzano/Bozen,44,1425,1754,77,7,6,0,0,3269,1157,2057,165,36,3,0,0,3418,6687
IT-BZ,Bolzano/Bozen,45,1420,1876,109,7,4,0,0,3416,1114,2145,180,36,4,0,0,3479,6895
IT-BZ,Bolzano/Bozen,46,1384,1878,138,12,1,0,0,3413,1086,2096,227,46,2,1,0,3458,6871
IT-BZ,Bolzano/Bozen,47,1315,1985,144,9,8,0,0,3461,1188,2136,254,39,3,0,0,3620,7081
IT-BZ,Bolzano/Bozen,48,1402,2181,170,14,2,0,0,3769,1129,2302,296,48,4,1,0,3780,7549
IT-BZ,Bolzano/Bozen,49,1489,2268,189,17,15,0,0,3978,1177,2401,311,81,4,0,0,3974,7952
IT-BZ,Bolzano/Bozen,50,1417,2225,267,20,8,0,0,3937,1162,2517,340,70,5,1,0,4095,8032
IT-BZ,Bolzano/Bozen,51,1450,2434,251,21,4,1,0,4161,1178,2619,356,66,4,1,0,4224,8385
IT-BZ,Bolzano/Bozen,52,1456,2525,270,26,7,0,0,4284,1084,2674,404,97,5,0,0,4264,8548
IT-BZ,Bolzano/Bozen,53,1355,2511,278,29,5,0,0,4178,979,2690,488,104,2,0,0,4263,8441
IT-BZ,Bolzano/Bozen,54,1458,2744,337,29,8,0,0,4576,960,2798,452,134,3,0,0,4347,8923
IT-BZ,Bolzano/Bozen,55,1277,2721,325,34,8,1,1,4367,953,2834,475,124,3,1,0,4390,8757
IT-BZ,Bolzano/Bozen,56,1172,2685,354,38,3,0,0,4252,879,2791,467,180,4,0,0,4321,8573
IT-BZ,Bolzano/Bozen,57,1182,2826,347,29,7,0,0,4391,812,2873,473,178,2,0,0,4338,8729
IT-BZ,Bolzano/Bozen,58,1069,2969,376,41,8,0,0,4463,853,2750,509,168,3,0,0,4283,8746
IT-BZ,Bolzano/Bozen,59,988,2941,398,57,4,0,0,4388,674,2885,459,231,3,1,0,4253,8641
IT-BZ,Bolzano/Bozen,60,835,2812,363,63,4,0,0,4077,649,2773,400,211,0,0,0,4033,8110
IT-BZ,Bolzano/Bozen,61,734,2706,319,53,2,0,0,3814,594,2639,429,248,0,0,0,3910,7724
IT-BZ,Bolzano/Bozen,62,694,2514,350,68,3,0,0,3629,571,2557,379,271,1,0,0,3779,7408
IT-BZ,Bolzano/Bozen,63,629,2527,343,68,5,0,0,3572,486,2414,357,289,1,0,0,3547,7119
IT-BZ,Bolzano/Bozen,64,517,2540,305,76,1,0,0,3439,457,2274,323,283,2,0,0,3339,6778
IT-BZ,Bolzano/Bozen,65,484,2282,256,79,3,0,0,3104,429,2101,291,353,2,0,0,3176,6280
IT-BZ,Bolzano/Bozen,66,446,2105,221,82,2,0,0,2856,424,2159,270,370,0,0,0,3223,6079
IT-BZ,Bolzano/Bozen,67,415,2091,204,75,4,0,0,2789,331,1955,247,400,1,0,0,2934,5723
IT-BZ,Bolzano/Bozen,68,360,2017,199,76,1,0,0,2653,321,1833,202,429,1,0,0,2786,5439
IT-BZ,Bolzano/Bozen,69,325,1885,187,84,1,0,0,2482,282,1752,215,419,2,0,0,2670,5152
IT-BZ,Bolzano/Bozen,70,301,1838,148,106,2,0,0,2395,265,1710,205,478,0,0,0,2658,5053
IT-BZ,Bolzano/Bozen,71,301,1723,143,101,1,0,0,2269,256,1669,152,511,0,0,0,2588,4857
IT-BZ,Bolzano/Bozen,72,242,1762,136,112,0,0,0,2252,207,1505,166,545,0,0,0,2423,4675
IT-BZ,Bolzano/Bozen,73,262,1650,143,125,1,0,0,2181,252,1491,168,588,1,0,0,2500,4681
IT-BZ,Bolzano/Bozen,74,225,1647,109,150,1,0,0,2132,216,1436,142,650,0,0,0,2444,4576
IT-BZ,Bolzano/Bozen,75,215,1708,105,136,1,0,1,2166,219,1441,126,736,0,0,0,2522,4688
IT-BZ,Bolzano/Bozen,76,200,1534,87,181,0,0,0,2002,191,1356,137,766,0,0,0,2450,4452
IT-BZ,Bolzano/Bozen,77,203,1621,81,210,0,0,0,2115,249,1368,138,873,0,0,0,2628,4743
IT-BZ,Bolzano/Bozen,78,133,1213,47,138,2,0,1,1534,155,906,101,716,0,0,0,1878,3412
IT-BZ,Bolzano/Bozen,79,161,1341,66,189,0,0,0,1757,188,1092,89,899,0,0,0,2268,4025
IT-BZ,Bolzano/Bozen,80,144,1479,49,231,1,0,0,1904,182,1079,104,962,0,0,0,2327,4231
IT-BZ,Bolzano/Bozen,81,146,1349,79,197,0,0,0,1771,186,942,88,1098,0,0,0,2314,4085
IT-BZ,Bolzano/Bozen,82,145,1301,57,231,0,0,0,1734,168,881,78,1119,0,0,0,2246,3980
IT-BZ,Bolzano/Bozen,83,127,1067,41,218,0,0,0,1453,161,688,65,1069,0,0,0,1983,3436
IT-BZ,Bolzano/Bozen,84,117,1021,25,227,0,0,0,1390,149,584,58,1155,0,0,0,1946,3336
IT-BZ,Bolzano/Bozen,85,78,834,24,238,0,0,0,1174,148,467,38,1020,0,0,0,1673,2847
IT-BZ,Bolzano/Bozen,86,73,722,20,204,0,0,0,1019,139,337,34,953,0,0,0,1463,2482
IT-BZ,Bolzano/Bozen,87,68,549,14,170,0,0,0,801,139,270,25,912,0,0,0,1346,2147
IT-BZ,Bolzano/Bozen,88,55,425,11,177,0,0,0,668,99,224,16,846,0,0,0,1185,1853
IT-BZ,Bolzano/Bozen,89,43,413,6,171,0,0,0,633,113,164,14,805,0,0,0,1096,1729
IT-BZ,Bolzano/Bozen,90,40,345,9,143,0,0,0,537,105,110,10,732,0,0,0,957,1494
IT-BZ,Bolzano/Bozen,91,16,249,4,169,0,0,0,438,84,79,11,641,0,0,0,815,1253
IT-BZ,Bolzano/Bozen,92,20,199,4,114,0,0,0,337,75,62,6,549,0,0,0,692,1029
IT-BZ,Bolzano/Bozen,93,21,139,4,102,0,0,0,266,71,42,11,453,0,0,0,577,843
IT-BZ,Bolzano/Bozen,94,7,68,0,79,0,0,0,154,53,30,4,348,0,0,0,435,589
IT-BZ,Bolzano/Bozen,95,7,69,1,55,0,0,0,132,36,21,4,245,0,0,0,306,438
IT-BZ,Bolzano/Bozen,96,7,36,0,47,0,0,0,90,34,9,4,197,0,0,0,244,334
IT-BZ,Bolzano/Bozen,97,1,17,1,23,0,0,0,42,27,4,1,133,0,0,0,165,207
IT-BZ,Bolzano/Bozen,98,0,13,0,25,0,0,0,38,20,3,2,96,0,0,0,121,159
IT-BZ,Bolzano/Bozen,99,1,3,0,16,0,0,0,20,16,1,0,72,0,0,0,89,109
IT-BZ,Bolzano/Bozen,100,2,3,0,17,0,0,0,22,17,1,0,116,0,0,0,134,156
IT-BZ,Bolzano/Bozen,999,144576,107513,8859,5475,192,8,3,266626,124926,108189,12222,25399,160,11,0,270907,537533
IT-BS,Brescia,0,4359,0,0,0,0,0,0,4359,4263,0,0,0,0,0,0,4263,8622
IT-BS,Brescia,1,4605,0,0,0,0,0,0,4605,4210,0,0,0,0,0,0,4210,8815
IT-BS,Brescia,2,4594,0,0,0,0,0,0,4594,4443,0,0,0,0,0,0,4443,9037
IT-BS,Brescia,3,4871,0,0,0,0,0,0,4871,4504,0,0,0,0,0,0,4504,9375
IT-BS,Brescia,4,4993,0,0,0,0,0,0,4993,4703,0,0,0,0,0,0,4703,9696
IT-BS,Brescia,5,5240,0,0,0,0,0,0,5240,4916,0,0,0,0,0,0,4916,10156
IT-BS,Brescia,6,5428,0,0,0,0,0,0,5428,5115,0,0,0,0,0,0,5115,10543
IT-BS,Brescia,7,5560,0,0,0,0,0,0,5560,5442,0,0,0,0,0,0,5442,11002
IT-BS,Brescia,8,5800,0,0,0,0,0,0,5800,5516,0,0,0,0,0,0,5516,11316
IT-BS,Brescia,9,5866,0,0,0,0,0,0,5866,5613,0,0,0,0,0,0,5613,11479
IT-BS,Brescia,10,6031,0,0,0,0,0,0,6031,5730,0,0,0,0,0,0,5730,11761
IT-BS,Brescia,11,6084,0,0,0,0,0,0,6084,5980,0,0,0,0,0,0,5980,12064
IT-BS,Brescia,12,6505,0,0,0,0,0,0,6505,6055,0,0,0,0,0,0,6055,12560
IT-BS,Brescia,13,6878,0,0,0,0,0,0,6878,6316,0,0,0,0,0,0,6316,13194
IT-BS,Brescia,14,6810,0,0,0,0,0,0,6810,6478,0,0,0,0,0,0,6478,13288
IT-BS,Brescia,15,6925,0,0,0,0,0,0,6925,6440,0,0,0,0,0,0,6440,13365
IT-BS,Brescia,16,6904,0,0,0,0,0,0,6904,6429,0,0,0,0,0,0,6429,13333
IT-BS,Brescia,17,6872,0,0,0,0,0,0,6872,6415,0,0,0,0,0,0,6415,13287
IT-BS,Brescia,18,6570,2,0,0,0,0,0,6572,6156,7,0,0,0,0,0,6163,12735
IT-BS,Brescia,19,6801,0,0,0,0,0,0,6801,6247,18,0,0,0,0,0,6265,13066
IT-BS,Brescia,20,6763,2,0,0,0,0,0,6765,6045,76,0,0,0,0,0,6121,12886
IT-BS,Brescia,21,6801,7,0,0,0,0,0,6808,5862,100,1,0,0,0,0,5963,12771
IT-BS,Brescia,22,6974,45,6,0,0,0,0,7025,6016,217,6,1,0,0,0,6240,13265
IT-BS,Brescia,23,6976,65,3,0,0,0,0,7044,5887,310,7,0,0,0,0,6204,13248
IT-BS,Brescia,24,6894,110,5,0,2,0,0,7011,5773,444,5,1,0,2,0,6225,13236
IT-BS,Brescia,25,6843,187,13,0,4,0,0,7047,5535,628,9,1,2,1,0,6176,13223
IT-BS,Brescia,26,6618,315,8,0,2,1,0,6944,5454,814,17,0,2,0,0,6287,13231
IT-BS,Brescia,27,6424,412,10,0,8,0,0,6854,5203,999,20,1,7,0,0,6230,13084
IT-BS,Brescia,28,6262,565,14,0,6,0,0,6847,4871,1374,31,2,7,0,0,6285,13132
IT-BS,Brescia,29,5965,750,19,0,9,1,0,6744,4597,1713,37,5,8,1,0,6361,13105
IT-BS,Brescia,30,5844,1065,23,0,8,0,0,6940,4376,2035,54,3,12,1,0,6481,13421
IT-BS,Brescia,31,5688,1339,25,0,12,0,0,7064,4165,2351,68,6,6,1,0,6597,13661
IT-BS,Brescia,32,5026,1684,43,3,13,0,0,6769,3830,2722,81,11,9,2,0,6655,13424
IT-BS,Brescia,33,4987,2002,56,2,6,1,0,7054,3651,3123,104,10,11,1,0,6900,13954
IT-BS,Brescia,34,4828,2172,61,6,7,2,0,7076,3321,3298,138,12,13,0,0,6782,13858
IT-BS,Brescia,35,4642,2717,83,3,12,0,0,7457,3185,3666,159,16,5,1,0,7032,14489
IT-BS,Brescia,36,4165,2791,85,11,13,3,0,7068,2865,3841,183,19,9,1,0,6918,13986
IT-BS,Brescia,37,3962,3007,113,8,20,1,0,7111,2681,4078,237,29,6,0,0,7031,14142
IT-BS,Brescia,38,3994,3341,149,6,23,0,0,7513,2598,4229,299,40,14,1,0,7181,14694
IT-BS,Brescia,39,3742,3722,189,9,8,0,0,7670,2430,4557,326,35,19,0,0,7367,15037
IT-BS,Brescia,40,3658,3974,221,10,16,2,0,7881,2507,4669,426,49,13,0,0,7664,15545
IT-BS,Brescia,41,3588,4279,248,11,19,0,0,8145,2373,4971,426,64,12,0,0,7846,15991
IT-BS,Brescia,42,3513,4337,294,18,14,0,0,8176,2301,5063,519,95,14,0,0,7992,16168
IT-BS,Brescia,43,3327,4625,325,22,15,5,0,8319,2251,5326,595,79,13,1,0,8265,16584
IT-BS,Brescia,44,3240,4761,369,26,19,1,0,8416,2137,5372,595,95,20,2,0,8221,16637
IT-BS,Brescia,45,3201,5310,445,29,19,1,1,9006,2174,5803,687,99,10,0,0,8773,17779
IT-BS,Brescia,46,3511,5476,465,28,28,2,0,9510,2054,6012,832,121,12,0,0,9031,18541
IT-BS,Brescia,47,3338,5640,568,35,24,1,1,9607,2140,6276,861,150,8,0,0,9435,19042
IT-BS,Brescia,48,3430,6381,639,53,19,0,0,10522,2122,6761,967,184,17,0,0,10051,20573
IT-BS,Brescia,49,3369,6566,749,47,25,0,0,10756,2067,7012,1018,183,10,0,0,10290,21046
IT-BS,Brescia,50,3031,6556,769,50,28,1,0,10435,1868,6889,1027,188,8,1,0,9981,20416
IT-BS,Brescia,51,2900,6786,853,56,20,1,0,10616,1783,6960,1017,259,10,0,0,10029,20645
IT-BS,Brescia,52,2733,6838,934,59,12,1,0,10577,1690,6898,1071,260,11,1,0,9931,20508
IT-BS,Brescia,53,2525,7055,869,67,17,0,0,10533,1578,6982,1096,264,11,0,0,9931,20464
IT-BS,Brescia,54,2415,7225,931,69,29,1,0,10670,1552,7135,1136,325,6,0,0,10154,20824
IT-BS,Brescia,55,2259,7313,909,81,24,2,1,10589,1424,7295,1081,370,7,0,1,10178,20767
IT-BS,Brescia,56,2124,7389,934,97,15,0,0,10559,1480,7212,1133,425,7,1,1,10259,20818
IT-BS,Brescia,57,2011,7392,1017,125,20,0,0,10565,1379,7270,1123,469,5,0,0,10246,20811
IT-BS,Brescia,58,1851,7264,928,112,19,1,2,10177,1280,7322,1102,494,7,0,1,10206,20383
IT-BS,Brescia,59,1680,7639,909,136,26,0,0,10390,1257,7289,1089,571,7,0,0,10213,20603
IT-BS,Brescia,60,1499,6974,841,151,16,0,0,9481,1073,6965,1002,637,8,0,0,9685,19166
IT-BS,Brescia,61,1347,6781,824,169,12,0,0,9133,998,6579,878,664,5,1,0,9125,18258
IT-BS,Brescia,62,1232,6734,739,175,16,0,0,8896,975,6417,838,772,10,1,0,9013,17909
IT-BS,Brescia,63,1094,6452,677,195,19,0,0,8437,894,6070,784,848,5,0,0,8601,17038
IT-BS,Brescia,64,992,6093,626,219,11,0,1,7942,787,5927,674,855,7,0,0,8250,16192
IT-BS,Brescia,65,917,5954,559,200,6,0,0,7636,705,5506,623,1024,4,0,0,7862,15498
IT-BS,Brescia,66,847,5757,540,237,3,0,1,7385,670,5493,606,1009,5,0,0,7783,15168
IT-BS,Brescia,67,825,5748,475,267,6,0,2,7323,658,5241,561,1147,2,0,0,7609,14932
IT-BS,Brescia,68,715,5407,456,252,8,0,0,6838,564,5007,525,1184,3,0,1,7284,14122
IT-BS,Brescia,69,678,5352,402,276,8,1,0,6717,539,4861,486,1181,3,0,0,7070,13787
IT-BS,Brescia,70,605,5176,334,316,5,0,0,6436,469,4688,431,1280,1,0,0,6869,13305
IT-BS,Brescia,71,613,4893,335,338,10,0,0,6189,491,4556,356,1484,1,0,1,6889,13078
IT-BS,Brescia,72,579,4856,300,356,7,0,0,6098,433,4433,346,1629,0,0,0,6841,12939
IT-BS,Brescia,73,529,5127,280,386,6,0,0,6328,448,4427,319,1785,0,0,1,6980,13308
IT-BS,Brescia,74,546,4971,251,486,5,1,0,6260,437,4283,310,1949,0,0,0,6979,13239
IT-BS,Brescia,75,520,5158,239,505,5,0,0,6427,434,4199,286,2230,1,0,0,7150,13577
IT-BS,Brescia,76,414,4738,222,521,3,0,0,5898,421,3786,276,2282,3,0,0,6768,12666
IT-BS,Brescia,77,447,4730,187,523,3,0,0,5890,400,3686,270,2547,0,0,0,6903,12793
IT-BS,Brescia,78,303,3179,121,445,2,0,0,4050,284,2429,171,2018,1,0,0,4903,8953
IT-BS,Brescia,79,342,3436,107,521,0,0,0,4406,337,2479,180,2401,1,0,0,5398,9804
IT-BS,Brescia,80,283,3174,97,577,4,0,0,4135,288,2352,128,2554,0,0,0,5322,9457
IT-BS,Brescia,81,319,3083,69,599,2,0,1,4073,314,2184,132,2608,0,0,0,5238,9311
IT-BS,Brescia,82,321,2892,71,597,2,0,0,3883,320,1945,127,2877,0,0,0,5269,9152
IT-BS,Brescia,83,278,2824,62,681,0,0,0,3845,349,1794,118,3183,0,0,0,5444,9289
IT-BS,Brescia,84,249,2617,55,665,1,0,0,3587,346,1455,95,3218,0,0,0,5114,8701
IT-BS,Brescia,85,220,2204,51,675,0,0,0,3150,309,1200,74,3154,0,0,0,4737,7887
IT-BS,Brescia,86,145,1749,29,551,1,0,0,2475,283,853,66,2710,0,0,0,3912,6387
IT-BS,Brescia,87,120,1270,13,495,1,0,0,1899,244,635,39,2460,0,0,0,3378,5277
IT-BS,Brescia,88,103,1054,21,513,0,0,0,1691,218,538,37,2492,0,0,0,3285,4976
IT-BS,Brescia,89,94,776,11,450,0,0,0,1331,205,308,28,2127,0,0,0,2668,3999
IT-BS,Brescia,90,74,623,6,375,1,0,0,1079,187,229,21,2033,0,0,0,2470,3549
IT-BS,Brescia,91,61,522,9,322,0,0,0,914,146,189,18,1749,0,0,0,2102,3016
IT-BS,Brescia,92,33,322,4,253,0,0,0,612,147,109,10,1503,0,0,1,1770,2382
IT-BS,Brescia,93,31,235,1,237,0,0,0,504,131,78,20,1329,0,0,0,1558,2062
IT-BS,Brescia,94,22,156,1,164,0,0,0,343,114,51,5,1056,0,0,0,1226,1569
IT-BS,Brescia,95,11,100,0,123,0,0,0,234,88,31,7,781,0,0,0,907,1141
IT-BS,Brescia,96,6,72,1,78,0,0,0,157,59,9,7,588,0,0,0,663,820
IT-BS,Brescia,97,6,26,1,52,0,0,0,85,49,5,4,392,0,0,0,450,535
IT-BS,Brescia,98,1,20,0,43,0,0,0,64,33,14,2,283,0,0,0,332,396
IT-BS,Brescia,99,2,9,1,25,0,0,0,37,21,4,0,183,0,0,0,208,245
IT-BS,Brescia,100,3,9,0,32,0,0,0,44,37,4,4,297,0,0,0,342,386
IT-BS,Brescia,999,306224,280359,23299,15224,724,30,10,625870,252638,280136,30447,71439,398,20,7,635085,1260955
IT-BR,Brindisi,0,1175,0,0,0,0,0,0,1175,1162,0,0,0,0,0,0,1162,2337
IT-BR,Brindisi,1,1321,0,0,0,0,0,0,1321,1197,0,0,0,0,0,0,1197,2518
IT-BR,Brindisi,2,1275,0,0,0,0,0,0,1275,1134,0,0,0,0,0,0,1134,2409
IT-BR,Brindisi,3,1299,0,0,0,0,0,0,1299,1210,0,0,0,0,0,0,1210,2509
IT-BR,Brindisi,4,1219,0,0,0,0,0,0,1219,1230,0,0,0,0,0,0,1230,2449
IT-BR,Brindisi,5,1359,0,0,0,0,0,0,1359,1313,0,0,0,0,0,0,1313,2672
IT-BR,Brindisi,6,1375,0,0,0,0,0,0,1375,1396,0,0,0,0,0,0,1396,2771
IT-BR,Brindisi,7,1484,0,0,0,0,0,0,1484,1390,0,0,0,0,0,0,1390,2874
IT-BR,Brindisi,8,1499,0,0,0,0,0,0,1499,1457,0,0,0,0,0,0,1457,2956
IT-BR,Brindisi,9,1577,0,0,0,0,0,0,1577,1504,0,0,0,0,0,0,1504,3081
IT-BR,Brindisi,10,1675,0,0,0,0,0,0,1675,1585,0,0,0,0,0,0,1585,3260
IT-BR,Brindisi,11,1673,0,0,0,0,0,0,1673,1597,0,0,0,0,0,0,1597,3270
IT-BR,Brindisi,12,1781,0,0,0,0,0,0,1781,1617,0,0,0,0,0,0,1617,3398
IT-BR,Brindisi,13,1750,0,0,0,0,0,0,1750,1709,0,0,0,0,0,0,1709,3459
IT-BR,Brindisi,14,1921,0,0,0,0,0,0,1921,1732,0,0,0,0,0,0,1732,3653
IT-BR,Brindisi,15,1825,0,0,0,0,0,0,1825,1741,0,0,0,0,0,0,1741,3566
IT-BR,Brindisi,16,1938,0,0,0,0,0,0,1938,1694,0,0,0,0,0,0,1694,3632
IT-BR,Brindisi,17,1924,0,0,0,0,0,0,1924,1759,0,0,0,0,0,0,1759,3683
IT-BR,Brindisi,18,1943,0,0,0,0,0,0,1943,1761,3,0,0,0,0,0,1764,3707
IT-BR,Brindisi,19,2018,0,0,0,0,0,0,2018,1832,5,0,0,0,0,0,1837,3855
IT-BR,Brindisi,20,1934,1,0,0,0,0,0,1935,1722,6,0,0,0,0,0,1728,3663
IT-BR,Brindisi,21,1975,2,0,0,0,0,0,1977,1817,14,0,0,0,0,0,1831,3808
IT-BR,Brindisi,22,1998,3,0,0,1,0,0,2002,1835,22,0,0,0,0,0,1857,3859
IT-BR,Brindisi,23,1962,4,0,0,1,0,0,1967,1925,22,0,0,0,1,0,1948,3915
IT-BR,Brindisi,24,2076,14,0,0,1,0,0,2091,1857,64,0,0,1,0,0,1922,4013
IT-BR,Brindisi,25,2011,19,0,0,0,0,0,2030,1776,86,0,1,0,0,0,1863,3893
IT-BR,Brindisi,26,1886,51,0,0,0,0,0,1937,1668,124,1,1,0,0,0,1794,3731
IT-BR,Brindisi,27,1944,71,0,0,0,0,0,2015,1645,160,2,1,0,0,0,1808,3823
IT-BR,Brindisi,28,1795,124,0,1,1,0,0,1921,1518,276,5,0,1,0,0,1800,3721
IT-BR,Brindisi,29,1791,175,3,0,1,0,0,1970,1484,349,9,0,1,0,0,1843,3813
IT-BR,Brindisi,30,1824,233,3,1,1,0,0,2062,1468,451,16,0,1,0,0,1936,3998
IT-BR,Brindisi,31,1827,315,4,1,3,0,0,2150,1390,646,8,0,2,0,0,2046,4196
IT-BR,Brindisi,32,1703,375,6,0,1,0,0,2085,1289,726,13,1,2,0,0,2031,4116
IT-BR,Brindisi,33,1644,490,9,2,0,0,0,2145,1202,776,19,1,1,0,0,1999,4144
IT-BR,Brindisi,34,1565,565,12,1,4,0,0,2147,1164,882,33,0,2,0,0,2081,4228
IT-BR,Brindisi,35,1422,704,12,0,2,0,0,2140,1035,1042,41,6,0,0,0,2124,4264
IT-BR,Brindisi,36,1395,811,19,1,4,0,0,2230,1024,1092,59,5,2,0,0,2182,4412
IT-BR,Brindisi,37,1265,819,29,3,1,0,0,2117,871,1152,53,4,0,0,0,2080,4197
IT-BR,Brindisi,38,1250,953,34,2,4,0,0,2243,823,1291,71,13,0,0,0,2198,4441
IT-BR,Brindisi,39,1138,1045,30,1,2,0,0,2216,800,1366,66,7,0,0,0,2239,4455
IT-BR,Brindisi,40,1009,1165,32,3,3,0,0,2212,724,1410,79,6,0,0,0,2219,4431
IT-BR,Brindisi,41,1007,1247,62,3,6,0,0,2325,685,1616,96,9,1,0,0,2407,4732
IT-BR,Brindisi,42,981,1239,59,1,1,0,0,2281,656,1570,104,19,1,0,0,2350,4631
IT-BR,Brindisi,43,906,1432,70,2,2,0,0,2412,618,1603,124,18,1,0,0,2364,4776
IT-BR,Brindisi,44,954,1539,73,9,5,0,0,2580,619,1764,136,20,1,0,0,2540,5120
IT-BR,Brindisi,45,839,1612,98,6,2,0,0,2557,622,1821,150,27,2,1,0,2623,5180
IT-BR,Brindisi,46,850,1695,119,10,1,0,0,2675,599,1990,171,38,1,0,0,2799,5474
IT-BR,Brindisi,47,834,1833,125,11,4,0,0,2807,618,2038,198,34,1,0,0,2889,5696
IT-BR,Brindisi,48,807,1914,145,14,0,0,0,2880,578,2151,215,52,1,0,0,2997,5877
IT-BR,Brindisi,49,821,2002,136,15,2,0,0,2976,557,2253,211,56,0,0,0,3077,6053
IT-BR,Brindisi,50,702,1901,153,17,4,0,0,2777,539,2176,207,60,0,0,0,2982,5759
IT-BR,Brindisi,51,622,1991,148,15,2,0,0,2778,489,2150,208,58,0,0,0,2905,5683
IT-BR,Brindisi,52,619,1978,173,21,2,0,0,2793,461,2236,189,87,0,0,0,2973,5766
IT-BR,Brindisi,53,567,2082,145,22,2,0,0,2818,451,2253,201,97,1,0,0,3003,5821
IT-BR,Brindisi,54,522,2091,182,23,3,0,0,2821,425,2348,229,99,0,0,0,3101,5922
IT-BR,Brindisi,55,507,2245,191,28,3,0,0,2974,412,2357,221,126,0,0,0,3116,6090
IT-BR,Brindisi,56,437,2321,155,35,4,0,0,2952,459,2328,216,148,0,0,0,3151,6103
IT-BR,Brindisi,57,450,2331,177,28,2,0,0,2988,396,2314,176,136,1,0,0,3023,6011
IT-BR,Brindisi,58,397,2343,170,54,0,0,0,2964,375,2429,203,163,1,0,0,3171,6135
IT-BR,Brindisi,59,366,2413,166,49,2,0,0,2996,406,2452,188,197,0,0,0,3243,6239
IT-BR,Brindisi,60,294,2297,157,53,2,0,0,2803,401,2374,190,225,2,0,0,3192,5995
IT-BR,Brindisi,61,269,2262,147,59,1,0,0,2738,356,2115,153,243,1,0,0,2868,5606
IT-BR,Brindisi,62,266,2247,110,54,2,0,0,2679,320,2308,151,256,0,0,0,3035,5714
IT-BR,Brindisi,63,202,2151,136,53,2,0,0,2544,297,2225,151,269,0,0,0,2942,5486
IT-BR,Brindisi,64,183,2177,122,86,0,0,0,2568,282,2011,141,335,0,0,0,2769,5337
IT-BR,Brindisi,65,185,2034,97,82,2,0,0,2400,248,1935,137,356,0,0,0,2676,5076
IT-BR,Brindisi,66,151,2029,128,65,0,0,0,2373,273,1903,123,356,0,0,0,2655,5028
IT-BR,Brindisi,67,168,2047,103,56,0,0,0,2374,258,1959,110,356,0,0,0,2683,5057
IT-BR,Brindisi,68,139,1904,98,91,0,0,0,2232,255,1817,116,450,1,0,0,2639,4871
IT-BR,Brindisi,69,143,1891,70,87,1,0,0,2192,218,1615,81,425,0,0,0,2339,4531
IT-BR,Brindisi,70,139,1730,55,118,1,0,0,2043,211,1568,89,478,1,0,0,2347,4390
IT-BR,Brindisi,71,109,1763,72,110,1,0,0,2055,240,1561,86,532,1,0,0,2420,4475
IT-BR,Brindisi,72,112,1709,72,109,0,0,0,2002,214,1577,66,626,0,0,0,2483,4485
IT-BR,Brindisi,73,94,1831,42,150,0,0,0,2117,218,1515,62,671,0,0,0,2466,4583
IT-BR,Brindisi,74,94,1830,46,140,2,0,0,2112,222,1524,66,732,0,0,0,2544,4656
IT-BR,Brindisi,75,77,1838,45,154,0,0,0,2114,230,1439,79,784,0,0,0,2532,4646
IT-BR,Brindisi,76,83,1620,37,189,0,0,0,1929,194,1341,57,792,0,0,0,2384,4313
IT-BR,Brindisi,77,77,1504,51,166,1,0,0,1799,180,1200,60,885,0,0,0,2325,4124
IT-BR,Brindisi,78,43,1233,32,155,1,0,0,1464,167,886,43,759,0,0,0,1855,3319
IT-BR,Brindisi,79,48,1070,24,144,0,0,0,1286,173,793,42,819,0,0,0,1827,3113
IT-BR,Brindisi,80,22,1115,21,158,0,0,0,1316,161,733,30,841,0,0,0,1765,3081
IT-BR,Brindisi,81,49,1027,27,184,1,0,0,1288,148,679,30,893,0,0,0,1750,3038
IT-BR,Brindisi,82,38,906,18,181,1,0,0,1144,126,550,28,822,0,0,0,1526,2670
IT-BR,Brindisi,83,31,886,14,210,0,0,0,1141,130,508,24,937,0,0,0,1599,2740
IT-BR,Brindisi,84,33,830,9,237,0,0,0,1109,147,481,28,979,0,0,0,1635,2744
IT-BR,Brindisi,85,20,705,14,199,0,0,0,938,139,341,18,906,0,0,0,1404,2342
IT-BR,Brindisi,86,16,569,9,203,0,0,0,797,115,268,18,834,0,0,0,1235,2032
IT-BR,Brindisi,87,20,473,3,197,0,0,0,693,88,210,18,756,0,0,0,1072,1765
IT-BR,Brindisi,88,14,368,3,165,0,0,0,550,78,165,13,685,0,0,0,941,1491
IT-BR,Brindisi,89,13,307,2,141,0,0,0,463,97,103,5,671,0,0,0,876,1339
IT-BR,Brindisi,90,4,244,1,141,0,0,0,390,67,92,7,559,0,0,0,725,1115
IT-BR,Brindisi,91,9,187,1,115,0,0,0,312,45,62,14,486,0,0,0,607,919
IT-BR,Brindisi,92,9,146,0,84,0,0,0,239,56,51,3,428,0,0,0,538,777
IT-BR,Brindisi,93,1,109,0,100,0,0,0,210,40,29,1,363,0,0,0,433,643
IT-BR,Brindisi,94,3,78,0,45,0,0,0,126,26,11,1,263,0,0,0,301,427
IT-BR,Brindisi,95,3,29,0,42,0,0,0,74,31,11,2,210,0,0,0,254,328
IT-BR,Brindisi,96,4,22,0,42,0,0,0,68,17,8,0,161,0,0,0,186,254
IT-BR,Brindisi,97,1,23,0,28,0,0,0,52,12,2,1,113,0,0,0,128,180
IT-BR,Brindisi,98,1,9,0,23,0,0,0,33,7,1,1,60,0,0,0,69,102
IT-BR,Brindisi,99,2,3,0,7,0,0,0,12,11,1,0,48,0,0,0,60,72
IT-BR,Brindisi,100,7,11,1,13,0,0,0,32,20,2,0,74,0,0,0,96,128
IT-BR,Brindisi,999,83809,89362,4507,5015,95,0,0,182788,75540,89788,6163,22928,31,2,0,194452,377240
IT-CA,Cagliari,0,965,0,0,0,0,0,0,965,887,0,0,0,0,0,0,887,1852
IT-CA,Cagliari,1,1062,0,0,0,0,0,0,1062,987,0,0,0,0,0,0,987,2049
IT-CA,Cagliari,2,1128,0,0,0,0,0,0,1128,1075,0,0,0,0,0,0,1075,2203
IT-CA,Cagliari,3,1140,0,0,0,0,0,0,1140,1032,0,0,0,0,0,0,1032,2172
IT-CA,Cagliari,4,1191,0,0,0,0,0,0,1191,1185,0,0,0,0,0,0,1185,2376
IT-CA,Cagliari,5,1229,0,0,0,0,0,0,1229,1159,0,0,0,0,0,0,1159,2388
IT-CA,Cagliari,6,1397,0,0,0,0,0,0,1397,1280,0,0,0,0,0,0,1280,2677
IT-CA,Cagliari,7,1518,0,0,0,0,0,0,1518,1345,0,0,0,0,0,0,1345,2863
IT-CA,Cagliari,8,1659,0,0,0,0,0,0,1659,1481,0,0,0,0,0,0,1481,3140
IT-CA,Cagliari,9,1624,0,0,0,0,0,0,1624,1485,0,0,0,0,0,0,1485,3109
IT-CA,Cagliari,10,1647,0,0,0,0,0,0,1647,1540,0,0,0,0,0,0,1540,3187
IT-CA,Cagliari,11,1813,0,0,0,0,0,0,1813,1707,0,0,0,0,0,0,1707,3520
IT-CA,Cagliari,12,1792,0,0,0,0,0,0,1792,1679,0,0,0,0,0,0,1679,3471
IT-CA,Cagliari,13,1864,0,0,0,0,0,0,1864,1770,0,0,0,0,0,0,1770,3634
IT-CA,Cagliari,14,1959,0,0,0,0,0,0,1959,1756,0,0,0,0,0,0,1756,3715
IT-CA,Cagliari,15,1868,0,0,0,0,0,0,1868,1788,0,0,0,0,0,0,1788,3656
IT-CA,Cagliari,16,1824,2,0,0,0,0,0,1826,1771,0,0,0,0,0,0,1771,3597
IT-CA,Cagliari,17,1945,0,0,0,0,0,0,1945,1788,0,0,0,0,0,0,1788,3733
IT-CA,Cagliari,18,1910,0,0,0,0,0,0,1910,1710,0,0,0,0,0,0,1710,3620
IT-CA,Cagliari,19,1845,0,0,0,0,0,0,1845,1743,1,0,0,0,0,0,1744,3589
IT-CA,Cagliari,20,1943,1,0,0,0,0,0,1944,1807,0,0,0,0,0,0,1807,3751
IT-CA,Cagliari,21,1836,1,0,0,0,0,0,1837,1721,5,0,0,0,0,0,1726,3563
IT-CA,Cagliari,22,1908,5,0,0,0,0,0,1913,1813,9,0,0,0,0,0,1822,3735
IT-CA,Cagliari,23,1933,3,0,0,0,0,0,1936,1758,13,1,0,0,0,0,1772,3708
IT-CA,Cagliari,24,1895,5,0,0,0,0,0,1900,1703,27,0,1,0,0,0,1731,3631
IT-CA,Cagliari,25,1897,16,0,0,2,0,0,1915,1587,31,1,0,0,0,0,1619,3534
IT-CA,Cagliari,26,1797,18,3,0,1,0,0,1819,1621,54,0,0,2,0,0,1677,3496
IT-CA,Cagliari,27,1846,42,1,0,0,0,0,1889,1610,90,1,0,3,0,0,1704,3593
IT-CA,Cagliari,28,1933,60,2,0,2,0,0,1997,1609,131,4,0,2,0,0,1746,3743
IT-CA,Cagliari,29,1934,96,4,0,3,0,0,2037,1661,188,3,1,1,0,0,1854,3891
IT-CA,Cagliari,30,1849,120,0,0,3,0,0,1972,1670,258,6,0,0,0,0,1934,3906
IT-CA,Cagliari,31,1902,162,7,0,5,0,0,2076,1644,356,13,1,2,0,0,2016,4092
IT-CA,Cagliari,32,1915,239,6,0,3,0,0,2163,1642,427,22,2,3,0,0,2096,4259
IT-CA,Cagliari,33,2014,362,9,0,2,0,0,2387,1657,540,21,2,4,0,0,2224,4611
IT-CA,Cagliari,34,1842,408,9,1,3,0,0,2263,1580,588,26,3,6,0,0,2203,4466
IT-CA,Cagliari,35,1900,494,17,1,2,0,0,2414,1523,724,42,10,2,0,0,2301,4715
IT-CA,Cagliari,36,1776,525,22,1,5,0,0,2329,1444,835,55,3,4,0,0,2341,4670
IT-CA,Cagliari,37,1671,607,29,2,6,0,1,2316,1467,881,61,4,6,1,0,2420,4736
IT-CA,Cagliari,38,1675,713,37,1,4,0,0,2430,1455,938,64,5,8,0,0,2470,4900
IT-CA,Cagliari,39,1635,849,44,2,8,0,0,2538,1354,1000,80,4,4,0,0,2442,4980
IT-CA,Cagliari,40,1683,912,50,3,6,0,0,2654,1301,1180,109,9,3,0,0,2602,5256
IT-CA,Cagliari,41,1638,1048,53,2,6,0,0,2747,1332,1346,116,9,3,0,0,2806,5553
IT-CA,Cagliari,42,1555,1019,79,5,4,0,0,2662,1281,1448,134,23,4,1,1,2892,5554
IT-CA,Cagliari,43,1560,1244,75,0,8,1,0,2888,1264,1460,144,13,5,1,0,2887,5775
IT-CA,Cagliari,44,1568,1252,107,7,10,0,0,2944,1201,1535,158,18,1,0,0,2913,5857
IT-CA,Cagliari,45,1507,1454,116,9,6,0,0,3092,1259,1663,199,27,7,1,0,3156,6248
IT-CA,Cagliari,46,1593,1513,121,3,8,1,0,3239,1222,1802,213,31,2,0,0,3270,6509
IT-CA,Cagliari,47,1579,1602,155,6,7,0,0,3349,1235,1935,221,36,1,0,0,3428,6777
IT-CA,Cagliari,48,1590,1821,195,13,5,0,0,3624,1256,2152,264,39,3,0,0,3714,7338
IT-CA,Cagliari,49,1619,1977,229,9,5,0,0,3839,1300,2211,291,48,6,1,0,3857,7696
IT-CA,Cagliari,50,1571,2067,245,13,8,0,0,3904,1139,2295,311,67,4,0,0,3816,7720
IT-CA,Cagliari,51,1398,2082,215,27,5,0,0,3727,1146,2296,385,67,1,0,0,3895,7622
IT-CA,Cagliari,52,1261,2049,254,26,7,0,0,3597,1080,2422,339,85,1,0,0,3927,7524
IT-CA,Cagliari,53,1194,2135,262,22,4,0,0,3617,950,2333,350,101,3,0,0,3737,7354
IT-CA,Cagliari,54,1148,2131,302,20,6,0,0,3607,857,2490,351,106,0,0,0,3804,7411
IT-CA,Cagliari,55,975,2192,258,22,5,0,0,3452,874,2431,384,110,0,0,0,3799,7251
IT-CA,Cagliari,56,1026,2277,283,33,5,0,0,3624,808,2464,353,124,5,0,0,3754,7378
IT-CA,Cagliari,57,912,2317,278,45,5,0,0,3557,801,2461,374,139,2,0,0,3777,7334
IT-CA,Cagliari,58,794,2432,303,58,2,0,0,3589,776,2559,387,194,3,0,0,3919,7508
IT-CA,Cagliari,59,802,2502,296,44,1,1,0,3646,675,2614,331,201,2,0,1,3824,7470
IT-CA,Cagliari,60,643,2376,327,44,2,0,0,3392,684,2420,346,226,0,0,0,3676,7068
IT-CA,Cagliari,61,559,2310,290,65,2,0,0,3226,578,2399,364,225,2,0,0,3568,6794
IT-CA,Cagliari,62,510,2214,230,61,4,0,0,3019,562,2335,313,274,0,0,0,3484,6503
IT-CA,Cagliari,63,440,2245,251,71,2,0,0,3009,518,2168,288,273,1,0,0,3248,6257
IT-CA,Cagliari,64,407,2190,238,86,2,0,0,2923,505,2218,307,330,0,0,0,3360,6283
IT-CA,Cagliari,65,332,2159,218,70,2,0,0,2781,428,2068,290,321,2,0,0,3109,5890
IT-CA,Cagliari,66,335,2118,203,84,2,1,0,2743,437,2108,255,401,0,0,0,3201,5944
IT-CA,Cagliari,67,290,2116,181,94,3,0,0,2684,359,2172,248,429,1,0,0,3209,5893
IT-CA,Cagliari,68,259,2075,176,94,2,0,0,2606,367,1933,192,431,1,0,0,2924,5530
IT-CA,Cagliari,69,223,2038,156,119,2,0,0,2538,392,1989,238,448,0,0,0,3067,5605
IT-CA,Cagliari,70,178,1914,157,123,1,0,0,2373,352,1813,203,515,0,0,0,2883,5256
IT-CA,Cagliari,71,182,1894,122,128,2,0,0,2328,290,1761,195,524,1,0,0,2771,5099
IT-CA,Cagliari,72,163,1806,120,114,1,0,0,2204,296,1717,169,544,0,0,0,2726,4930
IT-CA,Cagliari,73,139,1822,137,166,1,0,0,2265,291,1594,176,668,0,0,0,2729,4994
IT-CA,Cagliari,74,142,1782,76,148,0,0,0,2148,257,1575,142,674,0,0,0,2648,4796
IT-CA,Cagliari,75,126,1754,94,154,0,0,0,2128,259,1554,148,719,0,0,0,2680,4808
IT-CA,Cagliari,76,100,1679,100,178,0,0,1,2058,274,1414,114,800,0,0,0,2602,4660
IT-CA,Cagliari,77,78,1639,68,185,0,0,0,1970,257,1186,109,766,0,0,0,2318,4288
IT-CA,Cagliari,78,102,1432,41,169,0,0,0,1744,211,1098,104,842,0,0,0,2255,3999
IT-CA,Cagliari,79,69,1237,57,181,0,0,0,1544,206,928,66,722,0,0,0,1922,3466
IT-CA,Cagliari,80,58,1094,48,165,0,0,0,1365,198,827,61,885,0,0,0,1971,3336
IT-CA,Cagliari,81,72,1151,52,212,0,0,0,1487,204,789,52,950,0,0,0,1995,3482
IT-CA,Cagliari,82,42,1040,42,186,0,0,0,1310,200,701,56,925,0,0,0,1882,3192
IT-CA,Cagliari,83,57,1034,30,224,0,0,0,1345,203,611,61,1046,0,0,0,1921,3266
IT-CA,Cagliari,84,52,900,22,194,0,0,0,1168,185,497,50,935,0,0,0,1667,2835
IT-CA,Cagliari,85,49,743,14,169,0,0,0,975,148,386,41,853,0,0,0,1428,2403
IT-CA,Cagliari,86,40,586,20,198,0,0,0,844,136,328,28,821,0,0,0,1313,2157
IT-CA,Cagliari,87,33,518,18,181,0,0,0,750,128,244,17,823,0,0,0,1212,1962
IT-CA,Cagliari,88,17,376,7,147,0,0,0,547,121,192,17,691,0,0,0,1021,1568
IT-CA,Cagliari,89,13,329,6,145,0,0,0,493,106,158,18,707,0,0,0,989,1482
IT-CA,Cagliari,90,17,281,4,143,0,0,0,445,100,112,18,611,0,0,0,841,1286
IT-CA,Cagliari,91,15,202,2,99,0,0,0,318,90,77,5,478,0,0,0,650,968
IT-CA,Cagliari,92,10,154,2,108,0,0,0,274,64,43,10,434,0,0,0,551,825
IT-CA,Cagliari,93,10,132,1,83,0,0,0,226,48,31,2,400,0,0,0,481,707
IT-CA,Cagliari,94,5,71,1,61,0,0,0,138,56,25,7,328,0,0,1,417,555
IT-CA,Cagliari,95,2,35,1,52,0,0,0,90,48,18,2,236,0,0,0,304,394
IT-CA,Cagliari,96,3,34,0,37,0,0,0,74,28,9,3,184,0,0,0,224,298
IT-CA,Cagliari,97,0,21,0,18,0,0,0,39,26,5,0,116,0,0,0,147,186
IT-CA,Cagliari,98,2,10,0,11,0,0,0,23,13,2,1,85,0,0,0,101,124
IT-CA,Cagliari,99,2,6,0,10,0,0,0,18,11,0,1,49,0,0,0,61,79
IT-CA,Cagliari,100,1,6,0,20,0,0,0,27,12,2,1,86,0,0,0,101,128
IT-CA,Cagliari,999,101231,88277,7578,5172,190,4,2,202454,92899,89700,10532,23258,111,5,3,216508,418962
IT-CL,Caltanissetta,0,901,0,0,0,0,0,0,901,837,0,0,0,0,0,0,837,1738
IT-CL,Caltanissetta,1,928,0,0,0,0,0,0,928,835,0,0,0,0,0,0,835,1763
IT-CL,Caltanissetta,2,944,0,0,0,0,0,0,944,883,0,0,0,0,0,0,883,1827
IT-CL,Caltanissetta,3,950,0,0,0,0,0,0,950,878,0,0,0,0,0,0,878,1828
IT-CL,Caltanissetta,4,944,0,0,0,0,0,0,944,868,0,0,0,0,0,0,868,1812
IT-CL,Caltanissetta,5,998,0,0,0,0,0,0,998,995,0,0,0,0,0,0,995,1993
IT-CL,Caltanissetta,6,1027,0,0,0,0,0,0,1027,950,0,0,0,0,0,0,950,1977
IT-CL,Caltanissetta,7,1064,0,0,0,0,0,0,1064,1042,0,0,0,0,0,0,1042,2106
IT-CL,Caltanissetta,8,1125,0,0,0,0,0,0,1125,1035,0,0,0,0,0,0,1035,2160
IT-CL,Caltanissetta,9,1090,0,0,0,0,0,0,1090,1110,0,0,0,0,0,0,1110,2200
IT-CL,Caltanissetta,10,1106,0,0,0,0,0,0,1106,1043,0,0,0,0,0,0,1043,2149
IT-CL,Caltanissetta,11,1219,0,0,0,0,0,0,1219,1185,0,0,0,0,0,0,1185,2404
IT-CL,Caltanissetta,12,1179,0,0,0,0,0,0,1179,1104,0,0,0,0,0,0,1104,2283
IT-CL,Caltanissetta,13,1275,0,0,0,0,0,0,1275,1183,0,0,0,0,0,0,1183,2458
IT-CL,Caltanissetta,14,1299,0,0,0,0,0,0,1299,1238,0,0,0,0,0,0,1238,2537
IT-CL,Caltanissetta,15,1349,0,0,0,0,0,0,1349,1241,0,0,0,0,0,0,1241,2590
IT-CL,Caltanissetta,16,1364,0,0,0,0,0,0,1364,1219,0,0,0,0,0,0,1219,2583
IT-CL,Caltanissetta,17,1535,0,0,0,0,0,0,1535,1296,0,0,0,0,0,0,1296,2831
IT-CL,Caltanissetta,18,1521,0,0,0,0,0,0,1521,1381,3,0,0,0,0,0,1384,2905
IT-CL,Caltanissetta,19,1525,2,0,0,0,0,0,1527,1425,18,0,0,0,0,0,1443,2970
IT-CL,Caltanissetta,20,1437,2,0,0,0,0,0,1439,1344,14,0,0,0,0,0,1358,2797
IT-CL,Caltanissetta,21,1463,5,0,0,0,0,0,1468,1309,33,0,1,0,0,0,1343,2811
IT-CL,Caltanissetta,22,1472,18,0,0,0,0,0,1490,1350,44,0,0,1,0,0,1395,2885
IT-CL,Caltanissetta,23,1428,21,0,0,0,0,0,1449,1278,75,0,0,0,0,0,1353,2802
IT-CL,Caltanissetta,24,1442,38,0,0,1,0,0,1481,1325,126,0,0,0,0,0,1451,2932
IT-CL,Caltanissetta,25,1463,50,0,0,0,0,0,1513,1159,159,4,0,0,0,0,1322,2835
IT-CL,Caltanissetta,26,1328,79,0,0,0,0,0,1407,1129,193,1,0,0,0,0,1323,2730
IT-CL,Caltanissetta,27,1231,121,0,0,0,0,0,1352,977,296,6,0,1,0,0,1280,2632
IT-CL,Caltanissetta,28,1226,171,1,0,0,0,0,1398,974,355,4,1,0,0,0,1334,2732
IT-CL,Caltanissetta,29,1157,248,3,0,0,0,0,1408,842,443,6,1,0,0,0,1292,2700
IT-CL,Caltanissetta,30,1099,313,3,1,0,0,0,1416,845,541,15,1,0,0,0,1402,2818
IT-CL,Caltanissetta,31,1009,407,9,0,0,0,0,1425,757,611,16,0,0,0,0,1384,2809
IT-CL,Caltanissetta,32,975,504,9,0,0,0,0,1488,661,746,24,3,1,0,0,1435,2923
IT-CL,Caltanissetta,33,854,518,14,0,0,0,0,1386,567,839,24,2,1,0,0,1433,2819
IT-CL,Caltanissetta,34,852,630,10,0,0,0,0,1492,455,827,30,4,0,0,0,1316,2808
IT-CL,Caltanissetta,35,713,699,19,2,0,1,0,1434,462,889,24,4,0,0,0,1379,2813
IT-CL,Caltanissetta,36,656,692,18,0,0,0,0,1366,423,928,26,4,0,0,0,1381,2747
IT-CL,Caltanissetta,37,588,730,29,0,0,0,0,1347,382,942,37,3,1,0,0,1365,2712
IT-CL,Caltanissetta,38,562,845,23,0,0,0,0,1430,340,995,52,4,2,0,0,1393,2823
IT-CL,Caltanissetta,39,501,822,24,1,0,0,0,1348,344,994,55,11,0,0,0,1404,2752
IT-CL,Caltanissetta,40,486,916,34,2,1,0,0,1439,297,1098,64,13,0,0,0,1472,2911
IT-CL,Caltanissetta,41,433,910,49,2,1,0,0,1395,264,1070,60,9,0,0,0,1403,2798
IT-CL,Caltanissetta,42,412,975,40,5,0,0,0,1432,273,1153,68,17,0,0,0,1511,2943
IT-CL,Caltanissetta,43,445,1011,47,1,0,0,0,1504,258,1184,78,19,0,0,0,1539,3043
IT-CL,Caltanissetta,44,441,1024,60,4,2,0,0,1531,263,1249,82,18,0,0,0,1612,3143
IT-CL,Caltanissetta,45,432,1070,67,2,0,0,0,1571,216,1265,81,19,1,0,0,1582,3153
IT-CL,Caltanissetta,46,425,1163,62,5,1,0,0,1656,222,1210,93,23,1,0,0,1549,3205
IT-CL,Caltanissetta,47,391,1189,80,8,0,0,0,1668,227,1330,114,23,0,1,0,1695,3363
IT-CL,Caltanissetta,48,365,1262,86,8,1,1,0,1723,239,1388,95,34,0,0,0,1756,3479
IT-CL,Caltanissetta,49,332,1323,78,8,0,0,0,1741,216,1444,117,49,1,0,0,1827,3568
IT-CL,Caltanissetta,50,334,1313,89,14,0,0,0,1750,233,1458,135,67,1,1,0,1895,3645
IT-CL,Caltanissetta,51,348,1337,93,16,1,0,0,1795,214,1533,108,63,0,0,0,1918,3713
IT-CL,Caltanissetta,52,326,1364,88,22,0,0,0,1800,224,1526,107,65,0,1,0,1923,3723
IT-CL,Caltanissetta,53,273,1405,82,12,0,0,0,1772,252,1552,116,78,0,0,0,1998,3770
IT-CL,Caltanissetta,54,307,1423,97,11,1,0,0,1839,219,1610,117,77,0,0,0,2023,3862
IT-CL,Caltanissetta,55,275,1440,103,25,1,0,0,1844,214,1556,127,93,0,0,0,1990,3834
IT-CL,Caltanissetta,56,234,1568,98,20,2,0,0,1922,208,1626,106,95,0,0,0,2035,3957
IT-CL,Caltanissetta,57,243,1519,109,25,1,0,0,1897,208,1584,115,130,0,0,0,2037,3934
IT-CL,Caltanissetta,58,234,1533,97,23,0,0,0,1887,247,1614,105,136,0,0,0,2102,3989
IT-CL,Caltanissetta,59,202,1568,94,28,2,0,0,1894,220,1676,118,175,1,0,0,2190,4084
IT-CL,Caltanissetta,60,192,1572,72,31,0,0,0,1867,233,1452,87,159,1,0,0,1932,3799
IT-CL,Caltanissetta,61,150,1466,84,27,0,0,0,1727,205,1520,98,199,0,0,0,2022,3749
IT-CL,Caltanissetta,62,150,1401,62,39,0,0,0,1652,197,1420,77,204,0,0,0,1898,3550
IT-CL,Caltanissetta,63,160,1559,72,40,0,0,0,1831,199,1416,71,255,0,0,0,1941,3772
IT-CL,Caltanissetta,64,110,1383,64,46,0,0,0,1603,168,1371,80,238,0,0,0,1857,3460
IT-CL,Caltanissetta,65,126,1321,54,51,0,0,0,1552,170,1266,63,289,0,0,0,1788,3340
IT-CL,Caltanissetta,66,111,1270,53,39,0,0,0,1473,161,1212,67,289,0,0,0,1729,3202
IT-CL,Caltanissetta,67,89,1218,48,46,0,0,0,1401,130,1188,57,322,0,0,0,1697,3098
IT-CL,Caltanissetta,68,82,1330,46,77,0,0,0,1535,124,1135,56,333,0,0,0,1648,3183
IT-CL,Caltanissetta,69,80,1246,43,62,0,0,0,1431,123,1101,63,381,0,0,0,1668,3099
IT-CL,Caltanissetta,70,64,1056,43,55,0,0,0,1218,125,937,40,362,0,0,0,1464,2682
IT-CL,Caltanissetta,71,63,1034,33,55,0,0,0,1185,113,918,31,415,0,0,0,1477,2662
IT-CL,Caltanissetta,72,67,1088,31,62,0,0,0,1248,119,851,38,424,0,0,0,1432,2680
IT-CL,Caltanissetta,73,63,1045,25,70,0,0,0,1203,125,828,42,460,0,0,0,1455,2658
IT-CL,Caltanissetta,74,60,1110,22,105,1,0,0,1298,113,816,37,585,0,0,0,1551,2849
IT-CL,Caltanissetta,75,41,1080,21,92,1,0,0,1235,113,799,43,601,0,0,0,1556,2791
IT-CL,Caltanissetta,76,51,1030,21,91,0,0,0,1193,110,694,19,650,0,0,0,1473,2666
IT-CL,Caltanissetta,77,40,905,22,104,0,0,0,1071,90,548,16,598,0,0,0,1252,2323
IT-CL,Caltanissetta,78,47,729,10,90,0,0,0,876,94,482,6,610,0,0,0,1192,2068
IT-CL,Caltanissetta,79,35,669,14,87,1,0,0,806,81,380,16,566,0,0,0,1043,1849
IT-CL,Caltanissetta,80,32,636,5,84,0,0,0,757,74,319,6,595,0,0,0,994,1751
IT-CL,Caltanissetta,81,25,580,4,88,0,0,0,697,64,265,9,556,0,0,0,894,1591
IT-CL,Caltanissetta,82,28,503,7,92,0,0,0,630,80,265,11,579,0,0,0,935,1565
IT-CL,Caltanissetta,83,25,565,7,111,0,0,0,708,83,242,8,682,0,0,0,1015,1723
IT-CL,Caltanissetta,84,18,451,8,127,0,0,0,604,67,198,10,654,0,0,0,929,1533
IT-CL,Caltanissetta,85,12,466,6,108,0,0,0,592,61,155,11,722,0,0,0,949,1541
IT-CL,Caltanissetta,86,15,323,3,126,0,0,0,467,58,101,4,512,0,0,0,675,1142
IT-CL,Caltanissetta,87,5,294,3,125,0,0,0,427,60,78,5,551,0,0,0,694,1121
IT-CL,Caltanissetta,88,7,214,6,101,0,0,0,328,53,60,2,467,0,0,0,582,910
IT-CL,Caltanissetta,89,10,196,2,95,0,0,0,303,40,53,4,391,0,0,0,488,791
IT-CL,Caltanissetta,90,12,151,3,105,0,0,0,271,39,35,4,402,0,0,0,480,751
IT-CL,Caltanissetta,91,7,95,1,71,0,0,0,174,47,21,3,304,0,0,0,375,549
IT-CL,Caltanissetta,92,1,71,1,52,0,0,0,125,34,17,0,247,0,0,0,298,423
IT-CL,Caltanissetta,93,3,66,0,46,0,0,0,115,17,6,2,225,0,0,0,250,365
IT-CL,Caltanissetta,94,4,39,1,34,0,0,0,78,11,6,1,131,0,0,0,149,227
IT-CL,Caltanissetta,95,0,22,0,21,0,0,0,43,9,2,3,116,0,0,0,130,173
IT-CL,Caltanissetta,96,2,9,0,23,0,0,0,34,7,4,0,75,0,0,0,86,120
IT-CL,Caltanissetta,97,1,9,0,15,0,0,0,25,14,1,0,42,0,0,0,57,82
IT-CL,Caltanissetta,98,2,8,0,12,0,0,0,22,4,2,1,36,0,0,0,43,65
IT-CL,Caltanissetta,99,0,5,0,10,0,0,0,15,5,1,0,23,0,0,0,29,44
IT-CL,Caltanissetta,100,0,6,0,9,0,0,0,15,5,1,0,39,0,0,0,45,60
IT-CL,Caltanissetta,999,53727,60449,2612,2969,18,2,0,119777,47010,60363,3421,16531,13,3,0,127341,247118
IT-CB,Campobasso,0,630,0,0,0,0,0,0,630,570,0,0,0,0,0,0,570,1200
IT-CB,Campobasso,1,604,0,0,0,0,0,0,604,578,0,0,0,0,0,0,578,1182
IT-CB,Campobasso,2,610,0,0,0,0,0,0,610,609,0,0,0,0,0,0,609,1219
IT-CB,Campobasso,3,677,0,0,0,0,0,0,677,609,0,0,0,0,0,0,609,1286
IT-CB,Campobasso,4,712,0,0,0,0,0,0,712,677,0,0,0,0,0,0,677,1389
IT-CB,Campobasso,5,703,0,0,0,0,0,0,703,666,0,0,0,0,0,0,666,1369
IT-CB,Campobasso,6,786,0,0,0,0,0,0,786,725,0,0,0,0,0,0,725,1511
IT-CB,Campobasso,7,766,0,0,0,0,0,0,766,727,0,0,0,0,0,0,727,1493
IT-CB,Campobasso,8,794,0,0,0,0,0,0,794,742,0,0,0,0,0,0,742,1536
IT-CB,Campobasso,9,834,0,0,0,0,0,0,834,740,0,0,0,0,0,0,740,1574
IT-CB,Campobasso,10,826,0,0,0,0,0,0,826,781,0,0,0,0,0,0,781,1607
IT-CB,Campobasso,11,867,0,0,0,0,0,0,867,770,0,0,0,0,0,0,770,1637
IT-CB,Campobasso,12,873,0,0,0,0,0,0,873,860,0,0,0,0,0,0,860,1733
IT-CB,Campobasso,13,955,0,0,0,0,0,0,955,863,0,0,0,0,0,0,863,1818
IT-CB,Campobasso,14,867,0,0,0,0,0,0,867,815,0,0,0,0,0,0,815,1682
IT-CB,Campobasso,15,975,0,0,0,0,0,0,975,873,0,0,0,0,0,0,873,1848
IT-CB,Campobasso,16,970,0,1,0,0,0,0,971,901,0,0,0,0,0,0,901,1872
IT-CB,Campobasso,17,991,0,0,0,0,0,0,991,892,0,0,0,0,0,0,892,1883
IT-CB,Campobasso,18,1064,0,0,0,0,0,0,1064,882,0,0,0,0,0,0,882,1946
IT-CB,Campobasso,19,1095,2,0,0,0,0,0,1097,899,0,0,0,0,0,0,899,1996
IT-CB,Campobasso,20,1090,2,0,0,0,0,0,1092,957,5,0,0,0,0,0,962,2054
IT-CB,Campobasso,21,1095,1,0,0,0,0,0,1096,952,13,0,0,0,0,0,965,2061
IT-CB,Campobasso,22,1081,5,0,0,1,0,0,1087,961,12,2,0,0,0,0,975,2062
IT-CB,Campobasso,23,1121,5,0,2,1,0,0,1129,1017,14,1,0,0,0,0,1032,2161
IT-CB,Campobasso,24,1242,16,0,0,1,0,0,1259,1037,31,0,0,0,0,0,1068,2327
IT-CB,Campobasso,25,1216,11,0,0,1,0,0,1228,962,55,0,0,0,0,0,1017,2245
IT-CB,Campobasso,26,1189,26,0,0,0,0,0,1215,934,61,1,0,0,0,0,996,2211
IT-CB,Campobasso,27,1071,54,0,1,2,0,0,1128,906,120,2,0,0,0,0,1028,2156
IT-CB,Campobasso,28,1108,63,0,0,0,0,0,1171,901,127,3,1,0,0,0,1032,2203
IT-CB,Campobasso,29,1121,80,2,2,0,0,0,1205,822,198,5,1,1,0,0,1027,2232
IT-CB,Campobasso,30,1082,134,1,1,2,0,0,1220,799,257,2,1,0,0,0,1059,2279
IT-CB,Campobasso,31,1097,157,3,0,2,0,0,1259,828,289,4,0,1,0,0,1122,2381
IT-CB,Campobasso,32,1037,190,4,0,0,0,0,1231,715,321,7,0,0,0,0,1043,2274
IT-CB,Campobasso,33,972,248,2,0,0,0,0,1222,638,440,12,3,2,0,0,1095,2317
IT-CB,Campobasso,34,895,295,9,0,0,0,0,1199,625,428,13,1,0,0,0,1067,2266
IT-CB,Campobasso,35,841,351,7,1,0,0,0,1200,596,496,23,5,1,0,0,1121,2321
IT-CB,Campobasso,36,824,427,14,1,0,0,0,1266,484,526,29,5,1,0,0,1045,2311
IT-CB,Campobasso,37,740,410,8,2,0,0,0,1160,502,525,25,5,2,0,0,1059,2219
IT-CB,Campobasso,38,695,481,19,1,2,0,0,1198,459,681,27,6,0,0,0,1173,2371
IT-CB,Campobasso,39,656,527,30,1,1,0,0,1215,404,705,42,1,1,0,0,1153,2368
IT-CB,Campobasso,40,648,591,19,1,0,0,0,1259,396,731,40,5,0,0,0,1172,2431
IT-CB,Campobasso,41,638,616,25,0,3,0,0,1282,396,783,60,6,0,1,0,1246,2528
IT-CB,Campobasso,42,614,628,24,2,0,0,0,1268,356,810,60,9,0,0,0,1235,2503
IT-CB,Campobasso,43,573,671,32,0,0,0,0,1276,338,839,59,8,0,0,0,1244,2520
IT-CB,Campobasso,44,547,787,39,3,0,0,0,1376,301,943,74,24,0,0,0,1342,2718
IT-CB,Campobasso,45,535,806,51,2,1,0,0,1395,325,996,59,20,0,0,0,1400,2795
IT-CB,Campobasso,46,490,840,61,4,0,0,0,1395,319,1014,59,25,1,0,0,1418,2813
IT-CB,Campobasso,47,495,947,60,5,0,0,1,1508,298,974,82,29,0,0,0,1383,2891
IT-CB,Campobasso,48,534,997,66,7,0,0,0,1604,317,1154,108,23,0,0,0,1602,3206
IT-CB,Campobasso,49,474,1100,65,2,2,0,0,1643,285,1207,98,26,0,0,0,1616,3259
IT-CB,Campobasso,50,466,991,69,11,0,0,0,1537,235,1214,101,36,0,0,0,1586,3123
IT-CB,Campobasso,51,410,1120,61,9,0,0,0,1600,276,1259,75,34,0,0,0,1644,3244
IT-CB,Campobasso,52,395,1089,90,14,1,0,0,1589,206,1232,102,38,0,0,0,1578,3167
IT-CB,Campobasso,53,352,1178,80,12,0,0,0,1622,225,1260,101,55,2,0,0,1643,3265
IT-CB,Campobasso,54,346,1237,95,16,1,0,0,1695,229,1331,108,70,0,0,0,1738,3433
IT-CB,Campobasso,55,356,1208,80,18,0,0,0,1662,236,1301,102,74,0,0,0,1713,3375
IT-CB,Campobasso,56,305,1247,93,18,0,0,0,1663,186,1411,115,76,1,0,0,1789,3452
IT-CB,Campobasso,57,289,1312,89,19,0,0,0,1709,200,1431,105,93,1,0,0,1830,3539
IT-CB,Campobasso,58,268,1371,103,19,1,0,0,1762,183,1356,96,118,0,0,0,1753,3515
IT-CB,Campobasso,59,299,1409,73,22,0,0,0,1803,183,1410,99,138,1,0,0,1831,3634
IT-CB,Campobasso,60,254,1287,98,26,1,0,0,1666,138,1300,83,124,0,0,0,1645,3311
IT-CB,Campobasso,61,190,1294,86,24,1,0,0,1595,144,1307,75,161,0,0,0,1687,3282
IT-CB,Campobasso,62,205,1333,64,40,1,0,0,1643,131,1235,87,161,0,0,0,1614,3257
IT-CB,Campobasso,63,207,1310,69,28,0,0,0,1614,153,1258,81,194,1,0,0,1687,3301
IT-CB,Campobasso,64,166,1218,67,38,0,0,0,1489,139,1245,62,186,0,0,0,1632,3121
IT-CB,Campobasso,65,142,1118,62,40,0,0,0,1362,125,1189,66,210,0,0,0,1590,2952
IT-CB,Campobasso,66,136,1180,53,40,0,0,0,1409,107,1086,58,235,0,0,0,1486,2895
IT-CB,Campobasso,67,129,1187,45,50,0,0,0,1411,103,1070,44,264,0,0,0,1481,2892
IT-CB,Campobasso,68,117,1163,40,57,0,0,1,1378,115,1052,49,255,0,0,0,1471,2849
IT-CB,Campobasso,69,117,1093,54,58,0,0,0,1322,98,1059,56,291,0,0,0,1504,2826
IT-CB,Campobasso,70,90,1045,42,53,0,0,0,1230,95,914,34,266,0,0,0,1309,2539
IT-CB,Campobasso,71,108,1087,30,51,0,0,0,1276,95,995,34,312,0,0,0,1436,2712
IT-CB,Campobasso,72,71,1030,32,62,0,0,0,1195,85,846,37,315,0,0,0,1283,2478
IT-CB,Campobasso,73,57,1090,35,74,0,0,0,1256,83,858,24,406,0,0,1,1372,2628
IT-CB,Campobasso,74,72,1089,34,84,0,0,0,1279,82,854,25,463,0,0,0,1424,2703
IT-CB,Campobasso,75,65,1057,25,78,0,0,0,1225,87,805,31,447,0,0,0,1370,2595
IT-CB,Campobasso,76,70,931,25,77,0,0,0,1103,71,673,21,505,0,0,0,1270,2373
IT-CB,Campobasso,77,71,906,17,92,0,0,0,1086,76,626,19,447,0,0,0,1168,2254
IT-CB,Campobasso,78,39,630,20,86,0,0,0,775,53,458,10,429,0,0,0,950,1725
IT-CB,Campobasso,79,26,630,8,89,0,0,0,753,45,419,10,416,0,0,0,890,1643
IT-CB,Campobasso,80,35,555,7,79,0,0,0,676,50,350,13,435,0,0,0,848,1524
IT-CB,Campobasso,81,33,508,8,73,0,0,0,622,40,317,14,430,0,0,0,801,1423
IT-CB,Campobasso,82,22,518,7,104,0,0,0,651,45,349,13,505,0,0,0,912,1563
IT-CB,Campobasso,83,36,566,7,106,0,0,0,715,63,315,11,613,0,0,0,1002,1717
IT-CB,Campobasso,84,28,537,7,109,0,0,0,681,60,330,9,662,0,0,0,1061,1742
IT-CB,Campobasso,85,24,432,3,124,0,0,0,583,35,191,3,558,0,0,0,787,1370
IT-CB,Campobasso,86,21,344,4,144,0,0,0,513,46,208,5,566,0,0,0,825,1338
IT-CB,Campobasso,87,19,313,3,114,0,0,0,449,48,162,7,563,0,0,0,780,1229
IT-CB,Campobasso,88,12,264,4,117,0,0,0,397,31,113,4,552,0,0,0,700,1097
IT-CB,Campobasso,89,15,219,1,111,0,0,0,346,48,113,5,486,0,0,0,652,998
IT-CB,Campobasso,90,11,171,0,89,0,0,0,271,38,65,5,423,0,0,0,531,802
IT-CB,Campobasso,91,6,109,0,94,0,0,0,209,32,62,4,349,0,0,0,447,656
IT-CB,Campobasso,92,5,80,0,73,0,0,0,158,26,49,4,292,0,0,0,371,529
IT-CB,Campobasso,93,2,66,3,62,0,0,0,133,23,25,2,266,0,0,0,316,449
IT-CB,Campobasso,94,2,46,0,58,0,0,0,106,16,14,0,213,0,0,0,243,349
IT-CB,Campobasso,95,2,28,0,36,0,0,0,66,12,12,1,159,0,0,0,184,250
IT-CB,Campobasso,96,2,18,0,27,0,0,0,47,7,8,0,145,0,0,0,160,207
IT-CB,Campobasso,97,1,10,0,17,0,0,0,28,8,9,1,87,0,0,0,105,133
IT-CB,Campobasso,98,0,6,0,13,0,0,0,19,1,0,1,61,0,0,0,63,82
IT-CB,Campobasso,99,0,4,0,4,0,0,0,8,3,3,0,46,0,0,0,52,60
IT-CB,Campobasso,100,0,5,1,18,0,0,0,24,8,4,1,86,0,0,0,99,123
IT-CB,Campobasso,999,48414,50107,2336,2915,25,0,2,103799,38833,49908,2910,14520,16,1,1,106189,209988
IT-CE,Caserta,0,3800,0,0,0,0,0,0,3800,3640,0,0,0,0,0,0,3640,7440
IT-CE,Caserta,1,3953,0,0,0,0,0,0,3953,3745,0,0,0,0,0,0,3745,7698
IT-CE,Caserta,2,3662,0,0,0,0,0,0,3662,3590,0,0,0,0,0,0,3590,7252
IT-CE,Caserta,3,4019,0,0,0,0,0,0,4019,3731,0,0,0,0,0,0,3731,7750
IT-CE,Caserta,4,3958,0,0,0,0,0,0,3958,3753,0,0,0,0,0,0,3753,7711
IT-CE,Caserta,5,4163,0,0,0,0,0,0,4163,4025,0,0,0,0,0,0,4025,8188
IT-CE,Caserta,6,4222,0,0,0,0,0,0,4222,4098,0,0,0,0,0,0,4098,8320
IT-CE,Caserta,7,4362,0,0,0,0,0,0,4362,4127,0,0,0,0,0,0,4127,8489
IT-CE,Caserta,8,4396,0,0,0,0,0,0,4396,4212,0,0,0,0,0,0,4212,8608
IT-CE,Caserta,9,4447,0,0,0,0,0,0,4447,4140,0,0,0,0,0,0,4140,8587
IT-CE,Caserta,10,4473,0,0,0,0,0,0,4473,4337,0,0,0,0,0,0,4337,8810
IT-CE,Caserta,11,4680,0,0,0,0,0,0,4680,4345,0,0,0,0,0,0,4345,9025
IT-CE,Caserta,12,4889,0,0,0,0,0,0,4889,4500,0,0,0,0,0,0,4500,9389
IT-CE,Caserta,13,4998,0,0,0,0,0,0,4998,4946,0,0,0,0,0,0,4946,9944
IT-CE,Caserta,14,5117,0,0,0,0,0,0,5117,4846,0,0,0,0,0,0,4846,9963
IT-CE,Caserta,15,5129,0,0,0,0,0,0,5129,4934,0,0,0,0,0,0,4934,10063
IT-CE,Caserta,16,5265,0,0,0,0,0,0,5265,4931,0,0,0,0,0,0,4931,10196
IT-CE,Caserta,17,5293,0,0,1,0,0,0,5294,5042,0,0,0,0,0,0,5042,10336
IT-CE,Caserta,18,5447,0,0,0,0,0,0,5447,4971,3,0,0,0,0,0,4974,10421
IT-CE,Caserta,19,5667,3,0,0,0,0,0,5670,5250,10,0,0,0,0,0,5260,10930
IT-CE,Caserta,20,5546,1,0,1,0,0,0,5548,5170,27,0,0,0,0,0,5197,10745
IT-CE,Caserta,21,5356,7,0,0,0,0,0,5363,5091,44,0,0,1,0,0,5136,10499
IT-CE,Caserta,22,5430,14,1,0,0,0,0,5445,5124,76,0,0,0,0,0,5200,10645
IT-CE,Caserta,23,5236,33,0,0,0,0,0,5269,4978,143,3,1,0,0,0,5125,10394
IT-CE,Caserta,24,5293,51,0,0,1,0,0,5345,4852,213,0,0,0,0,0,5065,10410
IT-CE,Caserta,25,5316,111,1,0,0,0,0,5428,4591,358,3,0,1,0,0,4953,10381
IT-CE,Caserta,26,5154,191,0,0,1,0,0,5346,4503,518,5,0,0,0,0,5026,10372
IT-CE,Caserta,27,5017,261,1,0,0,0,0,5279,4163,757,3,5,1,0,0,4929,10208
IT-CE,Caserta,28,4679,442,4,1,1,0,0,5127,3934,1168,11,1,2,0,0,5116,10243
IT-CE,Caserta,29,4680,680,5,1,0,0,0,5366,3740,1490,12,2,1,0,0,5245,10611
IT-CE,Caserta,30,4306,965,5,1,1,0,0,5278,3273,1950,17,4,2,0,0,5246,10524
IT-CE,Caserta,31,4143,1327,3,1,2,0,0,5476,3125,2422,19,6,1,0,0,5573,11049
IT-CE,Caserta,32,3890,1707,15,3,3,0,0,5618,2881,2787,34,9,3,0,0,5714,11332
IT-CE,Caserta,33,3643,1983,14,3,2,1,0,5646,2543,2995,40,4,3,0,0,5585,11231
IT-CE,Caserta,34,3391,2199,13,4,4,0,0,5611,2175,3478,57,12,0,0,0,5722,11333
IT-CE,Caserta,35,3158,2564,29,1,2,0,0,5754,2070,3563,62,16,2,0,0,5713,11467
IT-CE,Caserta,36,2815,2810,38,4,6,0,0,5673,1796,3749,90,24,2,0,0,5661,11334
IT-CE,Caserta,37,2588,3076,48,4,3,0,0,5719,1663,3956,116,22,7,1,0,5765,11484
IT-CE,Caserta,38,2459,3239,59,6,9,1,0,5773,1515,4207,103,22,4,0,0,5851,11624
IT-CE,Caserta,39,2329,3545,60,8,4,0,0,5946,1468,4387,125,43,6,0,0,6029,11975
IT-CE,Caserta,40,2273,3848,86,8,3,0,0,6218,1283,4683,123,31,4,0,0,6124,12342
IT-CE,Caserta,41,2055,4099,72,9,4,0,0,6239,1217,4799,148,38,0,0,0,6202,12441
IT-CE,Caserta,42,1950,4198,99,13,6,0,0,6266,1171,4700,160,61,1,0,0,6093,12359
IT-CE,Caserta,43,1879,4277,109,13,2,0,0,6280,1089,4883,194,72,4,0,0,6242,12522
IT-CE,Caserta,44,1864,4435,124,21,6,0,0,6450,1095,5057,211,70,0,0,0,6433,12883
IT-CE,Caserta,45,1764,4710,138,18,2,0,0,6632,1039,5221,246,83,1,0,0,6590,13222
IT-CE,Caserta,46,1647,4737,151,22,6,0,0,6563,998,5199,244,112,1,0,0,6554,13117
IT-CE,Caserta,47,1674,5000,145,22,5,0,0,6846,965,5545,257,136,1,0,0,6904,13750
IT-CE,Caserta,48,1591,5206,178,31,3,0,0,7009,958,5573,259,146,1,0,0,6937,13946
IT-CE,Caserta,49,1517,5378,201,41,3,0,0,7140,988,5849,263,159,0,0,0,7259,14399
IT-CE,Caserta,50,1350,5346,191,42,5,0,0,6934,949,5806,270,195,1,0,0,7221,14155
IT-CE,Caserta,51,1227,5224,183,62,4,0,0,6700,933,5718,307,228,0,0,0,7186,13886
IT-CE,Caserta,52,1232,5392,205,53,5,0,1,6888,872,5773,296,278,2,0,0,7221,14109
IT-CE,Caserta,53,1126,5461,193,64,5,0,0,6849,887,5609,301,256,1,0,0,7054,13903
IT-CE,Caserta,54,1012,5697,192,67,3,0,0,6971,822,5706,291,343,0,0,0,7162,14133
IT-CE,Caserta,55,980,5750,209,66,1,0,0,7006,858,5786,288,380,0,0,0,7312,14318
IT-CE,Caserta,56,912,5816,199,99,1,0,0,7027,797,5784,279,372,1,0,0,7233,14260
IT-CE,Caserta,57,801,5765,222,116,0,0,0,6904,828,5692,299,458,1,0,0,7278,14182
IT-CE,Caserta,58,794,5881,206,125,5,0,0,7011,778,5656,278,506,0,0,0,7218,14229
IT-CE,Caserta,59,697,6019,213,132,1,0,0,7062,772,5730,283,579,1,0,0,7365,14427
IT-CE,Caserta,60,625,5481,205,120,5,0,0,6436,703,5282,247,586,0,0,0,6818,13254
IT-CE,Caserta,61,521,5301,170,142,1,0,1,6136,676,4893,245,686,2,0,0,6502,12638
IT-CE,Caserta,62,502,5095,155,171,2,0,0,5925,620,4970,204,738,0,0,0,6532,12457
IT-CE,Caserta,63,459,4958,139,156,3,0,0,5715,583,4518,194,778,0,0,0,6073,11788
IT-CE,Caserta,64,366,4909,133,170,1,0,0,5579,584,4336,179,835,1,0,0,5935,11514
IT-CE,Caserta,65,383,4557,129,180,1,0,0,5250,558,4029,175,866,0,0,0,5628,10878
IT-CE,Caserta,66,339,4434,119,203,1,0,0,5096,438,3809,151,878,0,0,0,5276,10372
IT-CE,Caserta,67,273,4182,121,222,0,0,0,4798,409,3726,152,982,0,0,0,5269,10067
IT-CE,Caserta,68,288,4259,103,231,0,0,0,4881,428,3622,154,1082,1,0,0,5287,10168
IT-CE,Caserta,69,232,4190,94,232,3,0,0,4751,437,3605,141,1262,0,0,0,5445,10196
IT-CE,Caserta,70,209,3700,69,219,1,0,0,4198,352,3032,131,1114,0,0,0,4629,8827
IT-CE,Caserta,71,188,3528,67,279,0,0,0,4062,355,2766,113,1183,0,0,0,4417,8479
IT-CE,Caserta,72,165,3536,68,274,0,0,0,4043,313,2679,117,1331,0,0,0,4440,8483
IT-CE,Caserta,73,134,3526,75,286,1,0,0,4022,319,2731,97,1512,0,0,0,4659,8681
IT-CE,Caserta,74,158,3327,58,329,1,0,0,3873,311,2641,82,1601,0,0,0,4635,8508
IT-CE,Caserta,75,120,3246,56,395,0,0,0,3817,307,2518,93,1626,1,0,0,4545,8362
IT-CE,Caserta,76,128,3067,44,396,0,0,0,3635,274,2160,84,1788,0,0,0,4306,7941
IT-CE,Caserta,77,108,2947,47,386,0,0,0,3488,250,2055,72,1959,0,0,0,4336,7824
IT-CE,Caserta,78,77,2242,34,350,2,0,0,2705,207,1518,44,1586,0,0,0,3355,6060
IT-CE,Caserta,79,93,1858,24,321,0,0,0,2296,199,1155,30,1445,0,0,0,2829,5125
IT-CE,Caserta,80,76,1791,24,345,0,0,1,2237,216,1243,31,1640,0,0,0,3130,5367
IT-CE,Caserta,81,57,1658,14,345,0,0,0,2074,177,1010,29,1568,0,0,0,2784,4858
IT-CE,Caserta,82,52,1402,24,366,0,0,0,1844,198,871,30,1669,0,0,0,2768,4612
IT-CE,Caserta,83,63,1440,12,435,0,0,0,1950,198,833,31,1828,0,0,0,2890,4840
IT-CE,Caserta,84,39,1253,11,434,0,0,0,1737,194,670,25,1713,0,0,0,2602,4339
IT-CE,Caserta,85,26,989,11,412,0,0,0,1438,164,541,20,1557,0,0,0,2282,3720
IT-CE,Caserta,86,31,833,5,358,0,0,0,1227,121,406,17,1393,0,0,0,1937,3164
IT-CE,Caserta,87,26,645,7,337,0,0,0,1015,124,331,10,1374,0,0,0,1839,2854
IT-CE,Caserta,88,21,559,4,304,1,0,0,889,125,228,10,1243,0,0,0,1606,2495
IT-CE,Caserta,89,15,380,3,238,0,0,0,636,90,159,13,1086,0,0,0,1348,1984
IT-CE,Caserta,90,18,289,1,244,0,0,0,552,85,129,12,836,0,0,0,1062,1614
IT-CE,Caserta,91,11,244,1,201,0,0,0,457,55,108,2,775,0,0,0,940,1397
IT-CE,Caserta,92,8,158,2,177,0,0,0,345,63,66,2,652,0,0,0,783,1128
IT-CE,Caserta,93,11,129,0,141,0,0,0,281,51,44,4,535,0,0,0,634,915
IT-CE,Caserta,94,6,64,0,104,0,0,0,174,31,17,3,387,0,0,0,438,612
IT-CE,Caserta,95,5,48,1,66,0,0,0,120,29,20,1,294,0,0,0,344,464
IT-CE,Caserta,96,4,23,0,43,0,0,0,70,23,7,1,206,0,0,0,237,307
IT-CE,Caserta,97,1,15,0,37,0,0,0,53,16,8,0,148,0,0,0,172,225
IT-CE,Caserta,98,0,10,0,22,0,0,0,32,10,9,1,112,0,0,0,132,164
IT-CE,Caserta,99,0,3,0,11,0,0,0,14,6,3,1,83,0,0,0,93,107
IT-CE,Caserta,100,3,12,0,18,0,0,0,33,16,5,1,115,0,0,0,137,170
IT-CE,Caserta,999,210555,217736,5642,10763,132,2,3,444833,185432,219823,8646,47726,61,1,0,461689,906522
IT-CT,Catania,0,4364,0,0,0,0,0,0,4364,4068,0,0,0,0,0,0,4068,8432
IT-CT,Catania,1,4608,0,0,0,0,0,0,4608,4292,0,0,0,0,0,0,4292,8900
IT-CT,Catania,2,4619,0,0,0,0,0,0,4619,4405,0,0,0,0,0,0,4405,9024
IT-CT,Catania,3,4711,0,0,0,0,0,0,4711,4413,0,0,0,0,0,0,4413,9124
IT-CT,Catania,4,4848,0,0,0,0,0,0,4848,4545,0,0,0,0,0,0,4545,9393
IT-CT,Catania,5,4969,0,0,0,0,0,0,4969,4868,0,0,0,0,0,0,4868,9837
IT-CT,Catania,6,5157,0,0,0,0,0,0,5157,4733,0,0,0,0,0,0,4733,9890
IT-CT,Catania,7,5104,0,0,0,0,0,0,5104,5003,0,0,0,0,0,0,5003,10107
IT-CT,Catania,8,5418,0,0,0,0,0,0,5418,5071,0,0,0,0,0,0,5071,10489
IT-CT,Catania,9,5475,0,0,0,0,0,0,5475,5077,0,0,0,0,0,0,5077,10552
IT-CT,Catania,10,5327,0,0,0,0,0,0,5327,5018,0,0,0,0,0,0,5018,10345
IT-CT,Catania,11,5420,0,0,0,0,0,0,5420,5235,0,0,0,0,0,0,5235,10655
IT-CT,Catania,12,5467,0,0,0,0,0,0,5467,5361,0,0,0,0,0,0,5361,10828
IT-CT,Catania,13,5619,0,0,0,0,0,0,5619,5347,0,0,0,0,0,0,5347,10966
IT-CT,Catania,14,5751,0,0,0,0,0,0,5751,5353,0,0,0,0,0,0,5353,11104
IT-CT,Catania,15,5938,0,0,0,0,0,0,5938,5535,0,0,0,0,0,0,5535,11473
IT-CT,Catania,16,5745,0,0,0,0,0,0,5745,5529,0,0,0,0,0,0,5529,11274
IT-CT,Catania,17,6053,0,0,0,0,0,0,6053,5422,0,0,0,0,0,0,5422,11475
IT-CT,Catania,18,6152,1,0,1,0,0,0,6154,5630,4,0,0,0,0,0,5634,11788
IT-CT,Catania,19,6267,3,0,0,0,0,0,6270,5634,15,0,1,0,0,0,5650,11920
IT-CT,Catania,20,5985,8,0,0,0,0,0,5993,5572,35,0,2,0,0,0,5609,11602
IT-CT,Catania,21,5854,17,0,0,0,0,0,5871,5458,77,0,1,1,0,0,5537,11408
IT-CT,Catania,22,5791,26,0,0,0,0,0,5817,5365,118,3,1,0,0,0,5487,11304
IT-CT,Catania,23,5952,61,0,0,1,0,0,6014,5280,237,2,0,2,0,0,5521,11535
IT-CT,Catania,24,5809,102,1,0,2,0,0,5914,5253,332,5,0,3,0,0,5593,11507
IT-CT,Catania,25,5693,156,3,0,0,0,0,5852,5049,489,3,1,4,0,0,5546,11398
IT-CT,Catania,26,5565,270,1,2,2,0,0,5840,4826,678,8,1,0,0,0,5513,11353
IT-CT,Catania,27,5421,432,1,0,0,0,0,5854,4626,924,10,2,1,0,0,5563,11417
IT-CT,Catania,28,5098,609,6,0,1,0,0,5714,4350,1274,11,1,3,0,0,5639,11353
IT-CT,Catania,29,5080,832,8,0,2,0,0,5922,4310,1562,22,2,2,0,0,5898,11820
IT-CT,Catania,30,4903,1095,11,0,3,0,0,6012,4047,2004,35,4,8,0,0,6098,12110
IT-CT,Catania,31,5009,1472,11,1,1,0,0,6494,3826,2350,33,5,6,0,0,6220,12714
IT-CT,Catania,32,4519,1864,21,1,5,1,0,6411,3529,2852,57,7,3,0,0,6448,12859
IT-CT,Catania,33,4339,2179,28,1,7,0,0,6554,3295,3062,79,20,4,0,0,6460,13014
IT-CT,Catania,34,3919,2427,41,5,3,0,0,6395,3118,3359,91,18,4,0,0,6590,12985
IT-CT,Catania,35,3783,2684,67,1,4,0,1,6540,2693,3760,96,17,6,1,0,6573,13113
IT-CT,Catania,36,3401,2997,73,2,3,0,0,6476,2575,3884,110,17,2,0,0,6588,13064
IT-CT,Catania,37,3173,3307,74,2,3,0,0,6559,2267,3974,141,21,6,0,0,6409,12968
IT-CT,Catania,38,2985,3480,89,8,5,0,0,6567,2150,4362,176,25,10,1,0,6724,13291
IT-CT,Catania,39,2850,3796,115,8,8,0,0,6777,2115,4535,211,42,3,0,0,6906,13683
IT-CT,Catania,40,2656,3859,134,10,5,0,0,6664,1857,4486,188,38,2,1,0,6572,13236
IT-CT,Catania,41,2622,4130,156,8,8,0,0,6924,1798,4814,225,50,6,0,0,6893,13817
IT-CT,Catania,42,2429,4174,158,19,8,1,0,6789,1706,4955,274,52,7,0,0,6994,13783
IT-CT,Catania,43,2312,4425,177,13,9,1,0,6937,1620,5109,269,72,8,1,0,7079,14016
IT-CT,Catania,44,2209,4585,178,24,7,0,0,7003,1550,5322,324,83,2,0,0,7281,14284
IT-CT,Catania,45,2280,4851,215,27,5,0,0,7378,1558,5551,372,102,7,0,0,7590,14968
IT-CT,Catania,46,2053,5018,256,29,8,0,0,7364,1554,5519,349,109,2,0,0,7533,14897
IT-CT,Catania,47,2134,5164,269,38,5,0,0,7610,1491,6008,400,124,3,0,0,8026,15636
IT-CT,Catania,48,1936,5426,271,42,13,2,0,7690,1345,6128,448,142,4,0,0,8067,15757
IT-CT,Catania,49,2011,5679,323,44,3,0,0,8060,1423,6239,464,168,5,1,0,8300,16360
IT-CT,Catania,50,1832,5477,339,46,10,0,1,7705,1235,6275,476,194,2,1,0,8183,15888
IT-CT,Catania,51,1717,5873,339,46,6,0,0,7981,1232,6172,484,212,8,0,0,8108,16089
IT-CT,Catania,52,1622,5917,334,50,7,0,0,7930,1226,6486,506,207,6,0,0,8431,16361
IT-CT,Catania,53,1429,5837,364,53,5,0,0,7688,1185,6360,559,266,4,0,0,8374,16062
IT-CT,Catania,54,1384,6070,344,69,8,0,0,7875,1098,6497,561,337,0,2,0,8495,16370
IT-CT,Catania,55,1295,6150,386,78,4,0,0,7913,1046,6433,504,372,3,0,0,8358,16271
IT-CT,Catania,56,1240,6225,370,103,6,0,0,7944,1011,6571,529,419,3,0,0,8533,16477
IT-CT,Catania,57,1173,6181,395,103,4,0,0,7856,1000,6486,504,451,2,0,0,8443,16299
IT-CT,Catania,58,1058,6088,417,110,6,0,0,7679,955,6382,528,465,1,1,0,8332,16011
IT-CT,Catania,59,1010,6341,414,107,7,0,0,7879,962,6451,522,587,2,0,0,8524,16403
IT-CT,Catania,60,915,6028,358,158,4,0,1,7464,804,6126,476,585,0,0,0,7991,15455
IT-CT,Catania,61,769,6141,401,137,5,0,0,7453,840,6063,466,681,1,0,0,8051,15504
IT-CT,Catania,62,758,5942,351,189,2,0,0,7242,792,6050,448,732,0,0,0,8022,15264
IT-CT,Catania,63,688,5898,340,163,1,0,0,7090,742,5976,409,873,0,0,0,8000,15090
IT-CT,Catania,64,656,5626,297,207,4,0,0,6790,700,5493,403,886,0,0,0,7482,14272
IT-CT,Catania,65,569,5489,281,184,3,0,0,6526,635,5299,375,954,0,0,0,7263,13789
IT-CT,Catania,66,509,5483,257,215,3,1,0,6468,649,5188,367,1060,0,0,1,7265,13733
IT-CT,Catania,67,485,5274,231,226,2,0,0,6218,564,5007,321,1213,0,0,0,7105,13323
IT-CT,Catania,68,441,5301,238,260,3,0,0,6243,555,4812,305,1273,0,1,0,6946,13189
IT-CT,Catania,69,409,5061,223,293,3,0,0,5989,572,4687,332,1372,0,0,0,6963,12952
IT-CT,Catania,70,362,4857,195,265,2,0,0,5681,480,4187,313,1413,0,0,0,6393,12074
IT-CT,Catania,71,350,4544,173,308,1,0,0,5376,511,3862,263,1492,1,0,0,6129,11505
IT-CT,Catania,72,316,4444,153,305,1,0,0,5219,500,3655,205,1532,0,0,0,5892,11111
IT-CT,Catania,73,288,4463,147,355,3,0,0,5256,516,3589,278,1728,0,0,0,6111,11367
IT-CT,Catania,74,262,4234,147,352,0,0,0,4995,426,3307,210,1837,1,0,0,5781,10776
IT-CT,Catania,75,285,4398,123,404,2,0,0,5212,423,3269,205,2181,0,0,0,6078,11290
IT-CT,Catania,76,245,4115,119,440,1,0,0,4920,398,3052,197,2314,0,0,0,5961,10881
IT-CT,Catania,77,216,3594,101,431,2,0,0,4344,389,2621,177,2291,0,0,0,5478,9822
IT-CT,Catania,78,153,2904,70,381,0,0,0,3508,340,1925,118,1969,0,0,0,4352,7860
IT-CT,Catania,79,163,2577,69,372,0,0,0,3181,331,1680,130,1972,0,0,0,4113,7294
IT-CT,Catania,80,119,2305,69,393,0,0,0,2886,305,1444,112,2002,0,0,0,3863,6749
IT-CT,Catania,81,115,2153,38,399,0,0,0,2705,287,1225,80,2090,0,0,0,3682,6387
IT-CT,Catania,82,90,2055,37,412,0,0,0,2594,266,1069,84,2066,0,0,0,3485,6079
IT-CT,Catania,83,94,2058,53,473,0,0,0,2678,282,1110,114,2511,0,0,0,4017,6695
IT-CT,Catania,84,100,1813,28,500,1,0,0,2442,241,848,78,2459,0,0,0,3626,6068
IT-CT,Catania,85,80,1576,22,456,0,0,0,2134,253,709,64,2260,0,0,0,3286,5420
IT-CT,Catania,86,61,1228,18,386,0,0,0,1693,198,547,69,1934,0,0,0,2748,4441
IT-CT,Catania,87,60,1038,18,392,0,0,0,1508,194,370,46,1805,0,0,0,2415,3923
IT-CT,Catania,88,39,929,20,382,0,0,0,1370,163,295,45,1837,0,0,0,2340,3710
IT-CT,Catania,89,33,774,12,402,0,0,0,1221,171,229,38,1710,0,0,0,2148,3369
IT-CT,Catania,90,26,574,11,342,0,0,0,953,156,173,16,1501,0,0,0,1846,2799
IT-CT,Catania,91,23,432,6,276,0,0,0,737,103,96,25,1131,0,0,0,1355,2092
IT-CT,Catania,92,16,297,2,208,0,0,0,523,95,82,20,981,0,0,0,1178,1701
IT-CT,Catania,93,22,230,4,175,1,0,0,432,88,50,19,863,0,0,0,1020,1452
IT-CT,Catania,94,12,137,2,134,0,0,0,285,74,26,10,608,0,0,0,718,1003
IT-CT,Catania,95,12,78,2,97,0,0,0,189,47,20,10,475,0,0,0,552,741
IT-CT,Catania,96,11,46,0,74,0,0,0,131,37,11,3,335,0,0,0,386,517
IT-CT,Catania,97,5,27,1,41,0,0,0,74,32,9,4,246,0,0,0,291,365
IT-CT,Catania,98,11,16,2,27,0,0,0,56,24,5,1,165,0,0,0,195,251
IT-CT,Catania,99,9,10,0,29,0,0,0,48,20,5,2,104,0,0,0,131,179
IT-CT,Catania,100,15,11,1,33,0,0,0,60,33,9,1,159,0,0,0,202,262
IT-CT,Catania,999,248335,249448,11009,12327,228,6,3,521356,221331,252311,16418,60238,148,10,1,550457,1071813
IT-CZ,Catanzaro,0,1186,0,0,0,0,0,0,1186,1128,0,0,0,0,0,0,1128,2314
IT-CZ,Catanzaro,1,1242,0,0,0,0,0,0,1242,1158,0,0,0,0,0,0,1158,2400
IT-CZ,Catanzaro,2,1256,0,0,0,0,0,0,1256,1211,0,0,0,0,0,0,1211,2467
IT-CZ,Catanzaro,3,1287,0,0,0,0,0,0,1287,1215,0,0,0,0,0,0,1215,2502
IT-CZ,Catanzaro,4,1359,0,0,0,0,0,0,1359,1256,0,0,0,0,0,0,1256,2615
IT-CZ,Catanzaro,5,1360,0,0,0,0,0,0,1360,1308,0,0,0,0,0,0,1308,2668
IT-CZ,Catanzaro,6,1475,0,0,0,0,0,0,1475,1379,0,0,0,0,0,0,1379,2854
IT-CZ,Catanzaro,7,1532,0,0,0,0,0,0,1532,1461,0,0,0,0,0,0,1461,2993
IT-CZ,Catanzaro,8,1512,0,0,0,0,0,0,1512,1435,0,0,0,0,0,0,1435,2947
IT-CZ,Catanzaro,9,1553,0,0,0,0,0,0,1553,1433,0,0,0,0,0,0,1433,2986
IT-CZ,Catanzaro,10,1479,0,0,0,0,0,0,1479,1446,0,0,0,0,0,0,1446,2925
IT-CZ,Catanzaro,11,1643,0,0,0,0,0,0,1643,1516,0,0,0,0,0,0,1516,3159
IT-CZ,Catanzaro,12,1582,0,0,0,0,0,0,1582,1445,0,0,0,0,0,0,1445,3027
IT-CZ,Catanzaro,13,1552,0,0,0,0,0,0,1552,1543,0,0,0,0,0,0,1543,3095
IT-CZ,Catanzaro,14,1568,0,0,0,0,0,0,1568,1504,0,0,0,0,0,0,1504,3072
IT-CZ,Catanzaro,15,1576,0,0,0,0,0,0,1576,1619,0,0,0,0,0,0,1619,3195
IT-CZ,Catanzaro,16,1697,0,0,0,0,0,0,1697,1555,0,0,0,0,0,0,1555,3252
IT-CZ,Catanzaro,17,1800,0,0,0,0,0,0,1800,1552,0,0,0,0,0,0,1552,3352
IT-CZ,Catanzaro,18,1648,0,0,0,0,0,0,1648,1537,0,0,0,0,0,0,1537,3185
IT-CZ,Catanzaro,19,1830,0,0,0,0,0,0,1830,1625,7,0,0,0,0,0,1632,3462
IT-CZ,Catanzaro,20,1754,0,0,0,0,0,0,1754,1614,7,0,0,0,0,0,1621,3375
IT-CZ,Catanzaro,21,1779,4,0,0,0,0,0,1783,1555,16,0,0,0,0,0,1571,3354
IT-CZ,Catanzaro,22,1773,9,0,0,0,0,0,1782,1694,32,0,0,0,0,0,1726,3508
IT-CZ,Catanzaro,23,1820,11,1,0,0,0,0,1832,1667,39,0,0,0,0,0,1706,3538
IT-CZ,Catanzaro,24,1731,14,0,0,0,0,0,1745,1664,67,0,0,0,0,0,1731,3476
IT-CZ,Catanzaro,25,1830,40,1,0,0,0,0,1871,1588,123,2,0,0,0,0,1713,3584
IT-CZ,Catanzaro,26,1727,61,1,0,0,0,0,1789,1496,167,1,1,0,0,0,1665,3454
IT-CZ,Catanzaro,27,1729,87,1,0,0,0,0,1817,1400,240,2,0,0,0,0,1642,3459
IT-CZ,Catanzaro,28,1706,119,1,0,0,0,0,1826,1410,341,5,0,1,0,0,1757,3583
IT-CZ,Catanzaro,29,1616,183,6,0,1,0,0,1806,1277,424,9,0,0,0,0,1710,3516
IT-CZ,Catanzaro,30,1581,279,1,0,1,0,0,1862,1240,556,9,1,1,0,0,1807,3669
IT-CZ,Catanzaro,31,1593,375,1,0,1,0,0,1970,1240,701,9,0,0,0,0,1950,3920
IT-CZ,Catanzaro,32,1538,467,8,0,0,0,0,2013,1158,767,13,1,0,0,0,1939,3952
IT-CZ,Catanzaro,33,1504,554,8,3,0,0,0,2069,1031,851,24,1,1,0,0,1908,3977
IT-CZ,Catanzaro,34,1402,655,11,0,1,0,0,2069,882,1014,15,1,1,0,0,1913,3982
IT-CZ,Catanzaro,35,1321,796,14,1,0,0,0,2132,857,1114,36,3,0,0,0,2010,4142
IT-CZ,Catanzaro,36,1142,824,21,1,2,0,0,1990,756,1170,31,8,0,0,0,1965,3955
IT-CZ,Catanzaro,37,1140,934,19,0,0,0,0,2093,700,1210,44,6,2,0,0,1962,4055
IT-CZ,Catanzaro,38,1071,1001,26,1,0,0,0,2099,686,1266,56,5,0,0,0,2013,4112
IT-CZ,Catanzaro,39,1029,1092,35,4,0,0,0,2160,673,1290,77,10,1,0,0,2051,4211
IT-CZ,Catanzaro,40,935,1148,27,4,1,0,0,2115,567,1504,76,6,0,0,0,2153,4268
IT-CZ,Catanzaro,41,840,1202,49,2,1,0,0,2094,579,1523,66,18,0,0,0,2186,4280
IT-CZ,Catanzaro,42,828,1265,39,7,2,0,0,2141,543,1479,67,17,0,0,0,2106,4247
IT-CZ,Catanzaro,43,817,1281,53,4,1,0,0,2156,459,1613,83,23,1,0,0,2179,4335
IT-CZ,Catanzaro,44,818,1301,50,8,1,0,0,2178,504,1613,102,30,0,0,0,2249,4427
IT-CZ,Catanzaro,45,772,1506,68,5,0,0,0,2351,471,1666,91,25,0,0,0,2253,4604
IT-CZ,Catanzaro,46,708,1539,76,4,0,0,0,2327,490,1764,95,39,0,0,0,2388,4715
IT-CZ,Catanzaro,47,691,1599,69,5,1,0,0,2365,478,1852,113,43,1,0,0,2487,4852
IT-CZ,Catanzaro,48,677,1596,76,13,1,0,0,2363,439,1818,116,47,0,0,0,2420,4783
IT-CZ,Catanzaro,49,713,1656,78,12,0,0,0,2459,413,1863,123,62,1,0,0,2462,4921
IT-CZ,Catanzaro,50,639,1607,92,13,4,0,0,2355,378,1873,136,65,0,0,0,2452,4807
IT-CZ,Catanzaro,51,585,1643,109,17,2,0,0,2356,369,1931,142,78,0,0,0,2520,4876
IT-CZ,Catanzaro,52,558,1724,100,18,0,0,0,2400,380,2092,160,79,1,0,0,2712,5112
IT-CZ,Catanzaro,53,524,1876,111,16,0,0,0,2527,385,2062,140,96,0,0,0,2683,5210
IT-CZ,Catanzaro,54,527,1912,99,22,1,0,0,2561,386,2107,147,88,0,0,0,2728,5289
IT-CZ,Catanzaro,55,455,1945,103,16,0,0,0,2519,360,2049,160,123,0,0,0,2692,5211
IT-CZ,Catanzaro,56,441,1947,131,30,1,0,0,2550,340,2157,145,149,1,1,0,2793,5343
IT-CZ,Catanzaro,57,459,1937,117,27,1,0,0,2541,352,2214,141,160,1,0,0,2868,5409
IT-CZ,Catanzaro,58,384,2000,130,32,1,0,0,2547,307,2136,117,163,2,0,0,2725,5272
IT-CZ,Catanzaro,59,442,2111,117,52,1,0,0,2723,349,2272,136,230,0,0,0,2987,5710
IT-CZ,Catanzaro,60,329,2081,100,35,0,0,0,2545,280,2214,114,230,0,0,0,2838,5383
IT-CZ,Catanzaro,61,335,2027,102,45,0,0,0,2509,291,2157,128,224,0,0,0,2800,5309
IT-CZ,Catanzaro,62,286,2005,107,53,1,0,0,2452,265,2030,111,255,0,0,0,2661,5113
IT-CZ,Catanzaro,63,319,2126,100,49,0,0,0,2594,235,1981,100,335,1,0,0,2652,5246
IT-CZ,Catanzaro,64,263,1947,93,70,1,0,0,2374,258,1936,100,342,0,0,0,2636,5010
IT-CZ,Catanzaro,65,238,1873,87,62,1,0,0,2261,224,1772,98,342,0,0,0,2436,4697
IT-CZ,Catanzaro,66,205,1966,86,77,0,0,0,2334,196,1811,94,356,0,0,0,2457,4791
IT-CZ,Catanzaro,67,202,1918,65,77,0,0,0,2262,188,1691,90,395,0,0,0,2364,4626
IT-CZ,Catanzaro,68,189,1925,81,63,0,0,0,2258,153,1621,81,445,0,0,0,2300,4558
IT-CZ,Catanzaro,69,166,1876,73,81,0,0,0,2196,177,1615,82,467,0,0,0,2341,4537
IT-CZ,Catanzaro,70,149,1842,64,100,0,0,0,2155,167,1427,75,484,0,0,0,2153,4308
IT-CZ,Catanzaro,71,126,1667,62,97,0,0,0,1952,141,1280,55,507,0,0,0,1983,3935
IT-CZ,Catanzaro,72,109,1630,52,123,0,0,0,1914,160,1324,59,594,0,0,0,2137,4051
IT-CZ,Catanzaro,73,121,1602,39,108,0,0,0,1870,179,1300,65,623,0,0,0,2167,4037
IT-CZ,Catanzaro,74,83,1611,47,110,0,0,0,1851,134,1145,57,684,0,0,0,2020,3871
IT-CZ,Catanzaro,75,117,1529,39,124,1,0,0,1810,136,1163,43,754,0,0,0,2096,3906
IT-CZ,Catanzaro,76,94,1494,39,138,0,0,0,1765,126,989,34,765,0,0,0,1914,3679
IT-CZ,Catanzaro,77,78,1291,27,151,0,0,0,1547,144,929,32,806,0,0,0,1911,3458
IT-CZ,Catanzaro,78,42,958,24,107,0,0,0,1131,86,616,30,608,0,0,0,1340,2471
IT-CZ,Catanzaro,79,59,984,15,119,0,0,0,1177,93,566,24,644,0,0,0,1327,2504
IT-CZ,Catanzaro,80,46,900,23,127,0,0,0,1096,87,518,19,711,0,0,0,1335,2431
IT-CZ,Catanzaro,81,34,859,21,131,0,0,0,1045,72,462,25,780,0,0,0,1339,2384
IT-CZ,Catanzaro,82,40,700,11,110,0,0,0,861,93,426,17,690,0,0,0,1226,2087
IT-CZ,Catanzaro,83,40,780,7,165,0,0,0,992,88,407,22,809,0,0,0,1326,2318
IT-CZ,Catanzaro,84,29,677,11,170,0,0,0,887,78,327,16,771,0,0,0,1192,2079
IT-CZ,Catanzaro,85,27,563,11,138,0,0,0,739,59,299,6,746,0,0,0,1110,1849
IT-CZ,Catanzaro,86,23,543,7,160,0,0,0,733,74,219,9,758,0,0,0,1060,1793
IT-CZ,Catanzaro,87,16,410,7,166,0,0,0,599,53,217,11,718,0,0,0,999,1598
IT-CZ,Catanzaro,88,26,338,4,147,0,0,0,515,56,155,10,698,0,0,0,919,1434
IT-CZ,Catanzaro,89,13,316,2,150,0,0,0,481,58,126,9,598,0,0,0,791,1272
IT-CZ,Catanzaro,90,14,273,2,153,0,0,0,442,42,95,6,558,0,0,0,701,1143
IT-CZ,Catanzaro,91,7,178,0,126,0,0,0,311,35,83,2,502,0,0,0,622,933
IT-CZ,Catanzaro,92,11,146,2,104,0,0,0,263,25,40,4,441,0,0,0,510,773
IT-CZ,Catanzaro,93,5,87,1,86,0,0,0,179,33,36,6,354,0,0,0,429,608
IT-CZ,Catanzaro,94,3,55,1,54,0,0,0,113,24,24,0,300,0,0,0,348,461
IT-CZ,Catanzaro,95,0,41,1,38,0,0,0,80,17,24,2,186,0,0,0,229,309
IT-CZ,Catanzaro,96,4,28,1,37,0,0,0,70,17,14,2,138,0,0,0,171,241
IT-CZ,Catanzaro,97,0,16,0,24,0,0,0,40,8,8,1,94,0,0,0,111,151
IT-CZ,Catanzaro,98,0,11,0,25,0,0,0,36,7,6,0,76,0,0,0,89,125
IT-CZ,Catanzaro,99,0,8,0,17,0,0,0,25,9,10,0,50,0,0,0,69,94
IT-CZ,Catanzaro,100,0,16,0,19,0,0,0,35,9,5,1,73,0,0,0,88,123
IT-CZ,Catanzaro,999,77584,81597,3263,4253,29,0,0,166726,66040,82058,4329,21489,16,1,0,173933,340659
IT-CH,Chieti,0,1154,0,0,0,0,0,0,1154,1026,0,0,0,0,0,0,1026,2180
IT-CH,Chieti,1,1170,0,0,0,0,0,0,1170,1103,0,0,0,0,0,0,1103,2273
IT-CH,Chieti,2,1228,0,0,0,0,0,0,1228,1220,0,0,0,0,0,0,1220,2448
IT-CH,Chieti,3,1196,0,0,0,0,0,0,1196,1162,0,0,0,0,0,0,1162,2358
IT-CH,Chieti,4,1256,0,0,0,0,0,0,1256,1229,0,0,0,0,0,0,1229,2485
IT-CH,Chieti,5,1313,0,0,0,0,0,0,1313,1305,0,0,0,0,0,0,1305,2618
IT-CH,Chieti,6,1440,0,0,0,0,0,0,1440,1358,0,0,0,0,0,0,1358,2798
IT-CH,Chieti,7,1468,0,0,0,0,0,0,1468,1454,0,0,0,0,0,0,1454,2922
IT-CH,Chieti,8,1530,0,0,0,0,0,0,1530,1452,0,0,0,0,0,0,1452,2982
IT-CH,Chieti,9,1556,0,0,0,0,0,0,1556,1440,0,0,0,0,0,0,1440,2996
IT-CH,Chieti,10,1590,0,0,0,0,0,0,1590,1456,0,0,0,0,0,0,1456,3046
IT-CH,Chieti,11,1706,0,0,0,0,0,0,1706,1552,0,0,0,0,0,0,1552,3258
IT-CH,Chieti,12,1685,0,0,0,0,0,0,1685,1592,0,0,0,0,0,0,1592,3277
IT-CH,Chieti,13,1777,0,0,0,0,0,0,1777,1679,0,0,0,0,0,0,1679,3456
IT-CH,Chieti,14,1795,0,0,0,0,0,0,1795,1610,0,0,0,0,0,0,1610,3405
IT-CH,Chieti,15,1741,0,0,0,0,0,0,1741,1710,0,0,0,0,0,0,1710,3451
IT-CH,Chieti,16,1733,0,0,0,0,0,0,1733,1721,0,0,0,0,0,0,1721,3454
IT-CH,Chieti,17,1774,0,0,0,0,0,0,1774,1639,0,0,0,0,0,0,1639,3413
IT-CH,Chieti,18,1796,0,0,0,0,0,0,1796,1619,1,0,0,0,0,0,1620,3416
IT-CH,Chieti,19,1763,3,0,0,0,0,0,1766,1620,3,0,0,0,0,0,1623,3389
IT-CH,Chieti,20,1827,2,0,0,0,0,0,1829,1642,12,0,0,0,0,0,1654,3483
IT-CH,Chieti,21,1811,2,0,0,0,0,0,1813,1601,14,1,0,0,0,0,1616,3429
IT-CH,Chieti,22,1818,2,0,0,0,0,0,1820,1662,32,2,0,0,0,0,1696,3516
IT-CH,Chieti,23,1936,8,1,0,0,0,0,1945,1624,48,0,0,1,0,0,1673,3618
IT-CH,Chieti,24,1869,24,0,0,0,0,0,1893,1690,67,1,1,0,0,0,1759,3652
IT-CH,Chieti,25,1854,28,2,0,0,0,0,1884,1655,83,0,0,1,0,0,1739,3623
IT-CH,Chieti,26,1908,40,1,0,0,0,0,1949,1580,133,0,0,0,0,0,1713,3662
IT-CH,Chieti,27,1896,84,1,0,0,0,0,1981,1565,176,4,1,1,0,0,1747,3728
IT-CH,Chieti,28,1802,102,1,0,0,0,0,1905,1426,252,4,0,0,0,0,1682,3587
IT-CH,Chieti,29,1694,153,4,0,1,0,0,1852,1377,322,6,0,0,0,0,1705,3557
IT-CH,Chieti,30,1740,194,2,0,0,0,0,1936,1383,425,5,0,3,0,0,1816,3752
IT-CH,Chieti,31,1669,315,3,1,0,0,0,1988,1302,526,8,2,1,0,0,1839,3827
IT-CH,Chieti,32,1606,374,4,0,1,1,0,1986,1114,648,21,0,3,1,0,1787,3773
IT-CH,Chieti,33,1582,433,6,1,1,0,0,2023,1195,751,21,4,0,0,0,1971,3994
IT-CH,Chieti,34,1462,549,14,0,2,0,0,2027,1097,902,27,1,2,0,0,2029,4056
IT-CH,Chieti,35,1407,647,21,1,1,0,0,2077,962,988,40,3,1,0,0,1994,4071
IT-CH,Chieti,36,1248,737,16,6,1,0,0,2008,854,1016,41,4,0,0,0,1915,3923
IT-CH,Chieti,37,1222,835,19,2,1,0,0,2079,835,1117,48,6,3,1,0,2010,4089
IT-CH,Chieti,38,1151,965,37,3,1,0,0,2157,883,1228,75,10,3,1,0,2200,4357
IT-CH,Chieti,39,1117,1063,37,2,1,0,0,2220,750,1267,71,11,1,0,0,2100,4320
IT-CH,Chieti,40,1087,1081,51,1,2,0,0,2222,709,1347,90,9,3,0,0,2158,4380
IT-CH,Chieti,41,1089,1221,68,5,2,0,0,2385,688,1495,108,10,6,0,0,2307,4692
IT-CH,Chieti,42,1049,1203,62,5,1,0,0,2320,682,1446,96,15,1,0,0,2240,4560
IT-CH,Chieti,43,1004,1341,55,3,0,0,0,2403,646,1573,136,26,1,0,0,2382,4785
IT-CH,Chieti,44,997,1455,78,10,3,0,0,2543,572,1702,118,25,3,0,0,2420,4963
IT-CH,Chieti,45,937,1567,93,2,4,0,0,2603,591,1759,143,26,1,0,0,2520,5123
IT-CH,Chieti,46,972,1581,105,7,3,0,0,2668,573,1813,140,29,2,0,0,2557,5225
IT-CH,Chieti,47,885,1677,125,4,2,0,0,2693,610,1961,171,46,0,0,0,2788,5481
IT-CH,Chieti,48,886,1743,122,14,1,0,0,2766,546,2087,207,42,0,0,0,2882,5648
IT-CH,Chieti,49,859,1876,143,10,2,0,0,2890,501,2098,200,53,2,0,0,2854,5744
IT-CH,Chieti,50,788,1917,159,18,2,0,0,2884,466,2155,192,54,1,0,0,2868,5752
IT-CH,Chieti,51,722,1962,154,22,2,0,0,2862,489,2141,214,79,1,0,0,2924,5786
IT-CH,Chieti,52,682,2070,157,14,2,1,0,2926,438,2375,216,96,1,0,0,3126,6052
IT-CH,Chieti,53,656,1978,153,12,0,0,0,2799,387,2285,229,92,1,0,0,2994,5793
IT-CH,Chieti,54,605,2161,194,18,3,0,0,2981,403,2356,226,77,0,0,0,3062,6043
IT-CH,Chieti,55,546,2221,171,25,0,0,0,2963,329,2389,240,118,0,0,0,3076,6039
IT-CH,Chieti,56,477,2287,191,26,2,0,0,2983,357,2470,248,135,1,0,0,3211,6194
IT-CH,Chieti,57,450,2302,208,37,1,0,0,2998,340,2365,232,158,0,0,0,3095,6093
IT-CH,Chieti,58,446,2341,184,48,2,0,0,3021,276,2488,197,189,1,0,0,3151,6172
IT-CH,Chieti,59,438,2288,183,51,1,0,0,2961,289,2392,222,183,0,0,0,3086,6047
IT-CH,Chieti,60,360,2139,173,41,2,0,0,2715,239,2229,182,196,0,0,0,2846,5561
IT-CH,Chieti,61,330,2086,156,47,1,0,0,2620,205,2170,182,254,1,0,0,2812,5432
IT-CH,Chieti,62,311,2027,176,51,1,1,0,2567,256,2228,165,273,0,0,0,2922,5489
IT-CH,Chieti,63,290,2051,155,47,2,0,0,2545,221,2166,179,282,1,0,0,2849,5394
IT-CH,Chieti,64,250,2022,129,52,0,0,0,2453,184,2065,149,333,1,0,0,2732,5185
IT-CH,Chieti,65,260,1957,124,79,0,0,0,2420,193,2021,141,321,0,0,0,2676,5096
IT-CH,Chieti,66,219,1938,119,67,1,0,0,2344,184,1945,131,369,0,0,0,2629,4973
IT-CH,Chieti,67,197,1979,127,76,0,0,0,2379,144,1907,110,399,0,0,0,2560,4939
IT-CH,Chieti,68,204,1907,115,87,0,0,0,2313,142,1957,114,445,0,0,0,2658,4971
IT-CH,Chieti,69,203,1861,87,90,0,0,0,2241,119,1800,98,492,1,0,0,2510,4751
IT-CH,Chieti,70,161,1826,99,79,3,0,0,2168,139,1653,89,512,0,0,0,2393,4561
IT-CH,Chieti,71,167,1816,81,110,1,0,0,2175,109,1645,85,604,0,0,0,2443,4618
IT-CH,Chieti,72,129,1789,63,112,0,0,0,2093,117,1594,71,641,0,0,0,2423,4516
IT-CH,Chieti,73,144,1950,71,106,0,0,0,2271,103,1581,73,681,1,0,0,2439,4710
IT-CH,Chieti,74,148,2031,64,144,0,0,0,2387,117,1528,55,794,0,0,0,2494,4881
IT-CH,Chieti,75,121,1807,50,124,0,0,0,2102,106,1533,72,875,0,0,0,2586,4688
IT-CH,Chieti,76,100,1733,57,160,1,0,0,2051,86,1239,49,910,0,0,0,2284,4335
IT-CH,Chieti,77,103,1709,41,154,0,0,0,2007,84,1146,48,987,0,0,0,2265,4272
IT-CH,Chieti,78,73,1159,32,106,1,0,0,1371,64,805,30,733,0,0,0,1632,3003
IT-CH,Chieti,79,69,1233,20,161,0,0,0,1483,72,754,41,891,0,0,0,1758,3241
IT-CH,Chieti,80,52,1028,24,138,1,0,0,1243,76,686,28,845,0,0,0,1635,2878
IT-CH,Chieti,81,55,985,24,161,0,0,0,1225,63,567,24,853,0,0,0,1507,2732
IT-CH,Chieti,82,54,962,15,164,0,0,0,1195,47,538,26,923,0,0,0,1534,2729
IT-CH,Chieti,83,64,1024,10,217,0,0,0,1315,73,537,19,1032,0,0,0,1661,2976
IT-CH,Chieti,84,59,970,27,203,0,0,0,1259,60,459,17,1178,0,0,0,1714,2973
IT-CH,Chieti,85,40,779,13,188,0,0,0,1020,60,351,12,981,0,0,0,1404,2424
IT-CH,Chieti,86,29,690,11,191,0,0,0,921,44,304,14,993,0,0,0,1355,2276
IT-CH,Chieti,87,32,548,7,159,0,0,0,746,50,232,12,937,0,0,0,1231,1977
IT-CH,Chieti,88,27,485,13,177,0,0,0,702,58,160,7,892,0,0,0,1117,1819
IT-CH,Chieti,89,16,374,3,168,0,0,0,561,35,127,5,834,0,0,0,1001,1562
IT-CH,Chieti,90,12,311,3,167,0,0,0,493,42,108,7,763,0,0,0,920,1413
IT-CH,Chieti,91,15,231,4,107,0,0,0,357,34,71,7,572,0,0,0,684,1041
IT-CH,Chieti,92,10,170,5,115,0,0,0,300,39,42,7,508,0,0,0,596,896
IT-CH,Chieti,93,10,120,1,108,0,0,0,239,22,35,6,515,0,0,0,578,817
IT-CH,Chieti,94,1,75,0,58,0,0,0,134,27,21,4,328,0,0,0,380,514
IT-CH,Chieti,95,1,40,0,52,0,0,0,93,24,21,3,273,0,0,0,321,414
IT-CH,Chieti,96,2,35,0,47,0,0,0,84,13,6,1,206,0,0,0,226,310
IT-CH,Chieti,97,3,20,0,29,0,0,0,52,8,7,0,135,0,0,0,150,202
IT-CH,Chieti,98,1,8,0,20,0,0,0,29,8,10,0,103,0,0,0,121,150
IT-CH,Chieti,99,0,9,0,14,0,0,0,23,9,0,0,67,0,0,0,76,99
IT-CH,Chieti,100,0,11,0,15,0,0,0,26,7,12,2,140,0,0,0,161,187
IT-CH,Chieti,999,83187,88727,4924,4739,59,3,0,181639,68719,88968,6265,25575,50,3,0,189580,371219
IT-CO,Como,0,1910,0,0,0,0,0,0,1910,1871,0,0,0,0,0,0,1871,3781
IT-CO,Como,1,2019,0,0,0,0,0,0,2019,1837,0,0,0,0,0,0,1837,3856
IT-CO,Como,2,1955,0,0,0,0,0,0,1955,2064,0,0,0,0,0,0,2064,4019
IT-CO,Como,3,2163,0,0,0,0,0,0,2163,2013,0,0,0,0,0,0,2013,4176
IT-CO,Como,4,2252,0,0,0,0,0,0,2252,2133,0,0,0,0,0,0,2133,4385
IT-CO,Como,5,2306,0,0,0,0,0,0,2306,2186,0,0,0,0,0,0,2186,4492
IT-CO,Como,6,2436,0,0,0,0,0,0,2436,2301,0,0,0,0,0,0,2301,4737
IT-CO,Como,7,2556,0,0,0,0,0,0,2556,2507,0,0,0,0,0,0,2507,5063
IT-CO,Como,8,2651,0,0,0,0,0,0,2651,2525,0,0,0,0,0,0,2525,5176
IT-CO,Como,9,2694,0,0,0,0,0,0,2694,2515,0,0,0,0,0,0,2515,5209
IT-CO,Como,10,2808,0,0,0,0,0,0,2808,2557,0,0,0,0,0,0,2557,5365
IT-CO,Como,11,2903,0,0,0,0,0,0,2903,2697,0,0,0,0,0,0,2697,5600
IT-CO,Como,12,2878,0,0,0,0,0,0,2878,2732,0,0,0,0,0,0,2732,5610
IT-CO,Como,13,2934,0,0,0,0,0,0,2934,2804,0,0,0,0,0,0,2804,5738
IT-CO,Como,14,3132,0,0,0,0,0,0,3132,2802,0,0,0,0,0,0,2802,5934
IT-CO,Como,15,3039,0,0,0,0,0,0,3039,2901,0,0,0,0,0,0,2901,5940
IT-CO,Como,16,2976,0,0,0,0,0,0,2976,2859,0,0,0,0,0,0,2859,5835
IT-CO,Como,17,3005,2,1,0,0,0,0,3008,2833,1,0,0,0,0,0,2834,5842
IT-CO,Como,18,3052,0,0,0,0,0,0,3052,2796,1,0,0,0,0,0,2797,5849
IT-CO,Como,19,3082,2,0,0,0,0,0,3084,2839,2,0,0,0,0,0,2841,5925
IT-CO,Como,20,2992,5,0,0,0,0,0,2997,2711,16,0,0,1,0,0,2728,5725
IT-CO,Como,21,2857,7,0,0,0,0,0,2864,2640,28,0,0,0,0,0,2668,5532
IT-CO,Como,22,3036,8,2,0,0,0,0,3046,2684,42,1,0,0,0,0,2727,5773
IT-CO,Como,23,3179,17,2,0,0,0,0,3198,2727,77,1,0,0,0,0,2805,6003
IT-CO,Como,24,3105,29,4,0,0,0,0,3138,2761,127,6,0,0,0,0,2894,6032
IT-CO,Como,25,3185,63,0,0,1,0,0,3249,2617,163,4,0,2,0,0,2786,6035
IT-CO,Como,26,3104,77,1,0,1,0,0,3183,2617,256,5,0,1,0,0,2879,6062
IT-CO,Como,27,3031,137,2,0,1,0,0,3171,2542,339,4,1,1,0,0,2887,6058
IT-CO,Como,28,2978,178,5,0,2,0,0,3163,2426,455,16,0,2,0,0,2899,6062
IT-CO,Como,29,2905,283,8,0,1,0,0,3197,2360,610,11,0,2,1,0,2984,6181
IT-CO,Como,30,2830,403,16,1,5,0,0,3255,2167,805,27,0,2,0,0,3001,6256
IT-CO,Como,31,2725,528,13,0,1,0,0,3267,2070,970,27,3,8,0,0,3078,6345
IT-CO,Como,32,2633,691,16,4,5,0,0,3349,2025,1186,28,0,4,0,0,3243,6592
IT-CO,Como,33,2534,823,19,2,3,0,0,3381,1844,1301,60,2,3,0,0,3210,6591
IT-CO,Como,34,2360,982,28,0,4,0,0,3374,1730,1373,59,7,8,0,0,3177,6551
IT-CO,Como,35,2242,1141,25,1,6,1,0,3416,1564,1555,64,5,8,0,0,3196,6612
IT-CO,Como,36,1988,1214,48,1,5,0,0,3256,1423,1704,75,3,8,0,0,3213,6469
IT-CO,Como,37,1970,1343,48,3,3,0,0,3367,1402,1783,117,10,2,0,0,3314,6681
IT-CO,Como,38,1887,1491,77,5,3,0,1,3464,1337,1843,139,16,2,1,0,3338,6802
IT-CO,Como,39,1719,1654,75,4,7,0,0,3459,1268,2065,146,9,8,1,0,3497,6956
IT-CO,Como,40,1750,1766,93,4,7,0,0,3620,1227,2184,172,20,3,0,0,3606,7226
IT-CO,Como,41,1740,1872,108,2,6,0,0,3728,1269,2200,160,21,7,0,0,3657,7385
IT-CO,Como,42,1613,1864,133,13,7,0,0,3630,1134,2319,195,19,2,1,1,3671,7301
IT-CO,Como,43,1658,2026,135,7,3,0,0,3829,1111,2313,222,27,10,0,0,3683,7512
IT-CO,Como,44,1521,2181,168,12,11,0,0,3893,1062,2488,246,40,2,0,0,3838,7731
IT-CO,Como,45,1561,2485,193,10,8,0,0,4257,1022,2702,306,48,4,0,0,4082,8339
IT-CO,Como,46,1646,2511,230,12,7,0,0,4406,1132,2840,315,49,7,0,0,4343,8749
IT-CO,Como,47,1659,2682,247,17,5,1,0,4611,1101,3018,345,58,3,0,0,4525,9136
IT-CO,Como,48,1684,2938,285,19,12,0,0,4938,1127,3172,392,76,8,0,0,4775,9713
IT-CO,Como,49,1690,3067,300,20,5,0,0,5082,996,3317,460,76,1,1,0,4851,9933
IT-CO,Como,50,1512,3045,359,33,6,0,0,4955,1018,3369,454,85,3,0,0,4929,9884
IT-CO,Como,51,1473,3262,351,27,11,0,0,5124,941,3410,484,94,6,0,0,4935,10059
IT-CO,Como,52,1407,3338,373,21,7,0,1,5147,869,3356,473,108,3,0,0,4809,9956
IT-CO,Como,53,1228,3181,367,29,4,0,1,4810,826,3354,505,132,5,0,0,4822,9632
IT-CO,Como,54,1253,3420,407,23,6,0,0,5109,839,3647,490,153,4,0,0,5133,10242
IT-CO,Como,55,1176,3377,417,46,12,0,0,5028,815,3474,507,177,0,0,0,4973,10001
IT-CO,Como,56,1081,3623,441,36,13,0,0,5194,696,3542,529,168,6,0,0,4941,10135
IT-CO,Como,57,1010,3819,404,47,8,0,0,5288,706,3681,502,194,4,0,0,5087,10375
IT-CO,Como,58,947,3600,475,54,10,0,0,5086,684,3621,481,220,1,0,0,5007,10093
IT-CO,Como,59,857,3703,421,66,7,0,0,5054,648,3609,490,283,1,0,0,5031,10085
IT-CO,Como,60,744,3295,404,62,6,0,0,4511,546,3406,480,297,4,0,0,4733,9244
IT-CO,Como,61,712,3257,353,76,3,0,0,4401,512,3167,426,283,1,0,0,4389,8790
IT-CO,Como,62,545,3214,336,80,3,0,0,4178,488,3119,455,333,2,0,0,4397,8575
IT-CO,Como,63,509,3027,341,78,3,0,0,3958,430,3066,366,361,4,0,0,4227,8185
IT-CO,Como,64,513,3033,283,97,6,0,0,3932,399,2903,372,377,1,0,0,4052,7984
IT-CO,Como,65,418,2792,267,89,1,0,0,3567,339,2729,306,446,1,0,0,3821,7388
IT-CO,Como,66,400,2770,231,105,2,1,0,3509,306,2697,308,494,3,0,0,3808,7317
IT-CO,Como,67,321,2686,283,140,5,0,0,3435,328,2619,279,531,0,0,0,3757,7192
IT-CO,Como,68,329,2558,196,126,4,1,0,3214,292,2570,211,551,0,0,0,3624,6838
IT-CO,Como,69,312,2528,163,148,4,0,0,3155,271,2427,219,610,0,0,0,3527,6682
IT-CO,Como,70,283,2509,183,172,1,0,0,3148,230,2376,202,648,2,0,0,3458,6606
IT-CO,Como,71,283,2540,180,161,2,0,0,3166,264,2389,180,703,0,0,0,3536,6702
IT-CO,Como,72,271,2488,156,172,1,0,0,3088,221,2207,193,791,0,0,0,3412,6500
IT-CO,Como,73,245,2488,126,190,2,0,0,3051,251,2330,179,836,1,0,1,3598,6649
IT-CO,Como,74,239,2655,132,214,0,0,2,3242,253,2203,182,926,0,0,0,3564,6806
IT-CO,Como,75,251,2542,122,235,0,0,0,3150,249,2075,167,1061,0,0,0,3552,6702
IT-CO,Como,76,208,2473,99,263,2,0,0,3045,230,1952,140,1146,1,0,0,3469,6514
IT-CO,Como,77,212,2260,116,258,3,0,0,2849,248,1924,142,1261,0,0,0,3575,6424
IT-CO,Como,78,133,1750,59,239,1,0,0,2182,163,1242,87,981,0,0,0,2473,4655
IT-CO,Como,79,129,1696,70,255,0,0,0,2150,163,1271,105,1121,0,0,0,2660,4810
IT-CO,Como,80,125,1547,39,260,0,0,0,1971,180,1112,66,1251,0,0,0,2609,4580
IT-CO,Como,81,139,1485,53,271,1,0,0,1949,172,1019,62,1252,1,0,0,2506,4455
IT-CO,Como,82,122,1464,29,314,1,0,0,1930,136,965,60,1416,1,0,0,2578,4508
IT-CO,Como,83,96,1513,33,358,0,0,0,2000,184,881,67,1551,0,0,0,2683,4683
IT-CO,Como,84,94,1322,28,342,1,0,0,1787,173,797,55,1620,0,0,0,2645,4432
IT-CO,Como,85,100,1104,24,345,0,0,0,1573,160,652,40,1532,0,0,0,2384,3957
IT-CO,Como,86,61,883,16,300,0,0,0,1260,167,446,38,1380,1,0,0,2032,3292
IT-CO,Como,87,61,698,16,273,0,0,0,1048,147,381,32,1215,0,0,0,1775,2823
IT-CO,Como,88,54,634,14,241,0,0,0,943,122,272,24,1253,0,0,0,1671,2614
IT-CO,Como,89,35,460,7,225,0,0,0,727,138,227,20,1190,0,0,0,1575,2302
IT-CO,Como,90,30,350,7,188,0,0,0,575,88,124,9,1048,0,0,0,1269,1844
IT-CO,Como,91,22,259,3,175,0,0,0,459,102,78,14,923,0,0,0,1117,1576
IT-CO,Como,92,13,218,4,139,0,0,0,374,80,68,15,762,0,0,0,925,1299
IT-CO,Como,93,8,162,2,130,0,0,0,302,83,42,5,683,0,0,0,813,1115
IT-CO,Como,94,7,83,0,76,0,0,0,166,55,25,9,556,0,0,0,645,811
IT-CO,Como,95,9,62,1,68,0,0,0,140,49,15,1,346,0,0,0,411,551
IT-CO,Como,96,2,23,1,45,0,0,0,71,33,11,2,291,0,0,0,337,408
IT-CO,Como,97,1,14,0,29,0,0,0,44,22,3,1,213,0,0,0,239,283
IT-CO,Como,98,0,6,1,19,0,0,0,26,18,3,3,135,0,0,0,159,185
IT-CO,Como,99,1,2,1,10,0,0,0,14,8,3,2,94,0,0,0,107,121
IT-CO,Como,100,2,2,0,16,0,0,0,20,21,6,4,159,0,0,0,190,210
IT-CO,Como,999,142516,133690,10676,7503,255,4,5,294649,120231,134120,14046,34731,165,5,2,303300,597949
IT-CS,Cosenza,0,2324,0,0,0,0,0,0,2324,2242,0,0,0,0,0,0,2242,4566
IT-CS,Cosenza,1,2395,0,0,0,0,0,0,2395,2235,0,0,0,0,0,0,2235,4630
IT-CS,Cosenza,2,2392,0,0,0,0,0,0,2392,2246,0,0,0,0,0,0,2246,4638
IT-CS,Cosenza,3,2439,0,0,0,0,0,0,2439,2453,0,0,0,0,0,0,2453,4892
IT-CS,Cosenza,4,2610,0,0,0,0,0,0,2610,2489,0,0,0,0,0,0,2489,5099
IT-CS,Cosenza,5,2777,0,0,0,0,0,0,2777,2555,0,0,0,0,0,0,2555,5332
IT-CS,Cosenza,6,2753,0,0,0,0,0,0,2753,2757,0,0,0,0,0,0,2757,5510
IT-CS,Cosenza,7,2933,0,0,0,0,0,0,2933,2760,0,0,0,0,0,0,2760,5693
IT-CS,Cosenza,8,2844,0,0,0,0,0,0,2844,2821,0,0,0,0,0,0,2821,5665
IT-CS,Cosenza,9,2920,0,0,0,0,0,0,2920,2774,0,0,0,0,0,0,2774,5694
IT-CS,Cosenza,10,2870,0,0,0,0,0,0,2870,2877,0,0,0,0,0,0,2877,5747
IT-CS,Cosenza,11,3016,0,0,0,0,0,0,3016,2810,0,0,0,0,0,0,2810,5826
IT-CS,Cosenza,12,3105,0,0,0,0,0,0,3105,2893,0,0,0,0,0,0,2893,5998
IT-CS,Cosenza,13,3019,0,0,0,0,0,0,3019,2907,0,0,0,0,0,0,2907,5926
IT-CS,Cosenza,14,3251,0,0,0,0,0,0,3251,3053,0,0,0,0,0,0,3053,6304
IT-CS,Cosenza,15,3081,0,0,0,0,0,0,3081,3044,0,0,0,0,0,0,3044,6125
IT-CS,Cosenza,16,3195,0,1,0,0,0,0,3196,3001,0,0,0,0,0,0,3001,6197
IT-CS,Cosenza,17,3448,1,0,0,0,0,0,3449,3083,0,0,0,0,0,0,3083,6532
IT-CS,Cosenza,18,3395,0,0,0,0,0,0,3395,3041,0,0,0,0,0,0,3041,6436
IT-CS,Cosenza,19,3507,1,0,0,0,0,0,3508,3152,4,0,0,0,0,0,3156,6664
IT-CS,Cosenza,20,3379,0,0,0,0,0,0,3379,3204,10,0,0,0,0,0,3214,6593
IT-CS,Cosenza,21,3484,9,0,0,0,0,0,3493,3132,30,0,0,0,0,0,3162,6655
IT-CS,Cosenza,22,3393,13,1,0,0,0,0,3407,3176,37,0,0,0,0,0,3213,6620
IT-CS,Cosenza,23,3542,18,1,0,0,0,0,3561,3161,83,3,0,1,0,0,3248,6809
IT-CS,Cosenza,24,3529,31,0,0,0,0,0,3560,3109,134,3,1,0,0,0,3247,6807
IT-CS,Cosenza,25,3573,61,2,0,1,0,0,3637,3051,186,1,0,0,0,0,3238,6875
IT-CS,Cosenza,26,3454,95,3,1,0,0,0,3553,2947,284,3,0,1,0,0,3235,6788
IT-CS,Cosenza,27,3587,152,1,0,0,0,0,3740,2825,416,7,1,0,0,0,3249,6989
IT-CS,Cosenza,28,3365,227,2,1,2,0,0,3597,2704,555,4,1,3,0,0,3267,6864
IT-CS,Cosenza,29,3398,381,3,1,1,0,0,3784,2703,726,12,1,3,0,0,3445,7229
IT-CS,Cosenza,30,3368,521,3,2,0,0,0,3894,2502,983,12,2,1,0,0,3500,7394
IT-CS,Cosenza,31,3191,636,10,1,1,0,0,3839,2369,1255,16,2,3,0,0,3645,7484
IT-CS,Cosenza,32,3114,802,6,1,1,0,0,3924,2207,1442,25,8,1,0,0,3683,7607
IT-CS,Cosenza,33,2901,985,13,3,1,0,0,3903,2151,1580,40,8,2,0,0,3781,7684
IT-CS,Cosenza,34,2792,1215,20,0,1,0,0,4028,1994,1919,44,10,1,1,0,3969,7997
IT-CS,Cosenza,35,2603,1430,18,3,2,0,0,4056,1803,2057,61,9,3,0,0,3933,7989
IT-CS,Cosenza,36,2473,1524,30,2,4,0,0,4033,1659,2221,78,5,2,0,0,3965,7998
IT-CS,Cosenza,37,2280,1638,33,0,3,0,0,3954,1518,2375,74,21,2,0,0,3990,7944
IT-CS,Cosenza,38,2211,1869,42,2,1,0,0,4125,1489,2447,89,20,0,0,0,4045,8170
IT-CS,Cosenza,39,2119,2149,47,4,1,0,0,4320,1347,2601,99,25,2,0,0,4074,8394
IT-CS,Cosenza,40,1978,2232,53,1,1,0,0,4265,1207,2769,107,15,1,0,0,4099,8364
IT-CS,Cosenza,41,1862,2350,66,0,1,0,0,4279,1179,2920,126,34,0,0,0,4259,8538
IT-CS,Cosenza,42,1763,2473,67,6,5,0,0,4314,1126,3034,131,24,0,0,0,4315,8629
IT-CS,Cosenza,43,1632,2661,102,13,1,0,0,4409,1070,3088,156,40,0,0,0,4354,8763
IT-CS,Cosenza,44,1602,2782,88,13,1,0,0,4486,1048,3215,169,43,0,0,0,4475,8961
IT-CS,Cosenza,45,1529,2888,111,13,0,0,0,4541,941,3358,212,55,2,0,0,4568,9109
IT-CS,Cosenza,46,1547,3010,115,7,0,0,0,4679,935,3510,199,74,2,0,0,4720,9399
IT-CS,Cosenza,47,1521,3187,134,20,1,0,0,4863,903,3713,206,89,1,0,0,4912,9775
IT-CS,Cosenza,48,1419,3388,134,17,1,0,0,4959,886,3691,236,94,0,0,0,4907,9866
IT-CS,Cosenza,49,1280,3376,143,24,0,1,0,4824,851,3906,223,83,0,0,1,5064,9888
IT-CS,Cosenza,50,1240,3400,178,27,0,0,0,4845,830,3919,257,135,0,0,0,5141,9986
IT-CS,Cosenza,51,1215,3600,191,36,1,0,0,5043,789,3991,257,159,0,0,0,5196,10239
IT-CS,Cosenza,52,1147,3542,170,32,0,0,0,4891,701,4038,290,175,1,0,0,5205,10096
IT-CS,Cosenza,53,1027,3656,177,39,0,0,0,4899,743,3959,272,223,0,0,0,5197,10096
IT-CS,Cosenza,54,1030,3807,242,51,1,0,0,5131,733,4376,275,225,0,0,0,5609,10740
IT-CS,Cosenza,55,1041,3783,187,42,1,0,0,5054,731,4169,266,247,0,0,0,5413,10467
IT-CS,Cosenza,56,913,3996,197,68,2,0,0,5176,633,4296,275,292,1,0,0,5497,10673
IT-CS,Cosenza,57,825,4037,199,73,0,0,0,5134,663,4206,247,299,0,0,0,5415,10549
IT-CS,Cosenza,58,776,4039,186,76,0,0,0,5077,654,4281,254,345,1,0,0,5535,10612
IT-CS,Cosenza,59,737,4224,221,112,3,0,0,5297,617,4436,250,407,0,0,0,5710,11007
IT-CS,Cosenza,60,699,4052,187,92,0,1,0,5031,561,4075,238,473,1,0,0,5348,10379
IT-CS,Cosenza,61,622,4061,164,99,0,0,0,4946,542,4159,206,471,0,0,0,5378,10324
IT-CS,Cosenza,62,580,4072,188,117,0,0,0,4957,510,4039,175,543,0,0,0,5267,10224
IT-CS,Cosenza,63,547,4044,189,130,0,0,0,4910,486,3934,220,605,0,0,0,5245,10155
IT-CS,Cosenza,64,504,4025,168,122,0,0,0,4819,456,3769,180,663,0,0,0,5068,9887
IT-CS,Cosenza,65,470,3646,150,119,0,0,0,4385,412,3460,189,691,1,0,0,4753,9138
IT-CS,Cosenza,66,386,3881,145,132,0,0,0,4544,419,3414,159,763,0,0,0,4755,9299
IT-CS,Cosenza,67,386,3663,124,150,0,0,0,4323,378,3376,173,792,0,0,0,4719,9042
IT-CS,Cosenza,68,331,3627,126,123,0,0,0,4207,363,3293,140,912,0,0,0,4708,8915
IT-CS,Cosenza,69,296,3709,126,187,1,0,0,4319,351,3098,125,919,0,0,0,4493,8812
IT-CS,Cosenza,70,244,3363,116,181,1,0,0,3905,310,2857,131,993,0,0,0,4291,8196
IT-CS,Cosenza,71,236,3177,86,180,0,0,0,3679,271,2707,124,1026,0,0,0,4128,7807
IT-CS,Cosenza,72,215,3192,77,202,0,0,0,3686,281,2595,122,1141,0,0,0,4139,7825
IT-CS,Cosenza,73,209,3209,81,228,1,0,0,3728,279,2493,104,1200,0,0,0,4076,7804
IT-CS,Cosenza,74,184,3219,106,266,0,0,0,3775,259,2398,101,1344,0,0,0,4102,7877
IT-CS,Cosenza,75,163,3120,75,231,0,0,0,3589,258,2338,92,1445,0,0,0,4133,7722
IT-CS,Cosenza,76,151,2940,58,289,0,0,0,3438,241,2017,86,1580,0,0,0,3924,7362
IT-CS,Cosenza,77,156,2544,49,293,0,0,0,3042,215,1765,66,1471,0,0,0,3517,6559
IT-CS,Cosenza,78,97,1851,27,234,0,0,0,2209,136,1190,35,1189,0,0,0,2550,4759
IT-CS,Cosenza,79,106,1891,46,250,0,0,0,2293,163,1140,31,1308,0,0,0,2642,4935
IT-CS,Cosenza,80,82,1715,34,233,0,0,0,2064,164,1008,39,1303,0,0,0,2514,4578
IT-CS,Cosenza,81,76,1601,23,267,0,0,0,1967,143,904,30,1351,0,0,0,2428,4395
IT-CS,Cosenza,82,65,1504,24,290,0,0,0,1883,124,781,42,1342,0,0,0,2289,4172
IT-CS,Cosenza,83,73,1520,21,350,0,0,0,1964,126,805,36,1633,0,0,0,2600,4564
IT-CS,Cosenza,84,60,1464,18,365,0,0,0,1907,137,706,32,1645,0,0,0,2520,4427
IT-CS,Cosenza,85,50,1184,9,365,0,0,0,1608,120,568,27,1610,0,0,0,2325,3933
IT-CS,Cosenza,86,41,1068,14,338,0,0,0,1461,127,455,14,1457,0,0,0,2053,3514
IT-CS,Cosenza,87,35,902,8,318,0,0,0,1263,118,379,15,1376,0,0,0,1888,3151
IT-CS,Cosenza,88,42,723,6,310,0,0,0,1081,104,265,10,1364,0,0,0,1743,2824
IT-CS,Cosenza,89,34,618,4,278,0,0,0,934,94,206,14,1176,0,0,0,1490,2424
IT-CS,Cosenza,90,28,419,5,287,0,0,0,739,89,154,7,1060,0,0,0,1310,2049
IT-CS,Cosenza,91,13,349,4,237,0,0,0,603,74,131,8,969,0,0,0,1182,1785
IT-CS,Cosenza,92,13,223,3,190,0,0,0,429,69,85,11,750,0,0,0,915,1344
IT-CS,Cosenza,93,5,196,1,168,0,0,0,370,52,84,7,661,0,0,0,804,1174
IT-CS,Cosenza,94,8,128,2,133,0,0,0,271,35,39,8,504,0,0,0,586,857
IT-CS,Cosenza,95,5,71,0,101,0,0,0,177,26,28,1,364,0,0,0,419,596
IT-CS,Cosenza,96,3,56,1,80,0,0,0,140,29,16,0,264,0,0,0,309,449
IT-CS,Cosenza,97,0,26,0,55,0,0,0,81,21,10,0,195,0,0,0,226,307
IT-CS,Cosenza,98,1,27,0,36,0,0,0,64,16,13,4,139,0,0,0,172,236
IT-CS,Cosenza,99,2,17,0,19,0,0,0,38,13,12,0,96,0,0,0,121,159
IT-CS,Cosenza,100,6,41,0,32,0,0,0,79,17,22,0,170,0,0,0,209,288
IT-CS,Cosenza,999,153338,161327,5662,8768,41,2,0,329138,130073,161008,7981,42130,36,1,1,341230,670368
IT-CR,Cremona,0,1191,0,0,0,0,0,0,1191,1063,0,0,0,0,0,0,1063,2254
IT-CR,Cremona,1,1207,0,0,0,0,0,0,1207,1089,0,0,0,0,0,0,1089,2296
IT-CR,Cremona,2,1255,0,0,0,0,0,0,1255,1227,0,0,0,0,0,0,1227,2482
IT-CR,Cremona,3,1286,0,0,0,0,0,0,1286,1174,0,0,0,0,0,0,1174,2460
IT-CR,Cremona,4,1387,0,0,0,0,0,0,1387,1269,0,0,0,0,0,0,1269,2656
IT-CR,Cremona,5,1361,0,0,0,0,0,0,1361,1229,0,0,0,0,0,0,1229,2590
IT-CR,Cremona,6,1454,0,0,0,0,0,0,1454,1362,0,0,0,0,0,0,1362,2816
IT-CR,Cremona,7,1401,0,0,0,0,0,0,1401,1399,0,0,0,0,0,0,1399,2800
IT-CR,Cremona,8,1546,0,0,0,0,0,0,1546,1372,0,0,0,0,0,0,1372,2918
IT-CR,Cremona,9,1557,0,0,0,0,0,0,1557,1479,0,0,0,0,0,0,1479,3036
IT-CR,Cremona,10,1590,0,0,0,0,0,0,1590,1481,0,0,0,0,0,0,1481,3071
IT-CR,Cremona,11,1650,0,0,0,0,0,0,1650,1520,0,0,0,0,0,0,1520,3170
IT-CR,Cremona,12,1646,0,0,0,0,0,0,1646,1492,0,0,0,0,0,0,1492,3138
IT-CR,Cremona,13,1775,0,0,0,0,0,0,1775,1584,0,0,0,0,0,0,1584,3359
IT-CR,Cremona,14,1746,0,0,0,0,0,0,1746,1595,0,0,0,0,0,0,1595,3341
IT-CR,Cremona,15,1818,0,0,0,0,0,0,1818,1677,0,0,0,0,0,0,1677,3495
IT-CR,Cremona,16,1751,0,0,0,0,0,0,1751,1592,0,0,0,0,0,0,1592,3343
IT-CR,Cremona,17,1747,0,0,0,0,0,0,1747,1576,0,0,0,0,0,0,1576,3323
IT-CR,Cremona,18,1773,0,0,0,0,0,0,1773,1592,3,0,0,0,0,0,1595,3368
IT-CR,Cremona,19,1747,0,0,0,0,0,0,1747,1558,3,0,0,0,0,0,1561,3308
IT-CR,Cremona,20,1777,2,0,0,0,0,0,1779,1506,13,0,0,0,0,0,1519,3298
IT-CR,Cremona,21,1759,2,0,0,0,0,0,1761,1498,21,0,0,0,0,0,1519,3280
IT-CR,Cremona,22,1742,8,0,0,0,0,0,1750,1612,53,1,0,0,0,0,1666,3416
IT-CR,Cremona,23,1846,15,0,0,0,0,0,1861,1589,82,4,0,1,0,0,1676,3537
IT-CR,Cremona,24,1803,26,2,0,0,0,0,1831,1508,119,4,0,0,0,0,1631,3462
IT-CR,Cremona,25,1851,36,4,0,0,0,0,1891,1553,145,4,0,0,0,0,1702,3593
IT-CR,Cremona,26,1827,84,3,0,1,0,0,1915,1431,194,4,0,1,0,0,1630,3545
IT-CR,Cremona,27,1741,107,2,0,1,0,0,1851,1441,221,4,1,1,0,0,1668,3519
IT-CR,Cremona,28,1761,137,5,0,1,0,0,1904,1333,337,11,1,2,0,0,1684,3588
IT-CR,Cremona,29,1654,212,7,0,2,0,0,1875,1288,403,12,2,0,0,0,1705,3580
IT-CR,Cremona,30,1582,260,6,0,0,0,0,1848,1203,549,16,1,3,0,0,1772,3620
IT-CR,Cremona,31,1544,349,9,0,2,0,0,1904,1133,694,20,1,4,0,0,1852,3756
IT-CR,Cremona,32,1466,473,11,0,0,0,0,1950,1054,721,24,1,3,0,0,1803,3753
IT-CR,Cremona,33,1352,503,13,3,3,0,0,1874,993,823,42,5,3,0,0,1866,3740
IT-CR,Cremona,34,1318,615,15,4,2,1,0,1955,966,930,35,5,5,0,0,1941,3896
IT-CR,Cremona,35,1256,697,21,1,3,0,0,1978,788,983,43,0,1,0,0,1815,3793
IT-CR,Cremona,36,1150,745,26,1,1,0,0,1923,736,1087,48,8,5,0,0,1884,3807
IT-CR,Cremona,37,1116,782,21,2,3,1,0,1925,713,1145,51,6,3,0,0,1918,3843
IT-CR,Cremona,38,1078,905,48,3,4,0,0,2038,753,1085,75,8,5,0,0,1926,3964
IT-CR,Cremona,39,1043,1000,59,3,4,0,0,2109,672,1179,93,16,1,0,0,1961,4070
IT-CR,Cremona,40,963,1042,56,1,3,0,1,2066,632,1247,89,9,4,0,0,1981,4047
IT-CR,Cremona,41,1017,1143,67,2,6,0,1,2236,641,1353,99,14,3,0,0,2110,4346
IT-CR,Cremona,42,937,1203,68,6,5,2,0,2221,630,1377,107,16,2,0,0,2132,4353
IT-CR,Cremona,43,894,1250,81,5,4,1,0,2235,617,1448,105,24,4,0,0,2198,4433
IT-CR,Cremona,44,923,1344,94,10,0,0,0,2371,615,1460,118,25,4,0,0,2222,4593
IT-CR,Cremona,45,957,1384,101,11,7,0,0,2460,570,1607,193,31,3,0,0,2404,4864
IT-CR,Cremona,46,986,1468,121,15,6,0,0,2596,612,1655,186,25,1,1,0,2480,5076
IT-CR,Cremona,47,967,1558,137,13,4,0,0,2679,638,1748,193,49,1,0,0,2629,5308
IT-CR,Cremona,48,996,1695,155,16,2,0,0,2864,579,1852,248,41,2,0,0,2722,5586
IT-CR,Cremona,49,949,1704,181,10,5,0,0,2849,557,1860,244,43,5,0,0,2709,5558
IT-CR,Cremona,50,838,1712,189,19,4,0,1,2763,535,1878,285,58,3,0,0,2759,5522
IT-CR,Cremona,51,864,1855,189,15,5,0,1,2929,542,1845,220,52,2,0,0,2661,5590
IT-CR,Cremona,52,846,1858,211,19,4,0,1,2939,493,1939,275,73,2,0,0,2782,5721
IT-CR,Cremona,53,736,1791,226,24,3,0,0,2780,415,1960,299,92,1,1,0,2768,5548
IT-CR,Cremona,54,744,1989,247,22,5,0,0,3007,466,2012,262,112,3,0,0,2855,5862
IT-CR,Cremona,55,724,2006,257,28,6,0,0,3021,425,2046,274,118,3,0,0,2866,5887
IT-CR,Cremona,56,650,1978,222,24,7,0,0,2881,401,2008,261,131,0,0,0,2801,5682
IT-CR,Cremona,57,645,2134,256,24,6,0,0,3065,399,2073,281,131,3,0,0,2887,5952
IT-CR,Cremona,58,588,2098,242,45,5,0,0,2978,402,2086,285,149,1,0,0,2923,5901
IT-CR,Cremona,59,586,2007,245,46,1,0,1,2886,343,2041,268,191,1,0,0,2844,5730
IT-CR,Cremona,60,500,2008,221,43,3,0,0,2775,340,2062,224,204,1,0,0,2831,5606
IT-CR,Cremona,61,433,1888,207,43,8,0,0,2579,303,1925,226,188,1,0,0,2643,5222
IT-CR,Cremona,62,396,1894,197,53,3,0,0,2543,268,1849,186,263,0,0,0,2566,5109
IT-CR,Cremona,63,371,1853,155,63,5,0,0,2447,241,1868,192,250,1,0,0,2552,4999
IT-CR,Cremona,64,348,1816,176,67,3,0,0,2410,224,1771,184,277,0,0,0,2456,4866
IT-CR,Cremona,65,335,1766,151,87,1,0,0,2340,257,1702,183,290,0,0,1,2433,4773
IT-CR,Cremona,66,306,1651,151,59,1,0,0,2168,199,1624,192,297,1,0,0,2313,4481
IT-CR,Cremona,67,270,1680,101,89,4,0,1,2145,157,1587,142,361,0,0,0,2247,4392
IT-CR,Cremona,68,271,1628,120,80,1,0,0,2100,167,1636,152,386,0,0,0,2341,4441
IT-CR,Cremona,69,243,1605,104,115,2,0,0,2069,144,1458,104,428,0,0,0,2134,4203
IT-CR,Cremona,70,223,1517,96,105,4,0,0,1945,153,1418,134,428,0,0,0,2133,4078
IT-CR,Cremona,71,218,1535,96,108,3,0,0,1960,144,1358,99,488,1,0,0,2090,4050
IT-CR,Cremona,72,218,1538,73,97,1,0,0,1927,133,1301,103,500,0,0,0,2037,3964
IT-CR,Cremona,73,223,1605,76,154,3,0,0,2061,129,1377,87,535,0,0,0,2128,4189
IT-CR,Cremona,74,215,1533,76,163,2,0,0,1989,147,1284,92,686,0,0,0,2209,4198
IT-CR,Cremona,75,218,1575,67,145,1,0,0,2006,120,1323,84,737,0,0,0,2264,4270
IT-CR,Cremona,76,178,1485,68,169,0,0,0,1900,115,1158,62,754,0,0,1,2090,3990
IT-CR,Cremona,77,153,1447,50,176,1,0,0,1827,143,1121,65,810,1,0,0,2140,3967
IT-CR,Cremona,78,115,923,27,141,1,0,0,1207,111,668,47,602,0,0,1,1429,2636
IT-CR,Cremona,79,115,917,26,176,0,0,0,1234,109,714,43,754,0,0,0,1620,2854
IT-CR,Cremona,80,122,879,26,181,1,0,0,1209,98,663,39,782,0,0,0,1582,2791
IT-CR,Cremona,81,123,888,18,201,0,0,0,1230,114,607,41,876,0,0,0,1638,2868
IT-CR,Cremona,82,118,841,21,184,0,0,0,1164,111,566,35,918,0,0,0,1630,2794
IT-CR,Cremona,83,131,795,23,236,0,0,0,1185,105,501,39,1003,0,0,0,1648,2833
IT-CR,Cremona,84,95,785,12,270,0,0,0,1162,91,454,25,1033,0,0,0,1603,2765
IT-CR,Cremona,85,97,657,7,210,0,0,0,971,109,390,24,1051,1,0,0,1575,2546
IT-CR,Cremona,86,78,538,9,182,0,0,0,807,92,227,19,924,0,0,0,1262,2069
IT-CR,Cremona,87,57,425,9,160,0,0,0,651,85,213,9,860,0,0,0,1167,1818
IT-CR,Cremona,88,53,350,5,174,0,0,0,582,74,153,20,823,0,0,0,1070,1652
IT-CR,Cremona,89,40,276,5,140,0,0,0,461,60,123,6,739,0,0,0,928,1389
IT-CR,Cremona,90,27,192,4,118,0,0,0,341,73,71,4,669,0,0,0,817,1158
IT-CR,Cremona,91,26,145,1,118,0,0,0,290,43,47,10,614,0,0,0,714,1004
IT-CR,Cremona,92,20,102,0,74,0,0,0,196,57,37,2,493,0,0,0,589,785
IT-CR,Cremona,93,9,68,0,85,0,0,0,162,44,26,2,439,0,0,0,511,673
IT-CR,Cremona,94,7,52,1,47,0,0,0,107,50,21,3,313,0,0,0,387,494
IT-CR,Cremona,95,6,33,0,37,0,0,0,76,21,11,2,250,0,0,0,284,360
IT-CR,Cremona,96,1,24,0,34,0,0,0,59,15,4,2,174,0,0,0,195,254
IT-CR,Cremona,97,0,9,0,25,0,0,0,34,15,7,0,159,0,0,0,181,215
IT-CR,Cremona,98,4,7,0,15,0,0,0,26,14,0,1,101,0,0,0,116,142
IT-CR,Cremona,99,0,5,0,6,0,0,0,11,12,0,0,67,0,0,0,79,90
IT-CR,Cremona,100,3,3,0,17,0,0,0,23,6,4,0,101,0,0,0,111,134
IT-CR,Cremona,999,84730,79115,5976,5019,163,5,7,175015,67505,79614,7667,23066,93,2,3,177950,352965
IT-KR,Crotone,0,629,0,0,0,0,0,0,629,607,0,0,0,0,0,0,607,1236
IT-KR,Crotone,1,716,0,0,0,0,0,0,716,635,0,0,0,0,0,0,635,1351
IT-KR,Crotone,2,650,0,0,0,0,0,0,650,626,0,0,0,0,0,0,626,1276
IT-KR,Crotone,3,718,0,0,0,0,0,0,718,656,0,0,0,0,0,0,656,1374
IT-KR,Crotone,4,699,0,0,0,0,0,0,699,732,0,0,0,0,0,0,732,1431
IT-KR,Crotone,5,777,0,0,0,0,0,0,777,698,0,0,0,0,0,0,698,1475
IT-KR,Crotone,6,769,0,0,0,0,0,0,769,719,0,0,0,0,0,0,719,1488
IT-KR,Crotone,7,754,0,0,0,0,0,0,754,746,0,0,0,0,0,0,746,1500
IT-KR,Crotone,8,816,0,0,0,0,0,0,816,738,0,0,0,0,0,0,738,1554
IT-KR,Crotone,9,783,0,0,0,0,0,0,783,736,0,0,0,0,0,0,736,1519
IT-KR,Crotone,10,805,0,0,0,0,0,0,805,745,0,0,0,0,0,0,745,1550
IT-KR,Crotone,11,847,0,0,0,0,0,0,847,760,0,0,0,0,0,0,760,1607
IT-KR,Crotone,12,868,0,0,0,0,0,0,868,791,0,0,0,0,0,0,791,1659
IT-KR,Crotone,13,875,0,0,0,0,0,0,875,919,0,0,0,0,0,0,919,1794
IT-KR,Crotone,14,917,0,0,0,0,0,0,917,804,0,0,0,0,0,0,804,1721
IT-KR,Crotone,15,972,0,0,0,0,0,0,972,845,0,0,0,0,0,0,845,1817
IT-KR,Crotone,16,878,0,0,0,0,0,0,878,815,0,0,0,0,0,0,815,1693
IT-KR,Crotone,17,893,0,0,0,0,0,0,893,909,0,0,0,0,0,0,909,1802
IT-KR,Crotone,18,968,0,0,0,0,0,0,968,905,0,0,0,0,0,0,905,1873
IT-KR,Crotone,19,1014,0,0,0,0,0,0,1014,929,2,0,0,0,0,0,931,1945
IT-KR,Crotone,20,972,3,0,0,0,0,0,975,845,5,0,0,0,0,0,850,1825
IT-KR,Crotone,21,889,5,0,0,0,0,0,894,810,15,0,0,0,0,0,825,1719
IT-KR,Crotone,22,929,4,0,0,0,0,0,933,856,17,0,0,0,0,0,873,1806
IT-KR,Crotone,23,921,4,0,0,0,0,0,925,914,37,1,0,0,0,0,952,1877
IT-KR,Crotone,24,931,13,0,0,0,0,0,944,796,54,0,0,0,0,0,850,1794
IT-KR,Crotone,25,919,13,0,0,0,0,0,932,791,85,0,0,0,0,0,876,1808
IT-KR,Crotone,26,800,42,1,0,0,0,0,843,699,124,0,0,0,0,0,823,1666
IT-KR,Crotone,27,800,54,0,0,0,0,0,854,687,169,1,1,0,0,0,858,1712
IT-KR,Crotone,28,791,84,1,0,0,0,0,876,616,203,2,0,0,0,0,821,1697
IT-KR,Crotone,29,738,137,0,0,0,0,0,875,637,258,5,0,0,0,0,900,1775
IT-KR,Crotone,30,752,164,2,0,0,0,0,918,564,333,8,0,0,0,0,905,1823
IT-KR,Crotone,31,774,202,2,0,0,0,0,978,511,362,14,0,1,0,0,888,1866
IT-KR,Crotone,32,662,275,2,0,0,0,0,939,482,440,11,2,0,1,0,936,1875
IT-KR,Crotone,33,678,311,8,1,0,0,0,998,420,495,11,3,0,0,0,929,1927
IT-KR,Crotone,34,623,403,6,0,0,0,0,1032,400,522,8,3,0,0,0,933,1965
IT-KR,Crotone,35,605,416,8,1,0,0,0,1030,353,580,14,3,0,0,0,950,1980
IT-KR,Crotone,36,560,461,14,0,0,0,0,1035,350,615,26,4,1,0,0,996,2031
IT-KR,Crotone,37,490,507,12,1,0,0,0,1010,261,633,32,4,0,0,0,930,1940
IT-KR,Crotone,38,480,490,9,2,0,0,0,981,235,691,25,2,0,0,0,953,1934
IT-KR,Crotone,39,439,565,17,1,0,0,0,1022,259,654,27,6,0,0,0,946,1968
IT-KR,Crotone,40,424,555,23,0,0,0,0,1002,249,679,25,5,0,0,0,958,1960
IT-KR,Crotone,41,427,614,23,1,0,0,0,1065,228,697,49,7,0,0,0,981,2046
IT-KR,Crotone,42,366,617,20,0,0,0,0,1003,212,736,38,8,0,0,0,994,1997
IT-KR,Crotone,43,374,688,27,1,0,0,0,1090,213,779,40,12,0,0,0,1044,2134
IT-KR,Crotone,44,358,707,40,7,1,0,0,1113,205,757,38,8,0,0,0,1008,2121
IT-KR,Crotone,45,317,723,35,5,0,0,0,1080,198,797,47,12,0,1,0,1055,2135
IT-KR,Crotone,46,302,683,25,5,0,0,0,1015,174,868,47,17,0,0,0,1106,2121
IT-KR,Crotone,47,310,788,40,5,0,0,0,1143,190,823,64,23,0,0,0,1100,2243
IT-KR,Crotone,48,274,749,57,8,0,0,0,1088,187,882,52,22,0,0,0,1143,2231
IT-KR,Crotone,49,277,842,41,6,0,0,0,1166,198,907,57,35,0,0,0,1197,2363
IT-KR,Crotone,50,241,796,68,13,0,0,0,1118,190,892,49,32,0,0,0,1163,2281
IT-KR,Crotone,51,263,859,49,7,0,0,0,1178,172,950,60,35,0,0,0,1217,2395
IT-KR,Crotone,52,239,865,54,8,0,0,0,1166,178,962,59,38,0,0,0,1237,2403
IT-KR,Crotone,53,236,882,35,10,0,0,0,1163,158,917,52,52,0,0,0,1179,2342
IT-KR,Crotone,54,224,876,57,9,0,0,0,1166,173,979,57,68,2,0,0,1279,2445
IT-KR,Crotone,55,207,873,53,13,0,0,0,1146,147,981,58,56,0,0,0,1242,2388
IT-KR,Crotone,56,186,890,45,9,0,0,0,1130,160,989,55,79,0,0,0,1283,2413
IT-KR,Crotone,57,168,937,42,18,0,0,0,1165,150,963,45,85,0,0,0,1243,2408
IT-KR,Crotone,58,172,932,40,18,0,0,0,1162,158,948,56,81,0,0,0,1243,2405
IT-KR,Crotone,59,166,1029,49,26,0,0,0,1270,137,961,52,95,0,0,0,1245,2515
IT-KR,Crotone,60,119,963,44,17,0,0,0,1143,127,966,36,94,0,0,0,1223,2366
IT-KR,Crotone,61,104,946,41,17,0,0,0,1108,117,958,50,112,0,0,0,1237,2345
IT-KR,Crotone,62,128,985,48,23,0,0,0,1184,140,883,34,137,0,0,0,1194,2378
IT-KR,Crotone,63,100,943,32,23,0,0,0,1098,113,861,37,132,0,0,0,1143,2241
IT-KR,Crotone,64,86,882,51,22,0,0,0,1041,117,839,30,153,0,0,0,1139,2180
IT-KR,Crotone,65,89,836,37,29,0,0,0,991,68,781,37,167,0,0,0,1053,2044
IT-KR,Crotone,66,75,932,28,38,0,0,0,1073,78,738,35,169,0,0,0,1020,2093
IT-KR,Crotone,67,74,860,19,42,0,0,0,995,84,769,29,193,0,0,0,1075,2070
IT-KR,Crotone,68,62,853,28,28,0,0,0,971,89,737,29,210,0,0,0,1065,2036
IT-KR,Crotone,69,62,849,24,43,0,0,0,978,80,692,31,228,0,0,0,1031,2009
IT-KR,Crotone,70,66,750,35,45,0,0,0,896,85,640,21,237,0,0,0,983,1879
IT-KR,Crotone,71,46,718,16,45,0,0,0,825,59,591,25,232,0,0,0,907,1732
IT-KR,Crotone,72,31,725,14,42,0,0,0,812,71,558,14,246,0,0,0,889,1701
IT-KR,Crotone,73,40,764,19,45,0,0,0,868,63,563,15,290,0,0,0,931,1799
IT-KR,Crotone,74,52,692,20,56,0,0,0,820,67,577,13,344,0,0,0,1001,1821
IT-KR,Crotone,75,25,689,17,54,0,0,0,785,54,531,16,334,0,0,0,935,1720
IT-KR,Crotone,76,32,632,9,65,0,0,0,738,61,434,10,367,0,0,0,872,1610
IT-KR,Crotone,77,21,598,11,60,0,0,0,690,57,377,11,354,0,0,0,799,1489
IT-KR,Crotone,78,27,460,9,69,0,0,0,565,50,297,15,321,0,0,0,683,1248
IT-KR,Crotone,79,18,419,6,56,0,0,0,499,33,266,7,294,0,0,0,600,1099
IT-KR,Crotone,80,24,375,2,57,0,0,0,458,34,209,10,314,0,0,0,567,1025
IT-KR,Crotone,81,17,354,8,58,1,0,0,438,34,201,4,335,0,0,0,574,1012
IT-KR,Crotone,82,18,313,6,52,0,0,0,389,30,164,6,350,0,0,0,550,939
IT-KR,Crotone,83,11,355,4,72,0,0,0,442,34,163,13,418,0,0,0,628,1070
IT-KR,Crotone,84,12,275,5,75,0,0,0,367,36,152,8,365,0,0,0,561,928
IT-KR,Crotone,85,7,266,4,62,0,0,0,339,33,130,5,330,0,0,0,498,837
IT-KR,Crotone,86,5,204,4,79,0,0,0,292,18,99,5,354,0,0,0,476,768
IT-KR,Crotone,87,5,188,4,68,0,0,0,265,22,65,5,320,0,0,0,412,677
IT-KR,Crotone,88,6,151,1,83,0,0,0,241,21,46,1,272,0,0,0,340,581
IT-KR,Crotone,89,3,120,1,60,0,0,0,184,12,41,0,232,0,0,0,285,469
IT-KR,Crotone,90,2,100,1,54,0,0,0,157,11,30,1,205,0,0,0,247,404
IT-KR,Crotone,91,3,72,0,51,0,0,0,126,19,21,0,180,0,0,0,220,346
IT-KR,Crotone,92,2,34,1,45,0,0,0,82,13,20,0,166,0,0,0,199,281
IT-KR,Crotone,93,5,37,0,45,0,0,0,87,10,11,0,104,0,0,0,125,212
IT-KR,Crotone,94,0,19,0,26,0,0,0,45,5,3,2,83,0,0,0,93,138
IT-KR,Crotone,95,1,20,0,25,0,0,0,46,3,4,0,67,0,0,0,74,120
IT-KR,Crotone,96,0,8,0,15,0,0,0,23,5,2,0,52,0,0,0,59,82
IT-KR,Crotone,97,1,5,0,13,0,0,0,19,3,1,1,31,0,0,0,36,55
IT-KR,Crotone,98,0,5,0,6,0,0,0,11,0,1,0,25,0,0,0,26,37
IT-KR,Crotone,99,0,2,0,3,0,0,0,5,0,1,0,21,0,0,0,22,27
IT-KR,Crotone,100,1,0,0,6,0,0,0,7,4,3,0,21,0,0,0,28,35
IT-KR,Crotone,999,38012,38457,1454,1949,2,0,0,79874,32438,38186,1741,9657,4,2,0,82028,161902
IT-CN,Cuneo,0,2057,0,0,0,0,0,0,2057,1914,0,0,0,0,0,0,1914,3971
IT-CN,Cuneo,1,2050,0,0,0,0,0,0,2050,1967,0,0,0,0,0,0,1967,4017
IT-CN,Cuneo,2,2137,0,0,0,0,0,0,2137,2151,0,0,0,0,0,0,2151,4288
IT-CN,Cuneo,3,2225,0,0,0,0,0,0,2225,2099,0,0,0,0,0,0,2099,4324
IT-CN,Cuneo,4,2210,0,0,0,0,0,0,2210,2235,0,0,0,0,0,0,2235,4445
IT-CN,Cuneo,5,2375,0,0,0,0,0,0,2375,2227,0,0,0,0,0,0,2227,4602
IT-CN,Cuneo,6,2412,0,0,0,0,0,0,2412,2421,0,0,0,0,0,0,2421,4833
IT-CN,Cuneo,7,2562,0,0,0,0,0,0,2562,2427,0,0,0,0,0,0,2427,4989
IT-CN,Cuneo,8,2640,0,0,0,0,0,0,2640,2381,0,0,0,0,0,0,2381,5021
IT-CN,Cuneo,9,2669,0,0,0,0,0,0,2669,2573,0,0,0,0,0,0,2573,5242
IT-CN,Cuneo,10,2732,0,0,0,0,0,0,2732,2586,0,0,0,0,0,0,2586,5318
IT-CN,Cuneo,11,2812,0,0,0,0,0,0,2812,2609,0,0,0,0,0,0,2609,5421
IT-CN,Cuneo,12,2886,0,0,0,0,0,0,2886,2527,0,0,0,0,0,0,2527,5413
IT-CN,Cuneo,13,2881,0,0,0,0,0,0,2881,2634,0,0,0,0,0,0,2634,5515
IT-CN,Cuneo,14,2854,0,0,0,0,0,0,2854,2806,0,0,0,0,0,0,2806,5660
IT-CN,Cuneo,15,2905,0,0,0,0,0,0,2905,2712,0,0,0,0,0,0,2712,5617
IT-CN,Cuneo,16,2903,0,0,1,0,0,0,2904,2749,0,0,0,0,0,0,2749,5653
IT-CN,Cuneo,17,2848,0,0,0,0,0,0,2848,2700,0,0,0,0,0,0,2700,5548
IT-CN,Cuneo,18,2918,0,0,0,0,0,0,2918,2635,1,1,0,0,0,0,2637,5555
IT-CN,Cuneo,19,2987,3,0,0,0,0,0,2990,2652,13,0,0,0,0,0,2665,5655
IT-CN,Cuneo,20,2931,5,1,0,0,0,0,2937,2654,25,0,0,0,0,0,2679,5616
IT-CN,Cuneo,21,2900,7,0,0,0,0,0,2907,2617,57,0,0,0,0,0,2674,5581
IT-CN,Cuneo,22,3030,22,0,0,0,0,0,3052,2676,108,3,0,0,0,0,2787,5839
IT-CN,Cuneo,23,3235,22,0,0,0,0,0,3257,2754,154,4,0,0,0,0,2912,6169
IT-CN,Cuneo,24,3165,60,0,0,2,0,0,3227,2617,218,7,2,3,0,0,2847,6074
IT-CN,Cuneo,25,3279,92,4,0,0,0,0,3375,2539,285,6,0,1,0,0,2831,6206
IT-CN,Cuneo,26,3148,124,5,0,2,0,0,3279,2484,407,9,0,3,0,0,2903,6182
IT-CN,Cuneo,27,3184,217,5,0,0,0,0,3406,2305,555,8,0,0,1,0,2869,6275
IT-CN,Cuneo,28,2959,275,10,0,0,0,0,3244,2203,644,23,1,3,0,0,2874,6118
IT-CN,Cuneo,29,2764,397,11,1,3,0,0,3176,2087,895,23,0,3,0,0,3008,6184
IT-CN,Cuneo,30,2638,547,10,0,2,0,0,3197,1902,991,33,2,1,0,0,2929,6126
IT-CN,Cuneo,31,2613,728,17,0,2,1,0,3361,1871,1233,31,0,1,0,0,3136,6497
IT-CN,Cuneo,32,2421,946,20,1,2,0,0,3390,1595,1357,43,3,2,0,0,3000,6390
IT-CN,Cuneo,33,2295,1057,36,2,2,1,0,3393,1584,1451,62,3,1,0,0,3101,6494
IT-CN,Cuneo,34,2166,1171,39,7,8,2,0,3393,1396,1576,76,4,4,0,0,3056,6449
IT-CN,Cuneo,35,2053,1282,59,2,10,0,0,3406,1340,1712,83,6,4,0,0,3145,6551
IT-CN,Cuneo,36,1782,1364,42,1,5,0,0,3194,1196,1792,110,5,6,0,0,3109,6303
IT-CN,Cuneo,37,1779,1457,69,0,5,2,0,3312,1147,1864,136,11,3,0,0,3161,6473
IT-CN,Cuneo,38,1773,1561,78,2,3,2,0,3419,1101,1855,135,12,4,1,0,3108,6527
IT-CN,Cuneo,39,1629,1641,85,2,7,0,0,3364,1077,1964,129,11,6,0,0,3187,6551
IT-CN,Cuneo,40,1560,1788,120,8,5,0,0,3481,1088,1969,171,24,7,0,1,3260,6741
IT-CN,Cuneo,41,1487,1919,114,5,5,1,0,3531,1041,2126,206,22,2,0,0,3397,6928
IT-CN,Cuneo,42,1450,1898,141,10,4,0,0,3503,959,2172,209,25,4,0,0,3369,6872
IT-CN,Cuneo,43,1467,2035,144,8,7,0,0,3661,947,2335,263,35,5,0,0,3585,7246
IT-CN,Cuneo,44,1357,2094,138,9,3,0,0,3601,907,2333,255,35,3,0,0,3533,7134
IT-CN,Cuneo,45,1448,2190,192,14,5,0,0,3849,896,2438,279,41,1,0,0,3655,7504
IT-CN,Cuneo,46,1389,2309,193,9,3,0,0,3903,911,2493,325,53,11,0,0,3793,7696
IT-CN,Cuneo,47,1416,2483,237,15,2,0,0,4153,859,2757,347,51,4,0,0,4018,8171
IT-CN,Cuneo,48,1384,2635,267,21,4,0,0,4311,902,2850,410,76,9,0,0,4247,8558
IT-CN,Cuneo,49,1357,2808,312,13,5,0,0,4495,894,3108,431,70,3,0,0,4506,9001
IT-CN,Cuneo,50,1401,2818,342,12,6,0,0,4579,847,3005,465,96,4,0,0,4417,8996
IT-CN,Cuneo,51,1240,2949,343,18,4,0,0,4554,845,3090,465,102,3,0,0,4505,9059
IT-CN,Cuneo,52,1196,2954,408,24,2,0,0,4584,747,3226,474,138,2,0,0,4587,9171
IT-CN,Cuneo,53,1094,2987,363,40,2,0,0,4486,729,3183,460,107,5,0,0,4484,8970
IT-CN,Cuneo,54,1093,3147,395,29,7,1,0,4672,686,3284,512,129,1,0,0,4612,9284
IT-CN,Cuneo,55,1007,3243,415,55,7,2,0,4729,653,3356,515,159,3,0,0,4686,9415
IT-CN,Cuneo,56,1013,3183,429,46,3,0,0,4674,644,3288,515,187,3,0,0,4637,9311
IT-CN,Cuneo,57,955,3209,415,56,5,0,0,4640,633,3371,518,194,3,0,0,4719,9359
IT-CN,Cuneo,58,871,3412,427,66,9,0,0,4785,578,3353,480,252,2,0,1,4666,9451
IT-CN,Cuneo,59,784,3452,436,78,6,0,0,4756,554,3538,509,251,1,0,0,4853,9609
IT-CN,Cuneo,60,760,3197,384,70,4,0,0,4415,473,3119,476,290,2,0,1,4361,8776
IT-CN,Cuneo,61,648,3119,384,78,5,0,0,4234,442,3142,425,336,2,0,0,4347,8581
IT-CN,Cuneo,62,640,3010,379,55,3,0,1,4088,418,3033,395,351,0,0,0,4197,8285
IT-CN,Cuneo,63,553,3029,336,111,5,0,0,4034,404,2882,370,400,0,0,0,4056,8090
IT-CN,Cuneo,64,575,2938,314,103,2,0,0,3932,328,2786,369,482,0,0,0,3965,7897
IT-CN,Cuneo,65,513,2983,271,96,1,0,0,3864,315,2604,306,418,1,0,0,3644,7508
IT-CN,Cuneo,66,489,2847,266,120,4,0,0,3726,271,2715,325,506,0,0,0,3817,7543
IT-CN,Cuneo,67,446,2682,247,124,4,0,0,3503,262,2588,293,553,1,0,0,3697,7200
IT-CN,Cuneo,68,398,2738,239,145,1,0,0,3521,255,2463,244,644,0,0,0,3606,7127
IT-CN,Cuneo,69,379,2531,221,161,1,0,0,3293,208,2467,237,663,0,0,0,3575,6868
IT-CN,Cuneo,70,377,2543,190,169,4,0,0,3283,233,2303,232,676,0,0,0,3444,6727
IT-CN,Cuneo,71,384,2528,215,189,0,0,0,3316,218,2216,221,760,1,0,0,3416,6732
IT-CN,Cuneo,72,350,2458,176,155,1,0,0,3140,195,2269,196,752,1,0,0,3413,6553
IT-CN,Cuneo,73,362,2514,151,206,1,0,0,3234,187,2206,184,894,1,0,0,3472,6706
IT-CN,Cuneo,74,346,2511,144,235,1,0,0,3237,194,2115,173,992,1,0,0,3475,6712
IT-CN,Cuneo,75,317,2518,135,275,1,0,0,3246,186,2068,153,1152,1,0,0,3560,6806
IT-CN,Cuneo,76,280,2344,149,272,1,0,0,3046,194,1882,123,1174,0,0,0,3373,6419
IT-CN,Cuneo,77,279,2094,130,262,0,0,0,2765,161,1673,105,1215,0,0,0,3154,5919
IT-CN,Cuneo,78,237,1600,75,220,0,0,0,2132,123,1214,88,1024,0,0,0,2449,4581
IT-CN,Cuneo,79,226,1629,74,285,1,0,1,2216,129,1264,88,1140,1,0,0,2622,4838
IT-CN,Cuneo,80,217,1630,44,272,0,0,0,2163,147,1102,83,1269,0,0,0,2601,4764
IT-CN,Cuneo,81,222,1512,54,277,0,0,0,2065,161,1045,76,1348,0,0,0,2630,4695
IT-CN,Cuneo,82,234,1378,50,291,0,0,0,1953,175,944,61,1493,0,0,0,2673,4626
IT-CN,Cuneo,83,233,1353,41,334,0,0,0,1961,142,851,44,1633,0,0,0,2670,4631
IT-CN,Cuneo,84,198,1286,40,324,0,0,0,1848,162,721,53,1619,1,0,0,2556,4404
IT-CN,Cuneo,85,186,1138,32,367,1,0,0,1724,135,614,54,1686,0,0,0,2489,4213
IT-CN,Cuneo,86,153,927,27,316,0,0,0,1423,128,458,42,1493,0,0,0,2121,3544
IT-CN,Cuneo,87,100,725,14,298,0,0,0,1137,113,311,31,1339,0,0,0,1794,2931
IT-CN,Cuneo,88,106,613,17,298,0,0,0,1034,143,228,16,1325,0,0,0,1712,2746
IT-CN,Cuneo,89,90,488,5,259,0,0,0,842,111,175,16,1239,0,0,0,1541,2383
IT-CN,Cuneo,90,62,313,4,206,0,0,0,585,92,119,14,1073,0,0,0,1298,1883
IT-CN,Cuneo,91,43,268,7,176,0,0,0,494,71,70,10,930,0,0,0,1081,1575
IT-CN,Cuneo,92,36,198,5,158,0,0,0,397,77,56,11,787,0,0,0,931,1328
IT-CN,Cuneo,93,28,139,4,132,0,0,0,303,58,41,7,687,0,0,0,793,1096
IT-CN,Cuneo,94,13,107,2,110,0,0,0,232,82,21,6,502,0,0,0,611,843
IT-CN,Cuneo,95,10,64,3,61,0,0,0,138,45,8,2,424,0,0,0,479,617
IT-CN,Cuneo,96,10,41,1,49,0,0,0,101,35,9,5,284,0,0,0,333,434
IT-CN,Cuneo,97,7,19,1,40,0,0,0,67,18,6,5,229,0,0,0,258,325
IT-CN,Cuneo,98,1,9,1,20,0,0,0,31,23,0,3,153,0,0,0,179,210
IT-CN,Cuneo,99,3,7,0,19,0,0,0,29,19,0,0,105,0,0,0,124,153
IT-CN,Cuneo,100,4,5,1,24,0,0,0,34,21,1,1,137,0,0,0,160,194
IT-CN,Cuneo,999,139291,130524,11155,7917,188,12,2,289089,111624,130221,14274,36284,134,2,3,292542,581631
IT-EN,Enna,0,530,0,0,0,0,0,0,530,488,0,0,0,0,0,0,488,1018
IT-EN,Enna,1,510,0,0,0,0,0,0,510,496,0,0,0,0,0,0,496,1006
IT-EN,Enna,2,530,0,0,0,0,0,0,530,514,0,0,0,0,0,0,514,1044
IT-EN,Enna,3,531,0,0,0,0,0,0,531,507,0,0,0,0,0,0,507,1038
IT-EN,Enna,4,548,0,0,0,0,0,0,548,534,0,0,0,0,0,0,534,1082
IT-EN,Enna,5,572,0,0,0,0,0,0,572,574,0,0,0,0,0,0,574,1146
IT-EN,Enna,6,639,0,0,0,0,0,0,639,555,0,0,0,0,0,0,555,1194
IT-EN,Enna,7,569,0,0,0,0,0,0,569,605,0,0,0,0,0,0,605,1174
IT-EN,Enna,8,624,0,0,0,0,0,0,624,607,0,0,0,0,0,0,607,1231
IT-EN,Enna,9,592,0,0,0,0,0,0,592,592,0,0,0,0,0,0,592,1184
IT-EN,Enna,10,596,0,0,0,0,0,0,596,613,0,0,0,0,0,0,613,1209
IT-EN,Enna,11,659,0,0,0,0,0,0,659,590,0,0,0,0,0,0,590,1249
IT-EN,Enna,12,711,0,0,0,0,0,0,711,658,0,0,0,0,0,0,658,1369
IT-EN,Enna,13,688,0,0,0,0,0,0,688,713,0,0,0,0,0,0,713,1401
IT-EN,Enna,14,799,0,0,0,0,0,0,799,692,0,0,0,0,0,0,692,1491
IT-EN,Enna,15,761,0,0,0,0,0,0,761,727,0,0,0,0,0,0,727,1488
IT-EN,Enna,16,774,0,0,0,0,0,0,774,738,0,0,0,0,0,0,738,1512
IT-EN,Enna,17,862,1,0,0,0,0,0,863,727,0,0,0,0,0,0,727,1590
IT-EN,Enna,18,853,0,0,0,0,0,0,853,788,3,0,0,0,0,0,791,1644
IT-EN,Enna,19,848,0,0,0,0,0,0,848,769,1,0,0,0,0,0,770,1618
IT-EN,Enna,20,898,1,0,0,0,0,0,899,765,6,0,0,0,0,0,771,1670
IT-EN,Enna,21,828,5,0,0,0,0,0,833,842,10,0,0,0,0,0,852,1685
IT-EN,Enna,22,865,1,0,0,0,0,0,866,868,13,1,0,1,0,0,883,1749
IT-EN,Enna,23,891,11,0,0,0,0,0,902,841,25,0,0,0,0,0,866,1768
IT-EN,Enna,24,947,10,0,0,0,0,0,957,817,50,0,0,0,0,0,867,1824
IT-EN,Enna,25,881,18,1,0,0,0,0,900,764,69,0,0,0,0,0,833,1733
IT-EN,Enna,26,848,30,0,0,0,0,0,878,696,76,1,0,0,0,0,773,1651
IT-EN,Enna,27,817,38,0,0,0,0,0,855,688,110,1,0,1,0,0,800,1655
IT-EN,Enna,28,805,65,2,0,0,0,0,872,679,169,2,0,0,0,0,850,1722
IT-EN,Enna,29,779,85,0,0,0,0,0,864,601,225,3,0,0,0,0,829,1693
IT-EN,Enna,30,798,145,5,0,0,0,0,948,514,289,5,0,0,0,0,808,1756
IT-EN,Enna,31,703,161,3,0,0,0,0,867,551,268,5,1,0,0,0,825,1692
IT-EN,Enna,32,660,206,3,0,0,0,0,869,450,399,6,0,0,0,0,855,1724
IT-EN,Enna,33,597,250,2,0,1,0,0,850,436,427,6,0,0,0,0,869,1719
IT-EN,Enna,34,554,331,1,1,0,0,0,887,392,415,17,1,0,0,0,825,1712
IT-EN,Enna,35,510,364,8,0,0,0,0,882,326,494,22,3,0,0,0,845,1727
IT-EN,Enna,36,460,356,11,0,0,0,0,827,314,508,24,3,1,0,0,850,1677
IT-EN,Enna,37,443,423,10,1,0,0,0,877,310,518,14,5,0,0,0,847,1724
IT-EN,Enna,38,420,439,9,1,0,0,0,869,259,587,24,2,0,0,0,872,1741
IT-EN,Enna,39,418,481,10,0,0,0,0,909,232,607,35,7,0,0,0,881,1790
IT-EN,Enna,40,358,486,13,1,1,0,0,859,212,579,28,5,0,0,0,824,1683
IT-EN,Enna,41,351,518,25,0,1,0,0,895,212,629,29,7,0,0,0,877,1772
IT-EN,Enna,42,338,575,20,2,0,0,0,935,192,634,39,7,0,0,0,872,1807
IT-EN,Enna,43,333,580,31,2,0,0,0,946,195,665,44,7,0,0,0,911,1857
IT-EN,Enna,44,295,605,17,4,1,0,0,922,162,693,46,10,1,0,0,912,1834
IT-EN,Enna,45,276,577,33,0,0,0,0,886,167,712,63,17,0,0,0,959,1845
IT-EN,Enna,46,244,636,36,4,0,0,0,920,184,807,56,12,0,0,0,1059,1979
IT-EN,Enna,47,281,674,34,2,0,0,0,991,191,814,52,18,0,0,0,1075,2066
IT-EN,Enna,48,264,744,38,4,0,0,0,1050,163,875,61,23,0,0,0,1122,2172
IT-EN,Enna,49,254,792,46,4,1,0,0,1097,160,842,64,25,0,0,0,1091,2188
IT-EN,Enna,50,255,760,50,13,0,0,0,1078,148,858,61,35,0,0,0,1102,2180
IT-EN,Enna,51,229,797,67,5,0,0,0,1098,197,918,48,37,0,0,0,1200,2298
IT-EN,Enna,52,227,837,55,11,0,0,0,1130,143,946,66,32,0,0,0,1187,2317
IT-EN,Enna,53,208,845,51,5,0,0,0,1109,155,972,55,44,0,0,0,1226,2335
IT-EN,Enna,54,177,927,61,13,0,0,0,1178,141,1012,62,51,0,0,0,1266,2444
IT-EN,Enna,55,185,960,46,13,0,0,0,1204,135,1047,75,59,0,0,0,1316,2520
IT-EN,Enna,56,186,954,54,14,0,0,0,1208,122,980,72,66,0,0,0,1240,2448
IT-EN,Enna,57,177,1013,53,10,0,0,0,1253,159,967,56,45,0,0,0,1227,2480
IT-EN,Enna,58,155,948,74,17,0,0,0,1194,140,943,54,73,0,0,0,1210,2404
IT-EN,Enna,59,154,991,46,23,0,0,0,1214,160,1004,46,103,0,0,0,1313,2527
IT-EN,Enna,60,121,918,42,20,0,1,0,1102,155,953,51,96,0,0,0,1255,2357
IT-EN,Enna,61,127,959,49,27,0,0,0,1162,123,902,49,117,0,0,0,1191,2353
IT-EN,Enna,62,113,895,43,15,0,0,0,1066,122,922,57,127,0,0,0,1228,2294
IT-EN,Enna,63,107,927,42,23,0,0,0,1099,149,930,37,145,0,0,0,1261,2360
IT-EN,Enna,64,92,927,29,22,1,0,0,1071,106,865,35,139,0,0,0,1145,2216
IT-EN,Enna,65,75,838,30,25,0,0,0,968,109,832,41,159,0,0,0,1141,2109
IT-EN,Enna,66,90,790,26,29,0,0,0,935,128,812,35,179,0,0,0,1154,2089
IT-EN,Enna,67,64,835,31,32,0,0,0,962,108,739,44,184,0,0,0,1075,2037
IT-EN,Enna,68,66,825,29,52,0,0,0,972,110,757,35,188,0,0,0,1090,2062
IT-EN,Enna,69,74,796,23,34,0,0,0,927,115,772,27,205,0,0,0,1119,2046
IT-EN,Enna,70,75,765,25,29,0,0,0,894,119,629,38,223,0,0,0,1009,1903
IT-EN,Enna,71,58,719,26,45,0,1,0,849,106,645,23,252,0,0,0,1026,1875
IT-EN,Enna,72,42,735,17,44,0,0,0,838,86,617,16,264,0,0,0,983,1821
IT-EN,Enna,73,48,717,21,49,0,0,0,835,105,608,25,296,0,0,0,1034,1869
IT-EN,Enna,74,50,737,24,67,0,0,0,878,97,596,20,351,0,0,0,1064,1942
IT-EN,Enna,75,40,722,15,77,0,0,0,854,83,509,15,390,0,0,0,997,1851
IT-EN,Enna,76,44,647,13,67,0,0,0,771,82,491,15,345,0,0,0,933,1704
IT-EN,Enna,77,35,547,6,70,0,0,0,658,60,367,15,328,0,0,0,770,1428
IT-EN,Enna,78,22,448,8,58,0,0,0,536,60,332,5,344,0,0,0,741,1277
IT-EN,Enna,79,38,413,10,53,0,0,0,514,43,249,6,340,0,0,0,638,1152
IT-EN,Enna,80,19,364,8,59,0,0,0,450,50,225,9,331,0,0,0,615,1065
IT-EN,Enna,81,22,337,7,72,0,0,0,438,30,186,12,320,0,0,0,548,986
IT-EN,Enna,82,25,322,7,58,0,0,0,412,39,210,6,357,0,0,0,612,1024
IT-EN,Enna,83,18,391,3,67,0,0,0,479,56,197,10,453,0,0,0,716,1195
IT-EN,Enna,84,12,375,2,73,0,0,0,462,51,177,8,474,0,0,0,710,1172
IT-EN,Enna,85,18,327,5,92,0,0,0,442,50,145,4,427,0,0,0,626,1068
IT-EN,Enna,86,13,244,6,93,0,0,0,356,38,81,3,370,0,0,0,492,848
IT-EN,Enna,87,11,238,1,86,0,0,0,336,40,63,4,330,0,0,0,437,773
IT-EN,Enna,88,5,158,3,73,0,0,0,239,33,57,1,301,0,0,0,392,631
IT-EN,Enna,89,12,148,2,83,0,0,0,245,35,28,4,327,0,0,0,394,639
IT-EN,Enna,90,11,109,0,53,0,0,0,173,22,38,1,251,0,0,0,312,485
IT-EN,Enna,91,7,89,0,55,0,0,0,151,18,18,1,221,0,0,0,258,409
IT-EN,Enna,92,1,46,0,44,0,0,0,91,20,15,1,210,0,0,0,246,337
IT-EN,Enna,93,2,40,1,41,0,0,0,84,11,3,1,173,0,0,0,188,272
IT-EN,Enna,94,2,32,0,39,0,0,0,73,9,8,1,118,0,0,0,136,209
IT-EN,Enna,95,4,18,1,18,0,0,0,41,11,2,2,80,0,0,0,95,136
IT-EN,Enna,96,0,8,0,22,0,0,0,30,8,1,1,62,0,0,0,72,102
IT-EN,Enna,97,0,8,0,14,0,0,0,22,2,1,0,43,0,0,0,46,68
IT-EN,Enna,98,1,2,0,10,0,0,0,13,5,0,1,33,0,0,0,39,52
IT-EN,Enna,99,0,2,0,6,0,0,0,8,1,3,0,20,0,0,0,24,32
IT-EN,Enna,100,1,3,0,12,0,0,0,16,7,0,0,29,0,0,0,36,52
IT-EN,Enna,999,33830,37061,1470,2058,6,2,0,74427,29772,37151,1902,10300,4,0,0,79129,153556
IT-FM,Fermo,0,461,0,0,0,0,0,0,461,500,0,0,0,0,0,0,500,961
IT-FM,Fermo,1,483,0,0,0,0,0,0,483,507,0,0,0,0,0,0,507,990
IT-FM,Fermo,2,506,0,0,0,0,0,0,506,498,0,0,0,0,0,0,498,1004
IT-FM,Fermo,3,573,0,0,0,0,0,0,573,535,0,0,0,0,0,0,535,1108
IT-FM,Fermo,4,571,0,0,0,0,0,0,571,516,0,0,0,0,0,0,516,1087
IT-FM,Fermo,5,607,0,0,0,0,0,0,607,568,0,0,0,0,0,0,568,1175
IT-FM,Fermo,6,626,0,0,0,0,0,0,626,569,0,0,0,0,0,0,569,1195
IT-FM,Fermo,7,685,0,0,0,0,0,0,685,625,0,0,0,0,0,0,625,1310
IT-FM,Fermo,8,707,0,0,0,0,0,0,707,655,0,0,0,0,0,0,655,1362
IT-FM,Fermo,9,711,0,0,0,0,0,0,711,625,0,0,0,0,0,0,625,1336
IT-FM,Fermo,10,743,0,0,0,0,0,0,743,692,0,0,0,0,0,0,692,1435
IT-FM,Fermo,11,718,0,0,0,0,0,0,718,703,0,0,0,0,0,0,703,1421
IT-FM,Fermo,12,786,0,0,0,0,0,0,786,721,0,0,0,0,0,0,721,1507
IT-FM,Fermo,13,782,0,0,0,0,0,0,782,696,0,0,0,0,0,0,696,1478
IT-FM,Fermo,14,810,0,0,0,0,0,0,810,725,0,0,0,0,0,0,725,1535
IT-FM,Fermo,15,788,0,0,0,0,0,0,788,686,0,0,0,0,0,0,686,1474
IT-FM,Fermo,16,823,0,0,0,0,0,0,823,775,0,0,0,0,0,0,775,1598
IT-FM,Fermo,17,791,0,0,0,0,0,0,791,755,0,0,0,0,0,0,755,1546
IT-FM,Fermo,18,827,0,0,0,0,0,0,827,724,1,0,0,0,0,0,725,1552
IT-FM,Fermo,19,808,0,0,0,0,0,0,808,749,1,0,0,0,0,0,750,1558
IT-FM,Fermo,20,790,0,0,0,0,0,0,790,714,9,0,0,0,0,0,723,1513
IT-FM,Fermo,21,803,1,0,0,0,0,0,804,733,9,0,0,0,0,0,742,1546
IT-FM,Fermo,22,840,5,0,0,0,0,0,845,739,20,0,0,0,0,0,759,1604
IT-FM,Fermo,23,882,9,0,1,1,0,0,893,757,33,2,0,0,0,0,792,1685
IT-FM,Fermo,24,885,11,1,0,0,0,0,897,736,41,3,1,0,0,0,781,1678
IT-FM,Fermo,25,927,17,0,0,0,0,0,944,733,63,1,0,0,0,0,797,1741
IT-FM,Fermo,26,856,28,2,1,0,0,0,887,683,93,3,0,0,0,0,779,1666
IT-FM,Fermo,27,895,34,1,0,0,0,0,930,679,104,5,0,0,0,0,788,1718
IT-FM,Fermo,28,841,41,0,0,1,0,0,883,695,121,3,0,0,0,0,819,1702
IT-FM,Fermo,29,775,59,1,0,0,1,0,836,590,146,7,0,0,0,0,743,1579
IT-FM,Fermo,30,730,92,4,0,0,0,0,826,579,201,5,0,0,1,0,786,1612
IT-FM,Fermo,31,773,152,4,1,0,0,0,930,572,239,6,0,0,0,0,817,1747
IT-FM,Fermo,32,732,170,1,0,0,0,0,903,528,272,10,1,0,0,0,811,1714
IT-FM,Fermo,33,664,157,7,1,0,0,0,829,534,322,12,0,3,0,0,871,1700
IT-FM,Fermo,34,645,227,5,1,0,0,0,878,455,339,12,0,2,0,0,808,1686
IT-FM,Fermo,35,681,241,3,2,0,0,0,927,467,400,15,0,2,0,0,884,1811
IT-FM,Fermo,36,569,281,9,1,0,0,0,860,436,439,15,1,1,0,0,892,1752
IT-FM,Fermo,37,572,370,15,0,0,0,0,957,394,474,28,3,1,0,0,900,1857
IT-FM,Fermo,38,562,376,19,1,1,0,0,959,439,495,30,5,0,0,0,969,1928
IT-FM,Fermo,39,510,441,14,3,0,0,0,968,375,527,27,7,1,0,0,937,1905
IT-FM,Fermo,40,503,435,19,2,0,0,0,959,372,552,43,10,1,0,0,978,1937
IT-FM,Fermo,41,541,446,22,2,0,0,0,1011,335,569,59,7,1,0,0,971,1982
IT-FM,Fermo,42,480,489,30,7,1,0,0,1007,330,635,55,12,0,0,0,1032,2039
IT-FM,Fermo,43,460,543,37,2,3,0,0,1045,306,633,69,12,3,0,0,1023,2068
IT-FM,Fermo,44,483,595,38,3,1,0,0,1120,328,762,64,18,1,0,0,1173,2293
IT-FM,Fermo,45,456,650,44,5,0,0,0,1155,303,752,81,14,1,0,0,1151,2306
IT-FM,Fermo,46,439,664,59,3,0,0,0,1165,327,772,75,18,1,0,0,1193,2358
IT-FM,Fermo,47,489,737,58,5,1,0,0,1290,281,759,75,22,1,0,0,1138,2428
IT-FM,Fermo,48,423,707,60,4,0,0,0,1194,305,876,89,30,1,1,0,1302,2496
IT-FM,Fermo,49,418,740,72,5,0,0,0,1235,278,867,118,31,0,0,0,1294,2529
IT-FM,Fermo,50,387,775,69,4,0,0,0,1235,302,879,106,27,0,0,0,1314,2549
IT-FM,Fermo,51,376,759,65,1,1,0,0,1202,263,895,107,27,0,0,0,1292,2494
IT-FM,Fermo,52,363,827,85,9,1,0,0,1285,241,991,131,40,0,0,0,1403,2688
IT-FM,Fermo,53,386,840,85,6,1,0,0,1318,220,931,99,45,1,0,0,1296,2614
IT-FM,Fermo,54,340,877,89,11,1,0,0,1318,208,1029,113,55,0,0,0,1405,2723
IT-FM,Fermo,55,322,864,89,7,0,0,0,1282,198,966,103,57,0,0,0,1324,2606
IT-FM,Fermo,56,274,947,88,12,0,0,0,1321,163,1049,125,53,1,0,0,1391,2712
IT-FM,Fermo,57,279,937,110,17,1,0,0,1344,183,1026,104,73,0,0,0,1386,2730
IT-FM,Fermo,58,223,972,101,14,1,0,0,1311,145,1001,125,67,0,0,0,1338,2649
IT-FM,Fermo,59,238,1024,99,19,0,0,0,1380,145,1034,116,66,0,0,0,1361,2741
IT-FM,Fermo,60,206,946,88,22,1,0,0,1263,119,1043,114,68,2,0,0,1346,2609
IT-FM,Fermo,61,182,947,80,20,1,0,0,1230,116,979,87,100,0,0,0,1282,2512
IT-FM,Fermo,62,191,1001,95,28,0,0,0,1315,107,1001,114,106,0,0,0,1328,2643
IT-FM,Fermo,63,168,997,69,27,0,0,0,1261,109,969,95,107,0,0,0,1280,2541
IT-FM,Fermo,64,135,937,76,25,1,0,0,1174,92,949,93,100,0,0,0,1234,2408
IT-FM,Fermo,65,113,947,80,20,0,0,0,1160,83,908,67,147,0,0,0,1205,2365
IT-FM,Fermo,66,135,885,76,35,1,0,0,1132,84,846,80,162,1,0,0,1173,2305
IT-FM,Fermo,67,137,893,48,25,0,0,0,1103,85,948,65,212,0,0,0,1310,2413
IT-FM,Fermo,68,102,880,57,51,0,0,0,1090,78,886,52,184,0,0,0,1200,2290
IT-FM,Fermo,69,90,861,49,45,0,0,0,1045,61,822,49,186,1,0,0,1119,2164
IT-FM,Fermo,70,79,807,54,60,0,0,0,1000,61,755,50,188,0,0,0,1054,2054
IT-FM,Fermo,71,85,788,41,57,0,0,0,971,61,666,42,234,0,0,0,1003,1974
IT-FM,Fermo,72,73,774,32,57,2,0,0,938,52,704,40,271,0,0,0,1067,2005
IT-FM,Fermo,73,67,778,41,55,0,0,0,941,52,635,39,285,0,0,0,1011,1952
IT-FM,Fermo,74,55,763,31,72,0,0,0,921,47,661,25,279,0,0,0,1012,1933
IT-FM,Fermo,75,81,788,23,60,0,0,0,952,42,622,23,324,0,0,0,1011,1963
IT-FM,Fermo,76,45,718,28,63,0,0,0,854,48,597,34,341,0,0,0,1020,1874
IT-FM,Fermo,77,42,657,17,70,1,0,0,787,33,561,32,342,0,0,0,968,1755
IT-FM,Fermo,78,42,562,22,77,1,0,0,704,40,374,25,335,0,0,0,774,1478
IT-FM,Fermo,79,32,481,14,63,0,0,0,590,21,397,13,330,0,0,0,761,1351
IT-FM,Fermo,80,34,479,11,78,0,0,0,602,30,356,12,367,0,0,0,765,1367
IT-FM,Fermo,81,32,417,10,77,0,0,1,537,31,273,8,380,0,0,0,692,1229
IT-FM,Fermo,82,26,440,5,76,0,0,0,547,19,261,9,401,0,0,0,690,1237
IT-FM,Fermo,83,35,473,6,93,0,0,0,607,25,273,7,530,0,0,0,835,1442
IT-FM,Fermo,84,34,458,7,126,0,0,0,625,23,265,9,579,0,0,0,876,1501
IT-FM,Fermo,85,33,453,7,111,0,0,0,604,24,206,6,578,0,0,0,814,1418
IT-FM,Fermo,86,24,379,3,114,0,0,0,520,11,158,6,498,0,0,0,673,1193
IT-FM,Fermo,87,20,307,3,86,0,0,0,416,22,102,3,445,0,0,0,572,988
IT-FM,Fermo,88,13,245,3,101,0,0,0,362,18,95,5,504,0,0,0,622,984
IT-FM,Fermo,89,17,192,1,88,0,0,0,298,21,62,4,387,0,0,0,474,772
IT-FM,Fermo,90,7,148,3,66,0,0,0,224,14,58,4,400,0,0,0,476,700
IT-FM,Fermo,91,5,93,0,57,0,0,0,155,14,30,3,301,0,0,0,348,503
IT-FM,Fermo,92,5,90,0,65,0,0,0,160,17,23,2,255,0,0,0,297,457
IT-FM,Fermo,93,3,57,0,45,0,0,0,105,7,8,1,225,0,0,0,241,346
IT-FM,Fermo,94,5,37,0,35,0,0,0,77,8,12,0,173,0,0,0,193,270
IT-FM,Fermo,95,3,37,0,38,0,0,0,78,8,8,2,121,0,0,0,139,217
IT-FM,Fermo,96,1,15,0,15,0,0,0,31,5,5,0,95,0,0,0,105,136
IT-FM,Fermo,97,1,13,0,11,0,0,0,25,7,1,0,73,0,0,0,81,106
IT-FM,Fermo,98,1,4,0,11,0,0,0,16,4,1,0,55,0,0,0,60,76
IT-FM,Fermo,99,0,2,0,2,0,0,0,4,3,0,0,29,0,0,0,32,36
IT-FM,Fermo,100,0,3,0,10,0,0,0,13,5,0,1,41,0,0,0,47,60
IT-FM,Fermo,999,38977,38292,2485,2387,23,1,1,82166,31602,38847,3262,11440,26,2,0,85179,167345
IT-FE,Ferrara,0,933,0,0,0,0,0,0,933,886,0,0,0,0,0,0,886,1819
IT-FE,Ferrara,1,959,0,0,0,0,0,0,959,935,0,0,0,0,0,0,935,1894
IT-FE,Ferrara,2,1052,0,0,0,0,0,0,1052,919,0,0,0,0,0,0,919,1971
IT-FE,Ferrara,3,956,0,0,0,0,0,0,956,940,0,0,0,0,0,0,940,1896
IT-FE,Ferrara,4,1068,0,0,0,0,0,0,1068,1052,0,0,0,0,0,0,1052,2120
IT-FE,Ferrara,5,1108,0,0,0,0,0,0,1108,1045,0,0,0,0,0,0,1045,2153
IT-FE,Ferrara,6,1161,0,0,0,0,0,0,1161,1061,0,0,0,0,0,0,1061,2222
IT-FE,Ferrara,7,1143,0,0,0,0,0,0,1143,1181,0,0,0,0,0,0,1181,2324
IT-FE,Ferrara,8,1189,0,0,0,0,0,0,1189,1119,0,0,0,0,0,0,1119,2308
IT-FE,Ferrara,9,1254,0,0,0,0,0,0,1254,1215,0,0,0,0,0,0,1215,2469
IT-FE,Ferrara,10,1305,0,0,0,0,0,0,1305,1279,0,0,0,0,0,0,1279,2584
IT-FE,Ferrara,11,1354,0,0,0,0,0,0,1354,1299,0,0,0,0,0,0,1299,2653
IT-FE,Ferrara,12,1414,0,0,0,0,0,0,1414,1348,0,0,0,0,0,0,1348,2762
IT-FE,Ferrara,13,1461,0,0,0,0,0,0,1461,1431,0,0,0,0,0,0,1431,2892
IT-FE,Ferrara,14,1518,0,0,0,0,0,0,1518,1462,0,0,0,0,0,0,1462,2980
IT-FE,Ferrara,15,1526,0,0,0,0,0,0,1526,1407,0,0,0,0,0,0,1407,2933
IT-FE,Ferrara,16,1490,0,0,0,0,0,0,1490,1368,0,0,0,0,0,0,1368,2858
IT-FE,Ferrara,17,1528,0,0,0,0,0,0,1528,1343,0,0,0,0,0,0,1343,2871
IT-FE,Ferrara,18,1528,0,0,0,0,0,0,1528,1339,1,0,0,0,0,0,1340,2868
IT-FE,Ferrara,19,1474,0,0,0,0,0,0,1474,1344,3,0,0,0,0,0,1347,2821
IT-FE,Ferrara,20,1440,1,0,0,0,0,0,1441,1347,8,0,0,1,0,0,1356,2797
IT-FE,Ferrara,21,1474,2,0,0,0,0,0,1476,1384,17,0,0,0,0,0,1401,2877
IT-FE,Ferrara,22,1465,8,1,0,0,0,0,1474,1317,46,0,0,0,0,0,1363,2837
IT-FE,Ferrara,23,1501,16,1,0,0,0,0,1518,1338,51,2,0,0,0,0,1391,2909
IT-FE,Ferrara,24,1569,16,4,0,0,0,0,1589,1292,63,2,0,1,0,0,1358,2947
IT-FE,Ferrara,25,1681,43,3,0,0,0,0,1727,1244,128,4,0,0,0,0,1376,3103
IT-FE,Ferrara,26,1560,40,6,0,1,0,0,1607,1241,154,3,0,2,0,0,1400,3007
IT-FE,Ferrara,27,1548,68,0,0,0,0,0,1616,1243,196,4,1,1,0,0,1445,3061
IT-FE,Ferrara,28,1457,121,0,0,1,0,0,1579,1181,249,7,0,1,0,0,1438,3017
IT-FE,Ferrara,29,1434,145,2,0,1,0,0,1582,1163,304,8,0,0,0,0,1475,3057
IT-FE,Ferrara,30,1412,186,3,0,2,0,0,1603,1073,358,9,2,2,0,0,1444,3047
IT-FE,Ferrara,31,1436,260,3,0,1,0,0,1700,1054,418,10,2,1,0,0,1485,3185
IT-FE,Ferrara,32,1397,284,11,1,6,0,0,1699,1038,484,24,1,3,0,0,1550,3249
IT-FE,Ferrara,33,1307,356,14,1,3,0,0,1681,1001,565,36,3,1,0,0,1606,3287
IT-FE,Ferrara,34,1248,410,19,2,2,0,0,1681,899,634,32,4,2,0,0,1571,3252
IT-FE,Ferrara,35,1157,482,16,1,4,0,0,1660,940,696,45,7,3,0,0,1691,3351
IT-FE,Ferrara,36,1115,515,18,4,4,0,0,1656,828,713,45,4,0,1,0,1591,3247
IT-FE,Ferrara,37,1099,552,28,6,3,0,0,1688,773,759,67,14,3,0,0,1616,3304
IT-FE,Ferrara,38,1116,680,32,0,1,1,0,1830,741,803,58,9,3,0,0,1614,3444
IT-FE,Ferrara,39,1018,718,37,3,4,0,0,1780,764,873,66,15,2,0,0,1720,3500
IT-FE,Ferrara,40,1041,766,46,0,4,0,0,1857,781,953,104,16,2,1,0,1857,3714
IT-FE,Ferrara,41,947,844,49,3,2,0,0,1845,756,960,110,14,2,0,0,1842,3687
IT-FE,Ferrara,42,982,845,67,9,1,1,0,1905,765,991,105,16,4,0,0,1881,3786
IT-FE,Ferrara,43,998,884,63,8,5,0,0,1958,749,1085,110,23,4,0,0,1971,3929
IT-FE,Ferrara,44,1051,964,94,6,2,0,0,2117,792,1158,140,23,0,1,0,2114,4231
IT-FE,Ferrara,45,1151,1040,89,10,3,2,0,2295,842,1266,161,24,2,0,0,2295,4590
IT-FE,Ferrara,46,1151,1157,110,12,5,0,0,2435,902,1292,208,39,0,0,0,2441,4876
IT-FE,Ferrara,47,1188,1249,167,10,2,0,0,2616,866,1443,223,36,3,0,0,2571,5187
IT-FE,Ferrara,48,1146,1319,153,12,4,0,0,2634,887,1503,247,35,1,0,0,2673,5307
IT-FE,Ferrara,49,1194,1490,154,20,1,0,0,2859,903,1622,286,45,0,0,0,2856,5715
IT-FE,Ferrara,50,1130,1505,215,10,5,0,0,2865,841,1613,283,51,5,0,0,2793,5658
IT-FE,Ferrara,51,1158,1549,207,9,6,0,0,2929,818,1719,305,66,6,0,0,2914,5843
IT-FE,Ferrara,52,1054,1566,223,12,7,0,0,2862,783,1707,264,95,3,0,0,2852,5714
IT-FE,Ferrara,53,958,1580,250,17,6,0,0,2811,712,1792,334,74,6,0,0,2918,5729
IT-FE,Ferrara,54,1010,1652,240,21,5,0,0,2928,728,1780,371,116,1,0,0,2996,5924
IT-FE,Ferrara,55,886,1721,244,24,2,0,0,2877,631,1897,339,100,1,0,0,2968,5845
IT-FE,Ferrara,56,802,1678,282,28,4,0,0,2794,558,1798,342,145,3,0,1,2847,5641
IT-FE,Ferrara,57,808,1822,300,29,4,0,0,2963,525,1856,368,130,1,0,0,2880,5843
IT-FE,Ferrara,58,716,1818,281,38,6,0,0,2859,460,1925,361,155,2,0,0,2903,5762
IT-FE,Ferrara,59,617,1830,304,42,7,0,0,2800,476,1953,375,180,4,0,0,2988,5788
IT-FE,Ferrara,60,558,1865,297,29,4,0,0,2753,458,2017,305,165,0,0,0,2945,5698
IT-FE,Ferrara,61,504,1821,263,53,3,0,1,2645,388,1893,317,198,2,0,0,2798,5443
IT-FE,Ferrara,62,416,1755,276,65,6,0,0,2518,342,1920,342,219,1,0,0,2824,5342
IT-FE,Ferrara,63,407,1853,244,54,1,0,0,2559,268,1872,310,286,1,0,0,2737,5296
IT-FE,Ferrara,64,340,1837,247,73,1,0,0,2498,315,1888,277,259,2,0,0,2741,5239
IT-FE,Ferrara,65,316,1774,226,73,3,0,0,2392,243,1677,265,318,0,0,0,2503,4895
IT-FE,Ferrara,66,314,1778,210,84,2,0,0,2388,249,1816,269,321,0,0,0,2655,5043
IT-FE,Ferrara,67,241,1760,207,92,1,0,0,2301,218,1798,258,352,0,0,0,2626,4927
IT-FE,Ferrara,68,240,1663,185,92,2,0,0,2182,195,1640,221,367,1,0,0,2424,4606
IT-FE,Ferrara,69,213,1601,177,116,2,0,0,2109,178,1601,204,437,0,0,0,2420,4529
IT-FE,Ferrara,70,166,1652,138,102,0,0,0,2058,160,1538,196,433,0,0,0,2327,4385
IT-FE,Ferrara,71,153,1593,126,105,1,0,0,1978,136,1526,182,499,0,0,0,2343,4321
IT-FE,Ferrara,72,162,1547,101,139,1,0,0,1950,122,1429,155,521,1,0,0,2228,4178
IT-FE,Ferrara,73,143,1608,138,155,0,0,0,2044,114,1494,152,608,0,0,0,2368,4412
IT-FE,Ferrara,74,122,1553,106,166,0,0,0,1947,101,1434,154,646,0,0,0,2335,4282
IT-FE,Ferrara,75,117,1640,118,173,0,0,0,2048,107,1509,145,726,0,0,0,2487,4535
IT-FE,Ferrara,76,140,1751,88,197,0,1,0,2177,101,1397,112,847,0,0,0,2457,4634
IT-FE,Ferrara,77,124,1637,78,245,2,0,0,2086,108,1372,103,940,0,0,0,2523,4609
IT-FE,Ferrara,78,61,997,47,157,0,0,0,1262,65,798,70,595,0,0,0,1528,2790
IT-FE,Ferrara,79,84,1200,54,213,0,0,0,1551,73,896,66,803,0,0,0,1838,3389
IT-FE,Ferrara,80,78,1085,37,212,0,0,0,1412,82,827,59,868,0,0,0,1836,3248
IT-FE,Ferrara,81,65,954,47,211,0,0,0,1277,95,765,48,861,0,0,0,1769,3046
IT-FE,Ferrara,82,67,942,28,214,0,0,0,1251,81,615,50,949,0,0,0,1695,2946
IT-FE,Ferrara,83,67,974,23,254,0,0,0,1318,83,650,61,1153,0,0,0,1947,3265
IT-FE,Ferrara,84,49,848,31,281,1,0,0,1210,77,540,49,1092,0,0,0,1758,2968
IT-FE,Ferrara,85,45,781,15,251,0,0,0,1092,69,478,43,1122,0,0,0,1712,2804
IT-FE,Ferrara,86,46,639,10,222,0,0,0,917,57,350,32,1051,0,0,0,1490,2407
IT-FE,Ferrara,87,45,464,17,232,0,0,0,758,48,259,33,917,0,0,0,1257,2015
IT-FE,Ferrara,88,36,429,12,225,1,0,0,703,57,189,18,948,0,0,0,1212,1915
IT-FE,Ferrara,89,32,389,7,207,0,0,0,635,48,166,19,873,0,0,0,1106,1741
IT-FE,Ferrara,90,17,283,4,183,0,0,0,487,33,108,12,780,0,0,0,933,1420
IT-FE,Ferrara,91,18,187,2,120,0,0,0,327,20,66,10,672,0,0,0,768,1095
IT-FE,Ferrara,92,17,149,1,145,0,0,0,312,18,53,10,587,0,0,0,668,980
IT-FE,Ferrara,93,9,114,4,122,0,0,0,249,19,31,3,490,0,0,0,543,792
IT-FE,Ferrara,94,7,54,0,88,0,0,0,149,22,11,4,344,0,0,0,381,530
IT-FE,Ferrara,95,3,39,2,50,0,0,0,94,18,11,0,265,0,0,0,294,388
IT-FE,Ferrara,96,4,26,1,32,0,0,0,63,12,7,3,193,0,0,0,215,278
IT-FE,Ferrara,97,1,16,0,25,0,0,0,42,10,1,2,145,0,0,0,158,200
IT-FE,Ferrara,98,1,14,0,30,0,0,0,45,8,2,1,107,0,0,0,118,163
IT-FE,Ferrara,99,1,2,0,15,0,0,0,18,3,1,1,88,0,0,0,93,111
IT-FE,Ferrara,100,0,3,0,20,0,0,0,23,4,0,0,127,0,0,0,131,154
IT-FE,Ferrara,999,78272,73459,7303,5860,145,5,1,165045,65414,74481,10019,24617,84,3,1,174619,339664
IT-FI,Firenze,0,2976,0,0,0,0,0,0,2976,2936,0,0,0,0,0,0,2936,5912
IT-FI,Firenze,1,3273,0,0,0,0,0,0,3273,3022,0,0,0,0,0,0,3022,6295
IT-FI,Firenze,2,3297,0,0,0,0,0,0,3297,3189,0,0,0,0,0,0,3189,6486
IT-FI,Firenze,3,3370,0,0,0,0,0,0,3370,3073,0,0,0,0,0,0,3073,6443
IT-FI,Firenze,4,3392,0,0,0,0,0,0,3392,3223,0,0,0,0,0,0,3223,6615
IT-FI,Firenze,5,3565,0,0,0,0,0,0,3565,3484,0,0,0,0,0,0,3484,7049
IT-FI,Firenze,6,3788,0,0,0,0,0,0,3788,3598,0,0,0,0,0,0,3598,7386
IT-FI,Firenze,7,3874,0,0,0,0,0,0,3874,3713,0,0,0,0,0,0,3713,7587
IT-FI,Firenze,8,4009,0,0,0,0,0,0,4009,3663,0,0,0,0,0,0,3663,7672
IT-FI,Firenze,9,4221,0,0,0,0,0,0,4221,4029,0,0,0,0,0,0,4029,8250
IT-FI,Firenze,10,4260,0,0,0,0,0,0,4260,3991,0,0,0,0,0,0,3991,8251
IT-FI,Firenze,11,4479,0,0,0,0,0,0,4479,4267,0,0,0,0,0,0,4267,8746
IT-FI,Firenze,12,4495,0,0,0,0,0,0,4495,4206,0,0,0,0,0,0,4206,8701
IT-FI,Firenze,13,4706,0,0,0,0,0,0,4706,4358,0,0,0,0,0,0,4358,9064
IT-FI,Firenze,14,4679,0,0,0,0,0,0,4679,4504,0,0,0,0,0,0,4504,9183
IT-FI,Firenze,15,5015,0,0,0,0,0,0,5015,4413,0,0,0,0,0,0,4413,9428
IT-FI,Firenze,16,4893,0,0,0,0,0,0,4893,4424,0,0,0,0,0,0,4424,9317
IT-FI,Firenze,17,4875,0,0,0,0,0,0,4875,4507,0,1,0,0,0,0,4508,9383
IT-FI,Firenze,18,4946,0,0,0,0,0,0,4946,4632,2,0,0,0,0,0,4634,9580
IT-FI,Firenze,19,5181,0,0,0,0,0,0,5181,4526,9,0,0,0,0,0,4535,9716
IT-FI,Firenze,20,5039,0,0,0,0,0,0,5039,4446,23,0,0,0,0,0,4469,9508
IT-FI,Firenze,21,4939,5,0,0,1,0,0,4945,4544,51,0,0,0,0,0,4595,9540
IT-FI,Firenze,22,4886,10,2,0,0,0,0,4898,4453,66,2,0,0,0,0,4521,9419
IT-FI,Firenze,23,5139,19,2,0,1,0,0,5161,4433,118,4,0,0,0,0,4555,9716
IT-FI,Firenze,24,4941,40,4,0,1,0,0,4986,4251,173,4,0,0,0,0,4428,9414
IT-FI,Firenze,25,5065,87,8,0,0,0,0,5160,4293,254,7,0,0,0,0,4554,9714
IT-FI,Firenze,26,5005,123,7,0,1,0,0,5136,4294,324,7,0,1,0,0,4626,9762
IT-FI,Firenze,27,4750,169,9,1,1,0,0,4930,4155,438,6,1,2,1,0,4603,9533
IT-FI,Firenze,28,4636,266,8,0,5,0,0,4915,4138,628,13,1,4,0,0,4784,9699
IT-FI,Firenze,29,4554,366,17,0,1,1,0,4939,3959,801,23,0,2,0,0,4785,9724
IT-FI,Firenze,30,4506,466,20,0,9,0,0,5001,3777,940,34,2,14,2,0,4769,9770
IT-FI,Firenze,31,4484,682,12,0,4,1,0,5183,3884,1272,30,3,8,1,0,5198,10381
IT-FI,Firenze,32,4262,813,24,1,11,0,0,5111,3695,1417,65,3,10,1,0,5191,10302
IT-FI,Firenze,33,4324,1075,36,2,9,0,0,5446,3493,1678,57,4,11,0,0,5243,10689
IT-FI,Firenze,34,4003,1229,32,4,9,0,0,5277,3426,1958,80,8,7,0,0,5479,10756
IT-FI,Firenze,35,3860,1613,55,3,9,0,0,5540,3234,2199,86,8,12,1,0,5540,11080
IT-FI,Firenze,36,3618,1738,56,4,10,1,0,5427,2955,2224,110,17,17,0,0,5323,10750
IT-FI,Firenze,37,3299,1786,63,5,14,0,0,5167,2822,2440,166,26,15,2,0,5471,10638
IT-FI,Firenze,38,3367,2035,90,2,16,1,0,5511,2739,2664,174,33,11,2,0,5623,11134
IT-FI,Firenze,39,3124,2247,100,8,13,0,0,5492,2740,2801,215,22,9,1,0,5788,11280
IT-FI,Firenze,40,3152,2411,133,7,14,1,0,5718,2667,3014,222,29,17,0,0,5949,11667
IT-FI,Firenze,41,3081,2642,126,11,15,0,0,5875,2525,3040,241,28,13,0,0,5847,11722
IT-FI,Firenze,42,2995,2775,171,14,14,2,0,5971,2461,3241,263,45,14,1,0,6025,11996
IT-FI,Firenze,43,2831,2835,197,18,16,1,0,5898,2450,3298,297,49,6,0,0,6100,11998
IT-FI,Firenze,44,2805,3099,212,23,18,0,0,6157,2476,3476,332,83,11,0,0,6378,12535
IT-FI,Firenze,45,2914,3315,226,21,12,1,0,6489,2560,3764,426,89,13,1,0,6853,13342
IT-FI,Firenze,46,2858,3609,269,27,9,0,1,6773,2473,3972,455,77,11,0,0,6988,13761
IT-FI,Firenze,47,3003,3644,313,32,12,0,0,7004,2493,4312,500,94,12,2,0,7413,14417
IT-FI,Firenze,48,3120,3897,374,24,17,0,0,7432,2491,4536,573,105,14,0,0,7719,15151
IT-FI,Firenze,49,3105,4332,420,33,20,1,0,7911,2533,5077,631,108,11,0,0,8360,16271
IT-FI,Firenze,50,2913,4426,442,29,13,1,0,7824,2597,5038,663,152,11,0,1,8462,16286
IT-FI,Firenze,51,2654,4774,474,42,21,1,0,7966,2307,5146,759,149,13,0,0,8374,16340
IT-FI,Firenze,52,2580,4882,527,43,7,1,0,8040,2229,5352,785,197,7,2,0,8572,16612
IT-FI,Firenze,53,2476,4903,540,56,18,1,0,7994,2005,5219,793,198,3,0,0,8218,16212
IT-FI,Firenze,54,2331,5079,605,61,21,1,1,8099,2006,5383,832,191,8,0,0,8420,16519
IT-FI,Firenze,55,2145,5142,609,58,18,1,0,7973,1900,5350,841,236,8,0,0,8335,16308
IT-FI,Firenze,56,2020,5221,649,74,14,1,0,7979,1730,5631,865,292,3,1,1,8523,16502
IT-FI,Firenze,57,1968,5428,664,88,19,0,0,8167,1636,5615,881,308,7,0,0,8447,16614
IT-FI,Firenze,58,1741,5483,653,93,14,0,0,7984,1549,5717,904,300,4,0,0,8474,16458
IT-FI,Firenze,59,1625,5508,648,103,18,0,0,7902,1453,5588,907,350,2,1,1,8302,16204
IT-FI,Firenze,60,1384,5167,589,102,13,2,0,7257,1292,5210,845,367,4,0,0,7718,14975
IT-FI,Firenze,61,1203,5023,659,99,25,0,0,7009,1118,5096,772,430,2,0,0,7418,14427
IT-FI,Firenze,62,1144,4855,590,132,13,0,0,6734,1064,4795,734,484,10,0,0,7087,13821
IT-FI,Firenze,63,962,4891,571,137,12,0,0,6573,969,4877,749,475,6,0,0,7076,13649
IT-FI,Firenze,64,863,4773,558,145,12,0,2,6353,913,4745,714,539,4,0,0,6915,13268
IT-FI,Firenze,65,756,4582,454,161,12,0,1,5966,826,4483,649,597,4,0,1,6560,12526
IT-FI,Firenze,66,679,4455,449,171,9,0,0,5763,757,4354,624,636,4,0,0,6375,12138
IT-FI,Firenze,67,645,4200,394,199,14,0,1,5453,692,4287,589,715,2,0,1,6286,11739
IT-FI,Firenze,68,608,4207,374,217,11,0,0,5417,649,4120,556,819,2,0,0,6146,11563
IT-FI,Firenze,69,518,4199,392,212,8,0,1,5330,594,4207,511,854,1,0,1,6168,11498
IT-FI,Firenze,70,502,3995,312,234,7,0,0,5050,530,3817,459,871,1,0,0,5678,10728
IT-FI,Firenze,71,443,3910,293,232,10,0,0,4888,457,3882,416,970,3,0,0,5728,10616
IT-FI,Firenze,72,406,3969,279,276,3,0,0,4933,400,3819,427,1072,2,0,0,5720,10653
IT-FI,Firenze,73,390,4003,276,297,2,0,0,4968,410,3844,405,1216,3,0,0,5878,10846
IT-FI,Firenze,74,373,4171,253,347,8,0,0,5152,404,3959,381,1452,0,0,0,6196,11348
IT-FI,Firenze,75,352,4420,258,381,4,0,0,5415,391,4022,389,1697,1,1,0,6501,11916
IT-FI,Firenze,76,330,4286,229,449,4,0,0,5298,364,3916,371,1866,1,0,0,6518,11816
IT-FI,Firenze,77,311,4223,192,523,7,0,1,5257,368,3683,355,2003,0,0,0,6409,11666
IT-FI,Firenze,78,236,3178,157,429,2,0,0,4002,273,2810,256,1741,0,0,0,5080,9082
IT-FI,Firenze,79,207,3141,129,478,4,0,0,3959,288,2538,218,1841,0,0,0,4885,8844
IT-FI,Firenze,80,207,3032,97,484,3,0,0,3823,262,2487,214,2048,0,0,0,5011,8834
IT-FI,Firenze,81,199,2674,108,470,4,0,0,3455,283,2060,188,2098,0,0,0,4629,8084
IT-FI,Firenze,82,227,2607,102,501,2,0,0,3439,254,2139,179,2282,0,0,0,4854,8293
IT-FI,Firenze,83,200,2817,87,626,1,0,1,3732,288,2032,168,2720,0,0,0,5208,8940
IT-FI,Firenze,84,202,2576,74,675,1,0,0,3528,241,1807,165,2797,0,0,0,5010,8538
IT-FI,Firenze,85,159,2314,66,673,1,0,0,3213,265,1487,119,2827,0,0,0,4698,7911
IT-FI,Firenze,86,136,1802,68,615,0,0,0,2621,241,1100,104,2637,0,0,0,4082,6703
IT-FI,Firenze,87,101,1416,31,538,0,0,0,2086,207,823,81,2418,0,0,0,3529,5615
IT-FI,Firenze,88,101,1383,34,502,0,0,0,2020,194,706,71,2317,0,0,0,3288,5308
IT-FI,Firenze,89,62,1034,32,452,0,0,0,1580,172,514,53,2154,0,0,0,2893,4473
IT-FI,Firenze,90,70,861,13,427,1,0,0,1372,124,366,26,1962,0,0,0,2478,3850
IT-FI,Firenze,91,56,612,8,388,0,0,0,1064,148,237,41,1739,0,0,0,2165,3229
IT-FI,Firenze,92,43,509,12,308,1,0,0,873,111,173,29,1543,0,0,0,1856,2729
IT-FI,Firenze,93,39,349,7,264,1,0,0,660,102,125,32,1332,0,0,0,1591,2251
IT-FI,Firenze,94,24,251,7,218,0,0,0,500,88,76,16,1092,0,0,0,1272,1772
IT-FI,Firenze,95,15,167,3,179,0,0,0,364,72,50,15,848,0,0,0,985,1349
IT-FI,Firenze,96,13,114,1,127,0,0,0,255,63,29,9,661,1,0,0,763,1018
IT-FI,Firenze,97,6,50,0,91,0,0,0,147,41,13,6,456,0,0,0,516,663
IT-FI,Firenze,98,7,23,1,61,0,0,0,92,31,10,5,324,0,0,0,370,462
IT-FI,Firenze,99,4,16,1,42,0,0,0,63,25,6,3,226,0,0,0,260,323
IT-FI,Firenze,100,4,23,1,67,0,0,0,95,31,7,3,397,0,0,0,438,533
IT-FI,Firenze,999,237599,208452,16958,13816,620,19,9,477473,214032,212960,25201,58731,362,20,6,511312,988785
IT-FG,Foggia,0,2188,0,0,0,0,0,0,2188,2046,0,0,0,0,0,0,2046,4234
IT-FG,Foggia,1,2207,0,0,0,0,0,0,2207,1970,0,0,0,0,0,0,1970,4177
IT-FG,Foggia,2,2175,0,0,0,0,0,0,2175,2019,0,0,0,0,0,0,2019,4194
IT-FG,Foggia,3,2301,0,0,0,0,0,0,2301,2079,0,0,0,0,0,0,2079,4380
IT-FG,Foggia,4,2323,0,0,0,0,0,0,2323,2179,0,0,0,0,0,0,2179,4502
IT-FG,Foggia,5,2389,0,0,0,0,0,0,2389,2172,0,0,0,0,0,0,2172,4561
IT-FG,Foggia,6,2442,0,0,0,0,0,0,2442,2389,0,0,0,0,0,0,2389,4831
IT-FG,Foggia,7,2638,0,0,0,0,0,0,2638,2374,0,0,0,0,0,0,2374,5012
IT-FG,Foggia,8,2651,0,0,0,0,0,0,2651,2521,0,0,0,0,0,0,2521,5172
IT-FG,Foggia,9,2771,0,0,0,0,0,0,2771,2544,0,0,0,0,0,0,2544,5315
IT-FG,Foggia,10,2770,0,0,0,0,0,0,2770,2595,0,0,0,0,0,0,2595,5365
IT-FG,Foggia,11,2792,0,0,0,0,0,0,2792,2654,0,0,0,0,0,0,2654,5446
IT-FG,Foggia,12,2879,0,0,0,0,0,0,2879,2754,0,0,0,0,0,0,2754,5633
IT-FG,Foggia,13,3060,0,0,0,0,0,0,3060,2849,0,0,0,0,0,0,2849,5909
IT-FG,Foggia,14,3138,0,0,0,0,0,0,3138,3011,0,0,0,0,0,0,3011,6149
IT-FG,Foggia,15,3233,0,0,0,0,0,0,3233,2957,0,0,0,0,0,0,2957,6190
IT-FG,Foggia,16,3185,0,0,0,0,0,0,3185,2957,0,0,0,0,0,0,2957,6142
IT-FG,Foggia,17,3230,0,0,0,0,0,0,3230,3048,0,1,0,0,0,0,3049,6279
IT-FG,Foggia,18,3347,0,0,0,0,0,0,3347,3154,3,0,0,0,0,0,3157,6504
IT-FG,Foggia,19,3577,1,1,0,0,0,0,3579,3234,6,0,0,0,0,0,3240,6819
IT-FG,Foggia,20,3398,0,0,0,0,0,0,3398,3266,16,0,0,0,0,0,3282,6680
IT-FG,Foggia,21,3418,3,0,0,0,0,0,3421,3261,25,0,0,0,0,0,3286,6707
IT-FG,Foggia,22,3513,14,0,0,0,0,0,3527,3180,56,0,0,1,0,0,3237,6764
IT-FG,Foggia,23,3591,17,0,0,0,0,0,3608,3271,88,0,0,0,0,0,3359,6967
IT-FG,Foggia,24,3747,33,3,0,0,0,0,3783,3150,120,1,2,0,0,0,3273,7056
IT-FG,Foggia,25,3768,65,6,0,0,0,0,3839,3071,216,1,1,1,0,0,3290,7129
IT-FG,Foggia,26,3522,109,3,0,0,0,0,3634,2870,324,3,0,0,0,0,3197,6831
IT-FG,Foggia,27,3313,151,5,0,0,0,0,3469,2656,471,8,0,1,0,0,3136,6605
IT-FG,Foggia,28,3184,260,8,0,2,0,0,3454,2371,575,4,0,0,1,0,2951,6405
IT-FG,Foggia,29,3092,375,8,0,0,0,0,3475,2220,763,11,2,0,0,0,2996,6471
IT-FG,Foggia,30,3022,518,7,0,0,0,0,3547,2057,941,25,3,1,1,0,3028,6575
IT-FG,Foggia,31,2927,696,13,1,2,0,0,3639,2011,1210,23,1,1,0,0,3246,6885
IT-FG,Foggia,32,2714,858,11,0,2,0,0,3585,1813,1316,21,5,1,0,0,3156,6741
IT-FG,Foggia,33,2557,1107,24,2,1,0,0,3691,1661,1547,36,7,0,0,0,3251,6942
IT-FG,Foggia,34,2295,1150,25,3,1,0,0,3474,1552,1696,51,7,0,0,0,3306,6780
IT-FG,Foggia,35,2188,1324,27,1,0,0,0,3540,1407,1796,52,7,0,0,0,3262,6802
IT-FG,Foggia,36,1984,1553,36,3,0,0,0,3576,1249,1943,68,9,0,1,0,3270,6846
IT-FG,Foggia,37,1987,1569,38,6,2,0,0,3602,1126,1957,97,14,1,0,0,3195,6797
IT-FG,Foggia,38,1640,1679,62,1,1,0,0,3383,1040,2065,102,14,0,0,0,3221,6604
IT-FG,Foggia,39,1536,1796,58,5,2,0,0,3397,1034,2228,107,20,1,0,0,3390,6787
IT-FG,Foggia,40,1547,1901,65,9,2,0,0,3524,928,2312,126,22,1,0,0,3389,6913
IT-FG,Foggia,41,1483,2113,90,3,4,0,0,3693,904,2485,153,32,1,0,0,3575,7268
IT-FG,Foggia,42,1374,2192,98,9,2,0,0,3675,871,2612,140,42,2,0,0,3667,7342
IT-FG,Foggia,43,1319,2405,117,13,3,0,0,3857,763,2670,170,44,0,0,0,3647,7504
IT-FG,Foggia,44,1342,2443,118,19,1,0,1,3924,811,2779,186,46,0,0,0,3822,7746
IT-FG,Foggia,45,1315,2541,121,13,1,0,0,3991,715,3009,213,56,2,0,0,3995,7986
IT-FG,Foggia,46,1195,2832,149,20,2,0,0,4198,740,3122,197,57,1,0,0,4117,8315
IT-FG,Foggia,47,1228,2903,155,17,2,0,0,4305,717,3216,193,67,0,0,0,4193,8498
IT-FG,Foggia,48,1179,3059,168,25,1,0,0,4432,723,3257,220,93,1,0,0,4294,8726
IT-FG,Foggia,49,1068,3134,180,38,3,0,0,4423,638,3549,230,109,0,0,0,4526,8949
IT-FG,Foggia,50,1023,3093,169,23,1,0,0,4309,658,3420,247,119,0,0,0,4444,8753
IT-FG,Foggia,51,909,3203,174,24,0,0,0,4310,628,3432,231,127,1,0,0,4419,8729
IT-FG,Foggia,52,872,3333,220,28,3,0,0,4456,613,3583,250,152,1,0,0,4599,9055
IT-FG,Foggia,53,829,3291,203,33,0,0,0,4356,570,3513,258,172,0,0,0,4513,8869
IT-FG,Foggia,54,808,3540,190,40,3,0,0,4581,605,3620,252,191,3,0,0,4671,9252
IT-FG,Foggia,55,739,3555,176,35,2,0,0,4507,547,3703,226,223,1,1,0,4701,9208
IT-FG,Foggia,56,685,3688,204,50,2,0,0,4629,558,3801,262,240,0,0,0,4861,9490
IT-FG,Foggia,57,652,3673,250,67,0,0,0,4642,543,3651,244,267,0,0,0,4705,9347
IT-FG,Foggia,58,549,3757,194,77,1,0,0,4578,501,3750,215,288,0,0,0,4754,9332
IT-FG,Foggia,59,569,3794,202,77,2,0,0,4644,522,3833,253,338,0,0,0,4946,9590
IT-FG,Foggia,60,459,3493,203,80,2,0,0,4237,471,3599,197,354,0,0,0,4621,8858
IT-FG,Foggia,61,451,3454,175,81,0,0,0,4161,412,3471,198,357,0,0,0,4438,8599
IT-FG,Foggia,62,385,3361,150,75,0,0,0,3971,420,3213,186,370,0,0,0,4189,8160
IT-FG,Foggia,63,376,3358,154,107,1,0,0,3996,382,3210,175,467,0,0,0,4234,8230
IT-FG,Foggia,64,353,3172,148,114,0,0,0,3787,394,3088,164,461,0,0,0,4107,7894
IT-FG,Foggia,65,302,3095,114,116,0,0,0,3627,309,3041,167,521,0,0,0,4038,7665
IT-FG,Foggia,66,284,2972,112,124,0,0,0,3492,341,2838,148,577,0,0,0,3904,7396
IT-FG,Foggia,67,261,3035,93,125,0,0,0,3514,328,2783,163,618,0,0,0,3892,7406
IT-FG,Foggia,68,227,3019,106,144,1,0,0,3497,302,2651,137,680,0,0,0,3770,7267
IT-FG,Foggia,69,236,3006,105,146,1,0,0,3494,280,2608,110,671,0,0,0,3669,7163
IT-FG,Foggia,70,179,2673,101,182,0,0,0,3135,272,2386,95,702,0,0,0,3455,6590
IT-FG,Foggia,71,179,2595,75,183,0,0,0,3032,260,2180,95,777,0,0,0,3312,6344
IT-FG,Foggia,72,135,2545,67,181,0,0,0,2928,237,2159,109,797,1,0,0,3303,6231
IT-FG,Foggia,73,161,2517,79,194,1,0,0,2952,258,2200,85,885,0,0,0,3428,6380
IT-FG,Foggia,74,124,2727,59,207,0,0,0,3117,246,2158,84,956,0,0,0,3444,6561
IT-FG,Foggia,75,133,2687,67,251,0,0,0,3138,250,2193,76,1242,0,0,0,3761,6899
IT-FG,Foggia,76,131,2465,44,235,0,0,0,2875,253,1826,55,1098,0,0,0,3232,6107
IT-FG,Foggia,77,92,2276,42,283,0,0,0,2693,196,1735,74,1313,0,0,0,3318,6011
IT-FG,Foggia,78,85,1845,43,254,0,0,0,2227,190,1397,57,1078,0,0,0,2722,4949
IT-FG,Foggia,79,63,1610,30,244,0,0,0,1947,162,1192,37,1027,0,0,0,2418,4365
IT-FG,Foggia,80,53,1443,18,237,0,0,0,1751,188,1000,32,1037,0,0,0,2257,4008
IT-FG,Foggia,81,66,1490,23,297,0,0,0,1876,154,933,29,1155,0,0,0,2271,4147
IT-FG,Foggia,82,50,1306,17,270,0,0,0,1643,144,811,26,1162,0,0,0,2143,3786
IT-FG,Foggia,83,51,1287,14,301,0,0,0,1653,157,735,32,1426,0,0,0,2350,4003
IT-FG,Foggia,84,53,1220,17,360,0,0,0,1650,184,636,32,1390,0,0,0,2242,3892
IT-FG,Foggia,85,43,1046,12,313,0,0,0,1414,156,530,13,1330,0,0,0,2029,3443
IT-FG,Foggia,86,25,846,10,276,0,0,0,1157,122,453,17,1289,0,0,0,1881,3038
IT-FG,Foggia,87,30,653,9,308,0,0,0,1000,133,272,17,1209,0,0,0,1631,2631
IT-FG,Foggia,88,25,574,3,262,0,0,0,864,101,258,17,1096,0,0,0,1472,2336
IT-FG,Foggia,89,18,443,3,274,0,0,0,738,103,177,11,1033,0,0,0,1324,2062
IT-FG,Foggia,90,21,347,4,217,0,0,0,589,87,140,7,899,0,0,0,1133,1722
IT-FG,Foggia,91,15,248,1,211,0,0,0,475,76,107,7,763,0,0,0,953,1428
IT-FG,Foggia,92,7,173,3,164,0,0,0,347,46,61,9,623,0,0,0,739,1086
IT-FG,Foggia,93,7,138,1,143,0,0,0,289,51,38,3,577,0,0,0,669,958
IT-FG,Foggia,94,1,105,1,101,0,0,0,208,40,27,0,404,0,0,0,471,679
IT-FG,Foggia,95,1,46,2,105,0,0,0,154,33,14,6,338,0,0,0,391,545
IT-FG,Foggia,96,2,33,0,52,0,0,0,87,29,13,1,257,0,0,0,300,387
IT-FG,Foggia,97,3,19,0,42,0,0,0,64,15,9,1,177,0,0,0,202,266
IT-FG,Foggia,98,1,10,0,34,0,0,0,45,18,3,1,118,0,0,0,140,185
IT-FG,Foggia,99,1,8,0,30,0,0,0,39,7,4,0,99,0,0,0,110,149
IT-FG,Foggia,100,2,10,0,21,0,0,0,33,15,4,0,140,0,0,0,159,192
IT-FG,Foggia,999,138468,141078,5683,7986,54,0,1,293270,117149,140832,7550,34250,23,4,0,299808,593078
IT-FC,Forlì-Cesena,0,1287,0,0,0,0,0,0,1287,1226,0,0,0,0,0,0,1226,2513
IT-FC,Forlì-Cesena,1,1363,0,0,0,0,0,0,1363,1314,0,0,0,0,0,0,1314,2677
IT-FC,Forlì-Cesena,2,1311,0,0,0,0,0,0,1311,1272,0,0,0,0,0,0,1272,2583
IT-FC,Forlì-Cesena,3,1370,0,0,0,0,0,0,1370,1281,0,0,0,0,0,0,1281,2651
IT-FC,Forlì-Cesena,4,1392,0,0,0,0,0,0,1392,1328,0,0,0,0,0,0,1328,2720
IT-FC,Forlì-Cesena,5,1529,0,0,0,0,0,0,1529,1382,0,0,0,0,0,0,1382,2911
IT-FC,Forlì-Cesena,6,1620,0,0,0,0,0,0,1620,1432,0,0,0,0,0,0,1432,3052
IT-FC,Forlì-Cesena,7,1649,0,0,0,0,0,0,1649,1556,0,0,0,0,0,0,1556,3205
IT-FC,Forlì-Cesena,8,1691,0,0,0,0,0,0,1691,1565,0,0,0,0,0,0,1565,3256
IT-FC,Forlì-Cesena,9,1753,0,0,0,0,0,0,1753,1631,0,0,0,0,0,0,1631,3384
IT-FC,Forlì-Cesena,10,1775,0,0,0,0,0,0,1775,1769,0,0,0,0,0,0,1769,3544
IT-FC,Forlì-Cesena,11,1831,0,0,0,0,0,0,1831,1763,0,0,0,0,0,0,1763,3594
IT-FC,Forlì-Cesena,12,1988,0,0,0,0,0,0,1988,1782,0,0,0,0,0,0,1782,3770
IT-FC,Forlì-Cesena,13,2011,0,0,0,0,0,0,2011,1778,0,0,0,0,0,0,1778,3789
IT-FC,Forlì-Cesena,14,1977,0,0,0,0,0,0,1977,1813,0,0,0,0,0,0,1813,3790
IT-FC,Forlì-Cesena,15,1994,0,0,0,0,0,0,1994,1850,0,0,0,0,0,0,1850,3844
IT-FC,Forlì-Cesena,16,1997,0,0,0,0,0,0,1997,1865,0,0,0,0,0,0,1865,3862
IT-FC,Forlì-Cesena,17,1949,0,0,0,0,0,0,1949,1912,0,0,0,0,0,0,1912,3861
IT-FC,Forlì-Cesena,18,1965,0,0,0,0,0,0,1965,1771,0,0,0,0,0,0,1771,3736
IT-FC,Forlì-Cesena,19,1990,0,0,0,0,0,0,1990,1832,5,0,0,0,0,0,1837,3827
IT-FC,Forlì-Cesena,20,1945,3,0,0,0,0,0,1948,1760,16,0,0,0,0,0,1776,3724
IT-FC,Forlì-Cesena,21,1982,3,0,0,0,0,0,1985,1754,30,0,0,0,0,0,1784,3769
IT-FC,Forlì-Cesena,22,1965,7,3,0,0,0,0,1975,1698,53,0,0,0,0,0,1751,3726
IT-FC,Forlì-Cesena,23,2066,17,3,0,0,0,0,2086,1682,100,4,0,0,0,0,1786,3872
IT-FC,Forlì-Cesena,24,1944,26,3,1,1,0,0,1975,1614,127,7,0,0,0,0,1748,3723
IT-FC,Forlì-Cesena,25,1998,70,6,0,0,0,0,2074,1606,175,2,0,2,0,0,1785,3859
IT-FC,Forlì-Cesena,26,1918,67,7,0,0,0,0,1992,1565,230,4,0,0,1,0,1800,3792
IT-FC,Forlì-Cesena,27,1867,126,4,0,0,0,0,1997,1540,311,1,1,1,0,0,1854,3851
IT-FC,Forlì-Cesena,28,1783,165,1,0,3,1,0,1953,1438,373,11,0,0,0,0,1822,3775
IT-FC,Forlì-Cesena,29,1799,237,5,0,2,0,0,2043,1421,427,13,0,1,0,0,1862,3905
IT-FC,Forlì-Cesena,30,1708,278,10,0,0,0,0,1996,1246,505,16,0,1,0,0,1768,3764
IT-FC,Forlì-Cesena,31,1659,394,9,1,0,0,0,2063,1352,605,19,3,2,0,0,1981,4044
IT-FC,Forlì-Cesena,32,1612,484,14,2,2,0,0,2114,1243,736,20,7,2,0,0,2008,4122
IT-FC,Forlì-Cesena,33,1525,561,14,1,1,0,0,2102,1236,771,43,5,0,0,0,2055,4157
IT-FC,Forlì-Cesena,34,1452,628,21,5,2,0,0,2108,1164,874,31,7,2,0,0,2078,4186
IT-FC,Forlì-Cesena,35,1407,680,22,0,2,0,0,2111,1005,938,41,4,2,0,0,1990,4101
IT-FC,Forlì-Cesena,36,1300,723,29,0,4,0,0,2056,1029,1010,66,4,2,1,0,2112,4168
IT-FC,Forlì-Cesena,37,1282,835,49,4,4,0,0,2174,899,1079,73,12,2,0,0,2065,4239
IT-FC,Forlì-Cesena,38,1282,905,28,1,6,0,0,2222,1026,1141,93,14,2,1,0,2277,4499
IT-FC,Forlì-Cesena,39,1138,971,48,4,2,0,0,2163,920,1186,102,10,2,0,0,2220,4383
IT-FC,Forlì-Cesena,40,1171,983,51,5,3,0,0,2213,903,1216,101,15,3,0,0,2238,4451
IT-FC,Forlì-Cesena,41,1115,1125,58,1,6,0,0,2305,943,1326,115,10,6,0,0,2400,4705
IT-FC,Forlì-Cesena,42,1186,1187,74,4,4,0,0,2455,927,1362,139,20,0,1,0,2449,4904
IT-FC,Forlì-Cesena,43,1120,1199,75,7,3,0,0,2404,912,1457,126,20,1,0,0,2516,4920
IT-FC,Forlì-Cesena,44,1147,1358,93,5,1,0,0,2604,955,1495,164,27,3,0,0,2644,5248
IT-FC,Forlì-Cesena,45,1231,1423,100,13,5,0,0,2772,1018,1571,185,37,3,0,0,2814,5586
IT-FC,Forlì-Cesena,46,1255,1537,114,10,3,0,0,2919,946,1691,189,40,1,0,0,2867,5786
IT-FC,Forlì-Cesena,47,1220,1594,129,13,5,0,0,2961,960,1793,234,45,2,1,0,3035,5996
IT-FC,Forlì-Cesena,48,1255,1729,145,13,4,0,0,3146,985,1922,282,44,0,1,0,3234,6380
IT-FC,Forlì-Cesena,49,1329,1820,223,11,4,0,0,3387,974,2039,295,62,4,0,0,3374,6761
IT-FC,Forlì-Cesena,50,1164,1887,193,13,4,0,0,3261,849,2080,306,61,2,0,0,3298,6559
IT-FC,Forlì-Cesena,51,1062,1957,222,15,8,0,0,3264,837,2042,334,73,2,0,0,3288,6552
IT-FC,Forlì-Cesena,52,1060,1895,251,20,4,0,0,3230,759,2107,353,94,2,0,0,3315,6545
IT-FC,Forlì-Cesena,53,1021,2018,259,19,7,0,0,3324,665,2078,349,84,2,0,0,3178,6502
IT-FC,Forlì-Cesena,54,910,1993,249,20,4,0,0,3176,683,2125,392,97,0,0,0,3297,6473
IT-FC,Forlì-Cesena,55,821,2074,227,21,9,0,0,3152,644,2170,383,102,5,0,0,3304,6456
IT-FC,Forlì-Cesena,56,770,2066,269,33,3,0,0,3141,584,2113,341,114,1,0,0,3153,6294
IT-FC,Forlì-Cesena,57,770,2117,283,24,3,0,0,3197,527,2132,370,142,2,0,0,3173,6370
IT-FC,Forlì-Cesena,58,669,2156,272,36,6,0,0,3139,518,2176,366,156,1,0,0,3217,6356
IT-FC,Forlì-Cesena,59,669,2175,286,26,4,0,0,3160,508,2200,342,154,1,0,0,3205,6365
IT-FC,Forlì-Cesena,60,518,2090,262,39,1,0,0,2910,458,2148,326,181,0,0,0,3113,6023
IT-FC,Forlì-Cesena,61,478,2055,231,50,4,0,0,2818,385,2064,308,168,2,0,0,2927,5745
IT-FC,Forlì-Cesena,62,431,2026,272,50,6,0,0,2785,352,2035,305,245,2,0,0,2939,5724
IT-FC,Forlì-Cesena,63,382,1957,219,74,3,0,0,2635,323,2023,287,243,0,0,0,2876,5511
IT-FC,Forlì-Cesena,64,346,1911,225,72,4,0,1,2559,300,1927,292,265,0,0,0,2784,5343
IT-FC,Forlì-Cesena,65,313,1818,192,73,2,0,0,2398,268,1829,269,315,0,0,0,2681,5079
IT-FC,Forlì-Cesena,66,279,1824,204,69,5,0,0,2381,254,1790,237,288,0,0,0,2569,4950
IT-FC,Forlì-Cesena,67,236,1860,187,81,5,0,0,2369,229,1748,218,355,0,0,0,2550,4919
IT-FC,Forlì-Cesena,68,234,1759,161,81,1,0,0,2236,227,1707,219,362,0,0,0,2515,4751
IT-FC,Forlì-Cesena,69,204,1668,150,84,2,0,0,2108,183,1569,168,384,0,0,0,2304,4412
IT-FC,Forlì-Cesena,70,183,1644,118,105,2,0,0,2052,181,1553,186,414,1,0,0,2335,4387
IT-FC,Forlì-Cesena,71,208,1572,95,115,1,0,2,1993,152,1582,150,480,1,0,0,2365,4358
IT-FC,Forlì-Cesena,72,146,1598,112,138,1,0,1,1996,151,1527,161,461,0,0,0,2300,4296
IT-FC,Forlì-Cesena,73,174,1631,116,115,0,0,0,2036,139,1481,130,538,0,0,0,2288,4324
IT-FC,Forlì-Cesena,74,177,1645,102,156,0,1,0,2081,125,1440,141,590,1,0,0,2297,4378
IT-FC,Forlì-Cesena,75,156,1640,86,154,0,0,0,2036,117,1490,114,661,0,0,0,2382,4418
IT-FC,Forlì-Cesena,76,141,1633,90,168,0,0,0,2032,138,1340,112,709,0,0,0,2299,4331
IT-FC,Forlì-Cesena,77,126,1566,99,201,1,0,0,1993,113,1321,89,776,2,0,0,2301,4294
IT-FC,Forlì-Cesena,78,107,1208,61,163,0,0,0,1539,88,1000,72,653,0,0,0,1813,3352
IT-FC,Forlì-Cesena,79,97,1234,43,166,0,0,0,1540,87,1020,70,738,0,0,0,1915,3455
IT-FC,Forlì-Cesena,80,120,1128,46,195,1,0,0,1490,82,842,71,789,0,0,0,1784,3274
IT-FC,Forlì-Cesena,81,90,1065,40,202,0,0,0,1397,68,756,58,856,0,0,0,1738,3135
IT-FC,Forlì-Cesena,82,102,1035,42,219,0,0,0,1398,92,727,35,893,0,0,0,1747,3145
IT-FC,Forlì-Cesena,83,105,990,35,227,0,0,0,1357,103,702,44,1022,0,0,0,1871,3228
IT-FC,Forlì-Cesena,84,83,917,28,219,0,0,0,1247,83,649,51,1045,0,0,0,1828,3075
IT-FC,Forlì-Cesena,85,97,894,17,263,0,0,0,1271,81,489,46,1097,0,0,0,1713,2984
IT-FC,Forlì-Cesena,86,76,712,15,223,0,0,0,1026,78,337,23,998,0,0,0,1436,2462
IT-FC,Forlì-Cesena,87,60,553,18,197,0,0,0,828,63,248,22,896,0,0,0,1229,2057
IT-FC,Forlì-Cesena,88,59,500,11,244,0,0,0,814,53,187,17,951,0,0,0,1208,2022
IT-FC,Forlì-Cesena,89,40,387,9,202,0,0,0,638,46,141,14,812,0,0,0,1013,1651
IT-FC,Forlì-Cesena,90,23,313,7,168,0,0,0,511,49,116,7,763,0,0,0,935,1446
IT-FC,Forlì-Cesena,91,14,215,4,156,0,0,0,389,31,59,10,619,0,0,0,719,1108
IT-FC,Forlì-Cesena,92,14,158,3,105,0,0,0,280,41,41,10,527,0,0,0,619,899
IT-FC,Forlì-Cesena,93,12,110,1,95,0,0,0,218,28,42,8,476,0,0,0,554,772
IT-FC,Forlì-Cesena,94,12,72,2,81,0,0,0,167,24,17,3,413,0,0,0,457,624
IT-FC,Forlì-Cesena,95,6,43,1,58,0,0,0,108,25,10,5,304,0,0,0,344,452
IT-FC,Forlì-Cesena,96,0,39,0,56,0,0,0,95,14,3,1,229,0,0,0,247,342
IT-FC,Forlì-Cesena,97,2,15,0,28,0,0,0,45,17,6,1,154,0,0,0,178,223
IT-FC,Forlì-Cesena,98,0,9,1,15,0,0,0,25,10,2,1,132,0,0,0,145,170
IT-FC,Forlì-Cesena,99,0,7,1,17,0,0,0,25,6,2,0,80,0,0,0,88,113
IT-FC,Forlì-Cesena,100,0,3,0,13,0,0,0,16,5,1,0,121,0,0,0,127,143
IT-FC,Forlì-Cesena,999,94870,84977,7155,5465,158,2,4,192631,80686,85758,10193,23467,71,6,0,200181,392812
IT-FR,Frosinone,0,1403,0,0,0,0,0,0,1403,1432,0,0,0,0,0,0,1432,2835
IT-FR,Frosinone,1,1567,0,0,0,0,0,0,1567,1411,0,0,0,0,0,0,1411,2978
IT-FR,Frosinone,2,1543,0,0,0,0,0,0,1543,1488,0,0,0,0,0,0,1488,3031
IT-FR,Frosinone,3,1570,0,0,0,0,0,0,1570,1612,0,0,0,0,0,0,1612,3182
IT-FR,Frosinone,4,1670,0,0,0,0,0,0,1670,1579,0,0,0,0,0,0,1579,3249
IT-FR,Frosinone,5,1740,0,0,0,0,0,0,1740,1651,0,0,0,0,0,0,1651,3391
IT-FR,Frosinone,6,1853,0,0,0,0,0,0,1853,1803,0,0,0,0,0,0,1803,3656
IT-FR,Frosinone,7,2053,0,0,0,0,0,0,2053,1899,0,0,0,0,0,0,1899,3952
IT-FR,Frosinone,8,1921,0,0,0,0,0,0,1921,1934,0,0,0,0,0,0,1934,3855
IT-FR,Frosinone,9,1956,0,0,0,0,0,0,1956,1902,0,0,0,0,0,0,1902,3858
IT-FR,Frosinone,10,2025,0,0,0,0,0,0,2025,1962,0,0,0,0,0,0,1962,3987
IT-FR,Frosinone,11,2097,0,0,0,0,0,0,2097,2093,0,0,0,0,0,0,2093,4190
IT-FR,Frosinone,12,2107,0,0,0,0,0,0,2107,2006,0,0,0,0,0,0,2006,4113
IT-FR,Frosinone,13,2270,0,0,0,0,0,0,2270,2128,0,0,0,0,0,0,2128,4398
IT-FR,Frosinone,14,2202,0,0,0,0,0,0,2202,2033,0,0,0,0,0,0,2033,4235
IT-FR,Frosinone,15,2188,0,0,0,0,0,0,2188,2149,0,0,0,0,0,0,2149,4337
IT-FR,Frosinone,16,2278,0,0,0,0,0,0,2278,2068,0,0,0,0,0,0,2068,4346
IT-FR,Frosinone,17,2144,1,1,0,0,0,0,2146,2077,0,0,0,0,0,0,2077,4223
IT-FR,Frosinone,18,2189,0,0,0,0,0,0,2189,2054,1,0,0,0,0,0,2055,4244
IT-FR,Frosinone,19,2310,1,0,1,0,0,0,2312,2074,3,0,0,0,0,0,2077,4389
IT-FR,Frosinone,20,2215,1,0,0,0,0,0,2216,2049,11,0,0,0,0,0,2060,4276
IT-FR,Frosinone,21,2195,0,0,0,0,0,0,2195,2034,18,0,0,0,0,0,2052,4247
IT-FR,Frosinone,22,2259,3,0,0,0,0,0,2262,1937,42,0,0,0,0,0,1979,4241
IT-FR,Frosinone,23,2349,12,0,0,0,0,0,2361,2014,66,1,0,1,0,0,2082,4443
IT-FR,Frosinone,24,2372,27,0,0,0,0,0,2399,2042,70,0,1,0,0,0,2113,4512
IT-FR,Frosinone,25,2354,29,0,0,1,0,0,2384,2019,103,0,0,2,0,0,2124,4508
IT-FR,Frosinone,26,2441,56,1,0,0,0,0,2498,1938,180,3,0,0,0,0,2121,4619
IT-FR,Frosinone,27,2271,90,2,0,0,0,0,2363,1941,240,3,1,0,1,0,2186,4549
IT-FR,Frosinone,28,2335,143,4,0,2,0,0,2484,1870,315,7,0,0,0,0,2192,4676
IT-FR,Frosinone,29,2342,189,2,1,0,0,0,2534,1816,461,10,1,1,0,0,2289,4823
IT-FR,Frosinone,30,2221,271,3,1,0,0,0,2496,1708,593,14,1,1,1,0,2318,4814
IT-FR,Frosinone,31,2297,371,4,0,2,0,0,2674,1774,729,18,2,1,0,0,2524,5198
IT-FR,Frosinone,32,2160,521,7,0,3,0,0,2691,1607,863,14,2,0,0,0,2486,5177
IT-FR,Frosinone,33,2027,655,9,2,0,0,0,2693,1475,983,31,2,1,0,0,2492,5185
IT-FR,Frosinone,34,2014,751,23,0,0,0,0,2788,1407,1169,38,5,0,0,0,2619,5407
IT-FR,Frosinone,35,1851,886,26,1,3,0,0,2767,1307,1259,42,6,2,0,0,2616,5383
IT-FR,Frosinone,36,1724,1039,20,2,2,0,0,2787,1242,1268,50,8,0,1,0,2569,5356
IT-FR,Frosinone,37,1589,1098,22,2,2,0,0,2713,1170,1438,78,11,2,0,0,2699,5412
IT-FR,Frosinone,38,1641,1166,34,0,1,1,0,2843,1040,1541,71,9,1,0,0,2662,5505
IT-FR,Frosinone,39,1523,1304,49,4,0,0,0,2880,1037,1688,84,12,0,0,0,2821,5701
IT-FR,Frosinone,40,1497,1483,67,1,3,0,0,3051,933,1820,89,18,0,0,0,2860,5911
IT-FR,Frosinone,41,1437,1585,63,6,5,0,0,3096,873,1904,106,17,2,0,0,2902,5998
IT-FR,Frosinone,42,1292,1660,69,5,1,0,0,3027,938,1942,123,27,0,0,0,3030,6057
IT-FR,Frosinone,43,1273,1744,74,8,1,0,0,3100,804,2092,138,23,1,0,0,3058,6158
IT-FR,Frosinone,44,1200,1769,112,3,2,0,0,3086,814,2133,157,47,0,0,0,3151,6237
IT-FR,Frosinone,45,1170,1968,110,9,3,0,0,3260,805,2223,189,44,1,0,0,3262,6522
IT-FR,Frosinone,46,1177,1982,112,8,2,0,0,3281,755,2262,192,53,0,0,0,3262,6543
IT-FR,Frosinone,47,1087,2154,150,7,0,0,0,3398,718,2491,209,56,0,0,0,3474,6872
IT-FR,Frosinone,48,1050,2273,170,17,3,0,0,3513,660,2557,216,48,0,0,0,3481,6994
IT-FR,Frosinone,49,1100,2400,156,18,2,0,0,3676,647,2670,233,78,0,0,0,3628,7304
IT-FR,Frosinone,50,920,2379,173,19,0,0,0,3491,641,2646,208,78,0,0,0,3573,7064
IT-FR,Frosinone,51,858,2320,183,14,0,0,0,3375,526,2789,224,104,2,0,0,3645,7020
IT-FR,Frosinone,52,830,2564,189,29,3,0,0,3615,541,2782,232,97,1,0,0,3653,7268
IT-FR,Frosinone,53,743,2591,179,25,1,0,0,3539,489,2725,253,113,0,0,0,3580,7119
IT-FR,Frosinone,54,718,2651,173,34,0,0,0,3576,458,2971,256,127,0,0,0,3812,7388
IT-FR,Frosinone,55,645,2673,163,29,0,0,0,3510,424,2831,209,173,0,0,0,3637,7147
IT-FR,Frosinone,56,617,2759,212,55,1,0,0,3644,414,2995,272,168,1,0,0,3850,7494
IT-FR,Frosinone,57,532,2761,213,46,1,0,0,3553,371,2971,237,182,1,0,0,3762,7315
IT-FR,Frosinone,58,460,2866,230,47,1,0,0,3604,341,2983,234,241,2,0,0,3801,7405
IT-FR,Frosinone,59,434,2940,225,64,0,0,0,3663,348,3161,220,279,0,0,0,4008,7671
IT-FR,Frosinone,60,403,2766,182,67,1,0,0,3419,284,2909,201,257,0,0,0,3651,7070
IT-FR,Frosinone,61,373,2818,199,59,2,0,0,3451,297,2833,204,346,0,0,0,3680,7131
IT-FR,Frosinone,62,350,2698,167,64,2,0,0,3281,313,2726,166,359,0,0,0,3564,6845
IT-FR,Frosinone,63,332,2752,168,92,0,0,0,3344,229,2702,156,440,0,0,0,3527,6871
IT-FR,Frosinone,64,294,2645,165,105,0,0,0,3209,217,2661,144,433,0,0,0,3455,6664
IT-FR,Frosinone,65,273,2660,111,90,0,0,0,3134,208,2531,161,489,0,0,0,3389,6523
IT-FR,Frosinone,66,269,2637,122,120,0,0,0,3148,209,2385,127,533,0,0,0,3254,6402
IT-FR,Frosinone,67,230,2541,122,129,2,0,0,3024,168,2326,113,569,0,0,0,3176,6200
IT-FR,Frosinone,68,221,2613,124,141,1,0,0,3100,164,2386,136,624,0,0,0,3310,6410
IT-FR,Frosinone,69,193,2545,103,127,0,0,0,2968,168,2238,111,685,0,0,0,3202,6170
IT-FR,Frosinone,70,190,2376,91,137,0,0,0,2794,177,2106,95,666,0,0,0,3044,5838
IT-FR,Frosinone,71,168,2375,74,121,0,0,0,2738,179,1989,82,727,0,0,0,2977,5715
IT-FR,Frosinone,72,151,2413,74,152,0,0,0,2790,143,1915,80,838,0,0,0,2976,5766
IT-FR,Frosinone,73,118,2313,71,181,0,0,0,2683,143,1861,76,879,0,0,0,2959,5642
IT-FR,Frosinone,74,135,2380,86,229,0,0,0,2830,127,1875,81,934,0,0,0,3017,5847
IT-FR,Frosinone,75,129,2445,57,224,0,0,0,2855,139,1836,75,1100,0,0,0,3150,6005
IT-FR,Frosinone,76,110,2301,55,220,0,0,0,2686,127,1624,60,1159,0,0,0,2970,5656
IT-FR,Frosinone,77,87,1928,51,232,0,0,0,2298,117,1395,42,1148,0,0,0,2702,5000
IT-FR,Frosinone,78,65,1282,31,152,0,0,0,1530,68,869,34,805,0,0,0,1776,3306
IT-FR,Frosinone,79,64,1300,36,200,0,0,0,1600,89,878,31,991,0,0,0,1989,3589
IT-FR,Frosinone,80,65,1287,21,185,0,0,0,1558,92,824,36,999,0,0,0,1951,3509
IT-FR,Frosinone,81,59,1142,12,174,0,0,0,1387,71,667,27,969,0,0,0,1734,3121
IT-FR,Frosinone,82,40,1040,18,204,0,0,0,1302,81,633,22,1016,0,0,0,1752,3054
IT-FR,Frosinone,83,65,1212,22,255,0,0,0,1554,79,605,23,1140,0,0,0,1847,3401
IT-FR,Frosinone,84,46,1014,16,256,0,0,0,1332,82,543,20,1254,0,0,0,1899,3231
IT-FR,Frosinone,85,34,862,10,246,0,0,0,1152,74,428,13,1231,0,0,0,1746,2898
IT-FR,Frosinone,86,33,743,9,244,0,0,0,1029,74,361,15,1080,0,0,0,1530,2559
IT-FR,Frosinone,87,28,600,7,208,0,0,0,843,50,281,9,1007,0,0,0,1347,2190
IT-FR,Frosinone,88,18,506,7,205,0,0,0,736,54,208,10,945,0,0,0,1217,1953
IT-FR,Frosinone,89,20,420,1,204,0,0,0,645,51,165,8,940,0,0,0,1164,1809
IT-FR,Frosinone,90,13,343,5,186,0,0,0,547,37,118,5,777,0,0,0,937,1484
IT-FR,Frosinone,91,10,217,2,156,0,0,0,385,38,109,3,625,0,0,0,775,1160
IT-FR,Frosinone,92,10,190,2,146,0,0,0,348,37,61,2,554,0,0,0,654,1002
IT-FR,Frosinone,93,1,124,1,120,0,0,0,246,26,45,0,490,0,0,0,561,807
IT-FR,Frosinone,94,4,74,0,81,0,0,0,159,20,33,3,366,0,0,0,422,581
IT-FR,Frosinone,95,3,48,0,74,0,0,0,125,26,14,3,257,0,0,0,300,425
IT-FR,Frosinone,96,4,28,0,51,0,0,0,83,19,13,3,189,0,0,0,224,307
IT-FR,Frosinone,97,0,21,0,31,0,0,0,52,11,7,2,180,0,0,0,200,252
IT-FR,Frosinone,98,3,10,0,17,0,0,0,30,9,4,2,94,0,0,0,109,139
IT-FR,Frosinone,99,1,7,0,15,0,0,0,23,11,6,0,83,0,0,0,100,123
IT-FR,Frosinone,100,1,6,0,29,0,0,0,36,10,9,0,111,0,0,0,130,166
IT-FR,Frosinone,999,104919,111818,5452,6387,53,1,0,228630,87800,111168,6842,30323,23,3,0,236159,464789
IT-GE,Genova,0,2368,0,0,0,0,0,0,2368,2258,0,0,0,0,0,0,2258,4626
IT-GE,Genova,1,2490,0,0,0,0,0,0,2490,2239,0,0,0,0,0,0,2239,4729
IT-GE,Genova,2,2527,0,0,0,0,0,0,2527,2280,0,0,0,0,0,0,2280,4807
IT-GE,Genova,3,2565,0,0,0,0,0,0,2565,2435,0,0,0,0,0,0,2435,5000
IT-GE,Genova,4,2637,0,0,0,0,0,0,2637,2420,0,0,0,0,0,0,2420,5057
IT-GE,Genova,5,2643,0,0,0,0,0,0,2643,2523,0,0,0,0,0,0,2523,5166
IT-GE,Genova,6,2882,0,0,0,0,0,0,2882,2701,0,0,0,0,0,0,2701,5583
IT-GE,Genova,7,2892,0,0,0,0,0,0,2892,2728,0,0,0,0,0,0,2728,5620
IT-GE,Genova,8,3018,0,0,0,0,0,0,3018,2793,0,0,0,0,0,0,2793,5811
IT-GE,Genova,9,3208,0,0,0,0,0,0,3208,3005,0,0,0,0,0,0,3005,6213
IT-GE,Genova,10,3237,0,0,0,0,0,0,3237,3005,0,0,0,0,0,0,3005,6242
IT-GE,Genova,11,3385,0,0,0,0,0,0,3385,3156,0,0,0,0,0,0,3156,6541
IT-GE,Genova,12,3292,0,0,0,0,0,0,3292,3172,0,0,0,0,0,0,3172,6464
IT-GE,Genova,13,3478,0,0,0,0,0,0,3478,3377,0,0,0,0,0,0,3377,6855
IT-GE,Genova,14,3614,0,0,0,0,0,0,3614,3547,0,0,0,0,0,0,3547,7161
IT-GE,Genova,15,3703,0,0,0,0,0,0,3703,3530,0,0,0,0,0,0,3530,7233
IT-GE,Genova,16,3689,0,0,0,0,0,0,3689,3357,0,0,0,0,0,0,3357,7046
IT-GE,Genova,17,3734,0,0,0,0,0,0,3734,3489,0,0,0,0,0,0,3489,7223
IT-GE,Genova,18,3799,0,0,0,0,0,0,3799,3415,3,0,0,0,0,0,3418,7217
IT-GE,Genova,19,3802,2,1,0,0,0,0,3805,3475,10,0,0,0,0,0,3485,7290
IT-GE,Genova,20,3820,1,0,0,0,0,0,3821,3388,21,0,0,0,0,0,3409,7230
IT-GE,Genova,21,3873,7,0,0,0,0,0,3880,3514,28,0,0,0,0,0,3542,7422
IT-GE,Genova,22,3939,11,4,0,0,0,0,3954,3465,54,2,0,2,0,0,3523,7477
IT-GE,Genova,23,3972,26,3,0,0,0,0,4001,3476,135,3,0,0,0,0,3614,7615
IT-GE,Genova,24,4085,47,4,1,2,0,0,4139,3337,145,3,0,0,0,0,3485,7624
IT-GE,Genova,25,4062,63,2,0,1,0,0,4128,3375,211,6,0,2,0,0,3594,7722
IT-GE,Genova,26,3953,106,1,0,1,0,0,4061,3329,272,7,0,4,0,0,3612,7673
IT-GE,Genova,27,4136,177,12,0,1,0,0,4326,3243,432,15,1,2,0,0,3693,8019
IT-GE,Genova,28,3845,234,5,0,4,0,0,4088,3111,519,15,0,6,0,0,3651,7739
IT-GE,Genova,29,3781,304,6,0,2,1,0,4094,3020,744,27,3,6,0,0,3800,7894
IT-GE,Genova,30,3638,510,7,0,4,0,0,4159,2976,903,30,3,6,0,0,3918,8077
IT-GE,Genova,31,3584,605,20,1,6,0,0,4216,2749,1124,33,2,8,1,0,3917,8133
IT-GE,Genova,32,3434,798,27,1,6,0,0,4266,2637,1357,49,3,10,0,0,4056,8322
IT-GE,Genova,33,3131,1000,31,5,6,0,0,4173,2428,1447,71,3,8,1,0,3958,8131
IT-GE,Genova,34,3002,1089,27,7,6,0,0,4131,2297,1664,91,9,10,0,0,4071,8202
IT-GE,Genova,35,2835,1350,50,6,8,2,0,4251,2134,1820,99,11,12,0,0,4076,8327
IT-GE,Genova,36,2731,1429,76,5,7,0,0,4248,1937,1880,112,13,10,1,0,3953,8201
IT-GE,Genova,37,2407,1547,90,2,9,0,0,4055,1790,1887,163,19,10,0,0,3869,7924
IT-GE,Genova,38,2384,1738,95,6,7,0,0,4230,1773,2066,167,26,10,1,0,4043,8273
IT-GE,Genova,39,2316,1774,99,7,4,0,0,4200,1738,2153,166,22,12,0,0,4091,8291
IT-GE,Genova,40,2157,2020,130,5,7,0,0,4319,1629,2311,231,25,8,0,0,4204,8523
IT-GE,Genova,41,2002,2083,151,7,5,0,0,4248,1512,2328,250,30,10,0,0,4130,8378
IT-GE,Genova,42,1984,2224,188,12,8,1,0,4417,1521,2484,296,35,9,0,0,4345,8762
IT-GE,Genova,43,1986,2140,182,16,10,0,0,4334,1437,2577,306,55,6,0,0,4381,8715
IT-GE,Genova,44,1903,2288,177,18,12,0,0,4398,1497,2759,355,53,11,1,0,4676,9074
IT-GE,Genova,45,2026,2376,228,31,11,0,0,4672,1496,3036,410,66,9,0,0,5017,9689
IT-GE,Genova,46,2052,2687,271,24,13,0,0,5047,1522,3147,483,70,5,0,0,5227,10274
IT-GE,Genova,47,2132,2996,293,25,12,0,0,5458,1533,3328,497,100,6,0,0,5464,10922
IT-GE,Genova,48,2218,3199,370,26,13,0,0,5826,1645,3636,590,92,4,0,0,5967,11793
IT-GE,Genova,49,2228,3376,431,32,15,0,0,6082,1642,4020,655,109,6,0,0,6432,12514
IT-GE,Genova,50,2156,3641,448,36,6,0,0,6287,1519,4063,697,115,7,0,0,6401,12688
IT-GE,Genova,51,2239,3744,577,26,16,0,0,6602,1542,4263,822,138,12,0,0,6777,13379
IT-GE,Genova,52,2147,3929,577,37,17,1,0,6708,1536,4272,823,161,7,0,0,6799,13507
IT-GE,Genova,53,1902,4026,586,44,12,0,0,6570,1391,4381,902,208,7,1,0,6890,13460
IT-GE,Genova,54,1878,4099,659,32,16,0,0,6684,1376,4476,905,213,7,0,0,6977,13661
IT-GE,Genova,55,1796,4183,651,49,14,1,0,6694,1276,4546,894,269,6,1,0,6992,13686
IT-GE,Genova,56,1680,4096,677,60,13,0,0,6526,1186,4569,925,266,9,0,0,6955,13481
IT-GE,Genova,57,1624,4458,793,74,17,0,0,6966,1155,4724,1012,323,9,0,0,7223,14189
IT-GE,Genova,58,1580,4558,819,89,12,1,0,7059,1070,4829,1032,371,6,0,0,7308,14367
IT-GE,Genova,59,1474,4719,815,84,9,0,0,7101,1052,4913,1061,401,4,0,0,7431,14532
IT-GE,Genova,60,1222,4357,781,110,17,1,0,6488,927,4818,984,457,8,0,0,7194,13682
IT-GE,Genova,61,1146,4290,688,116,6,0,0,6246,863,4572,904,469,4,0,0,6812,13058
IT-GE,Genova,62,1055,4132,649,113,5,0,0,5954,744,4393,863,549,5,0,0,6554,12508
IT-GE,Genova,63,912,4212,638,122,13,0,0,5897,727,4298,801,552,3,0,0,6381,12278
IT-GE,Genova,64,891,4142,625,125,10,0,0,5793,644,4232,778,634,4,0,0,6292,12085
IT-GE,Genova,65,794,3962,541,142,7,0,0,5446,589,4053,726,709,1,0,0,6078,11524
IT-GE,Genova,66,736,3989,535,165,5,0,0,5430,559,3916,715,721,4,0,0,5915,11345
IT-GE,Genova,67,659,3897,476,169,3,0,0,5204,504,3763,681,801,2,0,0,5751,10955
IT-GE,Genova,68,600,3645,470,200,8,0,0,4923,445,3683,589,909,0,0,0,5626,10549
IT-GE,Genova,69,586,3809,426,202,5,0,0,5028,461,3620,552,983,1,0,0,5617,10645
IT-GE,Genova,70,501,3594,334,254,5,0,0,4688,424,3465,486,1051,2,0,0,5428,10116
IT-GE,Genova,71,498,3458,351,225,4,0,0,4536,382,3292,480,1068,3,0,1,5226,9762
IT-GE,Genova,72,451,3397,329,270,2,0,0,4449,391,3220,399,1187,2,0,0,5199,9648
IT-GE,Genova,73,469,3739,304,321,5,0,0,4838,405,3301,431,1339,2,0,0,5478,10316
IT-GE,Genova,74,398,3580,276,316,6,0,1,4577,359,3298,411,1434,1,0,0,5503,10080
IT-GE,Genova,75,394,3741,286,365,1,0,0,4787,407,3402,409,1698,0,0,0,5916,10703
IT-GE,Genova,76,369,3838,264,411,3,0,0,4885,409,3286,422,1856,0,0,0,5973,10858
IT-GE,Genova,77,342,3677,236,471,2,0,0,4728,349,3351,360,2065,1,0,0,6126,10854
IT-GE,Genova,78,262,2492,133,395,3,0,0,3285,246,2032,245,1622,3,0,0,4148,7433
IT-GE,Genova,79,225,2778,158,436,4,0,0,3601,258,2198,246,2015,2,0,0,4719,8320
IT-GE,Genova,80,223,2608,129,421,1,0,0,3382,276,2064,227,2011,0,0,0,4578,7960
IT-GE,Genova,81,217,2467,124,456,3,0,0,3267,271,1775,223,2273,1,0,0,4543,7810
IT-GE,Genova,82,210,2327,125,551,2,0,0,3215,275,1817,203,2368,0,0,0,4663,7878
IT-GE,Genova,83,207,2365,115,584,5,0,0,3276,284,1756,171,2725,0,0,0,4936,8212
IT-GE,Genova,84,182,2186,88,646,2,0,0,3104,300,1462,186,2822,0,0,0,4770,7874
IT-GE,Genova,85,173,1889,86,607,3,0,0,2758,268,1224,167,2807,0,0,0,4466,7224
IT-GE,Genova,86,143,1630,61,562,2,0,0,2398,216,956,118,2609,0,0,0,3899,6297
IT-GE,Genova,87,102,1279,46,513,0,0,0,1940,200,672,101,2362,0,0,0,3335,5275
IT-GE,Genova,88,95,1077,30,480,1,0,0,1683,187,578,100,2365,0,0,0,3230,4913
IT-GE,Genova,89,86,844,36,463,1,0,0,1430,182,431,62,2177,0,0,0,2852,4282
IT-GE,Genova,90,77,714,18,368,0,0,0,1177,156,351,70,1881,0,0,0,2458,3635
IT-GE,Genova,91,48,565,17,349,0,0,0,979,179,237,57,1809,0,0,0,2282,3261
IT-GE,Genova,92,36,436,15,290,1,0,0,778,152,195,37,1480,0,0,0,1864,2642
IT-GE,Genova,93,30,312,9,239,0,0,0,590,118,142,37,1357,0,0,0,1654,2244
IT-GE,Genova,94,28,189,8,200,0,0,0,425,107,71,17,1033,0,0,0,1228,1653
IT-GE,Genova,95,15,143,4,147,0,0,0,309,78,36,14,799,0,0,0,927,1236
IT-GE,Genova,96,12,85,2,102,0,0,0,201,74,32,13,573,0,0,0,692,893
IT-GE,Genova,97,8,46,2,72,0,0,0,128,45,18,8,445,0,0,0,516,644
IT-GE,Genova,98,6,34,0,49,0,0,0,89,33,5,2,336,0,0,0,376,465
IT-GE,Genova,99,6,17,2,26,0,0,0,51,22,9,3,197,0,0,0,231,282
IT-GE,Genova,100,2,16,0,53,0,0,0,71,33,5,5,341,0,0,0,384,455
IT-GE,Genova,999,185471,175618,19000,12874,447,8,1,393419,156708,179566,27508,60104,315,7,1,424209,817628
IT-GO,Gorizia,0,504,0,0,0,0,0,0,504,416,0,0,0,0,0,0,416,920
IT-GO,Gorizia,1,459,0,0,0,0,0,0,459,487,0,0,0,0,0,0,487,946
IT-GO,Gorizia,2,438,0,0,0,0,0,0,438,404,0,0,0,0,0,0,404,842
IT-GO,Gorizia,3,451,0,0,0,0,0,0,451,480,0,0,0,0,0,0,480,931
IT-GO,Gorizia,4,457,0,0,0,0,0,0,457,458,0,0,0,0,0,0,458,915
IT-GO,Gorizia,5,499,0,0,0,0,0,0,499,475,0,0,0,0,0,0,475,974
IT-GO,Gorizia,6,515,0,0,0,0,0,0,515,523,0,0,0,0,0,0,523,1038
IT-GO,Gorizia,7,523,0,0,0,0,0,0,523,493,0,0,0,0,0,0,493,1016
IT-GO,Gorizia,8,553,0,0,0,0,0,0,553,554,0,0,0,0,0,0,554,1107
IT-GO,Gorizia,9,550,0,0,0,0,0,0,550,488,0,0,0,0,0,0,488,1038
IT-GO,Gorizia,10,596,0,0,0,0,0,0,596,484,0,0,0,0,0,0,484,1080
IT-GO,Gorizia,11,593,0,0,0,0,0,0,593,553,0,0,0,0,0,0,553,1146
IT-GO,Gorizia,12,679,0,0,0,0,0,0,679,551,0,0,0,0,0,0,551,1230
IT-GO,Gorizia,13,623,0,0,0,0,0,0,623,598,0,0,0,0,0,0,598,1221
IT-GO,Gorizia,14,641,0,0,0,0,0,0,641,539,0,0,0,0,0,0,539,1180
IT-GO,Gorizia,15,677,0,0,0,0,0,0,677,584,0,0,0,0,0,0,584,1261
IT-GO,Gorizia,16,625,0,0,0,0,0,0,625,618,0,0,0,0,0,0,618,1243
IT-GO,Gorizia,17,663,0,0,0,0,0,0,663,620,0,0,0,0,0,0,620,1283
IT-GO,Gorizia,18,684,0,0,0,0,0,0,684,600,1,0,0,0,0,0,601,1285
IT-GO,Gorizia,19,653,1,0,0,0,0,0,654,593,2,0,0,0,0,0,595,1249
IT-GO,Gorizia,20,661,1,0,0,0,0,0,662,599,9,0,0,0,0,0,608,1270
IT-GO,Gorizia,21,699,1,0,0,0,0,0,700,551,20,0,0,0,0,0,571,1271
IT-GO,Gorizia,22,735,4,0,0,0,0,0,739,590,24,1,0,0,0,0,615,1354
IT-GO,Gorizia,23,720,3,0,0,1,0,0,724,587,63,1,0,0,0,0,651,1375
IT-GO,Gorizia,24,695,17,0,0,0,0,0,712,548,74,1,0,0,0,0,623,1335
IT-GO,Gorizia,25,765,36,3,0,0,0,0,804,518,100,3,0,1,0,0,622,1426
IT-GO,Gorizia,26,681,39,2,0,0,0,1,723,528,111,0,0,1,0,0,640,1363
IT-GO,Gorizia,27,703,59,6,0,0,0,0,768,488,137,1,1,1,0,0,628,1396
IT-GO,Gorizia,28,625,73,4,0,0,0,0,702,460,169,3,0,0,0,0,632,1334
IT-GO,Gorizia,29,593,88,2,0,0,0,0,683,441,172,4,0,0,0,0,617,1300
IT-GO,Gorizia,30,562,112,7,0,1,1,0,683,426,203,8,0,2,0,0,639,1322
IT-GO,Gorizia,31,573,140,7,0,1,0,0,721,402,248,10,1,0,0,0,661,1382
IT-GO,Gorizia,32,507,171,4,0,2,0,0,684,372,282,8,1,0,0,0,663,1347
IT-GO,Gorizia,33,522,211,5,1,0,0,0,739,324,317,8,0,0,0,0,649,1388
IT-GO,Gorizia,34,447,261,5,0,0,0,0,713,347,306,12,1,0,0,0,666,1379
IT-GO,Gorizia,35,445,248,6,5,2,0,0,706,293,335,11,0,1,0,0,640,1346
IT-GO,Gorizia,36,372,277,10,0,0,1,0,660,271,356,11,2,1,0,0,641,1301
IT-GO,Gorizia,37,366,308,14,1,2,0,0,691,241,371,19,2,0,0,0,633,1324
IT-GO,Gorizia,38,360,321,17,1,1,0,0,700,223,424,27,2,1,0,0,677,1377
IT-GO,Gorizia,39,374,354,20,1,1,0,0,750,235,408,40,4,0,0,0,687,1437
IT-GO,Gorizia,40,347,386,17,0,0,0,0,750,216,396,31,8,0,0,0,651,1401
IT-GO,Gorizia,41,372,426,32,4,0,0,0,834,250,412,49,5,0,0,0,716,1550
IT-GO,Gorizia,42,355,412,31,4,1,0,0,803,233,478,38,4,0,0,0,753,1556
IT-GO,Gorizia,43,371,445,48,7,2,0,0,873,226,449,56,4,0,0,0,735,1608
IT-GO,Gorizia,44,383,495,27,1,0,0,0,906,222,481,55,13,0,0,0,771,1677
IT-GO,Gorizia,45,379,519,48,6,0,0,0,952,259,529,71,8,1,0,0,868,1820
IT-GO,Gorizia,46,387,566,37,6,2,0,0,998,253,532,66,6,2,0,0,859,1857
IT-GO,Gorizia,47,394,535,57,6,0,0,0,992,222,575,94,22,1,0,0,914,1906
IT-GO,Gorizia,48,392,616,71,7,0,0,0,1086,253,613,105,13,1,0,0,985,2071
IT-GO,Gorizia,49,458,651,86,7,1,0,0,1203,280,697,112,26,1,0,0,1116,2319
IT-GO,Gorizia,50,400,605,98,2,1,0,0,1106,277,727,121,22,0,0,0,1147,2253
IT-GO,Gorizia,51,446,683,88,9,1,0,0,1227,241,756,124,31,1,0,0,1153,2380
IT-GO,Gorizia,52,406,695,79,4,2,0,0,1186,210,785,121,33,3,0,0,1152,2338
IT-GO,Gorizia,53,375,698,92,6,2,0,0,1173,242,730,142,44,1,0,0,1159,2332
IT-GO,Gorizia,54,358,748,127,15,1,0,0,1249,243,751,132,47,1,0,0,1174,2423
IT-GO,Gorizia,55,342,718,127,15,2,0,0,1204,214,744,145,38,0,0,0,1141,2345
IT-GO,Gorizia,56,342,749,138,7,0,0,0,1236,211,784,159,50,1,0,0,1205,2441
IT-GO,Gorizia,57,342,740,141,17,4,0,0,1244,179,754,173,61,0,0,0,1167,2411
IT-GO,Gorizia,58,296,770,126,15,1,0,0,1208,189,820,166,59,0,0,0,1234,2442
IT-GO,Gorizia,59,311,802,139,20,0,0,0,1272,181,800,179,83,0,0,0,1243,2515
IT-GO,Gorizia,60,239,808,115,16,1,0,0,1179,165,751,139,67,0,0,0,1122,2301
IT-GO,Gorizia,61,217,768,110,23,1,0,0,1119,143,703,127,86,1,0,0,1060,2179
IT-GO,Gorizia,62,191,721,119,20,2,0,0,1053,122,719,129,103,0,0,0,1073,2126
IT-GO,Gorizia,63,218,738,117,20,0,0,0,1093,116,642,115,73,0,0,0,946,2039
IT-GO,Gorizia,64,130,663,121,25,1,0,0,940,77,649,113,114,0,0,0,953,1893
IT-GO,Gorizia,65,144,621,95,25,1,0,0,886,84,615,101,112,0,0,0,912,1798
IT-GO,Gorizia,66,123,585,84,17,1,0,0,810,92,610,97,133,0,0,0,932,1742
IT-GO,Gorizia,67,103,616,65,20,1,0,0,805,68,542,94,125,0,0,0,829,1634
IT-GO,Gorizia,68,100,600,86,45,0,0,0,831,78,532,89,145,0,0,0,844,1675
IT-GO,Gorizia,69,113,558,55,37,1,0,0,764,65,487,81,158,1,0,0,792,1556
IT-GO,Gorizia,70,84,567,58,48,0,0,0,757,64,569,82,179,0,0,0,894,1651
IT-GO,Gorizia,71,63,483,52,42,0,0,1,641,52,543,73,169,0,0,0,837,1478
IT-GO,Gorizia,72,84,570,58,54,0,0,0,766,47,504,68,205,0,0,0,824,1590
IT-GO,Gorizia,73,69,515,55,50,0,0,0,689,56,538,63,230,0,0,0,887,1576
IT-GO,Gorizia,74,54,588,50,55,0,0,0,747,39,550,58,253,0,0,0,900,1647
IT-GO,Gorizia,75,68,600,54,68,1,0,0,791,57,533,78,298,0,0,0,966,1757
IT-GO,Gorizia,76,57,592,43,60,0,0,0,752,46,513,56,343,0,0,0,958,1710
IT-GO,Gorizia,77,61,588,41,77,0,0,0,767,52,464,44,381,0,0,0,941,1708
IT-GO,Gorizia,78,35,411,22,57,1,0,0,526,28,299,28,255,0,0,0,610,1136
IT-GO,Gorizia,79,36,440,32,84,0,0,0,592,49,339,37,375,0,0,0,800,1392
IT-GO,Gorizia,80,38,422,25,83,0,0,0,568,45,314,41,335,0,0,0,735,1303
IT-GO,Gorizia,81,31,416,18,71,0,0,0,536,32,261,32,394,0,0,0,719,1255
IT-GO,Gorizia,82,38,383,17,116,0,0,0,554,44,276,21,424,0,0,0,765,1319
IT-GO,Gorizia,83,30,384,19,104,0,0,0,537,44,277,18,449,0,0,0,788,1325
IT-GO,Gorizia,84,29,338,12,77,0,0,0,456,50,210,20,440,0,0,0,720,1176
IT-GO,Gorizia,85,23,287,12,77,0,0,0,399,46,160,22,466,0,0,0,694,1093
IT-GO,Gorizia,86,23,238,11,88,0,0,0,360,46,105,12,412,0,0,0,575,935
IT-GO,Gorizia,87,18,221,4,76,0,0,0,319,28,96,9,396,0,0,0,529,848
IT-GO,Gorizia,88,10,158,3,85,0,0,0,256,29,64,11,363,0,0,0,467,723
IT-GO,Gorizia,89,14,115,2,55,0,0,0,186,30,47,9,362,0,0,0,448,634
IT-GO,Gorizia,90,6,91,0,65,0,0,0,162,41,37,5,301,0,0,0,384,546
IT-GO,Gorizia,91,6,79,1,46,0,0,0,132,27,21,6,235,0,0,0,289,421
IT-GO,Gorizia,92,6,47,1,48,0,0,0,102,17,14,5,249,0,0,0,285,387
IT-GO,Gorizia,93,4,43,0,45,0,0,0,92,23,15,3,232,0,0,0,273,365
IT-GO,Gorizia,94,1,19,1,27,0,0,0,48,16,8,4,145,0,0,0,173,221
IT-GO,Gorizia,95,0,21,0,25,0,0,0,46,11,4,1,110,0,0,0,126,172
IT-GO,Gorizia,96,2,9,0,14,0,0,0,25,7,4,2,90,0,0,0,103,128
IT-GO,Gorizia,97,1,10,0,12,0,0,0,23,10,1,0,78,0,0,0,89,112
IT-GO,Gorizia,98,0,3,0,6,0,0,0,9,5,0,0,43,0,0,0,48,57
IT-GO,Gorizia,99,0,1,0,7,0,0,0,8,4,0,3,34,0,0,0,41,49
IT-GO,Gorizia,100,0,1,0,8,0,0,0,9,10,0,1,60,0,0,0,71,80
IT-GO,Gorizia,999,32713,30302,3279,2145,42,2,2,68485,25628,29961,4204,10013,23,0,0,69829,138314
IT-GR,Grosseto,0,536,0,0,0,0,0,0,536,557,0,0,0,0,0,0,557,1093
IT-GR,Grosseto,1,617,0,0,0,0,0,0,617,572,0,0,0,0,0,0,572,1189
IT-GR,Grosseto,2,613,0,0,0,0,0,0,613,612,0,0,0,0,0,0,612,1225
IT-GR,Grosseto,3,642,0,0,0,0,0,0,642,595,0,0,0,0,0,0,595,1237
IT-GR,Grosseto,4,628,0,0,0,0,0,0,628,613,0,0,0,0,0,0,613,1241
IT-GR,Grosseto,5,776,0,0,0,0,0,0,776,672,0,0,0,0,0,0,672,1448
IT-GR,Grosseto,6,723,0,0,0,0,0,0,723,664,0,0,0,0,0,0,664,1387
IT-GR,Grosseto,7,798,0,0,0,0,0,0,798,719,0,0,0,0,0,0,719,1517
IT-GR,Grosseto,8,795,0,0,0,0,0,0,795,760,0,0,0,0,0,0,760,1555
IT-GR,Grosseto,9,773,0,0,0,0,0,0,773,731,0,0,0,0,0,0,731,1504
IT-GR,Grosseto,10,807,0,0,0,0,0,0,807,793,0,0,0,0,0,0,793,1600
IT-GR,Grosseto,11,888,0,0,0,0,0,0,888,805,0,0,0,0,0,0,805,1693
IT-GR,Grosseto,12,979,0,0,0,0,0,0,979,850,0,0,0,0,0,0,850,1829
IT-GR,Grosseto,13,905,0,0,0,0,0,0,905,903,0,0,0,0,0,0,903,1808
IT-GR,Grosseto,14,982,0,0,0,0,0,0,982,899,0,0,0,0,0,0,899,1881
IT-GR,Grosseto,15,1008,0,0,0,0,0,0,1008,941,0,0,0,0,0,0,941,1949
IT-GR,Grosseto,16,990,1,0,0,0,0,0,991,902,0,0,0,0,0,0,902,1893
IT-GR,Grosseto,17,1016,0,0,0,0,0,0,1016,896,1,0,0,0,0,0,897,1913
IT-GR,Grosseto,18,1003,0,0,0,0,0,0,1003,935,1,0,0,0,0,0,936,1939
IT-GR,Grosseto,19,1001,0,0,0,0,0,0,1001,886,7,0,0,0,0,0,893,1894
IT-GR,Grosseto,20,1015,1,0,0,0,0,0,1016,877,13,0,0,0,0,0,890,1906
IT-GR,Grosseto,21,962,4,0,0,0,0,0,966,902,12,0,0,0,0,0,914,1880
IT-GR,Grosseto,22,966,10,0,0,0,0,0,976,865,24,0,0,0,0,0,889,1865
IT-GR,Grosseto,23,979,11,1,0,0,0,0,991,840,40,0,0,0,0,0,880,1871
IT-GR,Grosseto,24,985,13,3,0,0,0,0,1001,848,59,1,1,0,0,0,909,1910
IT-GR,Grosseto,25,999,24,2,0,0,0,0,1025,840,67,1,0,0,0,0,908,1933
IT-GR,Grosseto,26,965,37,0,0,0,0,0,1002,799,93,1,0,0,0,0,893,1895
IT-GR,Grosseto,27,1012,46,0,0,2,0,0,1060,759,129,3,0,0,0,0,891,1951
IT-GR,Grosseto,28,940,69,4,0,1,0,0,1014,669,135,3,1,0,0,0,808,1822
IT-GR,Grosseto,29,971,82,3,0,2,0,0,1058,762,170,5,0,0,1,0,938,1996
IT-GR,Grosseto,30,926,111,7,1,1,0,0,1046,702,208,6,0,0,0,0,916,1962
IT-GR,Grosseto,31,872,167,4,0,1,0,0,1044,653,277,7,1,1,0,0,939,1983
IT-GR,Grosseto,32,871,155,3,1,1,0,0,1031,697,311,13,1,0,0,0,1022,2053
IT-GR,Grosseto,33,847,232,8,1,0,0,0,1088,633,326,12,2,2,0,0,975,2063
IT-GR,Grosseto,34,818,239,6,0,0,0,0,1063,624,395,17,2,0,1,0,1039,2102
IT-GR,Grosseto,35,848,299,29,2,0,0,0,1178,579,461,23,2,3,0,0,1068,2246
IT-GR,Grosseto,36,735,362,11,0,1,0,0,1109,536,468,25,1,3,0,0,1033,2142
IT-GR,Grosseto,37,664,367,15,0,1,0,0,1047,510,516,38,2,3,0,0,1069,2116
IT-GR,Grosseto,38,689,422,14,2,1,0,0,1128,499,516,35,2,1,0,0,1053,2181
IT-GR,Grosseto,39,677,479,26,1,0,0,0,1183,487,560,51,4,2,1,0,1105,2288
IT-GR,Grosseto,40,707,450,26,1,0,0,0,1184,499,609,48,5,2,0,0,1163,2347
IT-GR,Grosseto,41,629,535,27,3,0,0,0,1194,523,671,69,7,0,0,0,1270,2464
IT-GR,Grosseto,42,637,562,38,2,2,0,0,1241,480,658,72,9,4,0,0,1223,2464
IT-GR,Grosseto,43,686,614,46,3,0,0,0,1349,425,703,85,3,0,0,0,1216,2565
IT-GR,Grosseto,44,644,669,49,1,2,0,0,1365,471,760,88,12,1,0,0,1332,2697
IT-GR,Grosseto,45,627,751,63,3,1,0,0,1445,501,795,117,13,2,1,0,1429,2874
IT-GR,Grosseto,46,639,752,69,6,3,1,0,1470,511,889,120,21,1,1,0,1543,3013
IT-GR,Grosseto,47,639,801,90,7,2,0,0,1539,521,953,148,22,0,0,0,1644,3183
IT-GR,Grosseto,48,664,897,108,8,1,0,0,1678,457,1030,156,23,0,0,0,1666,3344
IT-GR,Grosseto,49,607,951,101,8,1,0,1,1669,497,1050,164,25,2,0,0,1738,3407
IT-GR,Grosseto,50,580,986,118,13,0,0,0,1697,460,1120,176,28,0,0,0,1784,3481
IT-GR,Grosseto,51,587,989,110,12,1,0,0,1699,458,1204,190,53,2,0,0,1907,3606
IT-GR,Grosseto,52,498,1072,128,7,1,0,0,1706,387,1170,208,61,1,0,0,1827,3533
IT-GR,Grosseto,53,520,1078,151,11,1,0,0,1761,370,1137,199,53,1,0,0,1760,3521
IT-GR,Grosseto,54,493,1173,154,9,1,0,0,1830,385,1255,216,51,1,0,0,1908,3738
IT-GR,Grosseto,55,457,1131,179,17,1,0,0,1785,352,1215,214,61,1,0,0,1843,3628
IT-GR,Grosseto,56,410,1152,164,18,1,0,0,1745,339,1188,206,63,2,0,0,1798,3543
IT-GR,Grosseto,57,357,1203,189,16,2,0,0,1767,306,1252,218,105,1,0,0,1882,3649
IT-GR,Grosseto,58,331,1239,214,28,1,1,0,1814,311,1274,220,97,1,0,0,1903,3717
IT-GR,Grosseto,59,326,1240,178,29,3,0,0,1776,282,1367,235,105,0,0,0,1989,3765
IT-GR,Grosseto,60,315,1210,189,34,1,0,0,1749,259,1281,236,122,0,0,0,1898,3647
IT-GR,Grosseto,61,241,1183,166,25,3,0,0,1618,215,1177,192,124,1,0,0,1709,3327
IT-GR,Grosseto,62,238,1148,167,31,1,0,0,1585,206,1238,177,110,1,0,0,1732,3317
IT-GR,Grosseto,63,192,1209,148,35,3,0,0,1587,189,1190,165,155,1,0,0,1700,3287
IT-GR,Grosseto,64,188,1109,158,24,1,0,0,1480,173,1079,163,177,1,0,0,1593,3073
IT-GR,Grosseto,65,178,1080,129,38,0,0,0,1425,171,1141,172,175,0,0,0,1659,3084
IT-GR,Grosseto,66,176,1100,128,43,1,0,0,1448,163,1118,174,199,0,0,0,1654,3102
IT-GR,Grosseto,67,141,1155,131,53,3,0,0,1483,156,1074,157,227,0,0,0,1614,3097
IT-GR,Grosseto,68,156,1115,113,51,0,0,0,1435,134,1124,143,227,1,0,0,1629,3064
IT-GR,Grosseto,69,133,1101,111,63,2,0,0,1410,125,1021,151,273,0,0,0,1570,2980
IT-GR,Grosseto,70,135,1070,93,46,1,0,0,1345,88,1007,119,260,0,0,0,1474,2819
IT-GR,Grosseto,71,88,1061,96,74,0,0,0,1319,86,900,90,271,0,0,0,1347,2666
IT-GR,Grosseto,72,121,1002,77,78,0,0,0,1278,115,873,104,282,0,0,0,1374,2652
IT-GR,Grosseto,73,106,1088,73,83,0,0,0,1350,101,946,100,317,0,0,0,1464,2814
IT-GR,Grosseto,74,83,1115,73,91,0,0,0,1362,105,928,74,432,0,0,0,1539,2901
IT-GR,Grosseto,75,77,1122,72,119,0,0,1,1391,89,953,85,447,1,0,0,1575,2966
IT-GR,Grosseto,76,71,1047,77,109,0,0,0,1304,89,904,71,517,0,0,0,1581,2885
IT-GR,Grosseto,77,77,1068,47,129,1,0,0,1322,76,834,47,531,0,0,0,1488,2810
IT-GR,Grosseto,78,45,764,35,143,0,0,0,987,59,626,56,497,0,0,0,1238,2225
IT-GR,Grosseto,79,56,739,51,110,1,0,0,957,44,554,33,492,0,0,0,1123,2080
IT-GR,Grosseto,80,45,662,34,111,0,0,0,852,51,515,35,515,0,0,0,1116,1968
IT-GR,Grosseto,81,42,606,20,111,1,0,0,780,43,474,31,530,0,0,0,1078,1858
IT-GR,Grosseto,82,40,657,25,121,0,0,0,843,51,431,35,578,0,0,0,1095,1938
IT-GR,Grosseto,83,47,640,28,127,0,0,0,842,44,445,31,736,0,0,0,1256,2098
IT-GR,Grosseto,84,48,554,17,163,0,0,0,782,43,329,26,733,0,0,0,1131,1913
IT-GR,Grosseto,85,52,514,13,147,0,0,0,726,52,293,23,692,0,0,0,1060,1786
IT-GR,Grosseto,86,30,413,8,126,1,0,0,578,51,231,19,642,0,0,0,943,1521
IT-GR,Grosseto,87,19,366,10,126,0,0,0,521,39,170,9,565,0,0,0,783,1304
IT-GR,Grosseto,88,22,315,3,120,0,0,0,460,37,122,15,582,0,0,0,756,1216
IT-GR,Grosseto,89,23,247,6,109,0,0,0,385,22,75,11,550,0,0,0,658,1043
IT-GR,Grosseto,90,25,164,3,116,0,0,0,308,21,62,10,494,0,0,0,587,895
IT-GR,Grosseto,91,12,142,3,73,0,0,0,230,15,44,7,350,0,0,0,416,646
IT-GR,Grosseto,92,12,113,3,57,0,0,0,185,15,29,6,354,0,0,0,404,589
IT-GR,Grosseto,93,9,68,0,53,0,0,0,130,10,19,7,319,0,0,0,355,485
IT-GR,Grosseto,94,3,46,0,37,0,0,0,86,7,9,2,246,0,0,0,264,350
IT-GR,Grosseto,95,1,37,0,39,0,0,0,77,5,9,2,193,0,0,0,209,286
IT-GR,Grosseto,96,2,17,0,35,0,0,0,54,6,5,1,148,0,0,0,160,214
IT-GR,Grosseto,97,4,14,0,19,0,0,0,37,4,4,1,115,0,0,0,124,161
IT-GR,Grosseto,98,1,6,0,13,0,0,0,20,3,1,0,64,0,0,0,68,88
IT-GR,Grosseto,99,0,3,0,6,0,0,0,9,3,0,0,49,0,0,0,52,61
IT-GR,Grosseto,100,1,3,0,16,0,0,0,20,2,0,1,64,0,0,0,67,87
IT-GR,Grosseto,999,48514,48449,4645,3314,55,2,2,104981,41088,48324,6171,15190,43,5,0,110821,215802
IT-IM,Imperia,0,603,0,0,0,0,0,0,603,552,0,0,0,0,0,0,552,1155
IT-IM,Imperia,1,617,0,0,0,0,0,0,617,624,0,0,0,0,0,0,624,1241
IT-IM,Imperia,2,662,0,0,0,0,0,0,662,623,0,0,0,0,0,0,623,1285
IT-IM,Imperia,3,681,0,0,0,0,0,0,681,680,0,0,0,0,0,0,680,1361
IT-IM,Imperia,4,655,0,0,0,0,0,0,655,653,0,0,0,0,0,0,653,1308
IT-IM,Imperia,5,717,0,0,0,0,0,0,717,654,0,0,0,0,0,0,654,1371
IT-IM,Imperia,6,754,0,0,0,0,0,0,754,732,0,0,0,0,0,0,732,1486
IT-IM,Imperia,7,789,0,0,0,0,0,0,789,739,0,0,0,0,0,0,739,1528
IT-IM,Imperia,8,793,0,0,0,0,0,0,793,754,0,0,0,0,0,0,754,1547
IT-IM,Imperia,9,832,0,0,0,0,0,0,832,764,0,0,0,0,0,0,764,1596
IT-IM,Imperia,10,820,0,0,0,0,0,0,820,785,0,0,0,0,0,0,785,1605
IT-IM,Imperia,11,859,0,0,0,0,0,0,859,812,0,0,0,0,0,0,812,1671
IT-IM,Imperia,12,896,0,0,0,0,0,0,896,787,0,0,0,0,0,0,787,1683
IT-IM,Imperia,13,899,0,0,0,0,0,0,899,821,0,0,0,0,0,0,821,1720
IT-IM,Imperia,14,891,0,0,0,0,0,0,891,890,0,0,0,0,0,0,890,1781
IT-IM,Imperia,15,935,0,0,0,0,0,0,935,908,0,0,0,0,0,0,908,1843
IT-IM,Imperia,16,986,0,0,0,0,0,0,986,837,0,0,0,0,0,0,837,1823
IT-IM,Imperia,17,873,0,0,0,0,0,0,873,874,0,0,0,0,0,0,874,1747
IT-IM,Imperia,18,972,0,0,0,0,0,0,972,921,0,0,0,0,0,0,921,1893
IT-IM,Imperia,19,979,0,0,0,0,0,0,979,901,4,0,0,0,0,0,905,1884
IT-IM,Imperia,20,925,3,0,0,0,0,0,928,812,10,0,0,0,0,0,822,1750
IT-IM,Imperia,21,976,2,0,0,0,0,0,978,773,23,0,0,0,0,0,796,1774
IT-IM,Imperia,22,999,7,0,0,0,0,0,1006,924,25,3,0,0,0,0,952,1958
IT-IM,Imperia,23,1027,7,1,0,0,0,0,1035,837,60,0,0,2,0,0,899,1934
IT-IM,Imperia,24,1016,10,0,0,0,0,0,1026,899,65,3,1,1,0,0,969,1995
IT-IM,Imperia,25,1119,17,3,0,0,0,0,1139,826,62,0,0,2,0,0,890,2029
IT-IM,Imperia,26,1050,41,0,0,0,0,0,1091,791,116,4,0,1,0,0,912,2003
IT-IM,Imperia,27,1079,44,1,2,2,0,0,1128,769,149,4,0,3,0,0,925,2053
IT-IM,Imperia,28,980,84,5,0,0,0,0,1069,770,175,2,1,1,0,0,949,2018
IT-IM,Imperia,29,922,99,4,0,3,0,0,1028,727,214,9,0,0,0,0,950,1978
IT-IM,Imperia,30,969,114,8,0,1,0,0,1092,656,312,6,1,2,1,0,978,2070
IT-IM,Imperia,31,956,169,6,0,0,0,0,1131,719,294,18,0,2,0,0,1033,2164
IT-IM,Imperia,32,850,217,11,1,0,0,0,1079,627,354,19,1,2,0,0,1003,2082
IT-IM,Imperia,33,824,273,8,0,1,0,0,1106,589,416,22,2,2,0,0,1031,2137
IT-IM,Imperia,34,750,320,15,3,3,0,0,1091,578,421,25,1,4,0,0,1029,2120
IT-IM,Imperia,35,739,305,14,0,3,0,0,1061,585,463,31,4,3,0,0,1086,2147
IT-IM,Imperia,36,739,378,20,1,1,1,0,1140,530,461,28,2,2,0,0,1023,2163
IT-IM,Imperia,37,695,420,27,2,3,0,0,1147,475,489,45,2,0,0,0,1011,2158
IT-IM,Imperia,38,661,413,29,2,3,0,0,1108,468,575,56,11,3,0,0,1113,2221
IT-IM,Imperia,39,582,506,32,4,0,0,0,1124,428,519,63,10,3,0,0,1023,2147
IT-IM,Imperia,40,576,530,38,2,0,0,0,1146,421,576,66,8,4,0,0,1075,2221
IT-IM,Imperia,41,566,508,38,4,2,0,0,1118,389,589,66,6,3,0,0,1053,2171
IT-IM,Imperia,42,579,552,48,5,3,0,0,1187,389,642,90,11,0,0,1,1133,2320
IT-IM,Imperia,43,561,547,55,5,2,0,0,1170,393,627,99,20,4,0,0,1143,2313
IT-IM,Imperia,44,500,592,62,8,3,0,0,1165,361,694,83,10,1,0,0,1149,2314
IT-IM,Imperia,45,552,623,69,9,0,0,0,1253,436,739,123,20,2,0,0,1320,2573
IT-IM,Imperia,46,546,649,83,6,3,0,0,1287,425,754,136,28,2,0,0,1345,2632
IT-IM,Imperia,47,542,739,89,2,2,0,0,1374,401,852,160,26,1,0,0,1440,2814
IT-IM,Imperia,48,579,771,98,5,2,0,0,1455,415,893,152,23,2,0,0,1485,2940
IT-IM,Imperia,49,547,847,127,4,2,0,0,1527,448,916,196,44,1,0,0,1605,3132
IT-IM,Imperia,50,587,844,119,9,1,0,0,1560,396,958,178,35,3,0,0,1570,3130
IT-IM,Imperia,51,609,939,155,13,1,0,1,1718,400,992,240,34,3,0,0,1669,3387
IT-IM,Imperia,52,551,942,139,11,3,0,0,1646,346,1014,228,47,2,0,0,1637,3283
IT-IM,Imperia,53,559,953,155,14,3,0,0,1684,373,1041,254,72,1,0,0,1741,3425
IT-IM,Imperia,54,505,1044,174,13,4,0,0,1740,327,1064,237,71,3,0,0,1702,3442
IT-IM,Imperia,55,491,1113,170,19,2,0,0,1795,343,1078,274,75,1,0,0,1771,3566
IT-IM,Imperia,56,444,1027,199,7,4,0,0,1681,321,1161,257,83,2,0,0,1824,3505
IT-IM,Imperia,57,490,1070,199,21,0,0,0,1780,304,1161,275,99,2,0,0,1841,3621
IT-IM,Imperia,58,405,1154,229,31,6,0,0,1825,319,1253,273,100,0,0,0,1945,3770
IT-IM,Imperia,59,402,1133,219,25,3,0,0,1782,273,1270,285,121,1,0,0,1950,3732
IT-IM,Imperia,60,347,1084,215,25,2,0,0,1673,252,1159,246,130,1,0,0,1788,3461
IT-IM,Imperia,61,332,1127,196,25,3,0,0,1683,232,1139,254,127,1,0,0,1753,3436
IT-IM,Imperia,62,304,1079,199,39,2,0,0,1623,182,1122,232,156,0,0,0,1692,3315
IT-IM,Imperia,63,223,1136,204,47,1,0,0,1611,203,1037,231,158,1,0,0,1630,3241
IT-IM,Imperia,64,250,1064,204,38,2,0,0,1558,175,1053,238,193,0,0,0,1659,3217
IT-IM,Imperia,65,204,998,165,50,3,0,0,1420,158,1016,225,193,0,0,0,1592,3012
IT-IM,Imperia,66,235,1038,182,48,2,0,1,1506,162,980,175,207,0,0,0,1524,3030
IT-IM,Imperia,67,191,964,173,57,1,0,0,1386,136,942,177,198,0,0,1,1454,2840
IT-IM,Imperia,68,165,951,144,47,2,0,0,1309,145,870,168,252,0,0,0,1435,2744
IT-IM,Imperia,69,150,940,136,61,0,0,0,1287,119,863,149,262,0,0,0,1393,2680
IT-IM,Imperia,70,145,952,118,63,3,0,0,1281,106,858,164,289,0,0,0,1417,2698
IT-IM,Imperia,71,136,869,116,65,4,0,0,1190,100,787,142,257,0,0,0,1286,2476
IT-IM,Imperia,72,105,846,97,69,1,0,0,1118,89,793,134,311,0,0,0,1327,2445
IT-IM,Imperia,73,106,866,93,89,1,0,0,1155,100,800,120,361,0,0,0,1381,2536
IT-IM,Imperia,74,92,905,85,79,0,0,0,1161,92,770,128,436,1,0,0,1427,2588
IT-IM,Imperia,75,118,875,111,112,1,0,0,1217,93,816,116,452,1,0,0,1478,2695
IT-IM,Imperia,76,95,917,85,102,0,0,0,1199,97,755,117,484,0,0,0,1453,2652
IT-IM,Imperia,77,89,867,72,107,1,0,0,1136,82,751,110,515,1,0,0,1459,2595
IT-IM,Imperia,78,72,616,57,95,1,0,0,841,58,523,73,452,0,0,0,1106,1947
IT-IM,Imperia,79,82,662,58,126,0,0,0,928,74,516,68,497,0,0,0,1155,2083
IT-IM,Imperia,80,66,590,50,119,1,0,0,826,72,462,61,484,0,0,0,1079,1905
IT-IM,Imperia,81,68,603,53,120,0,0,0,844,55,423,68,550,0,0,0,1096,1940
IT-IM,Imperia,82,52,591,32,155,0,0,0,830,60,432,62,596,0,0,0,1150,1980
IT-IM,Imperia,83,52,583,34,145,0,0,0,814,71,438,62,675,0,0,0,1246,2060
IT-IM,Imperia,84,53,496,40,127,0,0,0,716,57,325,57,681,0,0,0,1120,1836
IT-IM,Imperia,85,38,486,27,137,0,0,0,688,57,272,49,627,0,0,0,1005,1693
IT-IM,Imperia,86,45,403,21,119,0,0,0,588,45,214,50,615,0,0,0,924,1512
IT-IM,Imperia,87,31,339,15,127,0,0,0,512,50,186,32,572,0,0,0,840,1352
IT-IM,Imperia,88,30,271,22,133,0,0,0,456,50,143,27,556,0,0,0,776,1232
IT-IM,Imperia,89,19,204,10,110,0,0,0,343,35,103,32,458,0,0,0,628,971
IT-IM,Imperia,90,8,184,9,97,0,0,0,298,28,74,19,431,0,0,0,552,850
IT-IM,Imperia,91,19,114,4,85,0,0,0,222,27,57,18,416,0,0,0,518,740
IT-IM,Imperia,92,5,79,3,59,0,0,0,146,30,39,12,312,0,0,0,393,539
IT-IM,Imperia,93,11,66,3,63,0,0,0,143,29,22,6,323,0,0,0,380,523
IT-IM,Imperia,94,8,44,2,38,0,0,0,92,22,16,7,224,0,0,0,269,361
IT-IM,Imperia,95,6,34,1,39,0,0,0,80,18,13,7,182,0,0,0,220,300
IT-IM,Imperia,96,3,21,0,23,0,0,0,47,9,6,5,107,0,0,0,127,174
IT-IM,Imperia,97,2,6,1,8,0,0,0,17,9,5,1,98,0,0,0,113,130
IT-IM,Imperia,98,2,6,0,8,0,0,0,16,4,6,2,65,0,0,0,77,93
IT-IM,Imperia,99,1,3,3,10,0,0,0,17,7,4,2,42,0,0,0,55,72
IT-IM,Imperia,100,3,2,0,14,0,0,0,19,8,3,2,94,0,0,0,107,126
IT-IM,Imperia,999,48625,43887,5689,3308,97,1,2,101609,39972,44274,7858,15007,77,1,2,107191,208800
IT-IS,Isernia,0,228,0,0,0,0,0,0,228,219,0,0,0,0,0,0,219,447
IT-IS,Isernia,1,259,0,0,0,0,0,0,259,236,0,0,0,0,0,0,236,495
IT-IS,Isernia,2,233,0,0,0,0,0,0,233,223,0,0,0,0,0,0,223,456
IT-IS,Isernia,3,255,0,0,0,0,0,0,255,195,0,0,0,0,0,0,195,450
IT-IS,Isernia,4,270,0,0,0,0,0,0,270,263,0,0,0,0,0,0,263,533
IT-IS,Isernia,5,269,0,0,0,0,0,0,269,286,0,0,0,0,0,0,286,555
IT-IS,Isernia,6,289,0,0,0,0,0,0,289,282,0,0,0,0,0,0,282,571
IT-IS,Isernia,7,280,0,0,0,0,0,0,280,287,0,0,0,0,0,0,287,567
IT-IS,Isernia,8,324,0,0,0,0,0,0,324,276,0,0,0,0,0,0,276,600
IT-IS,Isernia,9,329,0,0,0,0,0,0,329,268,0,0,0,0,0,0,268,597
IT-IS,Isernia,10,316,0,0,0,0,0,0,316,297,0,0,0,0,0,0,297,613
IT-IS,Isernia,11,322,0,0,0,0,0,0,322,304,0,0,0,0,0,0,304,626
IT-IS,Isernia,12,300,0,0,0,0,0,0,300,300,0,0,0,0,0,0,300,600
IT-IS,Isernia,13,334,0,0,0,0,0,0,334,309,0,0,0,0,0,0,309,643
IT-IS,Isernia,14,329,0,0,0,0,0,0,329,296,0,0,0,0,0,0,296,625
IT-IS,Isernia,15,347,0,0,0,0,0,0,347,297,0,0,0,0,0,0,297,644
IT-IS,Isernia,16,341,0,0,0,0,0,0,341,329,0,0,0,0,0,0,329,670
IT-IS,Isernia,17,344,0,0,0,0,0,0,344,311,0,0,0,0,0,0,311,655
IT-IS,Isernia,18,367,0,0,0,0,0,0,367,352,0,0,0,0,0,0,352,719
IT-IS,Isernia,19,385,0,0,0,0,0,0,385,308,0,0,0,0,0,0,308,693
IT-IS,Isernia,20,379,0,0,0,0,0,0,379,298,1,0,0,0,0,0,299,678
IT-IS,Isernia,21,385,5,0,0,0,0,0,390,356,1,0,0,0,0,0,357,747
IT-IS,Isernia,22,398,1,0,0,0,0,0,399,342,4,0,0,1,0,0,347,746
IT-IS,Isernia,23,404,1,0,0,0,0,0,405,335,10,0,0,0,0,0,345,750
IT-IS,Isernia,24,406,5,0,1,0,0,0,412,319,7,0,0,1,0,0,327,739
IT-IS,Isernia,25,463,10,0,0,0,0,0,473,342,11,1,0,1,0,0,355,828
IT-IS,Isernia,26,421,14,1,0,0,0,0,436,322,28,0,0,0,0,0,350,786
IT-IS,Isernia,27,408,21,1,0,0,0,0,430,335,34,0,0,0,0,0,369,799
IT-IS,Isernia,28,380,28,0,0,0,0,0,408,340,49,3,0,0,0,0,392,800
IT-IS,Isernia,29,422,24,0,0,0,0,0,446,321,56,0,0,1,0,0,378,824
IT-IS,Isernia,30,397,45,0,0,0,0,0,442,320,80,1,0,0,0,0,401,843
IT-IS,Isernia,31,388,66,1,0,0,0,0,455,308,117,2,0,0,0,0,427,882
IT-IS,Isernia,32,408,62,1,0,0,0,0,471,269,125,4,1,0,0,0,399,870
IT-IS,Isernia,33,370,91,1,0,0,0,0,462,252,167,3,2,0,0,0,424,886
IT-IS,Isernia,34,336,99,2,1,0,0,0,438,244,179,4,0,0,0,0,427,865
IT-IS,Isernia,35,353,157,2,0,0,0,0,512,231,186,9,1,1,0,0,428,940
IT-IS,Isernia,36,323,132,5,0,0,0,0,460,203,236,4,1,0,0,0,444,904
IT-IS,Isernia,37,323,194,6,0,0,0,0,523,196,224,8,2,0,0,0,430,953
IT-IS,Isernia,38,271,224,9,0,0,0,0,504,189,256,5,1,0,0,0,451,955
IT-IS,Isernia,39,292,219,2,0,0,0,0,513,165,245,13,5,1,0,0,429,942
IT-IS,Isernia,40,237,230,13,1,0,0,0,481,156,247,9,3,0,0,0,415,896
IT-IS,Isernia,41,249,228,10,0,0,0,0,487,160,283,11,6,0,0,0,460,947
IT-IS,Isernia,42,216,278,8,2,1,0,0,505,161,311,22,3,0,0,0,497,1002
IT-IS,Isernia,43,219,271,7,1,1,0,0,499,126,335,21,4,0,0,0,486,985
IT-IS,Isernia,44,217,274,13,2,1,0,0,507,127,337,16,2,0,0,0,482,989
IT-IS,Isernia,45,200,303,13,1,0,0,0,517,125,349,16,5,0,0,0,495,1012
IT-IS,Isernia,46,200,336,20,2,0,0,0,558,121,351,27,6,0,0,0,505,1063
IT-IS,Isernia,47,191,380,28,2,0,0,0,601,124,374,21,7,0,0,0,526,1127
IT-IS,Isernia,48,177,404,22,3,2,0,0,608,102,370,29,10,0,0,0,511,1119
IT-IS,Isernia,49,192,408,13,0,3,0,0,616,99,439,34,17,0,0,0,589,1205
IT-IS,Isernia,50,178,378,22,4,0,0,0,582,98,452,37,16,0,0,0,603,1185
IT-IS,Isernia,51,145,395,30,2,1,0,0,573,94,440,32,7,0,0,0,573,1146
IT-IS,Isernia,52,158,392,27,6,1,0,0,584,85,494,33,17,0,0,0,629,1213
IT-IS,Isernia,53,148,391,24,0,0,0,0,563,75,452,38,25,0,0,0,590,1153
IT-IS,Isernia,54,123,404,29,4,0,0,0,560,78,488,41,21,0,0,0,628,1188
IT-IS,Isernia,55,142,443,32,7,0,0,0,624,72,524,36,31,0,0,0,663,1287
IT-IS,Isernia,56,149,450,32,6,0,0,0,637,78,506,43,34,0,0,0,661,1298
IT-IS,Isernia,57,122,502,22,2,0,0,0,648,91,481,29,46,0,0,0,647,1295
IT-IS,Isernia,58,120,476,35,7,0,0,0,638,71,496,34,52,0,0,0,653,1291
IT-IS,Isernia,59,105,522,37,7,1,0,0,672,66,520,34,59,0,0,0,679,1351
IT-IS,Isernia,60,105,494,25,15,0,0,0,639,57,509,27,46,0,0,0,639,1278
IT-IS,Isernia,61,100,445,32,17,1,0,0,595,60,473,32,53,0,0,0,618,1213
IT-IS,Isernia,62,81,463,32,12,0,0,0,588,54,470,14,69,0,0,0,607,1195
IT-IS,Isernia,63,81,500,18,12,1,0,0,612,63,471,24,81,0,0,0,639,1251
IT-IS,Isernia,64,64,495,19,13,0,0,0,591,58,456,29,87,0,0,0,630,1221
IT-IS,Isernia,65,73,440,22,19,1,0,0,555,46,438,15,81,0,0,0,580,1135
IT-IS,Isernia,66,68,473,25,17,0,0,0,583,54,415,16,107,0,0,0,592,1175
IT-IS,Isernia,67,55,507,19,18,0,0,0,599,33,419,22,85,0,0,0,559,1158
IT-IS,Isernia,68,57,446,20,19,1,0,0,543,53,411,22,96,0,0,0,582,1125
IT-IS,Isernia,69,60,478,16,26,0,0,0,580,41,402,18,118,1,0,0,580,1160
IT-IS,Isernia,70,38,436,20,30,0,0,0,524,40,384,12,126,0,0,0,562,1086
IT-IS,Isernia,71,36,445,15,18,0,0,0,514,49,349,12,116,0,0,0,526,1040
IT-IS,Isernia,72,22,397,14,28,0,0,0,461,38,315,9,133,0,0,0,495,956
IT-IS,Isernia,73,34,397,12,27,0,0,0,470,31,321,8,161,0,0,0,521,991
IT-IS,Isernia,74,33,428,17,35,0,0,0,513,33,326,12,181,0,0,0,552,1065
IT-IS,Isernia,75,34,385,10,46,0,0,0,475,34,292,5,180,0,0,0,511,986
IT-IS,Isernia,76,26,380,13,42,0,0,0,461,32,287,10,187,0,0,0,516,977
IT-IS,Isernia,77,23,342,6,42,0,0,0,413,22,237,9,172,0,0,0,440,853
IT-IS,Isernia,78,25,242,6,37,0,0,0,310,15,166,2,148,0,0,0,331,641
IT-IS,Isernia,79,15,227,6,27,0,0,0,275,16,162,9,166,0,0,0,353,628
IT-IS,Isernia,80,18,191,2,37,0,0,0,248,19,144,3,148,0,0,0,314,562
IT-IS,Isernia,81,14,204,5,46,0,0,0,269,19,119,7,150,0,0,0,295,564
IT-IS,Isernia,82,9,193,6,32,0,0,0,240,24,130,3,189,0,0,0,346,586
IT-IS,Isernia,83,13,204,2,49,0,0,0,268,22,125,6,210,0,0,0,363,631
IT-IS,Isernia,84,11,200,5,52,0,0,0,268,14,115,2,238,0,0,0,369,637
IT-IS,Isernia,85,5,174,2,34,0,0,0,215,14,102,2,184,0,0,0,302,517
IT-IS,Isernia,86,12,138,0,46,0,0,0,196,16,66,3,212,0,0,0,297,493
IT-IS,Isernia,87,5,122,0,54,0,0,0,181,9,69,2,226,0,0,0,306,487
IT-IS,Isernia,88,5,100,2,50,0,0,0,157,17,42,2,182,0,0,0,243,400
IT-IS,Isernia,89,11,85,1,51,0,0,0,148,13,31,4,178,0,0,0,226,374
IT-IS,Isernia,90,5,69,1,43,0,0,0,118,20,40,2,174,0,0,0,236,354
IT-IS,Isernia,91,5,48,0,30,0,0,0,83,9,25,2,143,0,0,0,179,262
IT-IS,Isernia,92,1,47,0,32,0,0,0,80,9,17,1,143,0,0,0,170,250
IT-IS,Isernia,93,2,32,0,26,0,0,0,60,9,11,2,115,0,0,0,137,197
IT-IS,Isernia,94,0,20,0,21,0,0,0,41,6,8,1,91,0,0,0,106,147
IT-IS,Isernia,95,0,13,0,16,0,0,0,29,9,6,0,62,0,0,0,77,106
IT-IS,Isernia,96,2,7,0,9,0,0,0,18,3,5,0,52,0,0,0,60,78
IT-IS,Isernia,97,1,10,1,6,0,0,0,18,6,2,0,48,0,0,0,56,74
IT-IS,Isernia,98,0,4,0,3,0,0,0,7,3,2,0,27,0,0,0,32,39
IT-IS,Isernia,99,1,1,0,6,0,0,0,8,2,3,0,25,0,0,0,30,38
IT-IS,Isernia,100,1,6,0,6,0,0,0,13,3,1,1,40,0,0,0,45,58
IT-IS,Isernia,999,18287,19151,842,1210,15,0,0,39505,14509,18631,970,5614,7,0,0,39731,79236
IT-AQ,L'Aquila,0,887,0,0,0,0,0,0,887,772,0,0,0,0,0,0,772,1659
IT-AQ,L'Aquila,1,880,0,0,0,0,0,0,880,873,0,0,0,0,0,0,873,1753
IT-AQ,L'Aquila,2,862,0,0,0,0,0,0,862,864,0,0,0,0,0,0,864,1726
IT-AQ,L'Aquila,3,992,0,0,0,0,0,0,992,913,0,0,0,0,0,0,913,1905
IT-AQ,L'Aquila,4,974,0,0,0,0,0,0,974,928,0,0,0,0,0,0,928,1902
IT-AQ,L'Aquila,5,1070,0,0,0,0,0,0,1070,977,0,0,0,0,0,0,977,2047
IT-AQ,L'Aquila,6,1099,0,0,0,0,0,0,1099,1031,0,0,0,0,0,0,1031,2130
IT-AQ,L'Aquila,7,1188,0,0,0,0,0,0,1188,1025,0,0,0,0,0,0,1025,2213
IT-AQ,L'Aquila,8,1225,0,0,0,0,0,0,1225,1105,0,0,0,0,0,0,1105,2330
IT-AQ,L'Aquila,9,1168,0,0,0,0,0,0,1168,1124,0,0,0,0,0,0,1124,2292
IT-AQ,L'Aquila,10,1202,0,0,0,0,0,0,1202,1133,0,0,0,0,0,0,1133,2335
IT-AQ,L'Aquila,11,1292,0,0,0,0,0,0,1292,1274,0,0,0,0,0,0,1274,2566
IT-AQ,L'Aquila,12,1306,0,0,0,0,0,0,1306,1210,0,0,0,0,0,0,1210,2516
IT-AQ,L'Aquila,13,1282,0,0,0,0,0,0,1282,1250,0,0,0,0,0,0,1250,2532
IT-AQ,L'Aquila,14,1304,0,0,0,0,0,0,1304,1189,0,0,0,0,0,0,1189,2493
IT-AQ,L'Aquila,15,1338,0,0,0,0,0,0,1338,1177,0,0,0,0,0,0,1177,2515
IT-AQ,L'Aquila,16,1294,0,0,0,0,0,0,1294,1181,0,0,0,0,0,0,1181,2475
IT-AQ,L'Aquila,17,1272,0,0,0,0,0,0,1272,1156,0,0,0,0,0,0,1156,2428
IT-AQ,L'Aquila,18,1309,1,0,0,0,0,0,1310,1268,0,0,0,0,0,0,1268,2578
IT-AQ,L'Aquila,19,1447,1,0,0,0,0,0,1448,1196,3,0,0,0,0,0,1199,2647
IT-AQ,L'Aquila,20,1370,1,0,0,0,0,0,1371,1142,10,0,0,0,0,0,1152,2523
IT-AQ,L'Aquila,21,1285,7,0,0,0,0,0,1292,1152,21,0,0,0,0,0,1173,2465
IT-AQ,L'Aquila,22,1392,11,0,0,0,0,0,1403,1198,31,0,0,0,0,0,1229,2632
IT-AQ,L'Aquila,23,1453,14,0,0,0,0,0,1467,1196,55,1,0,0,0,0,1252,2719
IT-AQ,L'Aquila,24,1424,16,0,1,0,0,0,1441,1196,70,1,0,0,0,0,1267,2708
IT-AQ,L'Aquila,25,1411,26,0,0,1,0,0,1438,1187,96,1,0,1,0,0,1285,2723
IT-AQ,L'Aquila,26,1334,34,1,5,0,0,0,1374,1156,122,1,0,0,0,0,1279,2653
IT-AQ,L'Aquila,27,1357,60,0,0,0,0,0,1417,1173,137,3,0,2,1,0,1316,2733
IT-AQ,L'Aquila,28,1389,90,1,1,0,0,0,1481,1161,180,4,0,2,0,0,1347,2828
IT-AQ,L'Aquila,29,1393,119,4,5,0,0,0,1521,1079,289,8,1,0,0,0,1377,2898
IT-AQ,L'Aquila,30,1371,135,1,3,0,0,0,1510,1044,286,6,3,1,0,0,1340,2850
IT-AQ,L'Aquila,31,1375,200,4,1,1,0,0,1581,1029,398,5,1,2,0,0,1435,3016
IT-AQ,L'Aquila,32,1393,235,4,1,2,0,0,1635,1037,465,13,0,0,0,0,1515,3150
IT-AQ,L'Aquila,33,1310,343,5,4,0,0,0,1662,891,553,22,1,2,0,0,1469,3131
IT-AQ,L'Aquila,34,1291,419,13,1,1,0,0,1725,866,610,19,4,0,0,0,1499,3224
IT-AQ,L'Aquila,35,1190,470,11,1,2,0,0,1674,800,725,27,4,1,0,0,1557,3231
IT-AQ,L'Aquila,36,1112,541,13,2,0,0,0,1668,779,748,30,3,1,0,0,1561,3229
IT-AQ,L'Aquila,37,1085,604,14,3,2,0,0,1708,747,815,35,5,0,0,0,1602,3310
IT-AQ,L'Aquila,38,1053,647,25,4,0,0,0,1729,738,886,50,9,2,0,0,1685,3414
IT-AQ,L'Aquila,39,998,750,31,3,0,0,0,1782,693,956,46,7,1,0,0,1703,3485
IT-AQ,L'Aquila,40,962,812,31,4,1,0,0,1810,658,950,57,10,1,0,0,1676,3486
IT-AQ,L'Aquila,41,951,890,33,0,1,0,0,1875,662,1092,54,12,0,0,0,1820,3695
IT-AQ,L'Aquila,42,900,988,52,7,1,0,0,1948,559,1135,64,19,0,0,0,1777,3725
IT-AQ,L'Aquila,43,857,1002,48,3,3,0,0,1913,568,1100,93,17,1,0,0,1779,3692
IT-AQ,L'Aquila,44,836,1127,65,9,0,0,0,2037,545,1236,97,22,1,0,0,1901,3938
IT-AQ,L'Aquila,45,847,1203,90,7,2,0,0,2149,480,1234,110,22,0,0,0,1846,3995
IT-AQ,L'Aquila,46,802,1229,62,11,0,0,0,2104,508,1271,119,25,0,0,0,1923,4027
IT-AQ,L'Aquila,47,813,1268,110,9,1,0,0,2201,472,1334,121,28,0,0,0,1955,4156
IT-AQ,L'Aquila,48,759,1335,100,13,1,0,0,2208,507,1430,133,36,1,0,0,2107,4315
IT-AQ,L'Aquila,49,703,1448,97,5,2,0,0,2255,470,1559,174,56,2,0,0,2261,4516
IT-AQ,L'Aquila,50,635,1282,109,15,0,0,0,2041,443,1540,136,45,1,0,0,2165,4206
IT-AQ,L'Aquila,51,600,1445,132,12,1,0,0,2190,398,1626,179,53,0,0,0,2256,4446
IT-AQ,L'Aquila,52,624,1431,139,7,0,0,0,2201,382,1588,183,55,0,0,0,2208,4409
IT-AQ,L'Aquila,53,581,1505,118,8,2,0,0,2214,348,1565,180,71,0,0,0,2164,4378
IT-AQ,L'Aquila,54,528,1578,136,15,1,0,0,2258,337,1570,170,81,0,0,0,2158,4416
IT-AQ,L'Aquila,55,502,1605,132,25,1,0,0,2265,349,1661,175,117,0,0,0,2302,4567
IT-AQ,L'Aquila,56,473,1627,151,19,1,0,0,2271,320,1743,168,76,1,0,0,2308,4579
IT-AQ,L'Aquila,57,468,1665,149,30,0,0,0,2312,271,1801,180,126,0,0,0,2378,4690
IT-AQ,L'Aquila,58,430,1706,169,28,0,0,0,2333,250,1778,173,121,0,0,0,2322,4655
IT-AQ,L'Aquila,59,399,1855,150,30,1,0,0,2435,245,1755,187,161,0,0,0,2348,4783
IT-AQ,L'Aquila,60,367,1707,163,32,1,0,0,2270,251,1783,189,186,1,0,0,2410,4680
IT-AQ,L'Aquila,61,323,1729,166,36,0,0,0,2254,248,1685,146,203,0,0,0,2282,4536
IT-AQ,L'Aquila,62,299,1643,135,50,0,0,0,2127,233,1739,145,200,0,0,0,2317,4444
IT-AQ,L'Aquila,63,285,1711,117,46,0,0,0,2159,208,1699,140,229,1,0,0,2277,4436
IT-AQ,L'Aquila,64,252,1694,110,45,0,0,0,2101,215,1664,117,243,0,0,0,2239,4340
IT-AQ,L'Aquila,65,247,1612,103,59,0,0,0,2021,165,1557,125,236,0,0,0,2083,4104
IT-AQ,L'Aquila,66,233,1619,96,58,0,0,0,2006,171,1525,119,270,0,0,0,2085,4091
IT-AQ,L'Aquila,67,193,1699,107,58,1,0,0,2058,154,1429,111,317,0,0,0,2011,4069
IT-AQ,L'Aquila,68,195,1657,90,72,0,0,0,2014,144,1437,94,370,0,0,0,2045,4059
IT-AQ,L'Aquila,69,168,1643,82,73,0,0,0,1966,148,1439,102,377,0,0,0,2066,4032
IT-AQ,L'Aquila,70,130,1492,81,89,0,0,0,1792,112,1308,87,382,0,0,0,1889,3681
IT-AQ,L'Aquila,71,138,1466,81,101,0,0,0,1786,124,1221,87,429,0,0,0,1861,3647
IT-AQ,L'Aquila,72,118,1365,74,85,0,0,0,1642,110,1175,83,461,0,0,0,1829,3471
IT-AQ,L'Aquila,73,113,1458,67,113,0,0,0,1751,117,1139,62,480,0,0,0,1798,3549
IT-AQ,L'Aquila,74,106,1370,55,125,1,0,0,1657,114,1231,58,547,0,0,0,1950,3607
IT-AQ,L'Aquila,75,113,1437,56,121,1,0,0,1728,113,1079,57,639,0,0,0,1888,3616
IT-AQ,L'Aquila,76,105,1303,46,135,0,0,0,1589,130,973,44,661,0,0,0,1808,3397
IT-AQ,L'Aquila,77,97,1156,38,146,1,0,0,1438,102,875,35,587,0,0,0,1599,3037
IT-AQ,L'Aquila,78,47,830,32,77,0,0,0,986,68,566,32,504,0,0,0,1170,2156
IT-AQ,L'Aquila,79,56,869,24,106,0,0,0,1055,69,577,24,564,0,0,0,1234,2289
IT-AQ,L'Aquila,80,70,818,23,117,0,0,0,1028,72,528,19,611,0,0,0,1230,2258
IT-AQ,L'Aquila,81,61,708,13,121,0,0,0,903,60,454,26,635,0,0,0,1175,2078
IT-AQ,L'Aquila,82,43,655,17,132,0,0,0,847,74,415,27,613,0,0,0,1129,1976
IT-AQ,L'Aquila,83,48,712,24,150,0,0,0,934,64,448,27,818,0,0,0,1357,2291
IT-AQ,L'Aquila,84,43,662,15,158,0,0,0,878,72,308,14,769,0,0,0,1163,2041
IT-AQ,L'Aquila,85,30,527,12,150,0,0,0,719,60,289,19,717,0,0,0,1085,1804
IT-AQ,L'Aquila,86,43,496,6,153,0,0,0,698,62,260,15,713,0,0,0,1050,1748
IT-AQ,L'Aquila,87,28,371,10,127,0,0,0,536,61,169,8,642,0,0,0,880,1416
IT-AQ,L'Aquila,88,27,310,1,131,0,0,0,469,48,157,10,624,0,0,0,839,1308
IT-AQ,L'Aquila,89,16,265,0,125,0,0,0,406,44,110,6,593,0,0,0,753,1159
IT-AQ,L'Aquila,90,18,245,1,105,0,0,0,369,34,98,6,558,0,0,0,696,1065
IT-AQ,L'Aquila,91,12,166,3,90,0,0,0,271,42,58,5,450,0,0,0,555,826
IT-AQ,L'Aquila,92,12,112,2,91,0,0,0,217,30,46,5,456,0,0,0,537,754
IT-AQ,L'Aquila,93,8,114,1,88,0,0,0,211,32,32,3,377,0,0,0,444,655
IT-AQ,L'Aquila,94,6,61,0,68,0,0,0,135,23,22,3,297,0,0,0,345,480
IT-AQ,L'Aquila,95,3,33,0,50,0,0,0,86,17,14,1,214,0,0,0,246,332
IT-AQ,L'Aquila,96,2,33,0,38,0,0,0,73,10,11,1,165,0,0,0,187,260
IT-AQ,L'Aquila,97,2,14,0,22,0,0,0,38,4,5,0,108,0,0,0,117,155
IT-AQ,L'Aquila,98,0,8,0,16,0,0,0,24,4,2,1,78,0,0,0,85,109
IT-AQ,L'Aquila,99,0,5,0,15,0,0,0,20,6,4,0,68,0,0,0,78,98
IT-AQ,L'Aquila,100,1,8,0,22,0,0,0,31,6,9,1,93,0,0,0,109,140
IT-AQ,L'Aquila,999,67105,67508,4051,3888,33,0,0,142585,54503,65964,5079,18675,25,1,0,144247,286832
IT-SP,La Spezia,0,663,0,0,0,0,0,0,663,570,0,0,0,0,0,0,570,1233
IT-SP,La Spezia,1,631,0,0,0,0,0,0,631,589,0,0,0,0,0,0,589,1220
IT-SP,La Spezia,2,629,0,0,0,0,0,0,629,682,0,0,0,0,0,0,682,1311
IT-SP,La Spezia,3,700,0,0,0,0,0,0,700,651,0,0,0,0,0,0,651,1351
IT-SP,La Spezia,4,711,0,0,0,0,0,0,711,674,0,0,0,0,0,0,674,1385
IT-SP,La Spezia,5,772,0,0,0,0,0,0,772,660,0,0,0,0,0,0,660,1432
IT-SP,La Spezia,6,827,0,0,0,0,0,0,827,754,0,0,0,0,0,0,754,1581
IT-SP,La Spezia,7,862,0,0,0,0,0,0,862,720,0,0,0,0,0,0,720,1582
IT-SP,La Spezia,8,812,0,0,0,0,0,0,812,757,0,0,0,0,0,0,757,1569
IT-SP,La Spezia,9,822,0,0,0,0,0,0,822,786,0,0,0,0,0,0,786,1608
IT-SP,La Spezia,10,904,0,0,0,0,0,0,904,820,0,0,0,0,0,0,820,1724
IT-SP,La Spezia,11,886,0,0,0,0,0,0,886,876,0,0,0,0,0,0,876,1762
IT-SP,La Spezia,12,927,0,0,0,0,0,0,927,835,0,0,0,0,0,0,835,1762
IT-SP,La Spezia,13,861,0,0,0,0,0,0,861,922,0,0,0,0,0,0,922,1783
IT-SP,La Spezia,14,931,0,0,0,0,0,0,931,904,0,0,0,0,0,0,904,1835
IT-SP,La Spezia,15,919,0,0,0,0,0,0,919,964,0,0,0,0,0,0,964,1883
IT-SP,La Spezia,16,991,0,0,0,0,0,0,991,842,0,0,0,0,0,0,842,1833
IT-SP,La Spezia,17,989,0,0,0,0,0,0,989,958,0,0,0,0,0,0,958,1947
IT-SP,La Spezia,18,959,0,0,0,0,0,0,959,832,0,0,0,0,0,0,832,1791
IT-SP,La Spezia,19,1067,2,0,0,0,0,0,1069,905,2,0,0,0,0,0,907,1976
IT-SP,La Spezia,20,979,0,0,0,0,0,0,979,884,4,1,0,0,0,0,889,1868
IT-SP,La Spezia,21,979,3,0,0,0,0,0,982,903,10,0,0,0,0,0,913,1895
IT-SP,La Spezia,22,949,2,2,0,0,0,0,953,944,12,2,0,0,0,0,958,1911
IT-SP,La Spezia,23,1022,4,0,0,1,0,0,1027,888,29,1,0,1,0,0,919,1946
IT-SP,La Spezia,24,1102,6,1,0,0,0,0,1109,848,33,3,0,0,0,0,884,1993
IT-SP,La Spezia,25,1093,16,0,1,0,0,0,1110,834,55,0,0,0,0,0,889,1999
IT-SP,La Spezia,26,1057,30,0,0,0,0,0,1087,879,66,1,0,2,0,0,948,2035
IT-SP,La Spezia,27,1029,37,4,0,0,0,0,1070,905,94,3,0,1,0,0,1003,2073
IT-SP,La Spezia,28,1010,42,3,0,0,0,0,1055,810,155,6,0,1,0,0,972,2027
IT-SP,La Spezia,29,990,85,2,0,0,0,0,1077,748,162,10,1,2,0,0,923,2000
IT-SP,La Spezia,30,972,108,6,0,0,0,0,1086,717,203,10,0,2,0,0,932,2018
IT-SP,La Spezia,31,988,158,3,0,0,0,0,1149,704,274,7,0,0,0,0,985,2134
IT-SP,La Spezia,32,879,185,11,3,3,0,0,1081,625,345,15,1,0,0,0,986,2067
IT-SP,La Spezia,33,894,248,10,2,2,0,0,1156,641,428,21,0,1,1,0,1092,2248
IT-SP,La Spezia,34,789,286,13,0,1,0,0,1089,645,406,25,1,4,0,0,1081,2170
IT-SP,La Spezia,35,797,354,19,4,2,1,0,1177,577,538,29,1,0,0,0,1145,2322
IT-SP,La Spezia,36,742,413,18,2,3,0,0,1178,519,496,35,0,2,0,0,1052,2230
IT-SP,La Spezia,37,685,429,28,1,2,0,0,1145,544,566,41,8,5,0,0,1164,2309
IT-SP,La Spezia,38,719,466,36,2,3,0,0,1226,470,580,54,7,2,0,0,1113,2339
IT-SP,La Spezia,39,661,490,28,2,1,0,0,1182,464,610,61,9,1,0,0,1145,2327
IT-SP,La Spezia,40,638,544,43,0,1,0,0,1226,431,607,65,7,4,0,0,1114,2340
IT-SP,La Spezia,41,608,606,38,4,2,0,0,1258,445,662,79,10,3,0,0,1199,2457
IT-SP,La Spezia,42,576,597,51,13,3,0,0,1240,421,718,67,12,2,1,0,1221,2461
IT-SP,La Spezia,43,582,625,47,6,1,0,0,1261,366,723,95,9,0,0,0,1193,2454
IT-SP,La Spezia,44,559,663,53,5,1,0,0,1281,414,750,84,18,1,1,0,1268,2549
IT-SP,La Spezia,45,596,775,63,9,2,0,0,1445,429,832,105,22,3,0,0,1391,2836
IT-SP,La Spezia,46,601,731,88,6,1,0,0,1427,435,908,117,15,4,0,0,1479,2906
IT-SP,La Spezia,47,599,796,84,9,3,0,0,1491,433,919,129,20,5,0,0,1506,2997
IT-SP,La Spezia,48,605,864,101,15,1,0,0,1586,389,968,143,25,2,0,0,1527,3113
IT-SP,La Spezia,49,592,952,115,12,2,0,0,1673,404,1071,171,29,4,0,0,1679,3352
IT-SP,La Spezia,50,601,995,110,9,0,0,0,1715,400,1107,171,53,4,0,0,1735,3450
IT-SP,La Spezia,51,561,1031,126,9,2,1,0,1730,347,1165,187,40,0,1,0,1740,3470
IT-SP,La Spezia,52,546,1059,139,8,3,0,0,1755,371,1164,206,43,1,0,0,1785,3540
IT-SP,La Spezia,53,514,1031,158,16,1,0,0,1720,333,1180,207,47,4,0,0,1771,3491
IT-SP,La Spezia,54,509,1100,164,9,4,0,0,1786,341,1226,237,72,2,0,0,1878,3664
IT-SP,La Spezia,55,462,1176,178,11,2,0,0,1829,323,1260,212,63,1,0,0,1859,3688
IT-SP,La Spezia,56,419,1181,158,17,6,1,0,1782,307,1281,243,83,1,0,0,1915,3697
IT-SP,La Spezia,57,432,1311,164,20,1,0,0,1928,300,1328,228,92,2,0,0,1950,3878
IT-SP,La Spezia,58,377,1242,210,23,1,0,1,1854,253,1393,247,92,3,0,0,1988,3842
IT-SP,La Spezia,59,370,1381,222,26,3,0,0,2002,245,1334,244,105,3,0,0,1931,3933
IT-SP,La Spezia,60,325,1240,171,20,3,0,0,1759,210,1264,235,100,2,0,0,1811,3570
IT-SP,La Spezia,61,276,1175,184,35,2,0,0,1672,205,1208,228,144,0,0,0,1785,3457
IT-SP,La Spezia,62,258,1236,166,29,2,0,0,1691,175,1212,214,125,0,1,0,1727,3418
IT-SP,La Spezia,63,226,1138,150,40,2,0,0,1556,128,1164,186,186,2,0,0,1666,3222
IT-SP,La Spezia,64,208,1104,153,31,1,0,0,1497,125,1082,183,134,0,0,0,1524,3021
IT-SP,La Spezia,65,206,1067,142,50,1,0,0,1466,130,1045,151,186,0,0,0,1512,2978
IT-SP,La Spezia,66,174,1031,131,44,2,0,0,1382,114,1021,155,190,1,0,0,1481,2863
IT-SP,La Spezia,67,142,1077,134,30,1,0,0,1384,98,991,149,207,0,0,0,1445,2829
IT-SP,La Spezia,68,138,980,94,61,0,0,0,1273,81,934,131,240,0,0,0,1386,2659
IT-SP,La Spezia,69,131,969,107,45,0,0,0,1252,81,948,130,269,0,0,0,1428,2680
IT-SP,La Spezia,70,93,975,69,57,0,0,0,1194,83,853,93,258,0,0,0,1287,2481
IT-SP,La Spezia,71,87,884,82,69,1,0,0,1123,60,882,106,244,0,0,0,1292,2415
IT-SP,La Spezia,72,94,889,79,50,0,0,0,1112,67,842,102,287,0,0,0,1298,2410
IT-SP,La Spezia,73,100,940,80,68,1,0,0,1189,63,873,66,319,0,0,0,1321,2510
IT-SP,La Spezia,74,98,962,68,95,1,0,0,1224,56,917,73,388,0,0,0,1434,2658
IT-SP,La Spezia,75,96,1065,50,105,0,0,0,1316,67,885,63,410,0,0,0,1425,2741
IT-SP,La Spezia,76,72,999,60,90,0,0,0,1221,64,882,83,498,0,0,0,1527,2748
IT-SP,La Spezia,77,77,1006,49,100,1,0,0,1233,62,846,76,527,0,0,0,1511,2744
IT-SP,La Spezia,78,50,627,28,106,0,0,0,811,45,545,41,392,0,0,0,1023,1834
IT-SP,La Spezia,79,62,721,37,107,0,0,0,927,51,603,53,536,0,1,0,1244,2171
IT-SP,La Spezia,80,56,706,29,106,0,0,0,897,28,498,49,563,0,0,0,1138,2035
IT-SP,La Spezia,81,36,685,32,114,0,0,0,867,49,510,29,584,0,0,0,1172,2039
IT-SP,La Spezia,82,44,663,27,141,0,0,0,875,48,492,42,622,0,0,0,1204,2079
IT-SP,La Spezia,83,61,657,20,142,1,0,0,881,51,439,44,697,0,0,0,1231,2112
IT-SP,La Spezia,84,39,564,16,147,0,0,0,766,41,388,36,678,0,0,0,1143,1909
IT-SP,La Spezia,85,47,509,16,131,0,0,0,703,51,292,33,685,0,0,0,1061,1764
IT-SP,La Spezia,86,34,396,15,121,0,0,0,566,40,225,26,628,0,0,0,919,1485
IT-SP,La Spezia,87,30,313,12,134,0,0,0,489,32,170,15,607,0,0,0,824,1313
IT-SP,La Spezia,88,27,257,5,112,0,0,0,401,40,110,14,542,0,0,0,706,1107
IT-SP,La Spezia,89,17,244,5,84,0,0,0,350,18,101,7,531,0,0,0,657,1007
IT-SP,La Spezia,90,17,166,5,85,0,0,0,273,26,68,7,445,0,0,0,546,819
IT-SP,La Spezia,91,14,130,5,83,0,0,0,232,23,56,8,434,0,0,0,521,753
IT-SP,La Spezia,92,17,102,4,53,0,0,0,176,31,45,6,387,0,0,0,469,645
IT-SP,La Spezia,93,7,90,2,66,0,0,0,165,18,29,2,366,0,0,0,415,580
IT-SP,La Spezia,94,8,56,2,50,0,0,0,116,13,10,4,291,0,0,0,318,434
IT-SP,La Spezia,95,5,31,0,35,0,0,0,71,13,15,0,215,0,0,0,243,314
IT-SP,La Spezia,96,3,25,0,19,0,0,0,47,19,7,1,166,0,0,0,193,240
IT-SP,La Spezia,97,0,14,0,15,0,0,0,29,7,4,5,100,0,0,0,116,145
IT-SP,La Spezia,98,1,8,1,13,0,0,0,23,3,0,1,74,0,0,0,78,101
IT-SP,La Spezia,99,0,4,0,6,0,0,0,10,6,4,1,57,0,0,0,68,78
IT-SP,La Spezia,100,2,5,1,11,0,0,0,19,10,2,2,93,0,0,0,107,126
IT-SP,La Spezia,999,49324,47734,4727,3144,77,3,1,105010,40169,48126,6412,15290,78,6,0,110081,215091
IT-LT,Latina,0,1881,0,0,0,0,0,0,1881,1825,0,0,0,0,0,0,1825,3706
IT-LT,Latina,1,1961,0,0,0,0,0,0,1961,1876,0,0,0,0,0,0,1876,3837
IT-LT,Latina,2,2102,0,0,0,0,0,0,2102,1955,0,0,0,0,0,0,1955,4057
IT-LT,Latina,3,2035,0,0,0,0,0,0,2035,1987,0,0,0,0,0,0,1987,4022
IT-LT,Latina,4,2206,0,0,0,0,0,0,2206,2086,0,0,0,0,0,0,2086,4292
IT-LT,Latina,5,2379,0,0,0,0,0,0,2379,2230,0,0,0,0,0,0,2230,4609
IT-LT,Latina,6,2519,0,0,0,0,0,0,2519,2293,0,0,0,0,0,0,2293,4812
IT-LT,Latina,7,2544,0,0,0,0,0,0,2544,2364,0,0,0,0,0,0,2364,4908
IT-LT,Latina,8,2460,0,0,0,0,0,0,2460,2412,0,0,0,0,0,0,2412,4872
IT-LT,Latina,9,2640,0,0,0,0,0,0,2640,2493,0,0,0,0,0,0,2493,5133
IT-LT,Latina,10,2726,0,0,0,0,0,0,2726,2598,0,0,0,0,0,0,2598,5324
IT-LT,Latina,11,2808,0,0,0,0,0,0,2808,2615,0,0,0,0,0,0,2615,5423
IT-LT,Latina,12,2828,0,0,0,0,0,0,2828,2700,0,0,0,0,0,0,2700,5528
IT-LT,Latina,13,2936,0,0,0,0,0,0,2936,2735,0,0,0,0,0,0,2735,5671
IT-LT,Latina,14,2875,0,0,0,0,0,0,2875,2767,0,0,0,0,0,0,2767,5642
IT-LT,Latina,15,2848,0,0,0,0,0,0,2848,2750,0,0,0,0,0,0,2750,5598
IT-LT,Latina,16,2866,0,0,0,0,0,0,2866,2698,0,0,0,0,0,0,2698,5564
IT-LT,Latina,17,2871,0,0,0,0,0,0,2871,2748,0,0,0,0,0,0,2748,5619
IT-LT,Latina,18,2759,0,0,0,0,0,0,2759,2686,1,0,0,0,0,0,2687,5446
IT-LT,Latina,19,2854,0,0,0,0,0,0,2854,2679,4,0,0,0,0,0,2683,5537
IT-LT,Latina,20,2907,3,0,0,0,0,0,2910,2699,16,0,0,0,0,0,2715,5625
IT-LT,Latina,21,2853,3,0,0,0,0,0,2856,2587,26,0,0,0,0,0,2613,5469
IT-LT,Latina,22,2904,8,0,0,0,0,0,2912,2649,37,0,0,0,0,0,2686,5598
IT-LT,Latina,23,3086,12,0,0,0,0,0,3098,2631,52,2,1,0,0,0,2686,5784
IT-LT,Latina,24,3056,27,0,0,0,0,0,3083,2608,96,0,0,0,0,0,2704,5787
IT-LT,Latina,25,2989,45,0,0,0,0,0,3034,2422,126,4,0,0,0,0,2552,5586
IT-LT,Latina,26,3085,84,0,1,0,0,0,3170,2480,245,1,1,1,0,0,2728,5898
IT-LT,Latina,27,2959,124,4,0,1,0,0,3088,2465,279,4,1,0,0,0,2749,5837
IT-LT,Latina,28,2935,170,1,0,0,0,0,3106,2301,430,7,0,2,1,0,2741,5847
IT-LT,Latina,29,2985,237,6,1,0,0,0,3229,2228,576,12,2,2,0,0,2820,6049
IT-LT,Latina,30,2818,363,5,0,0,0,0,3186,2159,711,11,4,0,1,0,2886,6072
IT-LT,Latina,31,2791,471,10,0,0,0,0,3272,2086,972,14,2,3,0,0,3077,6349
IT-LT,Latina,32,2498,633,9,1,1,0,0,3142,1934,1078,32,5,5,0,0,3054,6196
IT-LT,Latina,33,2550,767,20,2,2,0,0,3341,1787,1299,37,3,4,0,0,3130,6471
IT-LT,Latina,34,2371,958,21,3,2,0,0,3355,1748,1441,45,4,1,0,0,3239,6594
IT-LT,Latina,35,2353,1105,31,4,4,0,0,3497,1624,1594,70,8,5,0,0,3301,6798
IT-LT,Latina,36,2151,1173,32,2,6,0,0,3364,1486,1721,62,8,3,0,0,3280,6644
IT-LT,Latina,37,2172,1431,49,1,1,0,0,3654,1378,1701,71,9,1,0,0,3160,6814
IT-LT,Latina,38,1977,1527,48,2,3,0,0,3557,1336,1916,98,10,2,0,0,3362,6919
IT-LT,Latina,39,1913,1724,65,4,4,0,0,3710,1229,1987,104,13,4,0,0,3337,7047
IT-LT,Latina,40,1815,1762,58,5,3,0,0,3643,1149,2123,124,14,3,0,0,3413,7056
IT-LT,Latina,41,1764,1974,88,5,0,0,0,3831,1149,2350,141,37,3,0,0,3680,7511
IT-LT,Latina,42,1685,2099,88,7,2,1,0,3882,1135,2379,165,27,5,1,0,3712,7594
IT-LT,Latina,43,1590,2227,106,12,4,0,0,3939,993,2517,174,33,0,0,0,3717,7656
IT-LT,Latina,44,1538,2291,125,11,3,0,0,3968,971,2574,244,38,3,0,0,3830,7798
IT-LT,Latina,45,1542,2427,135,13,2,0,0,4119,966,2815,218,55,3,0,0,4057,8176
IT-LT,Latina,46,1498,2601,148,18,3,0,0,4268,945,2871,251,45,4,1,0,4117,8385
IT-LT,Latina,47,1448,2897,184,17,5,0,0,4551,929,3092,284,57,0,0,0,4362,8913
IT-LT,Latina,48,1443,2992,191,31,3,0,0,4660,917,3315,293,87,4,0,0,4616,9276
IT-LT,Latina,49,1314,3094,219,21,2,0,0,4650,912,3392,293,95,2,0,0,4694,9344
IT-LT,Latina,50,1290,3152,280,22,2,0,0,4746,872,3414,352,107,0,0,0,4745,9491
IT-LT,Latina,51,1216,3192,260,24,7,1,0,4700,797,3465,328,125,1,0,0,4716,9416
IT-LT,Latina,52,1139,3162,301,30,10,0,0,4642,744,3452,412,122,1,0,0,4731,9373
IT-LT,Latina,53,1003,3321,274,38,4,0,1,4641,628,3492,381,150,3,0,0,4654,9295
IT-LT,Latina,54,912,3290,301,36,5,0,0,4544,564,3551,400,183,1,0,0,4699,9243
IT-LT,Latina,55,862,3346,261,54,3,0,0,4526,546,3581,398,176,2,0,0,4703,9229
IT-LT,Latina,56,767,3431,312,51,5,1,0,4567,563,3487,407,216,2,0,0,4675,9242
IT-LT,Latina,57,656,3522,321,56,3,0,0,4558,515,3572,383,246,1,0,0,4717,9275
IT-LT,Latina,58,651,3528,322,59,4,0,0,4564,490,3479,391,231,1,0,0,4592,9156
IT-LT,Latina,59,593,3536,306,79,7,0,0,4521,452,3607,370,310,2,0,0,4741,9262
IT-LT,Latina,60,510,3292,319,64,2,0,0,4187,413,3272,349,318,4,0,0,4356,8543
IT-LT,Latina,61,429,3191,269,61,2,0,0,3952,358,3175,300,330,1,0,0,4164,8116
IT-LT,Latina,62,393,3156,236,79,2,0,0,3866,324,3159,310,376,0,0,1,4170,8036
IT-LT,Latina,63,336,3007,246,101,9,0,0,3699,303,2948,274,449,3,0,0,3977,7676
IT-LT,Latina,64,302,2976,226,108,1,0,0,3613,276,2820,277,468,2,0,0,3843,7456
IT-LT,Latina,65,263,2768,217,103,1,0,0,3352,277,2687,244,449,1,0,0,3658,7010
IT-LT,Latina,66,273,2728,195,111,2,0,0,3309,194,2655,197,534,0,0,0,3580,6889
IT-LT,Latina,67,224,2682,166,116,1,0,0,3189,220,2553,191,527,2,0,0,3493,6682
IT-LT,Latina,68,181,2691,163,130,2,0,0,3167,213,2578,182,559,0,0,0,3532,6699
IT-LT,Latina,69,172,2790,172,138,1,0,0,3273,198,2471,163,693,0,0,0,3525,6798
IT-LT,Latina,70,165,2524,111,167,0,0,0,2967,165,2222,135,625,0,0,0,3147,6114
IT-LT,Latina,71,147,2425,126,166,0,0,0,2864,160,2115,128,707,0,0,0,3110,5974
IT-LT,Latina,72,147,2421,112,156,1,0,0,2837,153,2142,136,808,1,0,0,3240,6077
IT-LT,Latina,73,112,2451,126,171,1,0,0,2861,151,2147,169,906,0,0,0,3373,6234
IT-LT,Latina,74,130,2496,133,220,1,0,0,2980,166,2063,152,1002,0,0,0,3383,6363
IT-LT,Latina,75,135,2594,109,252,1,0,0,3091,164,2055,130,1165,0,0,0,3514,6605
IT-LT,Latina,76,126,2540,83,248,1,0,0,2998,143,1771,126,1204,0,0,0,3244,6242
IT-LT,Latina,77,96,2275,72,268,1,0,0,2712,144,1671,107,1285,0,0,0,3207,5919
IT-LT,Latina,78,64,1508,54,193,0,0,0,1819,74,1093,63,883,0,0,0,2113,3932
IT-LT,Latina,79,64,1401,53,216,0,0,0,1734,93,983,62,988,0,0,0,2126,3860
IT-LT,Latina,80,58,1436,39,221,1,0,0,1755,76,962,47,1109,0,0,0,2194,3949
IT-LT,Latina,81,62,1389,40,225,1,0,0,1717,87,899,46,1183,0,0,0,2215,3932
IT-LT,Latina,82,51,1290,26,245,0,0,0,1612,113,763,42,1216,0,0,0,2134,3746
IT-LT,Latina,83,51,1287,36,310,1,0,0,1685,80,722,53,1359,0,0,0,2214,3899
IT-LT,Latina,84,45,1167,30,298,0,0,0,1540,87,635,43,1272,0,0,0,2037,3577
IT-LT,Latina,85,27,991,16,288,0,0,0,1322,64,504,24,1325,0,0,0,1917,3239
IT-LT,Latina,86,34,836,7,265,0,0,0,1142,81,375,24,1230,0,0,0,1710,2852
IT-LT,Latina,87,21,660,14,261,0,0,0,956,65,301,21,1066,0,0,0,1453,2409
IT-LT,Latina,88,31,591,10,235,2,0,0,869,49,232,12,1024,0,0,0,1317,2186
IT-LT,Latina,89,19,413,7,226,0,0,0,665,58,162,23,856,0,0,0,1099,1764
IT-LT,Latina,90,10,299,5,158,0,0,0,472,38,121,12,743,0,0,0,914,1386
IT-LT,Latina,91,8,261,0,151,0,0,0,420,29,96,6,660,0,0,0,791,1211
IT-LT,Latina,92,8,209,3,136,0,0,0,356,31,53,8,564,0,0,0,656,1012
IT-LT,Latina,93,5,133,2,115,0,0,0,255,43,45,11,486,0,0,0,585,840
IT-LT,Latina,94,5,90,2,93,0,0,0,190,20,21,3,350,0,0,0,394,584
IT-LT,Latina,95,4,62,0,60,0,0,0,126,18,20,2,282,0,0,0,322,448
IT-LT,Latina,96,4,35,0,39,0,0,0,78,11,8,1,196,0,0,0,216,294
IT-LT,Latina,97,2,23,1,33,0,0,0,59,7,6,0,137,0,0,0,150,209
IT-LT,Latina,98,0,14,0,17,0,0,0,31,4,6,2,106,0,0,0,118,149
IT-LT,Latina,99,0,8,0,13,0,0,0,21,9,7,0,83,0,0,0,99,120
IT-LT,Latina,100,2,12,2,23,0,0,0,39,6,10,2,110,0,0,0,128,167
IT-LT,Latina,999,133893,131831,8009,7090,135,3,1,280962,111736,131364,10660,32058,88,4,1,285911,566873
IT-LE,Lecce,0,2391,0,0,0,0,0,0,2391,2227,0,0,0,0,0,0,2227,4618
IT-LE,Lecce,1,2524,0,0,0,0,0,0,2524,2352,0,0,0,0,0,0,2352,4876
IT-LE,Lecce,2,2536,0,0,0,0,0,0,2536,2369,0,0,0,0,0,0,2369,4905
IT-LE,Lecce,3,2539,0,0,0,0,0,0,2539,2410,0,0,0,0,0,0,2410,4949
IT-LE,Lecce,4,2736,0,0,0,0,0,0,2736,2476,0,0,0,0,0,0,2476,5212
IT-LE,Lecce,5,2871,0,0,0,0,0,0,2871,2605,0,0,0,0,0,0,2605,5476
IT-LE,Lecce,6,2787,0,0,0,0,0,0,2787,2789,0,0,0,0,0,0,2789,5576
IT-LE,Lecce,7,2953,0,0,0,0,0,0,2953,2831,0,0,0,0,0,0,2831,5784
IT-LE,Lecce,8,2940,0,0,0,0,0,0,2940,2909,0,0,0,0,0,0,2909,5849
IT-LE,Lecce,9,3230,0,0,0,0,0,0,3230,2862,0,0,0,0,0,0,2862,6092
IT-LE,Lecce,10,3309,0,0,0,0,0,0,3309,3085,0,0,0,0,0,0,3085,6394
IT-LE,Lecce,11,3462,0,0,0,0,0,0,3462,3222,0,0,0,0,0,0,3222,6684
IT-LE,Lecce,12,3444,0,0,0,0,0,0,3444,3286,0,0,0,0,0,0,3286,6730
IT-LE,Lecce,13,3666,0,0,0,0,0,0,3666,3399,0,0,0,0,0,0,3399,7065
IT-LE,Lecce,14,3549,0,0,0,0,0,0,3549,3384,0,0,0,0,0,0,3384,6933
IT-LE,Lecce,15,3736,0,0,0,0,0,0,3736,3508,0,0,0,0,0,0,3508,7244
IT-LE,Lecce,16,3839,0,0,0,0,0,0,3839,3454,0,0,0,0,0,0,3454,7293
IT-LE,Lecce,17,3749,0,0,0,0,0,0,3749,3552,0,0,0,0,0,0,3552,7301
IT-LE,Lecce,18,3900,0,0,0,0,0,0,3900,3586,0,0,0,0,0,0,3586,7486
IT-LE,Lecce,19,4061,0,0,0,0,0,0,4061,3833,2,0,0,0,0,0,3835,7896
IT-LE,Lecce,20,4051,0,0,0,0,0,0,4051,3696,7,0,0,0,0,0,3703,7754
IT-LE,Lecce,21,3906,3,0,0,0,0,0,3909,3705,11,1,0,0,0,0,3717,7626
IT-LE,Lecce,22,4115,3,0,1,0,0,0,4119,3805,35,0,0,0,0,0,3840,7959
IT-LE,Lecce,23,4222,12,0,0,0,0,0,4234,3748,50,1,0,0,0,0,3799,8033
IT-LE,Lecce,24,4017,29,1,0,0,0,0,4047,3532,106,0,0,0,0,0,3638,7685
IT-LE,Lecce,25,4067,48,3,0,1,0,0,4119,3552,130,3,0,1,0,0,3686,7805
IT-LE,Lecce,26,3873,74,1,0,0,0,0,3948,3420,231,4,0,1,0,0,3656,7604
IT-LE,Lecce,27,3660,127,2,0,2,0,0,3791,3288,365,3,1,2,0,0,3659,7450
IT-LE,Lecce,28,3709,219,0,0,5,0,0,3933,3162,463,5,1,0,0,0,3631,7564
IT-LE,Lecce,29,3531,296,2,0,3,0,0,3832,3045,620,5,1,2,0,0,3673,7505
IT-LE,Lecce,30,3591,374,8,0,0,0,0,3973,2987,871,22,1,4,0,0,3885,7858
IT-LE,Lecce,31,3674,584,9,0,1,0,0,4268,2920,1090,19,3,1,0,0,4033,8301
IT-LE,Lecce,32,3342,707,12,0,3,0,0,4064,2687,1304,29,5,3,0,0,4028,8092
IT-LE,Lecce,33,3140,896,11,1,6,0,0,4054,2452,1465,31,5,3,1,0,3957,8011
IT-LE,Lecce,34,2934,1033,18,0,2,0,0,3987,2238,1682,50,6,3,0,0,3979,7966
IT-LE,Lecce,35,2862,1283,26,3,5,0,0,4179,2153,1930,66,10,3,1,0,4163,8342
IT-LE,Lecce,36,2626,1414,35,3,4,0,0,4082,1969,2014,76,9,6,1,0,4075,8157
IT-LE,Lecce,37,2506,1661,45,0,2,0,0,4214,1690,2157,95,14,1,1,0,3958,8172
IT-LE,Lecce,38,2325,1781,54,3,4,0,0,4167,1722,2447,121,15,2,0,0,4307,8474
IT-LE,Lecce,39,2285,1948,72,5,3,0,0,4313,1754,2608,141,15,0,0,0,4518,8831
IT-LE,Lecce,40,2214,2051,67,4,2,0,0,4338,1631,2774,158,23,2,0,0,4588,8926
IT-LE,Lecce,41,2110,2313,81,3,7,0,0,4514,1494,2957,169,36,1,0,0,4657,9171
IT-LE,Lecce,42,2026,2436,111,9,5,1,0,4588,1469,3211,214,41,1,0,0,4936,9524
IT-LE,Lecce,43,1991,2776,130,13,5,0,0,4915,1446,3373,239,38,3,0,0,5099,10014
IT-LE,Lecce,44,1942,3116,161,17,9,0,0,5245,1347,3740,263,46,3,0,0,5399,10644
IT-LE,Lecce,45,1861,3298,173,16,5,0,0,5353,1362,3841,302,46,3,0,0,5554,10907
IT-LE,Lecce,46,1902,3338,191,11,5,0,0,5447,1272,4116,284,78,4,0,0,5754,11201
IT-LE,Lecce,47,1848,3775,208,21,5,0,0,5857,1306,4317,335,78,2,0,0,6038,11895
IT-LE,Lecce,48,1709,3947,253,25,3,0,0,5937,1216,4271,376,107,2,0,0,5972,11909
IT-LE,Lecce,49,1535,4153,271,27,5,0,0,5991,1199,4521,380,103,4,0,0,6207,12198
IT-LE,Lecce,50,1425,3999,308,26,4,0,0,5762,1122,4462,389,110,1,0,0,6084,11846
IT-LE,Lecce,51,1317,3997,259,26,3,0,0,5602,958,4354,396,112,0,0,0,5820,11422
IT-LE,Lecce,52,1263,4248,281,30,11,0,0,5833,1003,4479,363,163,1,0,0,6009,11842
IT-LE,Lecce,53,1124,4262,280,39,3,0,0,5708,1004,4538,357,211,0,0,0,6110,11818
IT-LE,Lecce,54,1077,4363,297,61,3,0,0,5801,952,4773,361,205,2,0,0,6293,12094
IT-LE,Lecce,55,1009,4341,346,70,4,0,0,5770,932,4891,376,204,3,0,0,6406,12176
IT-LE,Lecce,56,970,4582,340,63,3,0,0,5958,942,4903,373,221,4,0,0,6443,12401
IT-LE,Lecce,57,886,4701,320,73,3,0,0,5983,962,4953,384,280,1,0,0,6580,12563
IT-LE,Lecce,58,771,4646,307,79,3,0,0,5806,881,4972,367,332,3,0,0,6555,12361
IT-LE,Lecce,59,697,4945,332,96,3,1,0,6074,870,4981,368,355,3,0,0,6577,12651
IT-LE,Lecce,60,603,4614,270,106,5,0,0,5598,788,4634,324,366,1,0,0,6113,11711
IT-LE,Lecce,61,545,4497,283,104,1,0,0,5430,773,4467,274,428,0,0,0,5942,11372
IT-LE,Lecce,62,507,4421,230,117,2,0,0,5277,711,4402,270,495,1,0,0,5879,11156
IT-LE,Lecce,63,441,4386,273,116,4,0,0,5220,657,4359,287,525,1,0,0,5829,11049
IT-LE,Lecce,64,413,4231,223,151,5,0,0,5023,658,4157,229,542,0,0,0,5586,10609
IT-LE,Lecce,65,359,3802,223,142,3,0,0,4529,606,3844,240,624,0,0,0,5314,9843
IT-LE,Lecce,66,355,4050,227,145,1,0,0,4778,571,3962,222,679,0,0,0,5434,10212
IT-LE,Lecce,67,291,4028,177,172,1,0,1,4670,585,3758,175,763,0,0,0,5281,9951
IT-LE,Lecce,68,294,4113,165,175,2,0,0,4749,558,3804,177,808,0,0,0,5347,10096
IT-LE,Lecce,69,273,3837,147,181,1,0,0,4439,542,3515,143,895,0,0,0,5095,9534
IT-LE,Lecce,70,256,3843,125,203,3,0,0,4430,462,3512,195,1012,0,0,0,5181,9611
IT-LE,Lecce,71,184,3500,109,193,0,0,0,3986,427,3117,152,976,1,0,0,4673,8659
IT-LE,Lecce,72,211,3841,125,233,1,0,0,4411,432,3348,152,1179,0,0,0,5111,9522
IT-LE,Lecce,73,177,3902,118,241,0,0,0,4438,472,3182,164,1282,0,0,0,5100,9538
IT-LE,Lecce,74,161,3600,93,281,2,0,0,4137,485,3026,136,1355,1,0,0,5003,9140
IT-LE,Lecce,75,174,3785,89,318,0,0,0,4366,478,3147,126,1609,0,0,0,5360,9726
IT-LE,Lecce,76,158,3567,92,370,0,0,0,4187,439,2804,103,1680,0,0,0,5026,9213
IT-LE,Lecce,77,143,3329,72,375,0,0,0,3919,435,2585,111,1782,0,0,0,4913,8832
IT-LE,Lecce,78,99,2713,49,320,0,0,0,3181,379,1896,92,1536,0,0,0,3903,7084
IT-LE,Lecce,79,88,2329,47,290,0,0,0,2754,338,1602,65,1442,0,0,0,3447,6201
IT-LE,Lecce,80,98,2328,42,356,2,0,0,2826,348,1630,59,1730,0,0,0,3767,6593
IT-LE,Lecce,81,86,2246,37,375,0,0,0,2744,356,1477,51,1771,0,0,0,3655,6399
IT-LE,Lecce,82,89,1974,24,384,0,0,0,2471,344,1274,55,1718,0,0,0,3391,5862
IT-LE,Lecce,83,83,1901,35,418,0,0,0,2437,327,1155,49,1940,0,0,0,3471,5908
IT-LE,Lecce,84,64,1830,31,483,0,0,0,2408,333,1068,45,2175,0,0,0,3621,6029
IT-LE,Lecce,85,43,1599,23,450,0,0,0,2115,313,851,27,2052,0,0,0,3243,5358
IT-LE,Lecce,86,57,1219,12,397,0,0,0,1685,282,643,27,1775,0,0,0,2727,4412
IT-LE,Lecce,87,42,1032,5,402,0,0,0,1481,201,454,23,1715,0,0,0,2393,3874
IT-LE,Lecce,88,29,924,12,407,0,0,0,1372,226,429,28,1638,0,0,0,2321,3693
IT-LE,Lecce,89,35,691,7,337,0,0,0,1070,203,287,12,1519,0,0,0,2021,3091
IT-LE,Lecce,90,22,517,8,316,0,0,0,863,156,214,16,1382,0,0,0,1768,2631
IT-LE,Lecce,91,19,397,2,278,0,0,0,696,136,159,10,1232,0,0,0,1537,2233
IT-LE,Lecce,92,19,307,3,239,0,0,0,568,129,103,6,1037,0,0,0,1275,1843
IT-LE,Lecce,93,13,225,2,214,0,0,0,454,93,71,16,993,0,0,0,1173,1627
IT-LE,Lecce,94,8,149,3,161,0,0,0,321,89,46,8,658,0,0,0,801,1122
IT-LE,Lecce,95,3,78,3,116,0,0,0,200,59,25,2,472,0,0,0,558,758
IT-LE,Lecce,96,4,56,0,74,0,0,0,134,33,12,4,390,0,0,0,439,573
IT-LE,Lecce,97,1,22,0,69,0,0,0,92,37,10,2,241,0,0,0,290,382
IT-LE,Lecce,98,1,18,0,44,0,0,0,63,21,7,2,159,0,0,0,189,252
IT-LE,Lecce,99,1,12,0,22,0,0,0,35,13,5,0,105,0,0,0,123,158
IT-LE,Lecce,100,2,17,1,37,0,0,0,57,14,7,0,181,0,0,0,202,259
IT-LE,Lecce,999,168786,181709,8402,10537,165,2,1,369602,155541,183063,11205,47736,80,4,0,397629,767231
IT-LC,Lecco,0,1056,0,0,0,0,0,0,1056,993,0,0,0,0,0,0,993,2049
IT-LC,Lecco,1,1086,0,0,0,0,0,0,1086,1040,0,0,0,0,0,0,1040,2126
IT-LC,Lecco,2,1104,0,0,0,0,0,0,1104,1034,0,0,0,0,0,0,1034,2138
IT-LC,Lecco,3,1128,0,0,0,0,0,0,1128,1106,0,0,0,0,0,0,1106,2234
IT-LC,Lecco,4,1268,0,0,0,0,0,0,1268,1134,0,0,0,0,0,0,1134,2402
IT-LC,Lecco,5,1289,0,0,0,0,0,0,1289,1169,0,0,0,0,0,0,1169,2458
IT-LC,Lecco,6,1441,0,0,0,0,0,0,1441,1275,0,0,0,0,0,0,1275,2716
IT-LC,Lecco,7,1287,0,0,0,0,0,0,1287,1368,0,0,0,0,0,0,1368,2655
IT-LC,Lecco,8,1515,0,0,0,0,0,0,1515,1426,0,0,0,0,0,0,1426,2941
IT-LC,Lecco,9,1433,0,0,0,0,0,0,1433,1374,0,0,0,0,0,0,1374,2807
IT-LC,Lecco,10,1494,0,0,0,0,0,0,1494,1473,0,0,0,0,0,0,1473,2967
IT-LC,Lecco,11,1573,0,0,0,0,0,0,1573,1543,0,0,0,0,0,0,1543,3116
IT-LC,Lecco,12,1616,0,0,0,0,0,0,1616,1564,0,0,0,0,0,0,1564,3180
IT-LC,Lecco,13,1760,0,0,0,0,0,0,1760,1599,0,0,0,0,0,0,1599,3359
IT-LC,Lecco,14,1788,0,0,0,0,0,0,1788,1574,0,0,0,0,0,0,1574,3362
IT-LC,Lecco,15,1747,0,0,0,0,0,0,1747,1669,0,0,0,0,0,0,1669,3416
IT-LC,Lecco,16,1742,0,0,0,0,0,0,1742,1642,0,0,0,0,0,0,1642,3384
IT-LC,Lecco,17,1674,0,0,0,0,0,0,1674,1635,0,0,0,0,0,0,1635,3309
IT-LC,Lecco,18,1760,0,0,0,0,0,0,1760,1628,0,0,0,0,0,0,1628,3388
IT-LC,Lecco,19,1678,0,0,0,0,0,0,1678,1591,1,0,0,0,0,0,1592,3270
IT-LC,Lecco,20,1656,1,0,0,0,0,0,1657,1615,6,0,0,0,0,0,1621,3278
IT-LC,Lecco,21,1732,0,0,0,0,0,0,1732,1703,15,0,0,0,0,0,1718,3450
IT-LC,Lecco,22,1708,4,0,1,0,0,0,1713,1603,34,0,0,0,0,0,1637,3350
IT-LC,Lecco,23,1790,6,0,0,0,0,0,1796,1602,50,3,0,0,0,0,1655,3451
IT-LC,Lecco,24,1793,11,2,0,1,0,0,1807,1519,68,4,1,0,0,0,1592,3399
IT-LC,Lecco,25,1793,28,3,0,0,0,0,1824,1467,97,1,0,1,0,0,1566,3390
IT-LC,Lecco,26,1771,41,2,0,1,0,0,1815,1448,152,1,0,0,0,0,1601,3416
IT-LC,Lecco,27,1797,63,5,0,1,0,0,1866,1394,222,7,0,2,0,0,1625,3491
IT-LC,Lecco,28,1635,99,3,1,2,0,0,1740,1314,280,8,0,1,0,0,1603,3343
IT-LC,Lecco,29,1614,163,4,0,3,0,0,1784,1230,348,9,0,1,0,0,1588,3372
IT-LC,Lecco,30,1476,222,8,0,2,0,0,1708,1176,463,5,0,4,0,0,1648,3356
IT-LC,Lecco,31,1496,287,3,0,3,0,0,1789,1091,537,11,1,1,0,0,1641,3430
IT-LC,Lecco,32,1401,338,7,1,1,1,0,1749,1005,599,16,2,2,0,0,1624,3373
IT-LC,Lecco,33,1318,404,9,1,2,0,0,1734,905,678,16,4,2,0,0,1605,3339
IT-LC,Lecco,34,1256,512,15,3,2,0,0,1788,881,762,23,2,2,0,0,1670,3458
IT-LC,Lecco,35,1145,620,20,2,4,0,0,1791,843,858,34,1,3,0,0,1739,3530
IT-LC,Lecco,36,1044,690,20,0,4,0,0,1758,734,915,43,4,1,0,0,1697,3455
IT-LC,Lecco,37,1071,704,29,1,3,0,0,1808,615,956,43,6,4,0,0,1624,3432
IT-LC,Lecco,38,958,773,26,4,1,0,0,1762,677,1036,46,11,3,1,0,1774,3536
IT-LC,Lecco,39,944,825,34,3,1,0,0,1807,615,1047,70,11,4,0,0,1747,3554
IT-LC,Lecco,40,863,899,37,1,3,1,0,1804,596,1144,99,2,4,0,0,1845,3649
IT-LC,Lecco,41,921,1034,44,6,2,0,0,2007,580,1219,91,11,1,0,0,1902,3909
IT-LC,Lecco,42,912,1074,67,6,4,0,0,2063,584,1266,76,23,3,0,0,1952,4015
IT-LC,Lecco,43,826,1060,70,9,2,0,0,1967,572,1282,105,16,0,0,0,1975,3942
IT-LC,Lecco,44,871,1136,70,5,1,0,0,2083,587,1353,108,20,2,0,0,2070,4153
IT-LC,Lecco,45,823,1230,100,6,2,2,0,2163,557,1535,133,19,1,0,0,2245,4408
IT-LC,Lecco,46,829,1414,102,9,1,0,0,2355,534,1627,163,22,3,0,0,2349,4704
IT-LC,Lecco,47,889,1514,100,14,1,0,0,2518,563,1630,157,35,1,0,0,2386,4904
IT-LC,Lecco,48,873,1619,133,16,3,0,0,2644,502,1734,218,38,4,0,0,2496,5140
IT-LC,Lecco,49,909,1682,143,17,3,0,0,2754,552,1783,215,43,3,0,1,2597,5351
IT-LC,Lecco,50,816,1733,168,12,1,0,0,2730,520,1815,240,58,1,0,0,2634,5364
IT-LC,Lecco,51,778,1691,176,16,2,0,0,2663,478,1921,236,39,3,0,0,2677,5340
IT-LC,Lecco,52,781,1698,185,16,3,0,0,2683,489,1866,237,73,0,0,0,2665,5348
IT-LC,Lecco,53,690,1855,187,19,1,0,0,2752,444,1872,229,81,3,0,0,2629,5381
IT-LC,Lecco,54,724,1870,209,16,2,0,0,2821,428,1924,254,61,1,0,0,2668,5489
IT-LC,Lecco,55,691,1902,212,16,2,1,0,2824,426,1968,264,79,2,0,0,2739,5563
IT-LC,Lecco,56,620,1898,226,22,7,0,0,2773,407,2014,284,101,2,0,0,2808,5581
IT-LC,Lecco,57,608,2097,216,25,1,0,1,2948,377,2155,245,92,2,0,0,2871,5819
IT-LC,Lecco,58,556,2024,202,27,5,0,0,2814,405,2068,263,128,1,0,0,2865,5679
IT-LC,Lecco,59,545,2038,247,41,2,0,0,2873,337,1988,215,129,1,0,0,2670,5543
IT-LC,Lecco,60,446,1922,192,29,3,0,0,2592,330,1906,243,126,1,0,0,2606,5198
IT-LC,Lecco,61,394,1845,204,56,4,0,0,2503,299,1780,217,168,2,0,0,2466,4969
IT-LC,Lecco,62,349,1787,173,41,2,0,0,2352,269,1814,177,176,0,0,0,2436,4788
IT-LC,Lecco,63,338,1770,143,54,3,0,0,2308,283,1716,182,195,1,0,0,2377,4685
IT-LC,Lecco,64,310,1724,159,46,1,0,0,2240,262,1708,167,204,1,0,0,2342,4582
IT-LC,Lecco,65,293,1675,135,47,4,0,0,2154,207,1646,163,225,2,0,0,2243,4397
IT-LC,Lecco,66,251,1604,117,50,0,0,0,2022,236,1587,115,268,2,0,0,2208,4230
IT-LC,Lecco,67,221,1726,122,76,4,0,0,2149,190,1561,125,289,1,0,1,2167,4316
IT-LC,Lecco,68,239,1619,98,75,4,0,0,2035,188,1497,100,317,0,0,0,2102,4137
IT-LC,Lecco,69,195,1565,83,78,0,0,1,1922,192,1416,113,322,2,0,0,2045,3967
IT-LC,Lecco,70,187,1497,79,75,0,0,0,1838,159,1380,108,345,0,0,0,1992,3830
IT-LC,Lecco,71,178,1525,62,91,3,0,0,1859,145,1321,86,379,0,0,0,1931,3790
IT-LC,Lecco,72,179,1476,72,96,0,0,1,1824,183,1392,86,428,0,0,0,2089,3913
IT-LC,Lecco,73,171,1473,69,122,0,0,0,1835,163,1352,75,503,0,0,0,2093,3928
IT-LC,Lecco,74,184,1508,59,117,0,0,0,1868,168,1299,71,537,0,0,0,2075,3943
IT-LC,Lecco,75,144,1486,64,144,1,0,0,1839,159,1224,70,618,0,0,0,2071,3910
IT-LC,Lecco,76,149,1386,57,143,1,0,0,1736,149,1143,55,653,0,0,0,2000,3736
IT-LC,Lecco,77,127,1395,41,167,0,0,0,1730,145,1049,49,692,0,0,0,1935,3665
IT-LC,Lecco,78,99,1051,29,146,0,0,0,1325,94,771,46,564,0,0,0,1475,2800
IT-LC,Lecco,79,95,1026,24,149,0,0,0,1294,99,720,37,696,0,0,0,1552,2846
IT-LC,Lecco,80,76,939,19,130,0,0,0,1164,98,735,36,625,0,0,0,1494,2658
IT-LC,Lecco,81,79,889,25,147,0,0,0,1140,113,611,29,758,0,0,0,1511,2651
IT-LC,Lecco,82,92,879,14,183,1,0,0,1169,113,585,22,801,0,0,0,1521,2690
IT-LC,Lecco,83,95,883,16,179,0,0,0,1173,126,559,19,828,0,0,0,1532,2705
IT-LC,Lecco,84,88,766,12,198,0,0,0,1064,127,428,13,886,0,0,0,1454,2518
IT-LC,Lecco,85,65,715,6,181,0,0,0,967,122,400,20,886,0,0,0,1428,2395
IT-LC,Lecco,86,43,545,9,164,0,0,0,761,100,282,11,805,0,0,0,1198,1959
IT-LC,Lecco,87,46,391,4,159,0,0,0,600,85,198,12,720,0,0,0,1015,1615
IT-LC,Lecco,88,36,318,5,130,0,0,0,489,78,144,11,728,0,0,0,961,1450
IT-LC,Lecco,89,24,264,7,119,0,0,0,414,75,79,4,629,0,0,0,787,1201
IT-LC,Lecco,90,23,229,2,109,0,0,0,363,76,83,5,578,0,0,0,742,1105
IT-LC,Lecco,91,19,167,4,95,0,0,0,285,59,54,3,540,0,0,0,656,941
IT-LC,Lecco,92,13,124,1,73,0,0,0,211,59,39,4,424,0,0,0,526,737
IT-LC,Lecco,93,10,86,2,58,0,0,0,156,43,21,4,360,0,0,0,428,584
IT-LC,Lecco,94,8,47,0,46,0,0,0,101,36,11,3,262,0,0,0,312,413
IT-LC,Lecco,95,7,28,0,44,0,0,0,79,25,8,0,223,0,0,0,256,335
IT-LC,Lecco,96,3,18,0,30,0,0,0,51,25,9,4,166,0,0,0,204,255
IT-LC,Lecco,97,2,15,0,21,0,0,0,38,18,3,1,107,0,0,0,129,167
IT-LC,Lecco,98,3,6,0,15,0,0,0,24,11,0,0,70,0,0,0,81,105
IT-LC,Lecco,99,0,2,0,7,0,0,0,9,8,0,1,61,0,0,0,70,79
IT-LC,Lecco,100,1,3,0,14,0,0,0,18,10,2,0,85,0,0,0,97,115
IT-LC,Lecco,999,79644,75633,5192,4220,110,5,3,164807,66539,75821,6659,19360,81,1,2,168463,333270
IT-LI,Livorno,0,881,0,0,0,0,0,0,881,840,0,0,0,0,0,0,840,1721
IT-LI,Livorno,1,925,0,0,0,0,0,0,925,925,0,0,0,0,0,0,925,1850
IT-LI,Livorno,2,984,0,0,0,0,0,0,984,906,0,0,0,0,0,0,906,1890
IT-LI,Livorno,3,952,0,0,0,0,0,0,952,908,0,0,0,0,0,0,908,1860
IT-LI,Livorno,4,984,0,0,0,0,0,0,984,1018,0,0,0,0,0,0,1018,2002
IT-LI,Livorno,5,1100,0,0,0,0,0,0,1100,1081,0,0,0,0,0,0,1081,2181
IT-LI,Livorno,6,1140,0,0,0,0,0,0,1140,1154,0,0,0,0,0,0,1154,2294
IT-LI,Livorno,7,1196,0,0,0,0,0,0,1196,1124,0,0,0,0,0,0,1124,2320
IT-LI,Livorno,8,1239,0,0,0,0,0,0,1239,1186,0,0,0,0,0,0,1186,2425
IT-LI,Livorno,9,1293,0,0,0,0,0,0,1293,1240,0,0,0,0,0,0,1240,2533
IT-LI,Livorno,10,1305,0,0,0,0,0,0,1305,1254,0,0,0,0,0,0,1254,2559
IT-LI,Livorno,11,1373,0,0,0,0,0,0,1373,1394,0,0,0,0,0,0,1394,2767
IT-LI,Livorno,12,1417,0,0,0,0,0,0,1417,1365,0,0,0,0,0,0,1365,2782
IT-LI,Livorno,13,1503,0,0,0,0,0,0,1503,1399,0,0,0,0,0,0,1399,2902
IT-LI,Livorno,14,1518,0,0,0,0,0,0,1518,1449,0,0,0,0,0,0,1449,2967
IT-LI,Livorno,15,1543,0,0,0,0,0,0,1543,1428,0,0,0,0,0,0,1428,2971
IT-LI,Livorno,16,1596,0,0,0,0,0,0,1596,1462,0,0,0,0,0,0,1462,3058
IT-LI,Livorno,17,1571,0,0,0,0,0,0,1571,1476,0,0,0,0,0,0,1476,3047
IT-LI,Livorno,18,1539,0,0,0,0,0,0,1539,1396,3,0,0,0,0,0,1399,2938
IT-LI,Livorno,19,1638,0,0,0,0,0,0,1638,1437,2,0,0,0,0,0,1439,3077
IT-LI,Livorno,20,1485,2,0,0,0,0,0,1487,1388,8,0,0,0,0,0,1396,2883
IT-LI,Livorno,21,1471,0,0,0,0,0,0,1471,1355,14,0,0,0,0,0,1369,2840
IT-LI,Livorno,22,1490,5,0,0,0,0,0,1495,1407,23,1,0,0,0,0,1431,2926
IT-LI,Livorno,23,1516,10,0,0,0,0,0,1526,1309,34,0,0,1,0,0,1344,2870
IT-LI,Livorno,24,1542,18,0,0,0,0,0,1560,1245,66,0,0,1,0,0,1312,2872
IT-LI,Livorno,25,1487,28,2,0,2,0,0,1519,1285,81,2,0,1,0,0,1369,2888
IT-LI,Livorno,26,1559,28,1,0,1,0,0,1589,1250,117,0,0,2,0,0,1369,2958
IT-LI,Livorno,27,1409,56,0,0,0,0,0,1465,1157,166,2,1,0,0,0,1326,2791
IT-LI,Livorno,28,1410,86,4,0,1,0,0,1501,1174,214,7,0,1,0,0,1396,2897
IT-LI,Livorno,29,1418,118,1,0,0,0,0,1537,1122,271,6,0,1,0,0,1400,2937
IT-LI,Livorno,30,1352,163,5,0,2,0,0,1522,1027,335,9,0,2,0,0,1373,2895
IT-LI,Livorno,31,1332,252,7,0,1,1,0,1593,1014,425,14,0,4,1,0,1458,3051
IT-LI,Livorno,32,1274,315,4,1,1,0,0,1595,958,493,24,1,2,1,0,1479,3074
IT-LI,Livorno,33,1285,383,11,3,3,0,0,1685,956,561,38,1,0,0,0,1556,3241
IT-LI,Livorno,34,1195,421,17,0,3,1,0,1637,867,618,25,3,5,0,0,1518,3155
IT-LI,Livorno,35,1140,502,15,0,3,0,0,1660,827,730,40,4,3,0,0,1604,3264
IT-LI,Livorno,36,973,536,16,1,6,0,0,1532,832,750,39,13,11,0,0,1645,3177
IT-LI,Livorno,37,921,604,23,1,3,0,0,1552,743,774,41,6,5,0,0,1569,3121
IT-LI,Livorno,38,974,676,48,1,2,0,0,1701,789,803,69,13,2,0,0,1676,3377
IT-LI,Livorno,39,899,690,41,4,5,0,0,1639,722,867,77,7,5,0,0,1678,3317
IT-LI,Livorno,40,873,832,41,3,3,0,0,1752,683,955,97,14,3,0,0,1752,3504
IT-LI,Livorno,41,992,857,62,2,1,0,0,1914,748,965,100,12,8,0,0,1833,3747
IT-LI,Livorno,42,867,846,62,4,3,0,0,1782,719,1027,123,14,2,0,0,1885,3667
IT-LI,Livorno,43,916,951,84,9,6,0,0,1966,708,1127,106,18,3,0,0,1962,3928
IT-LI,Livorno,44,902,1043,73,2,4,1,0,2025,703,1238,140,15,2,0,0,2098,4123
IT-LI,Livorno,45,1009,1153,91,6,7,0,0,2266,733,1309,160,14,2,0,0,2218,4484
IT-LI,Livorno,46,908,1217,119,8,3,0,0,2255,715,1394,193,22,3,0,0,2327,4582
IT-LI,Livorno,47,930,1259,150,11,3,0,0,2353,723,1477,214,24,0,0,0,2438,4791
IT-LI,Livorno,48,926,1396,161,9,1,0,0,2493,725,1582,244,31,5,1,0,2588,5081
IT-LI,Livorno,49,967,1536,201,11,4,0,0,2719,711,1709,274,52,3,0,0,2749,5468
IT-LI,Livorno,50,899,1586,230,17,3,0,0,2735,666,1793,295,41,3,0,0,2798,5533
IT-LI,Livorno,51,845,1608,219,18,2,0,0,2692,640,1893,329,45,2,0,0,2909,5601
IT-LI,Livorno,52,794,1710,237,18,2,0,0,2761,563,1792,340,59,3,1,0,2758,5519
IT-LI,Livorno,53,768,1712,268,14,3,0,0,2765,529,1784,371,67,1,0,0,2752,5517
IT-LI,Livorno,54,656,1790,280,18,4,1,0,2749,430,1920,356,87,2,0,0,2795,5544
IT-LI,Livorno,55,654,1703,255,26,7,0,0,2645,455,1919,365,96,3,0,1,2839,5484
IT-LI,Livorno,56,600,1792,287,23,4,0,0,2706,414,1915,389,111,4,0,0,2833,5539
IT-LI,Livorno,57,509,1834,311,24,4,0,0,2682,413,1968,406,117,1,0,0,2905,5587
IT-LI,Livorno,58,506,1833,316,41,7,0,0,2703,389,1957,423,106,4,0,0,2879,5582
IT-LI,Livorno,59,442,2030,330,52,6,0,0,2860,388,1981,421,141,4,0,0,2935,5795
IT-LI,Livorno,60,372,1915,329,54,3,0,0,2673,310,1929,416,160,4,0,0,2819,5492
IT-LI,Livorno,61,371,1852,290,41,2,0,0,2556,275,1862,321,174,1,0,0,2633,5189
IT-LI,Livorno,62,292,1804,274,52,4,0,0,2426,284,1824,331,217,5,0,0,2661,5087
IT-LI,Livorno,63,252,1690,247,48,8,1,0,2246,233,1706,294,223,4,0,0,2460,4706
IT-LI,Livorno,64,233,1653,211,65,3,0,0,2165,221,1617,299,246,0,0,0,2383,4548
IT-LI,Livorno,65,252,1567,193,48,2,0,0,2062,180,1596,312,256,4,0,0,2348,4410
IT-LI,Livorno,66,187,1684,210,62,1,0,0,2144,178,1596,246,286,3,0,0,2309,4453
IT-LI,Livorno,67,184,1644,165,74,1,0,0,2068,166,1588,209,365,1,0,1,2330,4398
IT-LI,Livorno,68,170,1610,182,70,1,0,0,2033,139,1552,219,361,0,0,1,2272,4305
IT-LI,Livorno,69,144,1473,129,95,1,0,0,1842,136,1556,199,364,1,0,0,2256,4098
IT-LI,Livorno,70,118,1472,147,94,0,0,0,1831,107,1388,195,366,1,0,0,2057,3888
IT-LI,Livorno,71,128,1491,130,84,1,0,0,1834,104,1396,130,388,2,0,0,2020,3854
IT-LI,Livorno,72,110,1431,101,86,1,0,0,1729,100,1306,117,448,0,0,0,1971,3700
IT-LI,Livorno,73,108,1450,108,118,1,0,0,1785,98,1316,138,480,1,0,0,2033,3818
IT-LI,Livorno,74,100,1579,101,143,1,0,0,1924,108,1346,129,559,0,0,0,2142,4066
IT-LI,Livorno,75,83,1635,87,165,3,0,0,1973,81,1416,157,658,0,0,0,2312,4285
IT-LI,Livorno,76,90,1595,108,195,2,1,0,1991,80,1378,144,758,0,0,0,2360,4351
IT-LI,Livorno,77,78,1667,73,197,0,0,0,2015,96,1456,139,865,1,0,0,2557,4572
IT-LI,Livorno,78,70,1279,60,161,1,0,0,1571,61,1060,103,719,0,0,0,1943,3514
IT-LI,Livorno,79,49,1198,64,186,0,0,0,1497,66,951,74,793,0,0,0,1884,3381
IT-LI,Livorno,80,38,1060,42,203,1,0,0,1344,66,844,66,745,0,0,0,1721,3065
IT-LI,Livorno,81,54,1038,38,195,0,0,0,1325,54,766,69,827,0,0,0,1716,3041
IT-LI,Livorno,82,51,931,32,196,2,0,1,1213,73,693,53,884,0,0,0,1703,2916
IT-LI,Livorno,83,51,955,30,219,1,0,0,1256,73,628,57,975,1,0,0,1734,2990
IT-LI,Livorno,84,45,901,18,209,0,0,0,1173,59,534,49,1029,0,0,0,1671,2844
IT-LI,Livorno,85,34,855,25,248,0,0,0,1162,55,482,36,1035,0,0,0,1608,2770
IT-LI,Livorno,86,29,688,21,198,0,0,0,936,46,360,30,930,0,0,0,1366,2302
IT-LI,Livorno,87,26,495,6,169,0,0,0,696,53,256,18,845,0,0,0,1172,1868
IT-LI,Livorno,88,28,430,16,199,0,0,0,673,46,168,22,833,0,0,0,1069,1742
IT-LI,Livorno,89,23,315,10,157,0,0,0,505,43,133,10,700,0,0,0,886,1391
IT-LI,Livorno,90,18,267,4,139,0,0,0,428,31,90,13,632,0,0,0,766,1194
IT-LI,Livorno,91,7,227,2,107,0,0,0,343,37,58,8,599,0,0,0,702,1045
IT-LI,Livorno,92,7,137,3,128,0,0,0,275,33,42,10,484,0,0,0,569,844
IT-LI,Livorno,93,6,98,2,94,0,0,0,200,25,27,2,447,0,0,0,501,701
IT-LI,Livorno,94,9,69,1,79,0,0,0,158,25,12,2,339,0,0,0,378,536
IT-LI,Livorno,95,3,38,1,70,0,0,0,112,21,10,3,263,0,0,0,297,409
IT-LI,Livorno,96,2,35,1,37,0,0,0,75,17,4,0,163,0,0,0,184,259
IT-LI,Livorno,97,1,8,0,25,0,0,0,34,9,5,1,124,0,0,0,139,173
IT-LI,Livorno,98,0,10,0,21,0,0,0,31,6,1,0,78,0,0,0,85,116
IT-LI,Livorno,99,0,8,1,17,0,0,0,26,6,5,0,70,0,0,0,81,107
IT-LI,Livorno,100,3,5,0,16,0,0,0,24,6,4,1,98,0,0,0,109,133
IT-LI,Livorno,999,71618,73840,7434,5091,150,6,1,158140,61731,74021,10362,21921,133,4,3,168175,326315
IT-LO,Lodi,0,780,0,0,0,0,0,0,780,763,0,0,0,0,0,0,763,1543
IT-LO,Lodi,1,873,0,0,0,0,0,0,873,779,0,0,0,0,0,0,779,1652
IT-LO,Lodi,2,848,0,0,0,0,0,0,848,861,0,0,0,0,0,0,861,1709
IT-LO,Lodi,3,859,0,0,0,0,0,0,859,806,0,0,0,0,0,0,806,1665
IT-LO,Lodi,4,927,0,0,0,0,0,0,927,888,0,0,0,0,0,0,888,1815
IT-LO,Lodi,5,993,0,0,0,0,0,0,993,867,0,0,0,0,0,0,867,1860
IT-LO,Lodi,6,1036,0,0,0,0,0,0,1036,946,0,0,0,0,0,0,946,1982
IT-LO,Lodi,7,1056,0,0,0,0,0,0,1056,1025,0,0,0,0,0,0,1025,2081
IT-LO,Lodi,8,1059,0,0,0,0,0,0,1059,1035,0,0,0,0,0,0,1035,2094
IT-LO,Lodi,9,1116,0,0,0,0,0,0,1116,1057,0,0,0,0,0,0,1057,2173
IT-LO,Lodi,10,1106,0,0,0,0,0,0,1106,1019,0,0,0,0,0,0,1019,2125
IT-LO,Lodi,11,1134,0,0,0,0,0,0,1134,1064,0,0,0,0,0,0,1064,2198
IT-LO,Lodi,12,1184,0,0,0,0,0,0,1184,1050,0,0,0,0,0,0,1050,2234
IT-LO,Lodi,13,1144,0,0,0,0,0,0,1144,1115,0,0,0,0,0,0,1115,2259
IT-LO,Lodi,14,1299,0,0,0,0,0,0,1299,1161,0,0,0,0,0,0,1161,2460
IT-LO,Lodi,15,1223,0,0,0,0,0,0,1223,1083,0,0,0,0,0,0,1083,2306
IT-LO,Lodi,16,1234,0,1,0,0,0,0,1235,1105,0,0,0,0,0,0,1105,2340
IT-LO,Lodi,17,1202,0,0,0,0,0,0,1202,1110,0,0,0,0,0,0,1110,2312
IT-LO,Lodi,18,1207,0,0,0,0,0,0,1207,1098,0,0,0,0,0,0,1098,2305
IT-LO,Lodi,19,1184,0,0,0,0,0,0,1184,1157,4,0,0,0,0,0,1161,2345
IT-LO,Lodi,20,1172,1,0,0,0,0,0,1173,1081,10,0,0,0,0,0,1091,2264
IT-LO,Lodi,21,1077,2,0,0,0,0,0,1079,1051,20,2,0,0,0,0,1073,2152
IT-LO,Lodi,22,1193,3,0,0,0,0,0,1196,1017,34,1,0,0,0,0,1052,2248
IT-LO,Lodi,23,1192,8,0,0,0,0,0,1200,1036,51,1,0,0,0,0,1088,2288
IT-LO,Lodi,24,1208,14,0,0,0,0,0,1222,1015,80,4,0,0,0,0,1099,2321
IT-LO,Lodi,25,1213,26,1,0,0,1,0,1241,963,110,2,0,1,0,0,1076,2317
IT-LO,Lodi,26,1143,43,0,0,0,0,0,1186,966,144,4,0,0,0,0,1114,2300
IT-LO,Lodi,27,1169,70,4,0,0,0,0,1243,964,180,3,0,0,0,0,1147,2390
IT-LO,Lodi,28,1125,87,3,0,0,0,0,1215,885,226,8,1,2,0,0,1122,2337
IT-LO,Lodi,29,1053,125,5,0,2,1,0,1186,860,311,8,1,2,0,0,1182,2368
IT-LO,Lodi,30,1038,185,3,0,1,0,0,1227,758,350,9,0,2,0,0,1119,2346
IT-LO,Lodi,31,1071,248,4,0,3,0,0,1326,787,419,7,1,1,1,0,1216,2542
IT-LO,Lodi,32,934,307,5,0,1,0,0,1247,697,500,18,1,5,0,0,1221,2468
IT-LO,Lodi,33,928,325,7,2,1,0,0,1263,724,511,13,2,2,0,0,1252,2515
IT-LO,Lodi,34,924,426,13,0,1,0,0,1364,655,590,12,3,3,0,0,1263,2627
IT-LO,Lodi,35,847,483,12,0,2,0,0,1344,574,695,25,1,4,0,0,1299,2643
IT-LO,Lodi,36,849,507,18,1,0,0,0,1375,542,744,32,7,2,0,0,1327,2702
IT-LO,Lodi,37,779,567,26,2,1,2,0,1377,516,753,44,10,1,0,0,1324,2701
IT-LO,Lodi,38,699,672,29,1,5,0,0,1406,482,765,40,7,1,0,0,1295,2701
IT-LO,Lodi,39,741,620,19,0,0,0,0,1380,464,886,56,5,2,0,0,1413,2793
IT-LO,Lodi,40,700,720,43,3,2,0,0,1468,447,830,55,10,3,1,0,1346,2814
IT-LO,Lodi,41,655,805,37,5,2,0,0,1504,406,911,73,16,4,0,0,1410,2914
IT-LO,Lodi,42,627,791,52,7,0,0,0,1477,427,910,80,13,5,0,0,1435,2912
IT-LO,Lodi,43,597,885,60,7,2,0,0,1551,385,1025,77,18,3,0,0,1508,3059
IT-LO,Lodi,44,590,954,57,5,3,0,0,1609,402,1020,86,20,1,0,0,1529,3138
IT-LO,Lodi,45,594,958,65,6,1,0,0,1624,377,1106,102,14,3,0,0,1602,3226
IT-LO,Lodi,46,628,1071,73,6,5,0,0,1783,398,1115,122,20,0,0,0,1655,3438
IT-LO,Lodi,47,617,1062,74,8,1,0,0,1762,352,1181,124,24,1,0,0,1682,3444
IT-LO,Lodi,48,636,1125,78,5,6,0,0,1850,405,1309,130,21,2,0,0,1867,3717
IT-LO,Lodi,49,592,1234,106,4,7,0,1,1944,383,1343,147,38,3,0,0,1914,3858
IT-LO,Lodi,50,565,1248,103,8,3,0,0,1927,351,1293,131,28,0,0,0,1803,3730
IT-LO,Lodi,51,533,1305,115,4,1,0,0,1958,381,1292,160,30,1,0,0,1864,3822
IT-LO,Lodi,52,529,1279,120,12,3,0,0,1943,295,1352,161,51,1,0,0,1860,3803
IT-LO,Lodi,53,521,1338,130,14,2,0,0,2005,282,1308,158,49,0,0,0,1797,3802
IT-LO,Lodi,54,467,1336,141,19,3,0,0,1966,288,1426,184,57,0,0,0,1955,3921
IT-LO,Lodi,55,463,1358,153,19,2,0,0,1995,292,1383,176,66,1,0,0,1918,3913
IT-LO,Lodi,56,429,1386,148,15,2,0,0,1980,270,1454,177,69,2,0,0,1972,3952
IT-LO,Lodi,57,419,1426,142,27,2,0,0,2016,230,1376,171,94,1,0,0,1872,3888
IT-LO,Lodi,58,367,1471,161,33,1,0,0,2033,199,1402,191,93,1,0,0,1886,3919
IT-LO,Lodi,59,330,1356,156,26,4,0,0,1872,191,1332,152,102,0,0,0,1777,3649
IT-LO,Lodi,60,302,1351,114,26,3,0,0,1796,200,1230,151,119,0,0,0,1700,3496
IT-LO,Lodi,61,249,1243,130,35,3,0,0,1660,145,1260,134,108,0,0,0,1647,3307
IT-LO,Lodi,62,271,1162,100,35,1,0,0,1569,148,1163,120,145,0,0,0,1576,3145
IT-LO,Lodi,63,181,1173,122,34,3,0,0,1513,141,1128,139,172,1,0,0,1581,3094
IT-LO,Lodi,64,199,1201,87,33,1,0,0,1521,132,1120,111,188,2,0,0,1553,3074
IT-LO,Lodi,65,185,1085,74,48,0,0,0,1392,114,1011,111,187,1,0,0,1424,2816
IT-LO,Lodi,66,154,1075,96,47,1,0,0,1373,126,986,103,227,0,0,0,1442,2815
IT-LO,Lodi,67,134,1059,61,53,0,0,0,1307,90,1024,93,247,0,0,0,1454,2761
IT-LO,Lodi,68,129,976,81,51,0,0,0,1237,94,988,85,203,0,0,0,1370,2607
IT-LO,Lodi,69,125,992,59,51,0,0,0,1227,89,971,74,272,0,0,0,1406,2633
IT-LO,Lodi,70,112,949,61,57,0,0,0,1179,74,810,62,248,0,0,0,1194,2373
IT-LO,Lodi,71,114,958,53,63,0,0,0,1188,77,829,69,315,1,0,0,1291,2479
IT-LO,Lodi,72,108,905,44,72,0,0,0,1129,75,801,46,261,0,0,0,1183,2312
IT-LO,Lodi,73,131,973,41,81,0,0,0,1226,72,799,56,358,1,0,1,1287,2513
IT-LO,Lodi,74,107,952,35,85,0,0,0,1179,70,760,51,418,0,0,0,1299,2478
IT-LO,Lodi,75,99,932,45,109,2,0,0,1187,60,759,49,397,0,0,0,1265,2452
IT-LO,Lodi,76,74,844,27,97,0,0,0,1042,72,680,36,457,0,0,0,1245,2287
IT-LO,Lodi,77,64,829,31,110,0,0,0,1034,55,667,37,476,0,0,0,1235,2269
IT-LO,Lodi,78,59,590,21,100,0,0,0,770,50,451,25,406,0,0,0,932,1702
IT-LO,Lodi,79,55,591,22,96,0,0,0,764,56,426,23,444,0,0,0,949,1713
IT-LO,Lodi,80,50,543,14,99,0,0,0,706,60,398,24,498,0,0,0,980,1686
IT-LO,Lodi,81,63,518,14,95,1,0,0,691,50,353,18,497,0,0,0,918,1609
IT-LO,Lodi,82,46,484,9,118,0,0,0,657,55,269,18,580,0,0,0,922,1579
IT-LO,Lodi,83,49,457,14,114,0,0,0,634,44,291,23,598,0,0,0,956,1590
IT-LO,Lodi,84,53,432,7,139,0,0,0,631,49,241,15,612,0,0,0,917,1548
IT-LO,Lodi,85,44,334,11,141,0,0,0,530,41,177,14,611,0,0,0,843,1373
IT-LO,Lodi,86,24,286,4,114,0,0,0,428,54,160,10,518,0,0,0,742,1170
IT-LO,Lodi,87,27,214,4,84,0,0,0,329,41,116,6,502,0,0,0,665,994
IT-LO,Lodi,88,17,183,3,95,0,0,0,298,41,77,3,450,0,0,0,571,869
IT-LO,Lodi,89,15,133,3,60,0,0,0,211,31,55,2,388,0,0,0,476,687
IT-LO,Lodi,90,12,125,4,53,0,0,0,194,20,33,7,325,0,0,0,385,579
IT-LO,Lodi,91,10,65,1,62,0,0,0,138,14,31,7,334,0,0,0,386,524
IT-LO,Lodi,92,7,48,1,39,0,0,0,95,22,19,1,279,0,0,0,321,416
IT-LO,Lodi,93,8,54,1,32,0,0,0,95,21,6,1,208,0,0,0,236,331
IT-LO,Lodi,94,8,34,0,25,0,0,0,67,18,6,0,162,0,0,0,186,253
IT-LO,Lodi,95,1,8,1,32,0,0,0,42,7,12,0,103,0,0,0,122,164
IT-LO,Lodi,96,2,9,1,9,0,0,0,21,11,1,0,87,0,0,0,99,120
IT-LO,Lodi,97,0,3,0,18,0,0,0,21,7,0,1,61,0,0,0,69,90
IT-LO,Lodi,98,2,6,0,4,0,0,0,12,1,1,0,46,0,0,0,48,60
IT-LO,Lodi,99,0,1,0,3,0,0,0,4,5,1,0,35,0,0,0,41,45
IT-LO,Lodi,100,0,0,0,5,0,0,0,5,8,0,0,47,0,0,0,55,60
IT-LO,Lodi,999,55968,51604,3560,2863,84,4,1,114084,45327,51861,4671,13461,66,2,1,115389,229473
IT-LU,Lucca,0,1066,0,0,0,0,0,0,1066,960,0,0,0,0,0,0,960,2026
IT-LU,Lucca,1,1088,0,0,0,0,0,0,1088,1012,0,0,0,0,0,0,1012,2100
IT-LU,Lucca,2,1167,0,0,0,0,0,0,1167,1146,0,0,0,0,0,0,1146,2313
IT-LU,Lucca,3,1114,0,0,0,0,0,0,1114,1118,0,0,0,0,0,0,1118,2232
IT-LU,Lucca,4,1257,0,0,0,0,0,0,1257,1233,0,0,0,0,0,0,1233,2490
IT-LU,Lucca,5,1258,0,0,0,0,0,0,1258,1260,0,0,0,0,0,0,1260,2518
IT-LU,Lucca,6,1404,0,0,0,0,0,0,1404,1275,0,0,0,0,0,0,1275,2679
IT-LU,Lucca,7,1447,0,0,0,0,0,0,1447,1364,0,0,0,0,0,0,1364,2811
IT-LU,Lucca,8,1482,0,0,0,0,0,0,1482,1364,0,0,0,0,0,0,1364,2846
IT-LU,Lucca,9,1517,0,0,0,0,0,0,1517,1459,0,0,0,0,0,0,1459,2976
IT-LU,Lucca,10,1595,0,0,0,0,0,0,1595,1534,0,0,0,0,0,0,1534,3129
IT-LU,Lucca,11,1732,0,0,0,0,0,0,1732,1652,0,0,0,0,0,0,1652,3384
IT-LU,Lucca,12,1646,0,0,0,0,0,0,1646,1637,0,0,0,0,0,0,1637,3283
IT-LU,Lucca,13,1758,0,0,0,0,0,0,1758,1656,0,0,0,0,0,0,1656,3414
IT-LU,Lucca,14,1778,0,0,0,0,0,0,1778,1577,0,0,0,0,0,0,1577,3355
IT-LU,Lucca,15,1878,0,0,0,0,0,0,1878,1798,0,0,0,0,0,0,1798,3676
IT-LU,Lucca,16,1853,0,0,0,0,0,0,1853,1715,0,0,0,0,0,0,1715,3568
IT-LU,Lucca,17,1839,0,0,0,0,0,0,1839,1742,0,0,0,0,0,0,1742,3581
IT-LU,Lucca,18,1898,0,0,0,0,0,0,1898,1718,0,0,0,0,0,0,1718,3616
IT-LU,Lucca,19,1808,0,0,0,0,0,0,1808,1672,4,0,0,0,0,0,1676,3484
IT-LU,Lucca,20,1829,4,0,0,0,0,0,1833,1620,9,1,0,1,0,0,1631,3464
IT-LU,Lucca,21,1797,2,0,0,1,0,0,1800,1630,16,0,0,0,0,0,1646,3446
IT-LU,Lucca,22,1825,3,1,0,0,0,0,1829,1665,38,1,0,0,0,0,1704,3533
IT-LU,Lucca,23,1781,11,2,0,1,0,0,1795,1586,41,1,0,0,0,0,1628,3423
IT-LU,Lucca,24,1824,27,3,0,0,0,0,1854,1530,63,5,0,0,0,0,1598,3452
IT-LU,Lucca,25,1838,28,1,0,1,0,0,1868,1583,78,2,0,0,0,0,1663,3531
IT-LU,Lucca,26,1812,43,2,0,0,0,0,1857,1503,127,2,0,2,0,0,1634,3491
IT-LU,Lucca,27,1755,61,2,0,0,0,0,1818,1582,165,4,1,0,0,0,1752,3570
IT-LU,Lucca,28,1712,82,5,0,2,0,1,1802,1409,245,6,0,2,0,0,1662,3464
IT-LU,Lucca,29,1660,142,1,0,0,0,0,1803,1400,286,11,0,2,0,0,1699,3502
IT-LU,Lucca,30,1699,175,10,0,0,0,0,1884,1321,400,11,0,2,0,0,1734,3618
IT-LU,Lucca,31,1608,252,8,0,4,0,0,1872,1286,509,14,1,3,0,0,1813,3685
IT-LU,Lucca,32,1580,334,7,1,3,0,0,1925,1220,598,24,0,2,1,0,1845,3770
IT-LU,Lucca,33,1515,410,16,0,2,1,0,1944,1195,664,28,4,8,0,0,1899,3843
IT-LU,Lucca,34,1378,479,15,2,4,0,0,1878,1044,714,39,3,8,0,0,1808,3686
IT-LU,Lucca,35,1348,582,24,0,5,1,0,1960,1065,893,37,6,7,0,1,2009,3969
IT-LU,Lucca,36,1238,612,23,1,3,0,0,1877,904,924,56,0,11,0,0,1895,3772
IT-LU,Lucca,37,1201,715,32,1,3,2,0,1954,842,913,69,7,12,0,0,1843,3797
IT-LU,Lucca,38,1144,816,47,0,3,1,0,2011,919,1064,76,9,5,0,0,2073,4084
IT-LU,Lucca,39,1124,894,60,0,6,0,0,2084,822,1137,93,7,11,0,0,2070,4154
IT-LU,Lucca,40,1047,941,58,4,4,0,1,2055,823,1159,109,10,7,0,0,2108,4163
IT-LU,Lucca,41,1121,1017,64,1,10,0,0,2213,827,1288,114,12,6,0,0,2247,4460
IT-LU,Lucca,42,1059,1119,80,6,4,0,0,2268,771,1319,142,16,5,1,0,2254,4522
IT-LU,Lucca,43,1027,1165,109,6,0,1,0,2308,802,1448,148,25,6,3,0,2432,4740
IT-LU,Lucca,44,1033,1265,93,9,8,0,0,2408,766,1517,166,20,4,0,0,2473,4881
IT-LU,Lucca,45,1019,1387,101,4,9,0,1,2521,822,1642,198,25,6,1,0,2694,5215
IT-LU,Lucca,46,1109,1475,138,11,7,0,0,2740,760,1696,240,30,8,0,1,2735,5475
IT-LU,Lucca,47,1063,1608,161,8,8,0,0,2848,767,1812,240,38,6,1,0,2864,5712
IT-LU,Lucca,48,1122,1667,182,9,11,2,1,2994,829,1949,281,44,10,1,0,3114,6108
IT-LU,Lucca,49,1055,1775,198,16,6,0,0,3050,738,2055,298,55,6,0,0,3152,6202
IT-LU,Lucca,50,1033,1837,220,17,6,1,0,3114,691,2115,344,53,4,1,0,3208,6322
IT-LU,Lucca,51,927,1927,262,15,9,0,0,3140,651,2212,374,57,12,0,0,3306,6446
IT-LU,Lucca,52,882,1978,282,16,5,0,0,3163,655,2220,380,95,6,0,0,3356,6519
IT-LU,Lucca,53,903,1983,282,26,3,1,0,3198,563,2170,404,85,10,0,0,3232,6430
IT-LU,Lucca,54,791,2066,328,13,6,0,0,3204,557,2252,402,113,3,0,0,3327,6531
IT-LU,Lucca,55,722,2169,318,22,12,0,0,3243,540,2287,395,115,5,0,0,3342,6585
IT-LU,Lucca,56,701,2151,320,36,5,0,0,3213,484,2293,409,135,6,0,0,3327,6540
IT-LU,Lucca,57,684,2192,335,39,10,0,0,3260,485,2312,407,132,4,0,0,3340,6600
IT-LU,Lucca,58,623,2324,329,36,10,0,0,3322,483,2458,419,165,5,0,0,3530,6852
IT-LU,Lucca,59,567,2281,368,40,8,0,1,3265,430,2415,467,190,3,0,0,3505,6770
IT-LU,Lucca,60,508,2253,347,49,12,0,0,3169,319,2236,417,208,1,0,0,3181,6350
IT-LU,Lucca,61,481,2099,276,48,9,0,0,2913,327,2119,368,242,3,0,0,3059,5972
IT-LU,Lucca,62,422,2117,269,50,7,0,0,2865,309,2121,399,260,2,0,0,3091,5956
IT-LU,Lucca,63,389,2138,295,60,8,0,0,2890,275,2027,332,280,5,0,0,2919,5809
IT-LU,Lucca,64,343,1996,234,54,5,0,0,2632,230,2016,321,307,1,0,0,2875,5507
IT-LU,Lucca,65,293,1894,251,64,2,0,0,2504,229,1943,258,280,0,0,0,2710,5214
IT-LU,Lucca,66,269,1808,208,65,4,0,0,2354,209,1858,275,337,2,0,0,2681,5035
IT-LU,Lucca,67,258,1849,207,105,5,0,0,2424,173,1786,224,356,1,0,0,2540,4964
IT-LU,Lucca,68,239,1750,190,90,6,0,0,2275,152,1753,201,390,1,0,0,2497,4772
IT-LU,Lucca,69,213,1817,177,79,4,0,0,2290,163,1706,225,419,0,0,0,2513,4803
IT-LU,Lucca,70,185,1745,157,104,1,0,0,2192,160,1544,183,474,1,0,0,2362,4554
IT-LU,Lucca,71,190,1699,124,127,4,0,0,2144,142,1620,166,541,1,0,0,2470,4614
IT-LU,Lucca,72,156,1641,141,133,4,0,0,2075,106,1570,184,515,0,0,0,2375,4450
IT-LU,Lucca,73,154,1741,113,136,5,0,1,2150,123,1504,158,568,0,0,0,2353,4503
IT-LU,Lucca,74,156,1704,106,150,1,0,1,2118,117,1447,132,663,0,0,0,2359,4477
IT-LU,Lucca,75,182,1764,112,159,0,0,0,2217,147,1530,132,763,0,0,0,2572,4789
IT-LU,Lucca,76,177,1682,97,193,2,0,0,2151,123,1473,114,853,0,0,0,2563,4714
IT-LU,Lucca,77,156,1738,85,227,1,0,0,2207,104,1401,104,972,1,0,0,2582,4789
IT-LU,Lucca,78,108,1205,60,188,2,0,0,1563,84,978,85,728,0,0,0,1875,3438
IT-LU,Lucca,79,125,1253,58,157,0,0,0,1593,99,939,74,903,1,0,0,2016,3609
IT-LU,Lucca,80,91,1164,47,214,0,0,0,1516,85,838,67,894,2,0,0,1886,3402
IT-LU,Lucca,81,101,1037,37,211,4,0,0,1390,94,795,69,954,0,0,0,1912,3302
IT-LU,Lucca,82,90,1092,29,229,2,0,0,1442,86,698,57,1057,1,0,0,1899,3341
IT-LU,Lucca,83,104,979,30,246,1,0,0,1360,89,655,52,1166,0,0,0,1962,3322
IT-LU,Lucca,84,89,905,28,198,0,0,0,1220,91,580,36,1128,1,0,0,1836,3056
IT-LU,Lucca,85,66,845,19,286,0,0,0,1216,76,492,34,1144,2,0,0,1748,2964
IT-LU,Lucca,86,75,646,21,221,0,0,0,963,70,356,31,1036,1,0,0,1494,2457
IT-LU,Lucca,87,58,509,19,231,1,0,0,818,71,258,32,910,0,0,0,1271,2089
IT-LU,Lucca,88,38,458,10,240,0,0,0,746,69,202,31,934,0,0,0,1236,1982
IT-LU,Lucca,89,29,341,16,171,0,0,0,557,57,154,14,817,0,0,0,1042,1599
IT-LU,Lucca,90,30,268,4,154,0,0,0,456,60,107,8,725,0,0,0,900,1356
IT-LU,Lucca,91,18,204,4,145,0,0,0,371,59,86,10,641,0,0,0,796,1167
IT-LU,Lucca,92,13,153,0,105,0,0,0,271,59,56,10,558,0,0,0,683,954
IT-LU,Lucca,93,18,113,4,103,0,0,0,238,36,33,6,489,0,0,0,564,802
IT-LU,Lucca,94,9,40,4,74,0,0,0,127,29,23,5,376,0,0,0,433,560
IT-LU,Lucca,95,6,35,2,48,0,0,0,91,24,11,3,294,0,0,0,332,423
IT-LU,Lucca,96,3,18,1,39,0,0,0,61,25,11,4,202,0,0,0,242,303
IT-LU,Lucca,97,3,13,1,24,0,0,0,41,15,2,1,143,0,0,0,161,202
IT-LU,Lucca,98,5,12,0,10,0,0,0,27,14,2,2,111,0,0,0,129,156
IT-LU,Lucca,99,1,8,0,12,0,0,0,21,10,1,1,80,0,0,0,92,113
IT-LU,Lucca,100,3,8,1,21,0,0,0,33,11,6,2,97,0,0,0,116,149
IT-LU,Lucca,999,86595,84740,8271,5559,269,10,7,185451,73183,86444,11244,25268,225,9,2,196375,381826
IT-MC,Macerata,0,981,0,0,0,0,0,0,981,915,0,0,0,0,0,0,915,1896
IT-MC,Macerata,1,977,0,0,0,0,0,0,977,892,0,0,0,0,0,0,892,1869
IT-MC,Macerata,2,1054,0,0,0,0,0,0,1054,1002,0,0,0,0,0,0,1002,2056
IT-MC,Macerata,3,1090,0,0,0,0,0,0,1090,998,0,0,0,0,0,0,998,2088
IT-MC,Macerata,4,1094,0,0,0,0,0,0,1094,1036,0,0,0,0,0,0,1036,2130
IT-MC,Macerata,5,1148,0,0,0,0,0,0,1148,1060,0,0,0,0,0,0,1060,2208
IT-MC,Macerata,6,1214,0,0,0,0,0,0,1214,1167,0,0,0,0,0,0,1167,2381
IT-MC,Macerata,7,1226,0,0,0,0,0,0,1226,1238,0,0,0,0,0,0,1238,2464
IT-MC,Macerata,8,1244,0,0,0,0,0,0,1244,1217,0,0,0,0,0,0,1217,2461
IT-MC,Macerata,9,1299,0,0,0,0,0,0,1299,1285,0,0,0,0,0,0,1285,2584
IT-MC,Macerata,10,1337,0,0,0,0,0,0,1337,1190,0,0,0,0,0,0,1190,2527
IT-MC,Macerata,11,1354,0,0,0,0,0,0,1354,1292,0,0,0,0,0,0,1292,2646
IT-MC,Macerata,12,1385,0,0,0,0,0,0,1385,1384,0,0,0,0,0,0,1384,2769
IT-MC,Macerata,13,1524,0,0,0,0,0,0,1524,1328,0,0,0,0,0,0,1328,2852
IT-MC,Macerata,14,1484,0,0,0,0,0,0,1484,1431,0,0,0,0,0,0,1431,2915
IT-MC,Macerata,15,1472,0,0,0,0,0,0,1472,1369,0,0,0,0,0,0,1369,2841
IT-MC,Macerata,16,1479,0,0,0,0,0,0,1479,1433,0,0,0,0,0,0,1433,2912
IT-MC,Macerata,17,1413,0,0,0,0,0,0,1413,1384,1,0,0,0,0,0,1385,2798
IT-MC,Macerata,18,1408,1,0,0,0,0,0,1409,1383,4,0,0,0,0,0,1387,2796
IT-MC,Macerata,19,1500,0,0,0,0,0,0,1500,1307,2,0,0,0,0,0,1309,2809
IT-MC,Macerata,20,1551,0,0,0,0,0,0,1551,1355,11,0,0,0,0,0,1366,2917
IT-MC,Macerata,21,1511,5,0,0,0,0,0,1516,1343,13,0,0,0,0,0,1356,2872
IT-MC,Macerata,22,1445,5,2,0,0,0,0,1452,1333,27,1,0,0,0,0,1361,2813
IT-MC,Macerata,23,1540,15,0,0,0,0,0,1555,1364,52,2,0,0,0,0,1418,2973
IT-MC,Macerata,24,1536,15,0,0,1,0,0,1552,1332,69,2,0,0,0,0,1403,2955
IT-MC,Macerata,25,1530,29,2,1,0,0,0,1562,1259,102,0,0,0,1,0,1362,2924
IT-MC,Macerata,26,1596,48,3,0,0,0,0,1647,1209,165,4,0,1,0,0,1379,3026
IT-MC,Macerata,27,1434,81,3,0,0,0,0,1518,1249,187,4,1,0,0,0,1441,2959
IT-MC,Macerata,28,1415,115,3,0,1,0,0,1534,1139,241,8,0,2,0,0,1390,2924
IT-MC,Macerata,29,1440,146,1,1,0,0,0,1588,1119,301,10,0,0,0,0,1430,3018
IT-MC,Macerata,30,1428,190,4,0,0,0,0,1622,1054,395,6,0,1,0,0,1456,3078
IT-MC,Macerata,31,1353,270,9,0,2,0,0,1634,995,488,18,0,1,0,0,1502,3136
IT-MC,Macerata,32,1242,316,5,1,1,0,0,1565,983,567,22,0,1,0,0,1573,3138
IT-MC,Macerata,33,1305,386,8,1,2,0,0,1702,937,663,20,3,3,0,0,1626,3328
IT-MC,Macerata,34,1199,465,8,0,1,0,0,1673,813,660,32,3,1,0,0,1509,3182
IT-MC,Macerata,35,1108,540,14,1,1,0,0,1664,827,814,33,3,1,0,0,1678,3342
IT-MC,Macerata,36,978,638,15,0,0,0,0,1631,699,831,33,5,2,0,1,1571,3202
IT-MC,Macerata,37,1012,678,21,2,1,0,0,1714,753,831,49,10,1,0,0,1644,3358
IT-MC,Macerata,38,971,729,21,8,2,0,0,1731,699,975,52,4,1,1,0,1732,3463
IT-MC,Macerata,39,945,736,40,3,4,0,0,1728,641,992,70,6,0,0,0,1709,3437
IT-MC,Macerata,40,867,827,48,2,0,0,0,1744,593,1069,80,9,3,0,0,1754,3498
IT-MC,Macerata,41,878,962,37,1,1,0,0,1879,651,1124,65,11,0,0,0,1851,3730
IT-MC,Macerata,42,869,958,57,1,3,0,0,1888,584,1176,79,17,4,0,0,1860,3748
IT-MC,Macerata,43,840,987,61,6,1,0,0,1895,543,1228,112,17,3,0,0,1903,3798
IT-MC,Macerata,44,819,1062,56,8,2,0,0,1947,556,1335,111,25,1,0,0,2028,3975
IT-MC,Macerata,45,824,1169,85,5,4,0,0,2087,583,1291,146,24,0,0,0,2044,4131
IT-MC,Macerata,46,796,1232,105,5,2,0,0,2140,538,1463,149,17,1,0,0,2168,4308
IT-MC,Macerata,47,785,1297,117,8,0,0,0,2207,508,1493,155,36,1,0,0,2193,4400
IT-MC,Macerata,48,806,1347,101,11,1,0,0,2266,536,1574,182,32,1,0,0,2325,4591
IT-MC,Macerata,49,741,1458,125,7,4,0,0,2335,515,1615,204,43,0,0,0,2377,4712
IT-MC,Macerata,50,702,1442,121,9,2,0,0,2276,488,1589,178,53,0,0,0,2308,4584
IT-MC,Macerata,51,690,1479,168,16,0,0,0,2353,404,1611,207,52,0,0,0,2274,4627
IT-MC,Macerata,52,679,1519,136,14,0,0,0,2348,431,1765,206,63,0,0,0,2465,4813
IT-MC,Macerata,53,581,1546,138,10,1,0,0,2276,382,1610,189,72,0,0,0,2253,4529
IT-MC,Macerata,54,583,1601,201,23,0,0,0,2408,376,1780,193,82,0,0,0,2431,4839
IT-MC,Macerata,55,529,1697,158,14,0,0,0,2398,332,1705,210,99,0,0,0,2346,4744
IT-MC,Macerata,56,489,1629,163,24,0,0,0,2305,347,1787,189,106,0,0,0,2429,4734
IT-MC,Macerata,57,483,1664,182,22,1,0,0,2352,342,1756,214,104,0,0,0,2416,4768
IT-MC,Macerata,58,427,1702,192,20,1,0,0,2342,293,1833,228,124,1,0,1,2480,4822
IT-MC,Macerata,59,449,1779,211,21,0,0,0,2460,273,1862,195,135,1,0,0,2466,4926
IT-MC,Macerata,60,346,1685,171,33,1,0,0,2236,256,1773,203,142,2,0,0,2376,4612
IT-MC,Macerata,61,340,1692,170,42,0,0,0,2244,220,1634,185,147,1,0,0,2187,4431
IT-MC,Macerata,62,331,1698,149,45,2,0,0,2225,241,1679,200,180,0,0,0,2300,4525
IT-MC,Macerata,63,275,1630,151,56,0,0,0,2112,210,1683,157,222,0,0,0,2272,4384
IT-MC,Macerata,64,277,1623,136,39,0,0,0,2075,172,1667,148,237,0,0,0,2224,4299
IT-MC,Macerata,65,235,1578,115,57,1,0,0,1986,172,1539,163,216,1,0,0,2091,4077
IT-MC,Macerata,66,197,1504,123,67,1,0,0,1892,167,1547,163,290,0,0,0,2167,4059
IT-MC,Macerata,67,193,1550,95,83,1,0,0,1922,167,1452,125,271,0,0,0,2015,3937
IT-MC,Macerata,68,190,1443,104,85,2,0,0,1824,141,1408,120,368,0,0,0,2037,3861
IT-MC,Macerata,69,179,1467,83,90,1,0,0,1820,120,1378,109,333,0,0,0,1940,3760
IT-MC,Macerata,70,177,1445,85,79,0,0,0,1786,96,1291,107,367,0,0,0,1861,3647
IT-MC,Macerata,71,164,1470,90,96,1,0,0,1821,113,1279,86,426,0,0,0,1904,3725
IT-MC,Macerata,72,163,1383,70,99,0,0,0,1715,112,1341,95,443,0,0,0,1991,3706
IT-MC,Macerata,73,133,1412,65,93,0,0,0,1703,95,1244,92,498,0,0,0,1929,3632
IT-MC,Macerata,74,146,1329,59,102,0,0,0,1636,83,1077,68,514,0,0,0,1742,3378
IT-MC,Macerata,75,112,1298,57,121,1,0,0,1589,102,1155,48,616,0,0,0,1921,3510
IT-MC,Macerata,76,130,1277,48,103,2,0,0,1560,62,1006,59,642,0,0,0,1769,3329
IT-MC,Macerata,77,101,1116,36,147,1,0,0,1401,61,974,45,640,0,0,0,1720,3121
IT-MC,Macerata,78,79,928,30,114,0,0,0,1151,66,721,45,641,0,0,0,1473,2624
IT-MC,Macerata,79,93,898,29,116,0,0,0,1136,67,627,33,673,0,0,0,1400,2536
IT-MC,Macerata,80,73,881,26,122,1,0,0,1103,64,607,34,720,0,0,0,1425,2528
IT-MC,Macerata,81,74,830,18,125,1,0,0,1048,45,530,26,802,0,0,0,1403,2451
IT-MC,Macerata,82,72,716,15,121,0,0,0,924,67,519,19,779,0,0,0,1384,2308
IT-MC,Macerata,83,81,830,15,157,0,0,0,1083,53,497,30,895,0,0,0,1475,2558
IT-MC,Macerata,84,87,826,13,159,0,0,0,1085,69,457,24,975,0,0,0,1525,2610
IT-MC,Macerata,85,61,756,14,225,0,0,0,1056,60,335,15,1104,0,0,0,1514,2570
IT-MC,Macerata,86,67,612,11,161,0,0,0,851,55,279,8,919,0,0,0,1261,2112
IT-MC,Macerata,87,38,457,9,136,0,0,0,640,53,169,12,883,0,0,0,1117,1757
IT-MC,Macerata,88,42,465,6,134,0,0,0,647,47,143,7,872,0,0,0,1069,1716
IT-MC,Macerata,89,32,359,6,161,0,0,0,558,39,86,9,787,0,0,0,921,1479
IT-MC,Macerata,90,24,263,1,120,0,0,0,408,35,58,5,695,0,0,0,793,1201
IT-MC,Macerata,91,24,188,1,90,0,0,0,303,35,47,5,603,0,0,0,690,993
IT-MC,Macerata,92,18,152,4,82,0,0,0,256,22,28,2,494,0,0,0,546,802
IT-MC,Macerata,93,8,101,0,75,0,0,0,184,26,21,3,470,0,0,0,520,704
IT-MC,Macerata,94,13,60,1,65,0,0,0,139,17,3,3,319,0,0,0,342,481
IT-MC,Macerata,95,7,55,1,42,0,0,0,105,17,9,2,230,0,0,0,258,363
IT-MC,Macerata,96,0,29,0,38,0,0,0,67,15,4,2,222,0,0,0,243,310
IT-MC,Macerata,97,2,13,0,17,0,0,0,32,15,5,1,161,0,0,0,182,214
IT-MC,Macerata,98,3,5,0,15,0,0,0,23,11,1,1,87,0,0,0,100,123
IT-MC,Macerata,99,1,10,0,11,0,0,0,22,4,1,0,62,0,0,0,67,89
IT-MC,Macerata,100,0,8,0,16,0,0,0,24,12,1,0,110,0,0,0,123,147
IT-MC,Macerata,999,70647,68807,4628,3984,55,0,0,148121,58173,69332,6117,21211,35,2,2,154872,302993
IT-MN,Mantova,0,1367,0,0,0,0,0,0,1367,1245,0,0,0,0,0,0,1245,2612
IT-MN,Mantova,1,1411,0,0,0,0,0,0,1411,1251,0,0,0,0,0,0,1251,2662
IT-MN,Mantova,2,1412,0,0,0,0,0,0,1412,1362,0,0,0,0,0,0,1362,2774
IT-MN,Mantova,3,1470,0,0,0,0,0,0,1470,1391,0,0,0,0,0,0,1391,2861
IT-MN,Mantova,4,1542,0,0,0,0,0,0,1542,1535,0,0,0,0,0,0,1535,3077
IT-MN,Mantova,5,1613,0,0,0,0,0,0,1613,1565,0,0,0,0,0,0,1565,3178
IT-MN,Mantova,6,1692,0,0,0,0,0,0,1692,1555,0,0,0,0,0,0,1555,3247
IT-MN,Mantova,7,1708,0,0,0,0,0,0,1708,1657,0,0,0,0,0,0,1657,3365
IT-MN,Mantova,8,1853,0,0,0,0,0,0,1853,1646,0,0,0,0,0,0,1646,3499
IT-MN,Mantova,9,1867,0,0,0,0,0,0,1867,1765,0,0,0,0,0,0,1765,3632
IT-MN,Mantova,10,1856,0,0,0,0,0,0,1856,1776,0,0,0,0,0,0,1776,3632
IT-MN,Mantova,11,1959,0,0,0,0,0,0,1959,1794,0,0,0,0,0,0,1794,3753
IT-MN,Mantova,12,2051,0,0,0,0,0,0,2051,1871,0,0,0,0,0,0,1871,3922
IT-MN,Mantova,13,2142,0,0,0,0,0,0,2142,1925,0,0,0,0,0,0,1925,4067
IT-MN,Mantova,14,2056,0,0,0,0,0,0,2056,1984,0,0,0,0,0,0,1984,4040
IT-MN,Mantova,15,2115,0,0,0,0,0,0,2115,1901,0,0,0,0,0,0,1901,4016
IT-MN,Mantova,16,2071,0,0,0,0,0,0,2071,1963,1,0,0,0,0,0,1964,4035
IT-MN,Mantova,17,2090,0,0,0,0,0,0,2090,1878,0,0,0,0,0,0,1878,3968
IT-MN,Mantova,18,2037,0,0,0,0,0,0,2037,1848,3,0,0,0,0,0,1851,3888
IT-MN,Mantova,19,1963,1,0,0,0,0,0,1964,1933,8,0,0,0,0,0,1941,3905
IT-MN,Mantova,20,1967,3,0,0,0,1,0,1971,1674,30,1,0,0,0,0,1705,3676
IT-MN,Mantova,21,2035,7,1,0,0,0,0,2043,1694,47,0,0,0,0,0,1741,3784
IT-MN,Mantova,22,2008,11,4,0,0,0,0,2023,1716,81,0,0,0,0,0,1797,3820
IT-MN,Mantova,23,2098,16,4,0,1,0,0,2119,1710,122,2,0,0,0,0,1834,3953
IT-MN,Mantova,24,2158,54,2,0,0,0,0,2214,1728,153,3,0,1,0,0,1885,4099
IT-MN,Mantova,25,2111,72,4,0,2,0,0,2189,1686,231,2,0,0,0,0,1919,4108
IT-MN,Mantova,26,2004,110,3,0,1,0,0,2118,1560,265,7,0,0,0,0,1832,3950
IT-MN,Mantova,27,1952,144,9,0,0,0,0,2105,1506,417,10,2,0,0,0,1935,4040
IT-MN,Mantova,28,1804,198,8,0,1,0,0,2011,1402,438,10,0,3,0,0,1853,3864
IT-MN,Mantova,29,1893,274,12,0,0,1,0,2180,1397,542,11,1,2,0,0,1953,4133
IT-MN,Mantova,30,1770,338,17,1,1,0,0,2127,1283,660,17,0,2,0,0,1962,4089
IT-MN,Mantova,31,1741,422,8,1,4,0,0,2176,1217,808,31,0,3,0,0,2059,4235
IT-MN,Mantova,32,1614,500,12,2,4,1,0,2133,1074,905,32,2,7,1,0,2021,4154
IT-MN,Mantova,33,1603,610,21,2,2,0,0,2238,1056,983,39,6,1,0,0,2085,4323
IT-MN,Mantova,34,1463,739,21,3,2,0,0,2228,1008,1054,47,1,3,1,0,2114,4342
IT-MN,Mantova,35,1444,855,40,0,2,1,0,2342,976,1173,47,11,1,0,0,2208,4550
IT-MN,Mantova,36,1321,972,24,1,4,1,0,2323,873,1234,55,5,5,0,0,2172,4495
IT-MN,Mantova,37,1274,1011,44,2,6,2,0,2339,827,1289,89,8,4,0,0,2217,4556
IT-MN,Mantova,38,1213,1041,63,3,4,0,0,2324,890,1302,74,8,2,0,0,2276,4600
IT-MN,Mantova,39,1253,1128,45,2,2,0,0,2430,812,1398,72,22,2,1,0,2307,4737
IT-MN,Mantova,40,1181,1213,68,5,4,0,0,2471,753,1330,130,11,4,0,0,2228,4699
IT-MN,Mantova,41,1180,1312,67,2,2,0,0,2563,749,1476,131,24,3,0,0,2383,4946
IT-MN,Mantova,42,1169,1386,105,11,3,0,0,2674,765,1583,156,24,2,0,0,2530,5204
IT-MN,Mantova,43,1173,1470,94,13,4,0,1,2755,824,1740,166,29,3,0,0,2762,5517
IT-MN,Mantova,44,1095,1588,100,6,5,1,0,2795,764,1731,185,35,3,0,0,2718,5513
IT-MN,Mantova,45,1199,1674,148,23,1,0,0,3045,796,1842,228,30,1,0,0,2897,5942
IT-MN,Mantova,46,1220,1777,173,19,4,0,0,3193,813,1930,250,43,2,0,0,3038,6231
IT-MN,Mantova,47,1205,1831,189,17,0,0,0,3242,785,1906,256,41,2,0,0,2990,6232
IT-MN,Mantova,48,1219,1967,218,13,5,0,0,3422,774,2113,261,56,1,0,0,3205,6627
IT-MN,Mantova,49,1180,2048,214,17,6,0,0,3465,763,2170,309,57,0,0,0,3299,6764
IT-MN,Mantova,50,1116,2106,231,13,2,0,0,3468,768,2161,351,69,2,1,0,3352,6820
IT-MN,Mantova,51,1070,2163,254,20,4,0,0,3511,695,2248,317,80,5,0,0,3345,6856
IT-MN,Mantova,52,948,2111,246,27,4,0,0,3336,669,2302,340,83,3,0,0,3397,6733
IT-MN,Mantova,53,947,2164,277,28,3,0,0,3419,586,2172,337,94,0,0,0,3189,6608
IT-MN,Mantova,54,882,2270,307,26,0,0,0,3485,554,2251,385,100,3,0,0,3293,6778
IT-MN,Mantova,55,808,2287,283,31,4,0,0,3413,578,2293,364,132,2,0,0,3369,6782
IT-MN,Mantova,56,774,2234,305,30,5,0,0,3348,493,2299,374,123,2,0,0,3291,6639
IT-MN,Mantova,57,670,2290,313,42,6,0,0,3321,480,2290,309,140,2,0,0,3221,6542
IT-MN,Mantova,58,686,2427,313,45,3,0,1,3475,439,2284,359,167,2,0,0,3251,6726
IT-MN,Mantova,59,595,2390,313,47,3,0,1,3349,391,2278,400,192,2,0,0,3263,6612
IT-MN,Mantova,60,513,2231,281,56,4,0,0,3085,396,2156,312,187,2,0,0,3053,6138
IT-MN,Mantova,61,452,2120,275,56,1,0,0,2904,348,2106,324,235,2,0,0,3015,5919
IT-MN,Mantova,62,446,2202,270,78,2,0,0,2998,292,2123,298,265,1,0,0,2979,5977
IT-MN,Mantova,63,385,2066,247,66,3,0,2,2769,320,1992,269,285,2,0,0,2868,5637
IT-MN,Mantova,64,333,2041,232,66,4,0,0,2676,263,1934,254,304,4,0,0,2759,5435
IT-MN,Mantova,65,288,1835,191,91,3,0,0,2408,224,1812,227,350,1,0,0,2614,5022
IT-MN,Mantova,66,284,1917,211,80,3,0,0,2495,222,1833,214,352,0,0,0,2621,5116
IT-MN,Mantova,67,246,1891,183,77,5,0,0,2402,184,1769,184,416,0,0,0,2553,4955
IT-MN,Mantova,68,218,1792,159,99,5,0,0,2273,219,1786,173,378,1,0,0,2557,4830
IT-MN,Mantova,69,229,1793,131,121,2,0,0,2276,201,1662,175,467,0,0,0,2505,4781
IT-MN,Mantova,70,177,1674,106,119,1,0,0,2077,137,1584,145,473,1,0,0,2340,4417
IT-MN,Mantova,71,190,1618,130,142,2,0,0,2082,161,1560,143,541,0,0,0,2405,4487
IT-MN,Mantova,72,161,1604,112,157,2,0,0,2036,138,1484,135,523,0,0,0,2280,4316
IT-MN,Mantova,73,166,1705,96,144,0,0,1,2112,127,1529,112,617,1,0,0,2386,4498
IT-MN,Mantova,74,161,1720,83,156,0,0,1,2121,127,1465,112,668,0,0,0,2372,4493
IT-MN,Mantova,75,155,1742,78,178,1,0,0,2154,138,1449,126,809,0,0,0,2522,4676
IT-MN,Mantova,76,162,1747,72,193,1,0,1,2176,127,1449,94,884,1,0,0,2555,4731
IT-MN,Mantova,77,186,1668,62,242,0,0,0,2158,124,1341,96,908,0,0,0,2469,4627
IT-MN,Mantova,78,81,1006,36,148,0,0,0,1271,78,780,65,707,0,0,0,1630,2901
IT-MN,Mantova,79,109,1152,38,174,1,0,1,1475,95,846,44,884,0,0,0,1869,3344
IT-MN,Mantova,80,103,1017,27,174,1,0,0,1322,96,843,55,879,0,0,0,1873,3195
IT-MN,Mantova,81,90,983,40,180,1,0,0,1294,107,697,41,909,0,0,0,1754,3048
IT-MN,Mantova,82,104,910,17,181,2,0,0,1214,80,660,44,1006,0,0,0,1790,3004
IT-MN,Mantova,83,106,982,26,253,0,0,0,1367,115,612,24,1123,0,0,0,1874,3241
IT-MN,Mantova,84,94,865,17,228,1,0,0,1205,83,510,34,1130,0,0,0,1757,2962
IT-MN,Mantova,85,60,800,12,234,0,0,0,1106,69,474,26,1197,0,0,0,1766,2872
IT-MN,Mantova,86,77,674,7,205,0,0,0,963,81,305,21,1038,0,0,0,1445,2408
IT-MN,Mantova,87,46,454,9,196,0,0,0,705,71,217,15,934,0,0,0,1237,1942
IT-MN,Mantova,88,46,423,7,200,0,0,0,676,61,190,9,962,0,0,0,1222,1898
IT-MN,Mantova,89,29,338,5,216,0,0,0,588,76,124,13,868,0,0,0,1081,1669
IT-MN,Mantova,90,26,259,4,148,0,0,0,437,44,96,5,757,0,0,0,902,1339
IT-MN,Mantova,91,21,188,3,128,0,0,0,340,41,52,4,687,0,0,0,784,1124
IT-MN,Mantova,92,16,144,0,105,0,0,0,265,33,31,3,575,0,0,0,642,907
IT-MN,Mantova,93,10,92,2,83,0,0,0,187,30,27,5,489,0,0,0,551,738
IT-MN,Mantova,94,4,59,1,55,0,0,0,119,28,10,1,385,0,0,0,424,543
IT-MN,Mantova,95,2,33,0,36,0,0,0,71,24,12,2,319,0,0,0,357,428
IT-MN,Mantova,96,3,20,0,36,0,0,0,59,14,8,3,222,0,0,0,247,306
IT-MN,Mantova,97,4,14,0,21,0,0,0,39,9,2,0,184,0,0,0,195,234
IT-MN,Mantova,98,3,13,0,11,0,0,0,27,10,2,0,118,0,0,0,130,157
IT-MN,Mantova,99,1,5,0,11,0,0,0,17,12,0,2,75,0,0,0,89,106
IT-MN,Mantova,100,5,6,0,14,0,0,0,25,12,2,0,130,0,0,0,144,169
IT-MN,Mantova,999,97110,91017,7730,5610,149,8,9,201633,78390,91077,9966,25836,96,4,0,205369,407002
IT-MS,Massa-Carrara,0,461,0,0,0,0,0,0,461,457,0,0,0,0,0,0,457,918
IT-MS,Massa-Carrara,1,483,0,0,0,0,0,0,483,514,0,0,0,0,0,0,514,997
IT-MS,Massa-Carrara,2,530,0,0,0,0,0,0,530,479,0,0,0,0,0,0,479,1009
IT-MS,Massa-Carrara,3,527,0,0,0,0,0,0,527,469,0,0,0,0,0,0,469,996
IT-MS,Massa-Carrara,4,518,0,0,0,0,0,0,518,529,0,0,0,0,0,0,529,1047
IT-MS,Massa-Carrara,5,594,0,0,0,0,0,0,594,564,0,0,0,0,0,0,564,1158
IT-MS,Massa-Carrara,6,648,0,0,0,0,0,0,648,613,0,0,0,0,0,0,613,1261
IT-MS,Massa-Carrara,7,646,0,0,0,0,0,0,646,615,0,0,0,0,0,0,615,1261
IT-MS,Massa-Carrara,8,661,0,0,0,0,0,0,661,573,0,0,0,0,0,0,573,1234
IT-MS,Massa-Carrara,9,687,0,0,0,0,0,0,687,658,0,0,0,0,0,0,658,1345
IT-MS,Massa-Carrara,10,733,0,0,0,0,0,0,733,710,0,0,0,0,0,0,710,1443
IT-MS,Massa-Carrara,11,791,0,0,0,0,0,0,791,753,0,0,0,0,0,0,753,1544
IT-MS,Massa-Carrara,12,769,0,0,0,0,0,0,769,795,0,0,0,0,0,0,795,1564
IT-MS,Massa-Carrara,13,777,0,0,0,0,0,0,777,784,0,0,0,0,0,0,784,1561
IT-MS,Massa-Carrara,14,768,0,0,0,0,0,0,768,736,0,0,0,0,0,0,736,1504
IT-MS,Massa-Carrara,15,895,0,0,0,0,0,0,895,812,0,0,0,0,0,0,812,1707
IT-MS,Massa-Carrara,16,830,0,0,0,0,0,0,830,777,0,0,0,0,0,0,777,1607
IT-MS,Massa-Carrara,17,877,0,0,0,0,0,0,877,767,0,0,0,0,0,0,767,1644
IT-MS,Massa-Carrara,18,887,0,0,0,0,0,0,887,764,1,0,0,0,0,0,765,1652
IT-MS,Massa-Carrara,19,808,0,0,0,0,0,0,808,791,2,0,0,0,0,0,793,1601
IT-MS,Massa-Carrara,20,837,2,0,0,0,0,0,839,758,7,0,0,0,0,0,765,1604
IT-MS,Massa-Carrara,21,906,0,0,0,0,0,0,906,768,11,0,0,0,0,0,779,1685
IT-MS,Massa-Carrara,22,849,3,0,0,0,0,0,852,744,13,0,0,0,0,0,757,1609
IT-MS,Massa-Carrara,23,885,7,0,0,0,0,0,892,753,18,1,0,0,0,0,772,1664
IT-MS,Massa-Carrara,24,831,9,0,0,0,0,0,840,770,29,0,0,1,0,0,800,1640
IT-MS,Massa-Carrara,25,882,12,1,0,1,0,0,896,771,43,3,1,0,0,0,818,1714
IT-MS,Massa-Carrara,26,847,16,0,0,0,0,0,863,689,60,1,0,0,0,0,750,1613
IT-MS,Massa-Carrara,27,857,30,0,0,0,0,0,887,714,72,0,0,0,0,0,786,1673
IT-MS,Massa-Carrara,28,877,44,0,0,0,0,0,921,709,100,6,1,0,0,0,816,1737
IT-MS,Massa-Carrara,29,775,56,0,0,0,0,0,831,654,152,5,0,1,0,0,812,1643
IT-MS,Massa-Carrara,30,813,91,1,0,0,0,0,905,606,191,7,1,0,0,0,805,1710
IT-MS,Massa-Carrara,31,809,115,4,0,0,0,0,928,601,242,10,1,1,0,0,855,1783
IT-MS,Massa-Carrara,32,749,130,3,1,1,0,0,884,581,279,9,2,1,0,0,872,1756
IT-MS,Massa-Carrara,33,729,183,5,0,3,0,0,920,559,306,21,3,2,0,0,891,1811
IT-MS,Massa-Carrara,34,696,196,7,0,1,0,0,900,512,312,16,0,0,0,0,840,1740
IT-MS,Massa-Carrara,35,682,256,13,0,3,0,0,954,496,390,28,2,1,0,0,917,1871
IT-MS,Massa-Carrara,36,623,271,13,0,1,0,0,908,472,430,29,2,0,0,0,933,1841
IT-MS,Massa-Carrara,37,603,311,28,3,2,0,0,947,411,447,27,3,1,0,0,889,1836
IT-MS,Massa-Carrara,38,619,334,22,1,0,0,0,976,461,498,29,4,2,0,0,994,1970
IT-MS,Massa-Carrara,39,632,422,19,1,0,0,0,1074,433,529,44,1,0,0,0,1007,2081
IT-MS,Massa-Carrara,40,615,447,31,2,1,0,0,1096,424,574,38,8,1,0,0,1045,2141
IT-MS,Massa-Carrara,41,540,475,21,2,1,0,0,1039,397,626,46,5,1,0,0,1075,2114
IT-MS,Massa-Carrara,42,511,532,32,3,3,0,0,1081,372,622,66,11,1,0,0,1072,2153
IT-MS,Massa-Carrara,43,577,572,52,6,2,0,0,1209,373,630,70,10,0,0,0,1083,2292
IT-MS,Massa-Carrara,44,549,544,50,3,4,0,0,1150,404,663,83,12,3,0,0,1165,2315
IT-MS,Massa-Carrara,45,542,631,59,3,1,0,0,1236,366,704,96,11,1,0,0,1178,2414
IT-MS,Massa-Carrara,46,559,694,67,4,1,0,0,1325,409,800,130,15,0,0,0,1354,2679
IT-MS,Massa-Carrara,47,593,738,81,3,1,0,0,1416,368,824,123,18,2,0,0,1335,2751
IT-MS,Massa-Carrara,48,542,816,78,10,1,0,0,1447,395,930,136,23,1,0,0,1485,2932
IT-MS,Massa-Carrara,49,552,787,81,8,5,0,0,1433,371,974,156,26,0,0,0,1527,2960
IT-MS,Massa-Carrara,50,508,872,122,3,1,0,0,1506,328,989,155,36,1,0,0,1509,3015
IT-MS,Massa-Carrara,51,514,924,110,11,1,0,0,1560,301,1041,146,29,1,0,0,1518,3078
IT-MS,Massa-Carrara,52,478,912,111,9,2,0,0,1512,349,949,169,41,1,0,0,1509,3021
IT-MS,Massa-Carrara,53,423,958,133,6,5,0,0,1525,282,1042,198,51,2,0,0,1575,3100
IT-MS,Massa-Carrara,54,441,981,150,16,1,0,0,1589,320,1105,194,49,2,0,0,1670,3259
IT-MS,Massa-Carrara,55,357,969,144,12,4,0,0,1486,259,1065,157,58,2,0,0,1541,3027
IT-MS,Massa-Carrara,56,367,995,141,8,0,0,0,1511,252,1070,177,51,2,0,0,1552,3063
IT-MS,Massa-Carrara,57,351,1038,142,21,3,0,1,1556,203,1130,201,70,0,0,0,1604,3160
IT-MS,Massa-Carrara,58,330,1133,156,20,0,0,0,1639,221,1141,191,63,0,0,0,1616,3255
IT-MS,Massa-Carrara,59,291,1196,174,24,4,0,0,1689,207,1210,200,93,2,0,0,1712,3401
IT-MS,Massa-Carrara,60,231,1160,173,19,2,0,0,1585,179,1224,208,92,1,0,0,1704,3289
IT-MS,Massa-Carrara,61,231,1130,160,30,1,0,0,1552,165,1123,168,98,1,0,0,1555,3107
IT-MS,Massa-Carrara,62,237,1050,145,36,0,0,0,1468,145,1135,137,133,0,0,0,1550,3018
IT-MS,Massa-Carrara,63,183,1015,125,26,0,0,0,1349,143,1006,154,125,0,0,0,1428,2777
IT-MS,Massa-Carrara,64,167,1071,126,37,1,0,0,1402,126,1027,141,149,2,0,0,1445,2847
IT-MS,Massa-Carrara,65,165,1047,106,51,2,1,0,1372,138,1086,124,183,0,0,0,1531,2903
IT-MS,Massa-Carrara,66,160,1025,97,28,1,0,0,1311,111,1030,121,216,0,0,0,1478,2789
IT-MS,Massa-Carrara,67,141,1057,97,47,3,0,0,1345,88,963,101,234,0,0,0,1386,2731
IT-MS,Massa-Carrara,68,124,950,95,67,1,0,0,1237,105,1003,83,224,0,0,0,1415,2652
IT-MS,Massa-Carrara,69,132,994,75,52,3,0,0,1256,88,876,85,228,0,0,0,1277,2533
IT-MS,Massa-Carrara,70,101,912,58,62,1,0,0,1134,90,839,68,291,0,0,0,1288,2422
IT-MS,Massa-Carrara,71,84,904,47,58,0,0,0,1093,75,756,66,275,0,0,0,1172,2265
IT-MS,Massa-Carrara,72,89,856,55,66,1,0,0,1067,63,742,60,276,1,0,0,1142,2209
IT-MS,Massa-Carrara,73,93,905,54,71,0,0,0,1123,72,731,73,340,0,0,0,1216,2339
IT-MS,Massa-Carrara,74,82,885,47,95,1,0,0,1110,62,753,76,358,0,0,0,1249,2359
IT-MS,Massa-Carrara,75,89,899,58,95,0,0,0,1141,63,743,62,432,0,0,0,1300,2441
IT-MS,Massa-Carrara,76,77,896,48,104,1,0,0,1126,52,789,49,473,0,0,0,1363,2489
IT-MS,Massa-Carrara,77,87,885,42,106,0,0,0,1120,49,675,54,520,0,0,0,1298,2418
IT-MS,Massa-Carrara,78,40,519,28,71,0,0,0,658,38,432,29,363,0,0,0,862,1520
IT-MS,Massa-Carrara,79,45,626,15,96,0,0,0,782,42,493,49,483,1,0,0,1068,1850
IT-MS,Massa-Carrara,80,45,569,21,90,0,0,0,725,41,417,28,444,0,0,0,930,1655
IT-MS,Massa-Carrara,81,37,577,15,91,0,0,0,720,35,401,19,471,0,0,0,926,1646
IT-MS,Massa-Carrara,82,46,585,16,111,0,0,0,758,37,424,32,544,0,0,0,1037,1795
IT-MS,Massa-Carrara,83,43,569,22,137,0,0,0,771,45,394,30,686,0,0,0,1155,1926
IT-MS,Massa-Carrara,84,31,494,11,135,0,0,0,671,40,301,18,596,0,0,0,955,1626
IT-MS,Massa-Carrara,85,36,461,13,136,0,0,0,646,46,213,9,631,0,0,0,899,1545
IT-MS,Massa-Carrara,86,38,347,6,117,0,0,0,508,35,177,13,609,0,0,0,834,1342
IT-MS,Massa-Carrara,87,21,272,5,101,0,0,0,399,34,138,13,536,0,0,0,721,1120
IT-MS,Massa-Carrara,88,20,228,4,78,0,0,0,330,32,110,9,516,0,0,0,667,997
IT-MS,Massa-Carrara,89,15,170,2,87,0,0,0,274,27,77,12,442,0,0,0,558,832
IT-MS,Massa-Carrara,90,11,145,1,67,0,0,0,224,21,53,9,404,0,0,0,487,711
IT-MS,Massa-Carrara,91,13,107,0,76,0,0,0,196,25,35,5,368,0,0,0,433,629
IT-MS,Massa-Carrara,92,7,72,0,52,0,0,0,131,13,24,7,306,0,0,0,350,481
IT-MS,Massa-Carrara,93,9,51,2,50,0,0,0,112,20,12,8,283,0,0,0,323,435
IT-MS,Massa-Carrara,94,2,38,0,51,0,0,0,91,19,7,3,221,0,0,0,250,341
IT-MS,Massa-Carrara,95,2,17,0,27,0,0,0,46,10,12,4,184,0,0,0,210,256
IT-MS,Massa-Carrara,96,0,24,0,16,0,0,0,40,5,4,2,104,0,0,0,115,155
IT-MS,Massa-Carrara,97,0,11,1,13,0,0,0,25,6,3,1,94,0,0,0,104,129
IT-MS,Massa-Carrara,98,1,4,0,14,0,0,0,19,5,2,0,66,0,0,0,73,92
IT-MS,Massa-Carrara,99,2,2,0,5,0,0,0,9,2,2,0,44,0,0,0,48,57
IT-MS,Massa-Carrara,100,2,2,0,7,0,0,0,11,3,2,0,74,0,0,0,79,90
IT-MS,Massa-Carrara,999,41970,42233,3821,2858,71,1,1,90955,34618,42455,5098,13817,39,0,0,96027,186982
IT-MT,Matera,0,595,0,0,0,0,0,0,595,537,0,0,0,0,0,0,537,1132
IT-MT,Matera,1,616,0,0,0,0,0,0,616,535,0,0,0,0,0,0,535,1151
IT-MT,Matera,2,677,0,0,0,0,0,0,677,617,0,0,0,0,0,0,617,1294
IT-MT,Matera,3,660,0,0,0,0,0,0,660,645,0,0,0,0,0,0,645,1305
IT-MT,Matera,4,712,0,0,0,0,0,0,712,643,0,0,0,0,0,0,643,1355
IT-MT,Matera,5,675,0,0,0,0,0,0,675,718,0,0,0,0,0,0,718,1393
IT-MT,Matera,6,759,0,0,0,0,0,0,759,679,0,0,0,0,0,0,679,1438
IT-MT,Matera,7,776,0,0,0,0,0,0,776,756,0,0,0,0,0,0,756,1532
IT-MT,Matera,8,766,0,0,0,0,0,0,766,712,0,0,0,0,0,0,712,1478
IT-MT,Matera,9,753,0,0,0,0,0,0,753,788,0,0,0,0,0,0,788,1541
IT-MT,Matera,10,803,0,0,0,0,0,0,803,741,0,0,0,0,0,0,741,1544
IT-MT,Matera,11,836,0,0,0,0,0,0,836,790,0,0,0,0,0,0,790,1626
IT-MT,Matera,12,828,0,0,0,0,0,0,828,810,0,0,0,0,0,0,810,1638
IT-MT,Matera,13,863,0,0,0,0,0,0,863,844,0,0,0,0,0,0,844,1707
IT-MT,Matera,14,898,0,0,0,0,0,0,898,844,0,0,0,0,0,0,844,1742
IT-MT,Matera,15,936,0,0,0,0,0,0,936,871,0,0,0,0,0,0,871,1807
IT-MT,Matera,16,930,0,0,0,0,0,0,930,842,1,0,0,0,0,0,843,1773
IT-MT,Matera,17,1027,0,0,0,0,0,0,1027,853,0,0,0,0,0,0,853,1880
IT-MT,Matera,18,1011,1,0,0,0,0,0,1012,875,1,0,0,0,0,0,876,1888
IT-MT,Matera,19,1060,1,0,0,0,0,0,1061,1015,1,0,0,0,0,0,1016,2077
IT-MT,Matera,20,1126,0,0,0,0,0,0,1126,944,9,0,0,0,0,0,953,2079
IT-MT,Matera,21,1053,1,0,0,0,0,0,1054,968,10,0,0,0,0,0,978,2032
IT-MT,Matera,22,1072,1,0,0,0,0,0,1073,903,25,0,0,0,0,0,928,2001
IT-MT,Matera,23,1173,12,0,0,0,0,0,1185,927,31,0,0,0,0,0,958,2143
IT-MT,Matera,24,1133,14,0,0,0,0,0,1147,929,29,0,0,0,0,0,958,2105
IT-MT,Matera,25,1135,14,1,0,0,0,0,1150,838,60,1,0,2,0,0,901,2051
IT-MT,Matera,26,1081,26,0,0,1,0,0,1108,910,75,1,0,0,0,0,986,2094
IT-MT,Matera,27,1075,39,1,0,0,0,0,1115,824,115,1,0,0,0,0,940,2055
IT-MT,Matera,28,1013,59,2,0,0,0,0,1074,760,159,0,0,0,0,0,919,1993
IT-MT,Matera,29,955,84,1,0,0,0,0,1040,739,212,4,1,0,0,0,956,1996
IT-MT,Matera,30,944,111,3,0,0,0,0,1058,738,218,9,0,2,0,0,967,2025
IT-MT,Matera,31,1022,166,0,0,0,0,0,1188,682,285,5,0,0,0,0,972,2160
IT-MT,Matera,32,919,226,3,1,0,0,0,1149,642,366,10,1,2,0,0,1021,2170
IT-MT,Matera,33,922,287,9,0,1,0,0,1219,575,491,15,0,2,0,0,1083,2302
IT-MT,Matera,34,848,314,6,1,1,0,0,1170,533,461,13,4,0,0,0,1011,2181
IT-MT,Matera,35,771,362,9,1,0,0,0,1143,471,562,27,0,0,0,0,1060,2203
IT-MT,Matera,36,717,433,15,2,0,0,0,1167,434,540,21,4,1,0,0,1000,2167
IT-MT,Matera,37,677,417,12,1,1,0,0,1108,395,574,25,1,2,0,0,997,2105
IT-MT,Matera,38,583,497,15,2,1,0,0,1098,371,697,33,6,1,0,0,1108,2206
IT-MT,Matera,39,601,538,13,1,2,0,0,1155,345,723,29,9,1,0,0,1107,2262
IT-MT,Matera,40,575,591,18,2,0,0,0,1186,329,765,47,3,0,0,0,1144,2330
IT-MT,Matera,41,508,632,30,2,0,0,0,1172,334,769,46,8,0,0,0,1157,2329
IT-MT,Matera,42,522,682,34,4,1,0,0,1243,302,799,57,16,1,0,0,1175,2418
IT-MT,Matera,43,466,707,30,2,1,0,0,1206,297,818,39,11,0,0,0,1165,2371
IT-MT,Matera,44,468,763,35,4,0,0,0,1270,252,874,62,15,1,0,0,1204,2474
IT-MT,Matera,45,505,837,44,2,0,0,0,1388,264,959,61,18,0,0,0,1302,2690
IT-MT,Matera,46,431,802,46,2,0,0,0,1281,274,1008,101,17,0,0,0,1400,2681
IT-MT,Matera,47,468,954,54,1,0,0,0,1477,255,992,105,27,0,0,0,1379,2856
IT-MT,Matera,48,405,939,73,6,0,0,0,1423,245,1048,99,35,0,0,0,1427,2850
IT-MT,Matera,49,409,984,70,13,2,0,0,1478,221,1125,91,28,0,0,0,1465,2943
IT-MT,Matera,50,370,1019,82,5,1,0,0,1477,247,1001,118,28,1,0,0,1395,2872
IT-MT,Matera,51,319,1010,90,8,3,0,0,1430,220,1096,100,32,1,0,0,1449,2879
IT-MT,Matera,52,380,945,88,6,0,0,0,1419,214,1111,98,57,1,0,0,1481,2900
IT-MT,Matera,53,304,1064,61,11,0,0,0,1440,202,1148,93,49,0,0,0,1492,2932
IT-MT,Matera,54,288,1028,69,12,0,0,0,1397,193,1118,82,62,0,0,0,1455,2852
IT-MT,Matera,55,258,1089,63,11,1,0,0,1422,195,1151,82,69,1,0,0,1498,2920
IT-MT,Matera,56,268,1077,79,17,2,0,0,1443,191,1156,89,66,2,0,0,1504,2947
IT-MT,Matera,57,215,1107,71,23,0,0,0,1416,196,1199,84,68,0,0,0,1547,2963
IT-MT,Matera,58,215,1120,75,19,0,0,0,1429,176,1234,59,74,0,0,0,1543,2972
IT-MT,Matera,59,189,1239,74,23,0,0,0,1525,181,1213,80,101,0,0,0,1575,3100
IT-MT,Matera,60,183,1131,78,33,0,0,0,1425,172,1094,58,117,0,0,0,1441,2866
IT-MT,Matera,61,151,1098,75,23,1,0,0,1348,138,1153,65,104,0,0,0,1460,2808
IT-MT,Matera,62,161,1047,78,21,0,0,0,1307,132,1183,64,130,0,0,0,1509,2816
IT-MT,Matera,63,121,1101,49,28,0,0,0,1299,137,1090,58,157,0,0,0,1442,2741
IT-MT,Matera,64,132,1089,55,33,0,0,0,1309,141,1075,43,149,0,0,0,1408,2717
IT-MT,Matera,65,109,1097,42,24,1,0,0,1273,120,1030,44,174,0,0,0,1368,2641
IT-MT,Matera,66,108,1010,42,25,0,0,0,1185,134,995,47,195,0,0,0,1371,2556
IT-MT,Matera,67,106,1082,47,38,0,0,0,1273,114,975,39,223,0,0,0,1351,2624
IT-MT,Matera,68,96,1024,28,38,0,0,0,1186,100,955,32,212,0,0,0,1299,2485
IT-MT,Matera,69,63,1021,39,44,0,0,0,1167,100,921,32,235,1,0,0,1289,2456
IT-MT,Matera,70,67,914,36,54,0,0,0,1071,87,781,15,248,0,0,0,1131,2202
IT-MT,Matera,71,60,906,30,52,0,0,0,1048,88,764,32,282,0,0,0,1166,2214
IT-MT,Matera,72,55,879,25,54,0,0,0,1013,75,766,38,291,0,0,0,1170,2183
IT-MT,Matera,73,71,892,34,58,0,0,0,1055,79,793,22,326,0,0,0,1220,2275
IT-MT,Matera,74,49,912,19,78,0,0,0,1058,62,764,23,357,0,0,0,1206,2264
IT-MT,Matera,75,46,975,18,73,0,0,0,1112,82,739,16,390,0,0,0,1227,2339
IT-MT,Matera,76,44,832,20,90,0,0,0,986,72,599,12,407,0,0,0,1090,2076
IT-MT,Matera,77,33,722,10,72,0,0,0,837,53,476,13,393,0,0,0,935,1772
IT-MT,Matera,78,18,575,11,49,0,0,0,653,56,392,7,356,0,0,0,811,1464
IT-MT,Matera,79,28,567,11,57,0,0,0,663,52,350,6,390,0,0,0,798,1461
IT-MT,Matera,80,19,525,5,71,0,0,0,620,46,273,12,421,0,0,0,752,1372
IT-MT,Matera,81,24,462,4,67,0,0,0,557,52,267,8,408,0,0,0,735,1292
IT-MT,Matera,82,15,432,6,63,0,0,0,516,40,226,6,393,0,0,0,665,1181
IT-MT,Matera,83,22,480,7,90,0,0,0,599,52,226,2,510,0,0,0,790,1389
IT-MT,Matera,84,17,437,3,110,0,0,0,567,40,222,3,518,0,0,0,783,1350
IT-MT,Matera,85,17,359,4,74,0,0,0,454,39,173,5,493,0,0,0,710,1164
IT-MT,Matera,86,16,328,3,88,0,0,0,435,40,136,7,507,0,0,0,690,1125
IT-MT,Matera,87,15,260,5,78,0,0,0,358,33,122,3,470,0,0,0,628,986
IT-MT,Matera,88,11,195,4,87,0,0,0,297,29,81,0,426,0,0,0,536,833
IT-MT,Matera,89,8,178,3,83,0,0,0,272,27,58,2,353,0,0,0,440,712
IT-MT,Matera,90,5,135,1,82,0,0,0,223,22,40,5,351,0,0,0,418,641
IT-MT,Matera,91,4,116,0,76,0,0,0,196,24,27,2,261,0,0,0,314,510
IT-MT,Matera,92,4,75,0,73,0,0,0,152,10,17,0,230,0,0,0,257,409
IT-MT,Matera,93,5,58,3,52,0,0,0,118,18,17,1,201,0,0,0,237,355
IT-MT,Matera,94,1,35,0,29,0,0,0,65,14,7,0,138,0,0,0,159,224
IT-MT,Matera,95,1,21,1,27,0,0,0,50,8,5,1,117,0,0,0,131,181
IT-MT,Matera,96,1,19,1,22,0,0,0,43,8,4,0,78,0,0,0,90,133
IT-MT,Matera,97,0,11,1,17,0,0,0,29,2,1,0,68,0,0,0,71,100
IT-MT,Matera,98,0,5,0,9,0,0,0,14,2,3,0,40,0,0,0,45,59
IT-MT,Matera,99,1,6,0,9,0,0,0,16,0,0,0,16,0,0,0,16,32
IT-MT,Matera,100,2,2,0,9,0,0,0,13,4,3,1,42,0,0,0,50,63
IT-MT,Matera,999,44453,45205,2074,2342,20,0,0,94094,36335,45032,2511,11987,22,0,0,95887,189981
IT-ME,Messina,0,1943,0,0,0,0,0,0,1943,1892,0,0,0,0,0,0,1892,3835
IT-ME,Messina,1,2001,0,0,0,0,0,0,2001,1921,0,0,0,0,0,0,1921,3922
IT-ME,Messina,2,2149,0,0,0,0,0,0,2149,1991,0,0,0,0,0,0,1991,4140
IT-ME,Messina,3,2154,0,0,0,0,0,0,2154,2038,0,0,0,0,0,0,2038,4192
IT-ME,Messina,4,2164,0,0,0,0,0,0,2164,2122,0,0,0,0,0,0,2122,4286
IT-ME,Messina,5,2386,0,0,0,0,0,0,2386,2149,0,0,0,0,0,0,2149,4535
IT-ME,Messina,6,2422,0,0,0,0,0,0,2422,2334,0,0,0,0,0,0,2334,4756
IT-ME,Messina,7,2355,0,0,0,0,0,0,2355,2218,0,0,0,0,0,0,2218,4573
IT-ME,Messina,8,2398,0,0,0,0,0,0,2398,2304,0,0,0,0,0,0,2304,4702
IT-ME,Messina,9,2545,0,0,0,0,0,0,2545,2456,0,0,0,0,0,0,2456,5001
IT-ME,Messina,10,2481,0,0,0,0,0,0,2481,2472,0,0,0,0,0,0,2472,4953
IT-ME,Messina,11,2645,0,0,0,0,0,0,2645,2485,0,0,0,0,0,0,2485,5130
IT-ME,Messina,12,2639,0,0,0,0,0,0,2639,2524,0,0,0,0,0,0,2524,5163
IT-ME,Messina,13,2756,0,0,0,0,0,0,2756,2689,0,0,0,0,0,0,2689,5445
IT-ME,Messina,14,2736,0,0,0,0,0,0,2736,2624,0,0,0,0,0,0,2624,5360
IT-ME,Messina,15,2838,0,0,0,0,0,0,2838,2766,0,0,0,0,0,0,2766,5604
IT-ME,Messina,16,2921,0,0,0,0,0,0,2921,2747,0,1,0,0,0,0,2748,5669
IT-ME,Messina,17,3035,0,0,0,0,0,0,3035,2713,0,0,0,0,0,0,2713,5748
IT-ME,Messina,18,3056,0,1,0,0,0,0,3057,2657,2,0,0,0,0,0,2659,5716
IT-ME,Messina,19,3123,5,0,0,0,0,0,3128,2839,3,1,0,1,0,0,2844,5972
IT-ME,Messina,20,3031,1,0,0,0,0,0,3032,2815,11,0,0,1,0,0,2827,5859
IT-ME,Messina,21,3015,6,0,0,0,0,0,3021,2802,37,0,0,0,0,0,2839,5860
IT-ME,Messina,22,3182,13,0,0,0,0,0,3195,2821,56,0,0,1,0,0,2878,6073
IT-ME,Messina,23,3169,16,2,0,0,0,0,3187,2814,83,1,0,0,0,0,2898,6085
IT-ME,Messina,24,3019,28,0,0,3,0,0,3050,2853,118,1,0,0,0,0,2972,6022
IT-ME,Messina,25,3006,66,2,0,1,0,0,3075,2698,147,4,0,0,0,0,2849,5924
IT-ME,Messina,26,2959,79,1,0,0,0,0,3039,2553,260,5,0,1,0,0,2819,5858
IT-ME,Messina,27,2982,145,1,0,0,0,0,3128,2565,401,2,0,0,0,0,2968,6096
IT-ME,Messina,28,2918,194,0,1,0,0,0,3113,2429,509,10,0,1,0,0,2949,6062
IT-ME,Messina,29,2837,317,3,0,1,0,0,3158,2355,685,7,0,0,0,0,3047,6205
IT-ME,Messina,30,2847,441,5,0,0,0,0,3293,2330,829,11,2,3,0,0,3175,6468
IT-ME,Messina,31,2769,565,11,0,2,0,0,3347,2243,1072,17,2,4,0,0,3338,6685
IT-ME,Messina,32,2616,753,8,0,0,1,0,3378,1977,1273,28,4,1,0,0,3283,6661
IT-ME,Messina,33,2505,911,29,1,4,0,0,3450,1934,1456,34,1,2,0,0,3427,6877
IT-ME,Messina,34,2305,1002,17,0,0,0,0,3324,1908,1613,43,5,2,0,0,3571,6895
IT-ME,Messina,35,2288,1185,26,0,1,0,0,3500,1714,1702,57,12,0,0,0,3485,6985
IT-ME,Messina,36,2132,1369,21,1,4,0,0,3527,1550,1760,56,15,4,0,0,3385,6912
IT-ME,Messina,37,1922,1568,34,1,0,0,0,3525,1403,1978,80,19,2,0,1,3483,7008
IT-ME,Messina,38,1845,1593,54,2,2,0,0,3496,1352,2033,105,12,4,1,0,3507,7003
IT-ME,Messina,39,1780,1674,67,8,0,0,0,3529,1315,2120,110,16,5,0,0,3566,7095
IT-ME,Messina,40,1634,1751,68,7,3,0,0,3463,1117,2230,129,18,1,0,0,3495,6958
IT-ME,Messina,41,1615,1926,83,5,1,0,0,3630,1152,2411,153,33,2,0,0,3751,7381
IT-ME,Messina,42,1550,1942,91,6,3,0,0,3592,1017,2487,170,32,2,0,0,3708,7300
IT-ME,Messina,43,1414,2248,80,3,2,0,0,3747,1013,2608,175,26,4,0,0,3826,7573
IT-ME,Messina,44,1384,2277,111,6,1,0,0,3779,1018,2663,188,37,3,1,0,3910,7689
IT-ME,Messina,45,1348,2442,121,7,5,0,0,3923,990,2775,202,52,1,0,0,4020,7943
IT-ME,Messina,46,1395,2477,168,14,0,0,1,4055,941,2860,239,63,1,0,0,4104,8159
IT-ME,Messina,47,1335,2657,194,16,1,0,0,4203,923,3188,253,65,0,0,0,4429,8632
IT-ME,Messina,48,1330,2815,206,17,2,0,0,4370,932,3145,271,68,1,0,0,4417,8787
IT-ME,Messina,49,1269,2916,201,25,2,0,0,4413,940,3427,293,88,0,0,0,4748,9161
IT-ME,Messina,50,1165,3011,214,26,1,0,0,4417,820,3463,349,123,1,0,0,4756,9173
IT-ME,Messina,51,1174,3079,246,26,3,0,0,4528,782,3634,345,119,0,0,0,4880,9408
IT-ME,Messina,52,1043,3245,232,40,1,0,0,4561,803,3620,334,156,0,0,0,4913,9474
IT-ME,Messina,53,1005,3133,231,31,2,0,0,4402,736,3469,339,156,2,0,0,4702,9104
IT-ME,Messina,54,951,3265,245,34,3,0,0,4498,729,3683,360,172,0,0,0,4944,9442
IT-ME,Messina,55,905,3354,276,47,6,0,0,4588,705,3579,374,237,0,0,0,4895,9483
IT-ME,Messina,56,885,3459,286,55,3,0,0,4688,688,3641,375,252,0,0,0,4956,9644
IT-ME,Messina,57,801,3504,296,58,3,0,0,4662,695,3726,346,276,0,0,0,5043,9705
IT-ME,Messina,58,733,3469,269,50,0,0,0,4521,688,3799,349,281,0,1,0,5118,9639
IT-ME,Messina,59,748,3588,294,77,2,0,0,4709,643,3787,358,328,0,0,0,5116,9825
IT-ME,Messina,60,623,3530,267,72,1,0,0,4493,619,3507,285,375,1,0,0,4787,9280
IT-ME,Messina,61,592,3480,259,87,6,1,0,4425,550,3696,297,440,0,0,0,4983,9408
IT-ME,Messina,62,539,3415,229,104,1,0,0,4288,557,3450,308,493,1,0,0,4809,9097
IT-ME,Messina,63,510,3535,259,114,1,0,0,4419,553,3453,274,536,0,0,0,4816,9235
IT-ME,Messina,64,510,3320,230,100,1,0,0,4161,540,3186,253,566,0,0,0,4545,8706
IT-ME,Messina,65,436,3186,198,120,1,0,0,3941,481,3114,235,625,0,0,0,4455,8396
IT-ME,Messina,66,410,3189,197,140,2,0,0,3938,463,3111,232,672,1,0,0,4479,8417
IT-ME,Messina,67,379,3150,172,149,0,0,0,3850,422,2950,188,720,0,0,0,4280,8130
IT-ME,Messina,68,393,3231,180,156,1,0,0,3961,402,2849,204,744,0,0,0,4199,8160
IT-ME,Messina,69,338,3119,165,169,1,0,0,3792,379,2733,191,820,0,0,0,4123,7915
IT-ME,Messina,70,301,2880,148,160,3,0,0,3492,335,2543,157,878,0,0,0,3913,7405
IT-ME,Messina,71,268,2707,143,182,1,0,0,3301,339,2320,155,891,0,0,0,3705,7006
IT-ME,Messina,72,236,2762,139,175,1,0,0,3313,328,2209,155,966,0,0,0,3658,6971
IT-ME,Messina,73,223,2756,118,222,0,0,0,3319,331,2193,134,1160,0,0,0,3818,7137
IT-ME,Messina,74,229,2704,100,259,0,0,1,3293,320,2168,109,1134,0,0,0,3731,7024
IT-ME,Messina,75,201,2800,95,276,2,0,0,3374,307,2091,117,1372,0,0,0,3887,7261
IT-ME,Messina,76,178,2614,107,286,1,0,0,3186,316,1817,131,1360,0,0,0,3624,6810
IT-ME,Messina,77,181,2335,62,267,1,0,0,2846,293,1612,101,1391,0,0,0,3397,6243
IT-ME,Messina,78,130,1763,60,230,0,0,0,2183,235,1184,70,1215,0,0,0,2704,4887
IT-ME,Messina,79,94,1667,41,242,0,0,0,2044,209,1080,74,1239,0,0,0,2602,4646
IT-ME,Messina,80,96,1536,47,260,0,0,0,1939,207,951,48,1279,0,0,0,2485,4424
IT-ME,Messina,81,89,1505,31,277,0,0,0,1902,171,896,63,1420,0,0,0,2550,4452
IT-ME,Messina,82,99,1427,24,292,0,0,0,1842,211,743,66,1478,0,0,0,2498,4340
IT-ME,Messina,83,80,1375,33,360,0,0,0,1848,187,706,55,1630,0,0,0,2578,4426
IT-ME,Messina,84,76,1254,29,343,0,0,0,1702,178,556,42,1500,0,0,0,2276,3978
IT-ME,Messina,85,70,986,18,289,0,0,0,1363,164,451,36,1453,0,0,0,2104,3467
IT-ME,Messina,86,51,837,11,304,1,0,0,1204,135,376,24,1332,0,0,0,1867,3071
IT-ME,Messina,87,36,740,11,277,0,0,0,1064,179,302,29,1279,0,0,0,1789,2853
IT-ME,Messina,88,42,593,7,270,1,0,0,913,151,225,13,1241,0,0,0,1630,2543
IT-ME,Messina,89,23,525,9,244,0,0,0,801,107,183,17,1160,0,0,0,1467,2268
IT-ME,Messina,90,35,383,6,226,0,0,0,650,111,110,17,1023,0,0,0,1261,1911
IT-ME,Messina,91,26,256,5,211,0,0,0,498,106,62,9,860,0,0,0,1037,1535
IT-ME,Messina,92,13,212,1,179,0,0,0,405,86,67,12,729,0,0,0,894,1299
IT-ME,Messina,93,14,169,4,134,0,0,0,321,79,34,5,620,0,0,0,738,1059
IT-ME,Messina,94,9,80,3,90,0,0,0,182,50,26,5,456,0,0,0,537,719
IT-ME,Messina,95,4,57,0,65,0,0,0,126,49,20,9,361,0,0,0,439,565
IT-ME,Messina,96,4,37,0,46,0,0,0,87,20,8,2,236,0,0,0,266,353
IT-ME,Messina,97,2,19,2,27,0,0,0,50,21,3,1,186,0,0,0,211,261
IT-ME,Messina,98,2,15,1,17,0,0,0,35,24,11,4,137,0,0,0,176,211
IT-ME,Messina,99,4,15,0,13,0,0,0,32,19,6,0,103,0,0,0,128,160
IT-ME,Messina,100,7,22,0,20,0,0,0,49,19,19,1,139,0,0,0,178,227
IT-ME,Messina,999,135111,138675,7605,8018,88,2,2,289501,119957,139364,10303,38889,53,3,1,308570,598071
IT-MI,Milano,0,11398,0,0,0,0,0,0,11398,10452,0,0,0,0,0,0,10452,21850
IT-MI,Milano,1,11716,0,0,0,0,0,0,11716,11008,0,0,0,0,0,0,11008,22724
IT-MI,Milano,2,11985,0,0,0,0,0,0,11985,11290,0,0,0,0,0,0,11290,23275
IT-MI,Milano,3,11845,0,0,0,0,0,0,11845,11370,0,0,0,0,0,0,11370,23215
IT-MI,Milano,4,12574,0,0,0,0,0,0,12574,11870,0,0,0,0,0,0,11870,24444
IT-MI,Milano,5,13154,0,0,0,0,0,0,13154,12564,0,0,0,0,0,0,12564,25718
IT-MI,Milano,6,13596,0,0,0,0,0,0,13596,12841,0,0,0,0,0,0,12841,26437
IT-MI,Milano,7,14108,0,0,0,0,0,0,14108,13274,0,0,0,0,0,0,13274,27382
IT-MI,Milano,8,14667,0,0,0,0,0,0,14667,13541,0,0,0,0,0,0,13541,28208
IT-MI,Milano,9,14688,0,0,0,0,0,0,14688,14052,0,0,0,0,0,0,14052,28740
IT-MI,Milano,10,14876,0,0,0,0,0,0,14876,13981,0,0,0,0,0,0,13981,28857
IT-MI,Milano,11,15455,0,0,0,0,0,0,15455,14431,0,0,0,0,0,0,14431,29886
IT-MI,Milano,12,15604,0,0,0,0,0,0,15604,14527,0,0,0,0,0,0,14527,30131
IT-MI,Milano,13,16147,0,0,0,0,0,0,16147,14792,0,0,0,0,0,0,14792,30939
IT-MI,Milano,14,16189,0,0,0,0,0,0,16189,15412,0,0,0,0,0,0,15412,31601
IT-MI,Milano,15,16424,0,0,0,0,0,0,16424,15541,0,0,0,0,0,0,15541,31965
IT-MI,Milano,16,16231,0,0,0,0,0,0,16231,15203,0,0,0,0,0,0,15203,31434
IT-MI,Milano,17,16583,0,0,0,0,0,0,16583,15297,3,0,0,0,0,0,15300,31883
IT-MI,Milano,18,16447,0,0,1,0,0,0,16448,14939,4,1,0,0,0,0,14944,31392
IT-MI,Milano,19,17058,1,1,0,0,0,0,17060,15407,15,0,0,0,0,0,15422,32482
IT-MI,Milano,20,16906,8,0,0,0,0,0,16914,14582,61,0,0,0,0,0,14643,31557
IT-MI,Milano,21,16674,14,0,0,1,0,0,16689,14540,123,1,0,0,0,0,14664,31353
IT-MI,Milano,22,16748,47,10,0,2,0,0,16807,14744,246,10,0,0,0,0,15000,31807
IT-MI,Milano,23,17300,63,10,0,0,0,0,17373,14770,415,12,0,1,0,0,15198,32571
IT-MI,Milano,24,17443,163,21,0,1,0,0,17628,14557,604,17,2,2,0,0,15182,32810
IT-MI,Milano,25,17727,263,18,1,4,0,0,18013,14871,859,13,0,1,0,0,15744,33757
IT-MI,Milano,26,17761,390,16,0,10,0,0,18177,15024,1219,21,1,7,2,0,16274,34451
IT-MI,Milano,27,17873,577,31,0,17,2,0,18500,15130,1707,38,3,14,0,0,16892,35392
IT-MI,Milano,28,17476,963,25,0,22,1,0,18487,14805,2324,47,2,12,2,0,17192,35679
IT-MI,Milano,29,17516,1387,28,0,29,2,0,18962,14589,3167,72,9,13,1,0,17851,36813
IT-MI,Milano,30,17196,1984,35,1,31,3,0,19250,14539,3844,90,7,27,1,0,18508,37758
IT-MI,Milano,31,17121,2724,57,1,38,1,0,19942,14053,4944,130,9,27,0,0,19163,39105
IT-MI,Milano,32,16362,3524,69,14,54,0,0,20023,13156,5863,175,30,26,3,0,19253,39276
IT-MI,Milano,33,15850,4407,102,12,63,2,0,20436,12585,6810,237,21,34,0,0,19687,40123
IT-MI,Milano,34,14910,5297,145,17,57,5,0,20431,12059,7636,252,28,37,6,0,20018,40449
IT-MI,Milano,35,14571,6177,146,21,87,6,1,21009,10977,8550,343,41,50,3,0,19964,40973
IT-MI,Milano,36,13042,6893,208,11,90,4,0,20248,9831,9095,420,36,39,6,0,19427,39675
IT-MI,Milano,37,12109,7712,266,25,88,4,2,20206,9137,9561,539,85,51,5,0,19378,39584
IT-MI,Milano,38,11708,8295,339,24,86,3,0,20455,8526,10327,692,98,53,3,0,19699,40154
IT-MI,Milano,39,11110,9142,382,20,71,3,0,20728,8348,10680,705,103,51,6,1,19894,40622
IT-MI,Milano,40,10617,9839,472,25,85,4,1,21043,8199,11153,814,136,42,2,0,20346,41389
IT-MI,Milano,41,10283,10611,524,32,87,4,0,21541,7940,12149,915,144,46,3,0,21197,42738
IT-MI,Milano,42,9746,10767,655,76,86,9,1,21340,7615,11963,1046,224,36,5,1,20890,42230
IT-MI,Milano,43,9582,11046,648,101,65,3,0,21445,7134,12203,1154,203,40,4,1,20739,42184
IT-MI,Milano,44,9152,11588,761,99,89,4,0,21693,7075,12654,1205,228,40,2,0,21204,42897
IT-MI,Milano,45,9246,12319,827,92,73,1,1,22559,7056,13151,1406,256,39,4,1,21913,44472
IT-MI,Milano,46,9225,12989,894,90,89,1,1,23289,7301,14004,1559,302,43,2,0,23211,46500
IT-MI,Milano,47,9291,13344,1143,107,70,2,2,23959,7218,14734,1737,362,43,5,1,24100,48059
IT-MI,Milano,48,9421,14390,1272,107,89,1,2,25282,7320,15674,2073,403,29,2,0,25501,50783
IT-MI,Milano,49,9460,15298,1447,142,106,2,2,26457,7323,16599,2089,433,35,2,0,26481,52938
IT-MI,Milano,50,8992,15865,1487,152,97,1,1,26595,7152,16858,2288,468,30,2,0,26798,53393
IT-MI,Milano,51,8500,16077,1629,147,109,2,1,26465,6658,17266,2563,489,32,3,0,27011,53476
IT-MI,Milano,52,8181,16630,1789,155,96,2,2,26855,6236,17453,2594,633,41,2,0,26959,53814
IT-MI,Milano,53,7520,16751,1863,171,100,0,5,26410,5940,17488,2746,679,38,3,0,26894,53304
IT-MI,Milano,54,7121,17254,2062,181,89,2,0,26709,5717,17923,2792,780,22,1,0,27235,53944
IT-MI,Milano,55,6652,17283,2046,194,99,2,2,26278,5234,17813,2854,861,32,2,0,26796,53074
IT-MI,Milano,56,6252,17203,2045,221,72,1,4,25798,5085,17774,2900,938,30,0,0,26727,52525
IT-MI,Milano,57,6096,17558,2172,316,85,5,2,26234,4757,18232,3021,1082,17,2,0,27111,53345
IT-MI,Milano,58,5577,17739,2260,308,88,1,2,25975,4533,18071,3007,1192,26,0,0,26829,52804
IT-MI,Milano,59,4959,17915,2243,339,69,1,3,25529,4339,17899,2952,1261,26,1,0,26478,52007
IT-MI,Milano,60,4194,16697,2026,346,75,2,3,23343,3682,16732,2809,1405,15,0,1,24644,47987
IT-MI,Milano,61,3625,15739,1902,398,80,0,1,21745,3369,15993,2607,1534,21,0,1,23525,45270
IT-MI,Milano,62,3335,15287,1813,419,81,0,5,20940,3020,15406,2378,1635,15,0,0,22454,43394
IT-MI,Milano,63,2920,14917,1584,479,44,0,2,19946,2755,14657,2269,1837,24,0,0,21542,41488
IT-MI,Milano,64,2618,14109,1482,442,47,0,3,18701,2513,14221,2145,2027,12,0,1,20919,39620
IT-MI,Milano,65,2398,13579,1335,506,62,1,1,17882,2370,13400,1894,2074,9,0,2,19749,37631
IT-MI,Milano,66,2109,13413,1240,514,36,1,0,17313,2217,13131,1888,2307,13,0,1,19557,36870
IT-MI,Milano,67,1998,13028,1219,628,25,0,5,16903,1985,12469,1754,2480,8,0,0,18696,35599
IT-MI,Milano,68,1605,12631,1064,584,28,1,0,15913,1742,12426,1679,2775,14,0,0,18636,34549
IT-MI,Milano,69,1604,12299,1028,702,26,1,2,15662,1689,11812,1499,2874,8,0,0,17882,33544
IT-MI,Milano,70,1454,11601,890,679,25,0,3,14652,1474,11222,1412,3085,5,0,0,17198,31850
IT-MI,Milano,71,1349,11471,804,716,28,1,1,14370,1452,11109,1374,3321,7,0,1,17264,31634
IT-MI,Milano,72,1220,10975,773,824,16,0,2,13810,1314,10895,1281,3682,8,0,2,17182,30992
IT-MI,Milano,73,1187,11450,701,933,17,0,0,14288,1297,11048,1223,4075,6,0,0,17649,31937
IT-MI,Milano,74,1131,11547,618,1020,24,0,1,14341,1315,10803,1214,4592,6,0,0,17930,32271
IT-MI,Milano,75,1071,12201,658,1230,28,0,1,15189,1284,10935,1269,5335,5,0,0,18828,34017
IT-MI,Milano,76,1037,11722,565,1316,24,0,2,14666,1236,10442,1157,5823,3,0,0,18661,33327
IT-MI,Milano,77,968,12094,577,1483,14,0,2,15138,1192,10324,1133,6521,3,0,0,19173,34311
IT-MI,Milano,78,670,8663,421,1179,3,0,2,10938,933,7137,759,5324,0,0,0,14153,25091
IT-MI,Milano,79,680,8894,383,1302,14,0,1,11274,934,7316,764,5986,3,0,0,15003,26277
IT-MI,Milano,80,585,8235,358,1372,8,1,2,10561,935,6749,714,6206,1,0,0,14605,25166
IT-MI,Milano,81,615,7996,297,1420,10,0,0,10338,889,6099,718,6920,1,0,0,14627,24965
IT-MI,Milano,82,520,7611,274,1630,9,0,1,10045,905,5674,632,7475,0,0,0,14686,24731
IT-MI,Milano,83,511,7958,258,1826,6,0,1,10560,968,5485,592,8500,1,0,0,15546,26106
IT-MI,Milano,84,446,7156,217,1849,9,0,0,9677,897,4781,481,8382,1,0,0,14542,24219
IT-MI,Milano,85,349,6426,168,1849,4,0,0,8796,887,3807,470,8278,0,0,0,13442,22238
IT-MI,Milano,86,286,5041,134,1733,5,0,1,7200,715,2918,325,7788,0,0,0,11746,18946
IT-MI,Milano,87,215,4051,105,1510,2,0,0,5883,603,2157,316,6906,1,0,0,9983,15866
IT-MI,Milano,88,198,3471,96,1443,1,0,0,5209,631,1732,248,6868,0,0,0,9479,14688
IT-MI,Milano,89,200,2721,63,1291,2,0,0,4277,565,1261,209,6239,0,0,0,8274,12551
IT-MI,Milano,90,132,2064,50,1089,3,0,0,3338,460,917,156,5352,1,0,0,6886,10224
IT-MI,Milano,91,108,1549,29,963,2,0,0,2651,434,615,137,4799,0,0,0,5985,8636
IT-MI,Milano,92,69,1220,24,819,3,0,0,2135,376,416,88,4097,0,0,0,4977,7112
IT-MI,Milano,93,41,844,17,672,1,0,1,1576,332,276,99,3430,0,0,0,4137,5713
IT-MI,Milano,94,37,558,13,512,0,0,0,1120,264,199,56,2740,0,0,0,3259,4379
IT-MI,Milano,95,25,347,1,370,1,0,0,744,200,93,43,2028,0,0,0,2364,3108
IT-MI,Milano,96,20,204,7,284,0,0,0,515,136,60,36,1502,0,0,0,1734,2249
IT-MI,Milano,97,15,111,0,205,0,0,0,331,83,30,26,1141,0,0,0,1280,1611
IT-MI,Milano,98,5,69,4,131,0,0,0,209,62,24,10,828,0,0,0,924,1133
IT-MI,Milano,99,4,22,1,61,0,0,0,88,47,12,10,509,0,0,0,578,666
IT-MI,Milano,100,10,43,1,101,0,0,0,155,82,20,7,881,0,0,0,990,1145
IT-MI,Milano,999,815585,672511,53348,40033,3257,92,78,1584904,710691,683921,83411,181110,1323,85,14,1660555,3245459
IT-MO,Modena,0,2452,0,0,0,0,0,0,2452,2309,0,0,0,0,0,0,2309,4761
IT-MO,Modena,1,2694,0,0,0,0,0,0,2694,2486,0,0,0,0,0,0,2486,5180
IT-MO,Modena,2,2690,0,0,0,0,0,0,2690,2488,0,0,0,0,0,0,2488,5178
IT-MO,Modena,3,2708,0,0,0,0,0,0,2708,2398,0,0,0,0,0,0,2398,5106
IT-MO,Modena,4,2633,0,0,0,0,0,0,2633,2559,0,0,0,0,0,0,2559,5192
IT-MO,Modena,5,2885,0,0,0,0,0,0,2885,2711,0,0,0,0,0,0,2711,5596
IT-MO,Modena,6,3013,0,0,0,0,0,0,3013,2816,0,0,0,0,0,0,2816,5829
IT-MO,Modena,7,3157,0,0,0,0,0,0,3157,2896,0,0,0,0,0,0,2896,6053
IT-MO,Modena,8,3127,0,0,0,0,0,0,3127,2951,0,0,0,0,0,0,2951,6078
IT-MO,Modena,9,3177,0,0,0,0,0,0,3177,3022,0,0,0,0,0,0,3022,6199
IT-MO,Modena,10,3308,0,0,0,0,0,0,3308,3088,0,0,0,0,0,0,3088,6396
IT-MO,Modena,11,3512,0,0,0,0,0,0,3512,3296,0,0,0,0,0,0,3296,6808
IT-MO,Modena,12,3597,0,0,0,0,0,0,3597,3273,0,0,0,0,0,0,3273,6870
IT-MO,Modena,13,3633,0,0,0,0,0,0,3633,3463,0,0,0,0,0,0,3463,7096
IT-MO,Modena,14,3624,0,0,0,0,0,0,3624,3428,0,0,0,0,0,0,3428,7052
IT-MO,Modena,15,3753,0,0,0,0,0,0,3753,3426,0,0,0,0,0,0,3426,7179
IT-MO,Modena,16,3629,0,0,0,0,0,0,3629,3403,0,0,0,0,0,0,3403,7032
IT-MO,Modena,17,3561,0,0,0,0,0,0,3561,3331,0,0,0,0,0,0,3331,6892
IT-MO,Modena,18,3579,0,0,0,0,0,0,3579,3350,3,0,0,0,0,0,3353,6932
IT-MO,Modena,19,3623,5,0,0,0,0,0,3628,3259,9,0,0,0,0,0,3268,6896
IT-MO,Modena,20,3510,1,0,0,0,0,0,3511,3207,32,0,0,0,0,0,3239,6750
IT-MO,Modena,21,3616,3,0,0,0,0,0,3619,3177,49,1,0,0,0,0,3227,6846
IT-MO,Modena,22,3645,19,4,0,0,0,0,3668,3252,88,0,0,0,0,0,3340,7008
IT-MO,Modena,23,3748,33,2,0,0,0,0,3783,3211,172,5,0,0,0,0,3388,7171
IT-MO,Modena,24,3706,45,5,0,1,0,0,3757,3135,214,6,0,0,0,0,3355,7112
IT-MO,Modena,25,3835,102,4,1,1,0,0,3943,2998,294,6,0,0,0,0,3298,7241
IT-MO,Modena,26,3754,149,2,0,0,0,0,3905,3024,429,3,0,1,0,0,3457,7362
IT-MO,Modena,27,3685,193,10,0,1,0,0,3889,2870,533,9,2,2,0,0,3416,7305
IT-MO,Modena,28,3599,340,5,0,1,0,0,3945,2709,690,19,3,3,0,0,3424,7369
IT-MO,Modena,29,3584,428,8,0,1,0,0,4021,2650,879,17,0,2,0,0,3548,7569
IT-MO,Modena,30,3459,603,15,0,1,0,0,4078,2533,1084,27,1,1,0,0,3646,7724
IT-MO,Modena,31,3459,769,15,0,3,0,1,4247,2517,1276,23,3,3,1,0,3823,8070
IT-MO,Modena,32,3223,877,30,3,8,0,0,4141,2347,1431,47,5,6,0,0,3836,7977
IT-MO,Modena,33,3148,1108,21,2,10,0,0,4289,2189,1679,38,8,6,0,0,3920,8209
IT-MO,Modena,34,2905,1196,44,6,5,1,1,4158,2102,1772,77,6,5,0,0,3962,8120
IT-MO,Modena,35,2784,1386,38,2,5,0,0,4215,1863,1941,63,12,8,1,0,3888,8103
IT-MO,Modena,36,2481,1528,42,0,6,0,0,4057,1845,2010,95,5,9,0,0,3964,8021
IT-MO,Modena,37,2312,1598,68,3,8,0,0,3989,1569,2163,109,12,9,0,0,3862,7851
IT-MO,Modena,38,2252,1745,70,4,3,0,0,4074,1696,2223,119,16,5,3,0,4062,8136
IT-MO,Modena,39,2214,1915,92,2,2,0,0,4225,1589,2381,167,15,7,2,0,4161,8386
IT-MO,Modena,40,2130,2101,102,4,2,0,0,4339,1442,2529,174,21,3,1,0,4170,8509
IT-MO,Modena,41,2166,2147,106,7,5,0,0,4431,1479,2475,207,32,3,0,0,4196,8627
IT-MO,Modena,42,2020,2219,126,9,2,0,0,4376,1456,2640,202,38,2,0,0,4338,8714
IT-MO,Modena,43,1953,2475,148,19,6,2,0,4603,1481,2745,262,52,4,0,0,4544,9147
IT-MO,Modena,44,1929,2528,158,19,4,0,0,4638,1457,2826,289,44,5,0,0,4621,9259
IT-MO,Modena,45,2038,2706,213,16,8,0,0,4981,1536,2938,310,63,9,0,0,4856,9837
IT-MO,Modena,46,2071,2865,241,22,4,0,0,5203,1552,3133,392,70,2,0,0,5149,10352
IT-MO,Modena,47,2093,2912,256,27,5,0,0,5293,1574,3324,385,76,6,0,0,5365,10658
IT-MO,Modena,48,2056,3335,323,26,4,0,0,5744,1573,3519,443,72,1,0,0,5608,11352
IT-MO,Modena,49,2295,3433,314,30,2,0,0,6074,1585,3600,518,108,4,3,0,5818,11892
IT-MO,Modena,50,2056,3571,367,28,6,1,0,6029,1479,3755,508,123,11,1,0,5877,11906
IT-MO,Modena,51,1879,3636,402,33,9,1,0,5960,1428,3762,550,102,6,2,0,5850,11810
IT-MO,Modena,52,1794,3667,439,34,8,0,0,5942,1390,3802,615,141,6,0,0,5954,11896
IT-MO,Modena,53,1622,3559,463,38,13,0,0,5695,1292,3601,588,155,4,0,0,5640,11335
IT-MO,Modena,54,1603,3688,470,39,8,0,0,5808,1210,3797,566,150,5,0,0,5728,11536
IT-MO,Modena,55,1452,3735,483,49,5,0,0,5724,1107,3673,648,183,1,0,0,5612,11336
IT-MO,Modena,56,1341,3725,535,47,9,0,0,5657,1052,3792,624,201,2,0,0,5671,11328
IT-MO,Modena,57,1271,3729,500,60,7,0,0,5567,1035,3715,649,245,0,0,1,5645,11212
IT-MO,Modena,58,1121,3834,487,66,4,1,0,5513,979,3687,617,289,2,0,0,5574,11087
IT-MO,Modena,59,1076,3864,489,78,2,0,0,5509,874,3844,623,273,0,0,0,5614,11123
IT-MO,Modena,60,914,3741,465,90,7,0,0,5217,880,3707,583,278,5,0,0,5453,10670
IT-MO,Modena,61,858,3484,442,90,3,0,0,4877,798,3551,535,306,2,0,0,5192,10069
IT-MO,Modena,62,779,3601,444,88,4,0,0,4916,762,3445,569,431,5,0,0,5212,10128
IT-MO,Modena,63,705,3380,431,92,5,0,0,4613,677,3322,540,396,3,0,0,4938,9551
IT-MO,Modena,64,596,3263,386,115,3,0,1,4364,703,3242,487,434,3,0,0,4869,9233
IT-MO,Modena,65,528,3183,343,107,0,0,0,4161,592,2964,422,470,3,0,0,4451,8612
IT-MO,Modena,66,497,3134,315,120,5,0,1,4072,548,3011,402,543,1,0,0,4505,8577
IT-MO,Modena,67,440,3170,312,122,2,0,0,4046,481,3095,380,569,0,0,0,4525,8571
IT-MO,Modena,68,415,3084,292,158,5,0,0,3954,452,2795,349,589,0,0,0,4185,8139
IT-MO,Modena,69,367,2990,239,149,2,0,0,3747,423,2784,361,693,1,0,0,4262,8009
IT-MO,Modena,70,317,2784,220,151,2,0,0,3474,365,2674,312,652,0,0,0,4003,7477
IT-MO,Modena,71,296,2700,187,192,0,0,0,3375,331,2559,276,758,0,0,0,3924,7299
IT-MO,Modena,72,305,2607,185,194,3,0,0,3294,290,2482,253,772,0,0,0,3797,7091
IT-MO,Modena,73,264,2685,187,228,0,0,0,3364,251,2547,262,963,1,0,0,4024,7388
IT-MO,Modena,74,249,2855,203,264,1,0,0,3572,255,2539,243,1075,1,0,0,4113,7685
IT-MO,Modena,75,280,2951,165,268,1,0,0,3665,257,2517,259,1069,1,0,0,4103,7768
IT-MO,Modena,76,216,2827,162,315,2,0,0,3522,221,2418,230,1198,0,0,0,4067,7589
IT-MO,Modena,77,219,2798,130,333,2,0,0,3482,212,2301,181,1370,0,0,0,4064,7546
IT-MO,Modena,78,143,1811,78,271,0,0,0,2303,129,1532,118,1103,0,0,0,2882,5185
IT-MO,Modena,79,131,1996,86,284,0,0,1,2498,141,1624,116,1304,0,0,0,3185,5683
IT-MO,Modena,80,155,1926,77,338,0,0,0,2496,163,1474,115,1326,0,0,0,3078,5574
IT-MO,Modena,81,155,1733,67,323,4,0,0,2282,174,1260,97,1356,0,0,0,2887,5169
IT-MO,Modena,82,139,1680,59,374,0,0,0,2252,137,1134,102,1469,0,0,0,2842,5094
IT-MO,Modena,83,148,1634,61,367,0,0,0,2210,154,1142,83,1637,0,0,0,3016,5226
IT-MO,Modena,84,122,1486,50,396,0,0,0,2054,147,1012,71,1723,0,0,0,2953,5007
IT-MO,Modena,85,141,1397,41,364,0,0,0,1943,122,821,55,1739,0,0,0,2737,4680
IT-MO,Modena,86,89,1088,24,403,0,0,0,1604,105,594,45,1598,0,0,0,2342,3946
IT-MO,Modena,87,80,892,24,320,0,0,0,1316,71,440,45,1507,0,0,0,2063,3379
IT-MO,Modena,88,80,816,22,328,0,0,0,1246,86,374,31,1524,0,0,0,2015,3261
IT-MO,Modena,89,79,637,13,340,0,0,0,1069,78,282,24,1443,0,0,0,1827,2896
IT-MO,Modena,90,35,491,4,273,0,0,0,803,80,171,18,1208,0,0,0,1477,2280
IT-MO,Modena,91,49,378,9,246,0,0,0,682,64,112,10,1068,0,0,0,1254,1936
IT-MO,Modena,92,36,265,1,200,0,0,0,502,44,85,12,903,0,0,0,1044,1546
IT-MO,Modena,93,24,190,5,157,0,0,0,376,42,63,16,822,0,0,0,943,1319
IT-MO,Modena,94,23,133,3,127,0,0,0,286,43,30,4,598,0,0,0,675,961
IT-MO,Modena,95,12,71,0,91,0,0,0,174,32,14,4,491,0,0,0,541,715
IT-MO,Modena,96,6,47,0,57,0,0,0,110,24,5,5,392,0,0,0,426,536
IT-MO,Modena,97,2,29,0,43,0,0,0,74,9,7,2,292,0,0,0,310,384
IT-MO,Modena,98,0,8,0,33,0,0,0,41,15,7,1,203,0,0,0,226,267
IT-MO,Modena,99,3,8,0,20,0,0,0,31,6,3,1,129,0,0,0,139,170
IT-MO,Modena,100,2,7,0,44,0,0,0,53,8,1,2,194,0,0,0,205,258
IT-MO,Modena,999,175139,151732,12829,9149,220,6,5,349080,147789,152649,17622,39121,169,14,1,357365,706445
IT-MB,Monza e della Brianza,0,2973,0,0,0,0,0,0,2973,2860,0,0,0,0,0,0,2860,5833
IT-MB,Monza e della Brianza,1,3156,0,0,0,0,0,0,3156,2999,0,0,0,0,0,0,2999,6155
IT-MB,Monza e della Brianza,2,3318,0,0,0,0,0,0,3318,2974,0,0,0,0,0,0,2974,6292
IT-MB,Monza e della Brianza,3,3269,0,0,0,0,0,0,3269,3094,0,0,0,0,0,0,3094,6363
IT-MB,Monza e della Brianza,4,3385,0,0,0,0,0,0,3385,3307,0,0,0,0,0,0,3307,6692
IT-MB,Monza e della Brianza,5,3638,0,0,0,0,0,0,3638,3326,0,0,0,0,0,0,3326,6964
IT-MB,Monza e della Brianza,6,3848,0,0,0,0,0,0,3848,3538,0,0,0,0,0,0,3538,7386
IT-MB,Monza e della Brianza,7,3855,0,0,0,0,0,0,3855,3643,0,0,0,0,0,0,3643,7498
IT-MB,Monza e della Brianza,8,3983,0,0,0,0,0,0,3983,3830,0,0,0,0,0,0,3830,7813
IT-MB,Monza e della Brianza,9,4108,0,0,0,0,0,0,4108,3933,0,0,0,0,0,0,3933,8041
IT-MB,Monza e della Brianza,10,4303,0,0,0,0,0,0,4303,3863,0,0,0,0,0,0,3863,8166
IT-MB,Monza e della Brianza,11,4394,0,0,0,0,0,0,4394,4190,0,0,0,0,0,0,4190,8584
IT-MB,Monza e della Brianza,12,4316,0,0,0,0,0,0,4316,4237,0,0,0,0,0,0,4237,8553
IT-MB,Monza e della Brianza,13,4482,0,0,0,0,0,0,4482,4301,0,0,0,0,0,0,4301,8783
IT-MB,Monza e della Brianza,14,4618,0,0,0,0,0,0,4618,4305,0,0,0,0,0,0,4305,8923
IT-MB,Monza e della Brianza,15,4619,0,0,0,0,0,0,4619,4385,0,0,0,0,0,0,4385,9004
IT-MB,Monza e della Brianza,16,4610,0,0,0,0,0,0,4610,4286,1,0,0,0,0,0,4287,8897
IT-MB,Monza e della Brianza,17,4723,0,1,0,0,0,0,4724,4284,0,0,0,0,0,0,4284,9008
IT-MB,Monza e della Brianza,18,4540,0,0,0,0,0,0,4540,4167,0,0,0,0,0,0,4167,8707
IT-MB,Monza e della Brianza,19,4589,4,0,0,0,0,0,4593,4166,4,0,0,0,0,0,4170,8763
IT-MB,Monza e della Brianza,20,4467,0,0,0,0,0,0,4467,4183,15,0,0,0,0,0,4198,8665
IT-MB,Monza e della Brianza,21,4491,6,0,0,0,0,0,4497,4017,35,0,0,0,0,0,4052,8549
IT-MB,Monza e della Brianza,22,4359,11,2,0,2,0,0,4374,4026,52,6,0,0,0,0,4084,8458
IT-MB,Monza e della Brianza,23,4572,20,5,0,0,0,0,4597,4075,121,9,0,0,0,0,4205,8802
IT-MB,Monza e della Brianza,24,4410,37,4,0,0,0,0,4451,3882,167,1,0,0,0,0,4050,8501
IT-MB,Monza e della Brianza,25,4582,90,6,0,2,0,0,4680,3803,258,12,1,0,0,0,4074,8754
IT-MB,Monza e della Brianza,26,4375,100,7,0,0,0,0,4482,3844,318,9,0,0,0,0,4171,8653
IT-MB,Monza e della Brianza,27,4281,178,8,0,2,0,0,4469,3751,509,7,0,6,0,0,4273,8742
IT-MB,Monza e della Brianza,28,4228,264,8,0,1,0,0,4501,3517,677,12,1,3,0,0,4210,8711
IT-MB,Monza e della Brianza,29,4138,397,16,1,1,1,0,4554,3438,873,19,3,3,0,0,4336,8890
IT-MB,Monza e della Brianza,30,3816,570,14,0,5,1,0,4406,3279,1108,28,4,10,0,0,4429,8835
IT-MB,Monza e della Brianza,31,3902,800,11,0,4,1,0,4718,3114,1352,30,3,5,1,0,4505,9223
IT-MB,Monza e della Brianza,32,3722,1005,20,4,9,0,0,4760,3035,1663,48,3,9,2,0,4760,9520
IT-MB,Monza e della Brianza,33,3630,1161,30,4,6,1,0,4832,2688,1910,57,14,7,1,0,4677,9509
IT-MB,Monza e della Brianza,34,3279,1460,35,4,10,0,0,4788,2625,2170,92,11,6,0,0,4904,9692
IT-MB,Monza e della Brianza,35,3190,1710,44,7,10,1,0,4962,2414,2426,91,11,18,1,0,4961,9923
IT-MB,Monza e della Brianza,36,2930,1822,68,2,12,1,0,4835,2288,2569,113,19,12,0,0,5001,9836
IT-MB,Monza e della Brianza,37,2732,2054,87,6,8,0,0,4887,2081,2584,156,18,9,0,0,4848,9735
IT-MB,Monza e della Brianza,38,2732,2224,105,5,11,0,0,5077,1997,2768,181,16,7,0,0,4969,10046
IT-MB,Monza e della Brianza,39,2523,2431,123,6,8,0,0,5091,1851,3000,217,28,5,2,0,5103,10194
IT-MB,Monza e della Brianza,40,2458,2643,107,8,3,1,0,5220,1870,3103,226,24,5,0,0,5228,10448
IT-MB,Monza e della Brianza,41,2476,2857,124,3,11,0,0,5471,1824,3357,263,25,6,0,0,5475,10946
IT-MB,Monza e della Brianza,42,2401,2872,174,20,14,0,0,5481,1649,3381,311,47,9,1,0,5398,10879
IT-MB,Monza e della Brianza,43,2269,3173,172,26,6,1,0,5647,1655,3608,341,48,13,0,0,5665,11312
IT-MB,Monza e della Brianza,44,2295,3370,197,25,15,0,0,5902,1597,3714,380,60,12,1,0,5764,11666
IT-MB,Monza e della Brianza,45,2302,3543,270,31,11,0,0,6157,1632,3937,418,55,7,0,0,6049,12206
IT-MB,Monza e della Brianza,46,2288,3710,296,28,11,0,0,6333,1539,4124,483,64,8,1,0,6219,12552
IT-MB,Monza e della Brianza,47,2317,3964,370,15,8,0,0,6674,1639,4325,535,74,5,1,0,6579,13253
IT-MB,Monza e della Brianza,48,2459,4311,388,30,10,0,0,7198,1618,4786,613,97,8,2,0,7124,14322
IT-MB,Monza e della Brianza,49,2347,4421,491,29,13,0,0,7301,1600,4984,664,119,9,1,0,7377,14678
IT-MB,Monza e della Brianza,50,2159,4540,478,28,9,0,1,7215,1481,4933,681,121,9,0,0,7225,14440
IT-MB,Monza e della Brianza,51,2059,4657,511,47,11,1,0,7286,1387,5065,670,129,4,0,0,7255,14541
IT-MB,Monza e della Brianza,52,1963,4941,531,54,16,1,1,7507,1265,5096,727,163,7,0,0,7258,14765
IT-MB,Monza e della Brianza,53,1792,4810,545,47,12,0,0,7206,1246,5159,743,180,6,0,0,7334,14540
IT-MB,Monza e della Brianza,54,1713,5111,580,53,7,0,0,7464,1226,5180,798,209,7,1,0,7421,14885
IT-MB,Monza e della Brianza,55,1708,5102,570,50,10,0,1,7441,1090,5333,805,234,3,0,0,7465,14906
IT-MB,Monza e della Brianza,56,1645,5040,628,57,8,0,0,7378,1000,5229,772,259,4,0,0,7264,14642
IT-MB,Monza e della Brianza,57,1420,5318,615,90,9,0,0,7452,963,5397,769,323,5,0,0,7457,14909
IT-MB,Monza e della Brianza,58,1308,5208,673,81,11,0,0,7281,956,5384,740,332,3,1,0,7416,14697
IT-MB,Monza e della Brianza,59,1196,5421,629,99,9,1,0,7355,851,5388,761,348,5,0,0,7353,14708
IT-MB,Monza e della Brianza,60,1078,5095,539,107,7,0,0,6826,751,4981,663,370,2,0,1,6768,13594
IT-MB,Monza e della Brianza,61,923,4695,520,116,4,0,0,6258,728,4687,612,418,1,0,0,6446,12704
IT-MB,Monza e della Brianza,62,780,4703,456,117,12,0,1,6069,666,4471,539,475,3,0,0,6154,12223
IT-MB,Monza e della Brianza,63,712,4487,406,123,2,0,0,5730,577,4469,525,481,1,0,0,6053,11783
IT-MB,Monza e della Brianza,64,621,4320,364,137,1,0,0,5443,556,4300,483,583,1,0,0,5923,11366
IT-MB,Monza e della Brianza,65,540,4049,373,154,6,0,0,5122,498,4040,401,591,0,0,0,5530,10652
IT-MB,Monza e della Brianza,66,540,4127,343,142,5,0,0,5157,422,3964,351,676,1,0,0,5414,10571
IT-MB,Monza e della Brianza,67,467,3965,279,163,3,0,0,4877,367,4096,367,734,2,0,0,5566,10443
IT-MB,Monza e della Brianza,68,453,3791,244,175,2,0,1,4666,364,3823,328,773,0,0,0,5288,9954
IT-MB,Monza e della Brianza,69,406,3716,231,210,3,0,0,4566,360,3757,303,840,1,0,0,5261,9827
IT-MB,Monza e della Brianza,70,368,3700,221,211,1,0,1,4502,338,3470,253,902,0,0,0,4963,9465
IT-MB,Monza e della Brianza,71,364,3642,192,218,3,0,0,4419,337,3361,236,1004,0,0,0,4938,9357
IT-MB,Monza e della Brianza,72,336,3529,168,247,1,0,0,4281,288,3280,192,1116,1,0,0,4877,9158
IT-MB,Monza e della Brianza,73,312,3570,152,299,1,0,0,4334,267,3297,195,1232,0,0,0,4991,9325
IT-MB,Monza e della Brianza,74,297,3522,128,295,1,0,0,4243,284,3140,202,1352,1,0,0,4979,9222
IT-MB,Monza e della Brianza,75,277,3617,119,323,1,0,0,4337,319,3208,182,1547,0,0,0,5256,9593
IT-MB,Monza e della Brianza,76,251,3363,112,330,2,0,0,4058,250,2832,161,1559,1,0,0,4803,8861
IT-MB,Monza e della Brianza,77,219,3431,110,396,0,0,0,4156,236,2813,185,1779,1,0,0,5014,9170
IT-MB,Monza e della Brianza,78,158,2402,82,323,1,0,0,2966,220,1984,131,1456,0,0,0,3791,6757
IT-MB,Monza e della Brianza,79,144,2451,68,355,0,0,0,3018,206,2000,114,1604,0,0,0,3924,6942
IT-MB,Monza e della Brianza,80,150,2336,43,389,0,0,0,2918,197,1683,92,1719,0,0,0,3691,6609
IT-MB,Monza e della Brianza,81,145,2322,47,376,0,0,0,2890,190,1706,99,1855,0,0,0,3850,6740
IT-MB,Monza e della Brianza,82,133,2138,45,418,1,0,0,2735,222,1497,87,2059,0,0,0,3865,6600
IT-MB,Monza e della Brianza,83,142,2215,44,521,0,0,0,2922,210,1479,65,2241,0,0,0,3995,6917
IT-MB,Monza e della Brianza,84,153,2133,39,489,0,0,0,2814,239,1199,70,2306,0,0,1,3815,6629
IT-MB,Monza e della Brianza,85,96,1735,37,521,0,0,0,2389,229,1017,63,2249,0,0,0,3558,5947
IT-MB,Monza e della Brianza,86,81,1414,23,475,0,0,0,1993,202,654,36,2033,0,0,0,2925,4918
IT-MB,Monza e della Brianza,87,71,1163,18,452,1,0,0,1705,155,495,33,1810,0,0,0,2493,4198
IT-MB,Monza e della Brianza,88,52,920,9,426,0,0,0,1407,166,355,30,1872,0,0,0,2423,3830
IT-MB,Monza e della Brianza,89,46,661,13,334,1,0,0,1055,141,262,20,1610,0,0,0,2033,3088
IT-MB,Monza e della Brianza,90,34,519,7,303,0,0,0,863,130,194,12,1402,0,0,0,1738,2601
IT-MB,Monza e della Brianza,91,27,400,4,265,0,0,0,696,114,150,12,1238,0,0,0,1514,2210
IT-MB,Monza e della Brianza,92,12,285,2,252,0,0,0,551,108,93,10,978,0,0,0,1189,1740
IT-MB,Monza e della Brianza,93,17,219,1,171,0,0,0,408,90,64,7,900,0,0,0,1061,1469
IT-MB,Monza e della Brianza,94,11,140,1,124,0,0,0,276,64,30,4,705,0,0,0,803,1079
IT-MB,Monza e della Brianza,95,8,71,2,98,0,0,0,179,63,17,4,497,0,0,0,581,760
IT-MB,Monza e della Brianza,96,3,49,0,67,0,0,0,119,37,15,0,384,0,0,0,436,555
IT-MB,Monza e della Brianza,97,5,23,2,49,0,0,0,79,21,3,2,255,0,0,0,281,360
IT-MB,Monza e della Brianza,98,2,11,0,28,0,0,0,41,14,3,1,166,0,0,0,184,225
IT-MB,Monza e della Brianza,99,1,8,0,18,0,0,0,27,10,2,1,122,0,0,0,135,162
IT-MB,Monza e della Brianza,100,1,7,0,14,0,0,0,22,27,0,0,181,0,0,0,208,230
IT-MB,Monza e della Brianza,999,208097,196300,14387,11091,354,11,6,430246,178347,198954,19859,49117,251,16,2,446546,876792
IT-NA,Napoli,0,12046,0,0,0,0,0,0,12046,11441,0,0,0,0,0,0,11441,23487
IT-NA,Napoli,1,12600,0,0,0,0,0,0,12600,11966,0,0,0,0,0,0,11966,24566
IT-NA,Napoli,2,12396,0,0,0,0,0,0,12396,11738,0,0,0,0,0,0,11738,24134
IT-NA,Napoli,3,12875,0,0,0,0,0,0,12875,12160,0,0,0,0,0,0,12160,25035
IT-NA,Napoli,4,13325,0,0,0,0,0,0,13325,12741,0,0,0,0,0,0,12741,26066
IT-NA,Napoli,5,13820,0,0,0,0,0,0,13820,12760,0,0,0,0,0,0,12760,26580
IT-NA,Napoli,6,14144,0,0,0,0,0,0,14144,13620,0,0,0,0,0,0,13620,27764
IT-NA,Napoli,7,14293,0,0,0,0,0,0,14293,13484,0,0,0,0,0,0,13484,27777
IT-NA,Napoli,8,14551,0,0,0,0,0,0,14551,13852,0,0,0,0,0,0,13852,28403
IT-NA,Napoli,9,14792,0,0,0,0,0,0,14792,13954,0,0,0,0,0,0,13954,28746
IT-NA,Napoli,10,15124,0,0,0,0,0,0,15124,14287,0,0,0,0,0,0,14287,29411
IT-NA,Napoli,11,15963,0,0,0,0,0,0,15963,14968,0,0,0,0,0,0,14968,30931
IT-NA,Napoli,12,16262,0,0,0,0,0,0,16262,15361,0,0,0,0,0,0,15361,31623
IT-NA,Napoli,13,16995,0,0,0,0,0,0,16995,15409,0,0,0,0,0,0,15409,32404
IT-NA,Napoli,14,17054,0,0,0,0,0,0,17054,16350,0,0,0,0,0,0,16350,33404
IT-NA,Napoli,15,17328,0,0,0,0,0,0,17328,16464,0,0,0,0,0,0,16464,33792
IT-NA,Napoli,16,17803,3,1,0,0,0,0,17807,17047,1,0,0,0,0,0,17048,34855
IT-NA,Napoli,17,18218,1,1,0,0,0,0,18220,16838,1,0,0,0,0,0,16839,35059
IT-NA,Napoli,18,18177,2,1,0,0,0,0,18180,17169,12,0,0,0,0,0,17181,35361
IT-NA,Napoli,19,18751,4,0,0,0,0,0,18755,17524,27,0,0,0,0,0,17551,36306
IT-NA,Napoli,20,18381,20,2,1,0,0,0,18404,17467,63,1,0,0,0,0,17531,35935
IT-NA,Napoli,21,17980,29,1,0,0,0,0,18010,16948,118,3,0,1,0,0,17070,35080
IT-NA,Napoli,22,18242,67,0,0,0,0,0,18309,16692,280,1,0,1,0,0,16974,35283
IT-NA,Napoli,23,18218,134,0,1,1,0,0,18354,16755,430,1,0,1,0,0,17187,35541
IT-NA,Napoli,24,17895,281,3,0,1,0,0,18180,16238,721,3,1,1,0,0,16964,35144
IT-NA,Napoli,25,17698,403,5,1,0,0,0,18107,15701,1151,12,2,0,0,0,16866,34973
IT-NA,Napoli,26,16932,619,5,1,2,0,0,17559,14966,1732,11,2,1,0,0,16712,34271
IT-NA,Napoli,27,16413,1071,12,0,4,0,0,17500,14200,2471,19,4,3,0,0,16697,34197
IT-NA,Napoli,28,15480,1581,9,0,7,0,0,17077,13591,3438,20,2,4,1,0,17056,34133
IT-NA,Napoli,29,15082,2204,11,1,11,0,0,17309,12446,4444,47,6,5,1,0,16949,34258
IT-NA,Napoli,30,14056,3063,23,0,8,1,0,17151,11540,5624,64,7,6,0,0,17241,34392
IT-NA,Napoli,31,13776,4161,38,3,8,0,0,17986,10902,7238,82,13,8,2,0,18245,36231
IT-NA,Napoli,32,12808,5054,41,3,8,0,0,17914,9705,8258,123,22,6,1,0,18115,36029
IT-NA,Napoli,33,11587,6145,70,8,10,0,0,17820,8555,9039,148,24,13,1,0,17780,35600
IT-NA,Napoli,34,10622,7034,76,10,10,1,0,17753,7701,9970,209,40,11,0,0,17931,35684
IT-NA,Napoli,35,10158,7734,114,15,13,0,0,18034,7032,11056,246,45,26,2,0,18407,36441
IT-NA,Napoli,36,9047,8653,142,9,19,0,0,17870,6157,11176,266,70,12,2,0,17683,35553
IT-NA,Napoli,37,8089,9206,162,17,17,0,0,17491,5506,11714,310,61,14,0,0,17605,35096
IT-NA,Napoli,38,7816,10288,194,26,20,0,0,18344,5104,12545,379,71,6,0,0,18105,36449
IT-NA,Napoli,39,7264,10630,225,25,10,0,0,18154,4856,13370,429,105,18,0,0,18778,36932
IT-NA,Napoli,40,6734,11474,260,25,10,1,0,18504,4558,13848,468,109,10,2,0,18995,37499
IT-NA,Napoli,41,6729,12354,287,36,9,1,0,19416,4294,14539,531,168,7,0,0,19539,38955
IT-NA,Napoli,42,5909,12130,332,57,13,1,0,18442,4080,14609,593,145,4,1,0,19432,37874
IT-NA,Napoli,43,5775,13071,358,46,11,0,0,19261,3737,15047,647,210,4,1,0,19646,38907
IT-NA,Napoli,44,5520,13419,436,60,13,2,0,19450,3667,15598,727,241,14,3,0,20250,39700
IT-NA,Napoli,45,5332,14113,398,66,12,0,0,19921,3562,16197,770,304,9,0,0,20842,40763
IT-NA,Napoli,46,5279,14685,492,80,19,2,0,20557,3542,16650,850,358,7,1,0,21408,41965
IT-NA,Napoli,47,5085,15236,548,92,13,0,0,20974,3677,17063,896,402,2,0,0,22040,43014
IT-NA,Napoli,48,5205,16304,621,98,24,0,1,22253,3536,17769,979,507,6,0,0,22797,45050
IT-NA,Napoli,49,4959,17041,656,137,10,0,0,22803,3631,18724,1085,605,8,0,0,24053,46856
IT-NA,Napoli,50,4566,16794,681,130,15,0,0,22186,3395,18543,1083,639,16,0,0,23676,45862
IT-NA,Napoli,51,4373,17290,712,158,15,1,0,22549,3263,18516,1121,736,2,1,0,23639,46188
IT-NA,Napoli,52,4036,16966,775,183,19,0,0,21979,3190,18593,1182,842,9,1,0,23817,45796
IT-NA,Napoli,53,3691,16999,762,195,21,1,0,21669,3012,18227,1188,868,6,0,0,23301,44970
IT-NA,Napoli,54,3524,17619,775,220,13,0,0,22151,2919,18396,1136,1094,4,1,0,23550,45701
IT-NA,Napoli,55,3182,17557,773,264,11,1,0,21788,2780,18413,1123,1104,5,0,0,23425,45213
IT-NA,Napoli,56,3031,17901,818,273,10,0,0,22033,2885,18689,1294,1298,9,0,0,24175,46208
IT-NA,Napoli,57,2831,18301,818,358,17,0,0,22325,2784,18596,1157,1516,1,0,0,24054,46379
IT-NA,Napoli,58,2628,18169,812,364,16,0,0,21989,2664,18300,1215,1642,3,0,0,23824,45813
IT-NA,Napoli,59,2551,18570,805,444,16,0,0,22386,2548,18484,1218,1992,3,0,0,24245,46631
IT-NA,Napoli,60,2212,17279,742,504,12,0,0,20749,2445,17422,1081,2048,0,0,0,22996,43745
IT-NA,Napoli,61,1956,17074,738,489,13,0,0,20270,2309,16866,993,2230,2,0,0,22400,42670
IT-NA,Napoli,62,1766,16500,654,546,14,0,0,19480,2116,16106,1033,2368,2,0,0,21625,41105
IT-NA,Napoli,63,1609,15345,642,555,11,0,0,18162,2003,15159,918,2489,1,0,0,20570,38732
IT-NA,Napoli,64,1462,15393,604,611,11,1,0,18082,1946,14561,876,2760,5,0,0,20148,38230
IT-NA,Napoli,65,1273,14658,517,643,10,0,0,17101,1869,13619,800,2929,2,0,0,19219,36320
IT-NA,Napoli,66,1203,14427,517,751,9,0,0,16907,1701,13406,843,3086,0,0,0,19036,35943
IT-NA,Napoli,67,1078,13584,435,765,7,0,0,15869,1529,12352,756,3296,2,0,0,17935,33804
IT-NA,Napoli,68,928,13888,440,800,3,1,0,16060,1580,12377,691,3636,1,0,0,18285,34345
IT-NA,Napoli,69,893,13680,386,911,7,0,0,15877,1521,11814,664,3826,0,1,0,17826,33703
IT-NA,Napoli,70,773,12289,368,892,6,0,0,14328,1325,10590,560,3796,0,0,0,16271,30599
IT-NA,Napoli,71,736,11725,306,901,5,0,0,13673,1311,9816,565,4010,3,0,0,15705,29378
IT-NA,Napoli,72,597,11437,287,986,5,0,0,13312,1250,9404,517,4325,0,1,0,15497,28809
IT-NA,Napoli,73,577,11451,262,1093,3,0,0,13386,1279,9238,481,4633,1,0,0,15632,29018
IT-NA,Napoli,74,573,11195,244,1153,4,0,0,13169,1199,8844,444,4924,0,0,0,15411,28580
IT-NA,Napoli,75,549,11058,231,1378,3,0,0,13219,1233,8362,441,5459,2,0,0,15497,28716
IT-NA,Napoli,76,463,10202,214,1333,3,0,0,12215,1235,7649,388,5753,0,0,0,15025,27240
IT-NA,Napoli,77,431,10041,191,1529,3,0,1,12196,1112,7395,325,6307,1,0,0,15140,27336
IT-NA,Napoli,78,350,8258,125,1447,3,0,0,10183,998,5879,297,5603,0,0,0,12777,22960
IT-NA,Napoli,79,251,6164,119,1178,0,0,1,7713,760,4187,223,4919,0,0,0,10089,17802
IT-NA,Napoli,80,256,6327,99,1318,0,0,0,8000,877,4251,200,5508,1,0,0,10837,18837
IT-NA,Napoli,81,240,5558,93,1290,1,0,0,7182,804,3569,200,5386,0,0,0,9959,17141
IT-NA,Napoli,82,202,4858,75,1334,0,0,0,6469,728,3123,160,5366,1,0,0,9378,15847
IT-NA,Napoli,83,192,4634,55,1366,1,0,0,6248,788,2729,128,5621,0,1,0,9267,15515
IT-NA,Napoli,84,164,3896,54,1347,0,0,0,5461,655,2385,116,5385,0,0,0,8541,14002
IT-NA,Napoli,85,144,3221,56,1259,2,0,1,4683,652,1844,93,5018,0,0,0,7607,12290
IT-NA,Napoli,86,122,2678,31,1105,0,0,0,3936,509,1426,106,4457,0,0,0,6498,10434
IT-NA,Napoli,87,90,2025,26,1014,0,0,0,3155,456,990,77,4015,0,0,0,5538,8693
IT-NA,Napoli,88,72,1678,17,963,0,0,0,2730,421,828,62,3728,0,0,0,5039,7769
IT-NA,Napoli,89,72,1319,7,808,0,0,0,2206,391,608,49,3207,0,0,0,4255,6461
IT-NA,Napoli,90,52,1006,14,732,0,0,0,1804,342,429,36,2893,0,0,0,3700,5504
IT-NA,Napoli,91,44,725,6,631,0,0,0,1406,264,316,35,2408,0,0,0,3023,4429
IT-NA,Napoli,92,20,517,5,543,1,0,0,1086,240,220,27,1972,0,0,0,2459,3545
IT-NA,Napoli,93,30,330,5,430,0,0,0,795,167,151,24,1617,0,0,0,1959,2754
IT-NA,Napoli,94,24,238,4,289,0,0,0,555,158,111,21,1216,0,0,0,1506,2061
IT-NA,Napoli,95,13,150,3,206,0,0,0,372,99,76,13,897,0,0,0,1085,1457
IT-NA,Napoli,96,5,84,0,134,0,0,0,223,78,27,7,617,0,0,0,729,952
IT-NA,Napoli,97,4,43,0,91,0,0,0,138,56,25,4,406,0,0,0,491,629
IT-NA,Napoli,98,7,29,1,66,0,0,0,103,37,26,8,292,0,0,0,363,466
IT-NA,Napoli,99,9,17,0,47,0,0,0,73,30,17,1,188,0,0,0,236,309
IT-NA,Napoli,100,19,35,0,63,0,0,0,117,66,37,4,350,0,0,0,457,574
IT-NA,Napoli,999,696462,689396,21828,36908,573,14,4,1445185,627458,707914,35904,154199,290,24,0,1525789,2970974
IT-NO,Novara,0,1102,0,0,0,0,0,0,1102,1149,0,0,0,0,0,0,1149,2251
IT-NO,Novara,1,1221,0,0,0,0,0,0,1221,1150,0,0,0,0,0,0,1150,2371
IT-NO,Novara,2,1269,0,0,0,0,0,0,1269,1194,0,0,0,0,0,0,1194,2463
IT-NO,Novara,3,1307,0,0,0,0,0,0,1307,1188,0,0,0,0,0,0,1188,2495
IT-NO,Novara,4,1373,0,0,0,0,0,0,1373,1285,0,0,0,0,0,0,1285,2658
IT-NO,Novara,5,1377,0,0,0,0,0,0,1377,1371,0,0,0,0,0,0,1371,2748
IT-NO,Novara,6,1444,0,0,0,0,0,0,1444,1382,0,0,0,0,0,0,1382,2826
IT-NO,Novara,7,1527,0,0,0,0,0,0,1527,1444,0,0,0,0,0,0,1444,2971
IT-NO,Novara,8,1536,0,0,0,0,0,0,1536,1480,0,0,0,0,0,0,1480,3016
IT-NO,Novara,9,1602,0,0,0,0,0,0,1602,1520,0,0,0,0,0,0,1520,3122
IT-NO,Novara,10,1615,0,0,0,0,0,0,1615,1600,0,0,0,0,0,0,1600,3215
IT-NO,Novara,11,1706,0,0,0,0,0,0,1706,1630,0,0,0,0,0,0,1630,3336
IT-NO,Novara,12,1740,0,0,0,0,0,0,1740,1632,0,0,0,0,0,0,1632,3372
IT-NO,Novara,13,1721,0,0,0,0,0,0,1721,1616,0,0,0,0,0,0,1616,3337
IT-NO,Novara,14,1757,0,0,0,0,0,0,1757,1709,0,0,0,0,0,0,1709,3466
IT-NO,Novara,15,1742,0,0,0,0,0,0,1742,1695,0,0,0,0,0,0,1695,3437
IT-NO,Novara,16,1831,0,0,0,0,0,0,1831,1818,0,0,0,0,0,0,1818,3649
IT-NO,Novara,17,1737,0,0,0,0,0,0,1737,1728,1,0,0,0,0,0,1729,3466
IT-NO,Novara,18,1817,0,0,0,0,0,0,1817,1676,1,0,0,0,0,0,1677,3494
IT-NO,Novara,19,1855,0,0,0,0,0,0,1855,1658,4,0,0,0,0,0,1662,3517
IT-NO,Novara,20,1824,0,0,0,1,0,0,1825,1602,12,0,0,0,0,0,1614,3439
IT-NO,Novara,21,1810,3,0,0,1,0,0,1814,1605,21,0,0,1,0,0,1627,3441
IT-NO,Novara,22,1829,11,4,0,0,0,0,1844,1517,46,1,0,0,0,0,1564,3408
IT-NO,Novara,23,1892,16,4,0,0,0,0,1912,1632,68,2,0,0,0,0,1702,3614
IT-NO,Novara,24,1903,29,1,0,0,0,0,1933,1570,103,5,0,1,0,0,1679,3612
IT-NO,Novara,25,1887,41,3,0,1,0,0,1932,1544,147,1,0,0,0,0,1692,3624
IT-NO,Novara,26,1886,50,1,0,0,0,0,1937,1551,153,4,0,1,0,0,1709,3646
IT-NO,Novara,27,1798,90,5,0,0,0,0,1893,1436,212,8,0,1,0,0,1657,3550
IT-NO,Novara,28,1783,100,7,1,0,0,0,1891,1414,304,7,1,0,1,0,1727,3618
IT-NO,Novara,29,1649,182,11,0,1,0,0,1843,1400,430,17,0,5,0,0,1852,3695
IT-NO,Novara,30,1653,254,8,0,1,0,0,1916,1209,510,17,1,1,2,0,1740,3656
IT-NO,Novara,31,1637,330,11,0,5,0,0,1983,1278,627,21,3,2,0,0,1931,3914
IT-NO,Novara,32,1531,392,18,1,2,0,0,1944,1149,658,35,2,4,1,0,1849,3793
IT-NO,Novara,33,1470,474,18,3,5,0,0,1970,965,774,20,2,3,0,0,1764,3734
IT-NO,Novara,34,1365,589,20,1,8,0,0,1983,984,873,38,5,4,0,0,1904,3887
IT-NO,Novara,35,1354,659,26,4,2,0,0,2045,903,931,46,5,4,0,0,1889,3934
IT-NO,Novara,36,1209,728,32,1,1,0,0,1971,815,1063,51,10,1,0,0,1940,3911
IT-NO,Novara,37,1128,778,45,1,4,1,0,1957,813,1102,68,8,1,0,0,1992,3949
IT-NO,Novara,38,1059,875,49,1,4,0,0,1988,735,1129,96,7,3,0,0,1970,3958
IT-NO,Novara,39,1032,968,45,2,3,1,0,2051,750,1153,83,10,0,0,0,1996,4047
IT-NO,Novara,40,1046,1077,65,4,3,0,0,2195,734,1325,112,14,3,1,0,2189,4384
IT-NO,Novara,41,1007,1117,64,6,3,2,0,2199,733,1329,132,19,3,0,0,2216,4415
IT-NO,Novara,42,1042,1209,85,7,2,0,0,2345,687,1386,153,21,1,0,0,2248,4593
IT-NO,Novara,43,1000,1270,91,4,2,0,0,2367,662,1350,153,24,5,0,0,2194,4561
IT-NO,Novara,44,959,1288,129,14,5,0,0,2395,663,1457,171,20,1,0,0,2312,4707
IT-NO,Novara,45,982,1409,120,9,1,1,0,2522,641,1576,180,35,2,0,0,2434,4956
IT-NO,Novara,46,980,1495,131,7,3,0,0,2616,671,1677,204,38,1,0,0,2591,5207
IT-NO,Novara,47,995,1528,156,6,9,0,0,2694,658,1802,243,48,0,0,0,2751,5445
IT-NO,Novara,48,1036,1628,177,15,4,0,0,2860,653,1883,270,53,1,0,0,2860,5720
IT-NO,Novara,49,948,1754,214,15,7,0,0,2938,626,1951,298,50,4,0,0,2929,5867
IT-NO,Novara,50,937,1789,227,16,11,0,1,2981,588,1933,321,64,1,1,0,2908,5889
IT-NO,Novara,51,819,1864,225,18,3,1,0,2930,584,2032,292,58,2,0,0,2968,5898
IT-NO,Novara,52,889,1945,225,23,4,1,0,3087,533,1959,311,68,2,0,0,2873,5960
IT-NO,Novara,53,722,1885,218,24,10,0,0,2859,491,2006,344,91,2,0,0,2934,5793
IT-NO,Novara,54,733,2077,282,23,4,0,0,3119,473,2088,357,116,0,1,0,3035,6154
IT-NO,Novara,55,713,1957,253,20,9,1,0,2953,437,2133,326,103,3,0,0,3002,5955
IT-NO,Novara,56,622,2068,282,33,6,0,0,3011,390,2098,335,146,2,0,0,2971,5982
IT-NO,Novara,57,632,2138,300,37,2,0,0,3109,438,2170,344,134,2,0,0,3088,6197
IT-NO,Novara,58,516,2060,301,37,5,1,0,2920,382,2242,367,165,1,0,0,3157,6077
IT-NO,Novara,59,502,2169,292,61,2,0,0,3026,344,2312,358,180,0,1,0,3195,6221
IT-NO,Novara,60,451,2130,251,50,3,1,0,2886,311,2114,301,207,1,0,0,2934,5820
IT-NO,Novara,61,407,2023,254,47,5,0,0,2736,303,1935,283,245,0,0,0,2766,5502
IT-NO,Novara,62,373,2052,247,48,3,0,0,2723,267,2009,297,229,1,0,0,2803,5526
IT-NO,Novara,63,316,1949,225,45,1,0,0,2536,243,1968,257,317,0,0,0,2785,5321
IT-NO,Novara,64,293,1938,187,56,3,0,0,2477,243,1858,223,320,0,0,0,2644,5121
IT-NO,Novara,65,271,1829,168,73,5,0,0,2346,171,1704,226,321,2,1,0,2425,4771
IT-NO,Novara,66,245,1727,174,82,2,0,0,2230,193,1773,215,308,2,0,0,2491,4721
IT-NO,Novara,67,224,1677,153,77,0,0,0,2131,145,1659,197,326,0,0,0,2327,4458
IT-NO,Novara,68,210,1726,143,102,0,0,1,2182,138,1680,175,385,1,0,0,2379,4561
IT-NO,Novara,69,201,1656,128,108,1,0,0,2094,155,1578,164,428,1,0,0,2326,4420
IT-NO,Novara,70,162,1678,113,123,2,1,0,2079,122,1418,145,439,1,0,0,2125,4204
IT-NO,Novara,71,168,1594,116,111,0,1,0,1990,118,1449,132,469,0,0,0,2168,4158
IT-NO,Novara,72,145,1571,93,107,0,0,0,1916,115,1374,130,460,1,0,0,2080,3996
IT-NO,Novara,73,149,1617,70,139,0,0,0,1975,120,1359,119,608,0,0,0,2206,4181
IT-NO,Novara,74,135,1534,72,144,0,0,0,1885,98,1348,127,656,1,0,0,2230,4115
IT-NO,Novara,75,134,1515,84,161,0,0,0,1894,93,1287,106,759,1,0,0,2246,4140
IT-NO,Novara,76,111,1467,73,160,0,0,0,1811,118,1187,113,804,0,0,0,2222,4033
IT-NO,Novara,77,94,1412,75,186,3,0,0,1770,84,1049,98,787,1,0,0,2019,3789
IT-NO,Novara,78,65,977,45,144,0,0,0,1231,76,793,70,663,0,0,0,1602,2833
IT-NO,Novara,79,75,994,45,155,1,0,0,1270,72,748,61,725,0,0,0,1606,2876
IT-NO,Novara,80,80,892,32,158,0,0,0,1162,79,680,64,787,0,0,0,1610,2772
IT-NO,Novara,81,63,842,43,184,0,0,0,1132,89,592,54,834,0,0,0,1569,2701
IT-NO,Novara,82,65,800,31,191,0,0,0,1087,101,605,46,970,0,0,0,1722,2809
IT-NO,Novara,83,60,803,32,211,0,0,0,1106,85,577,41,1065,1,0,0,1769,2875
IT-NO,Novara,84,63,766,32,216,0,0,0,1077,109,471,43,1036,0,0,0,1659,2736
IT-NO,Novara,85,50,726,18,221,0,0,0,1015,90,372,31,1092,0,0,0,1585,2600
IT-NO,Novara,86,42,569,14,209,0,0,0,834,82,320,19,1016,0,0,0,1437,2271
IT-NO,Novara,87,20,456,11,199,1,0,0,687,66,200,21,925,0,0,0,1212,1899
IT-NO,Novara,88,20,398,10,154,0,0,0,582,66,168,13,823,0,0,0,1070,1652
IT-NO,Novara,89,25,284,11,147,0,0,0,467,41,119,13,780,0,0,0,953,1420
IT-NO,Novara,90,29,241,4,138,0,0,0,412,57,81,12,690,0,0,0,840,1252
IT-NO,Novara,91,13,161,2,123,0,0,0,299,57,60,10,605,0,0,0,732,1031
IT-NO,Novara,92,17,120,3,103,0,0,0,243,46,38,7,537,0,0,0,628,871
IT-NO,Novara,93,7,90,0,75,0,0,0,172,43,26,2,448,0,0,0,519,691
IT-NO,Novara,94,7,58,1,61,0,0,0,127,25,13,2,349,0,0,0,389,516
IT-NO,Novara,95,2,38,1,57,0,0,0,98,20,10,4,260,0,0,0,294,392
IT-NO,Novara,96,1,16,1,30,0,0,0,48,11,5,1,213,0,0,0,230,278
IT-NO,Novara,97,1,12,1,19,0,0,0,33,16,0,0,135,0,0,0,151,184
IT-NO,Novara,98,2,6,0,17,0,0,0,25,11,2,0,86,0,0,0,99,124
IT-NO,Novara,99,2,3,3,7,0,0,0,15,11,1,0,69,0,0,0,81,96
IT-NO,Novara,100,0,0,0,18,0,0,0,18,9,1,0,117,0,0,0,127,145
IT-NO,Novara,999,84856,80643,7111,5050,164,12,2,177838,70484,81662,9613,23794,82,9,0,185644,363482
IT-NU,Nuoro,0,525,0,0,0,0,0,0,525,464,0,0,0,0,0,0,464,989
IT-NU,Nuoro,1,540,0,0,0,0,0,0,540,467,0,0,0,0,0,0,467,1007
IT-NU,Nuoro,2,577,0,0,0,0,0,0,577,534,0,0,0,0,0,0,534,1111
IT-NU,Nuoro,3,553,0,0,0,0,0,0,553,551,0,0,0,0,0,0,551,1104
IT-NU,Nuoro,4,642,0,0,0,0,0,0,642,579,0,0,0,0,0,0,579,1221
IT-NU,Nuoro,5,676,0,0,0,0,0,0,676,604,0,0,0,0,0,0,604,1280
IT-NU,Nuoro,6,700,0,0,0,0,0,0,700,673,0,0,0,0,0,0,673,1373
IT-NU,Nuoro,7,693,0,0,0,0,0,0,693,685,0,0,0,0,0,0,685,1378
IT-NU,Nuoro,8,735,0,0,0,0,0,0,735,699,0,0,0,0,0,0,699,1434
IT-NU,Nuoro,9,777,0,0,0,0,0,0,777,740,0,0,0,0,0,0,740,1517
IT-NU,Nuoro,10,825,0,0,0,0,0,0,825,746,0,0,0,0,0,0,746,1571
IT-NU,Nuoro,11,862,0,0,0,0,0,0,862,769,0,0,0,0,0,0,769,1631
IT-NU,Nuoro,12,860,0,0,0,0,0,0,860,844,0,0,0,0,0,0,844,1704
IT-NU,Nuoro,13,938,0,0,0,0,0,0,938,846,0,0,0,0,0,0,846,1784
IT-NU,Nuoro,14,969,0,0,0,0,0,0,969,797,0,0,0,0,0,0,797,1766
IT-NU,Nuoro,15,925,0,0,0,0,0,0,925,866,0,0,0,0,0,0,866,1791
IT-NU,Nuoro,16,921,0,0,0,0,0,0,921,826,0,0,0,0,0,0,826,1747
IT-NU,Nuoro,17,975,0,0,0,0,0,0,975,859,0,0,0,0,0,0,859,1834
IT-NU,Nuoro,18,979,0,0,1,0,0,0,980,914,0,0,0,0,0,0,914,1894
IT-NU,Nuoro,19,977,0,0,0,0,0,0,977,860,1,0,0,0,0,0,861,1838
IT-NU,Nuoro,20,991,0,0,0,0,0,0,991,887,0,0,0,0,0,0,887,1878
IT-NU,Nuoro,21,912,0,0,0,0,0,0,912,862,1,0,0,0,0,0,863,1775
IT-NU,Nuoro,22,1009,1,0,0,0,0,0,1010,932,5,0,0,0,0,0,937,1947
IT-NU,Nuoro,23,1006,3,0,0,0,0,0,1009,909,10,0,0,0,0,0,919,1928
IT-NU,Nuoro,24,1000,1,0,0,0,0,0,1001,877,13,3,0,0,0,0,893,1894
IT-NU,Nuoro,25,981,4,2,0,0,0,0,987,896,17,0,0,0,0,0,913,1900
IT-NU,Nuoro,26,1006,16,0,0,0,0,0,1022,858,31,0,0,0,0,0,889,1911
IT-NU,Nuoro,27,986,12,0,0,1,0,0,999,826,53,0,0,0,0,0,879,1878
IT-NU,Nuoro,28,1038,39,0,0,0,0,0,1077,841,74,0,0,0,0,0,915,1992
IT-NU,Nuoro,29,1004,41,0,0,1,0,0,1046,799,83,2,0,0,0,0,884,1930
IT-NU,Nuoro,30,949,48,1,0,0,0,0,998,774,130,6,0,0,0,0,910,1908
IT-NU,Nuoro,31,968,69,3,0,0,0,0,1040,708,192,1,0,0,0,0,901,1941
IT-NU,Nuoro,32,971,95,4,0,1,0,0,1071,743,221,3,3,0,0,0,970,2041
IT-NU,Nuoro,33,925,131,3,0,1,0,0,1060,696,298,9,2,1,1,0,1007,2067
IT-NU,Nuoro,34,863,170,3,0,2,0,0,1038,633,289,11,1,0,1,0,935,1973
IT-NU,Nuoro,35,888,238,5,0,0,0,0,1131,614,372,17,4,0,0,0,1007,2138
IT-NU,Nuoro,36,708,245,9,2,0,0,0,964,569,367,19,3,2,0,0,960,1924
IT-NU,Nuoro,37,745,285,12,0,1,0,0,1043,544,455,17,2,0,0,0,1018,2061
IT-NU,Nuoro,38,744,331,13,1,1,0,0,1090,481,470,23,6,0,0,0,980,2070
IT-NU,Nuoro,39,753,348,11,3,1,0,0,1116,493,483,23,2,1,0,0,1002,2118
IT-NU,Nuoro,40,720,382,10,0,0,0,0,1112,497,541,40,9,0,1,0,1088,2200
IT-NU,Nuoro,41,687,437,23,0,0,0,0,1147,446,582,36,5,0,0,0,1069,2216
IT-NU,Nuoro,42,658,481,20,1,1,0,0,1161,434,652,47,9,0,0,0,1142,2303
IT-NU,Nuoro,43,668,565,25,3,2,0,0,1263,414,645,43,10,1,0,0,1113,2376
IT-NU,Nuoro,44,698,540,33,2,2,0,0,1275,376,706,52,13,0,0,0,1147,2422
IT-NU,Nuoro,45,683,647,44,6,0,0,0,1380,419,867,71,11,1,0,0,1369,2749
IT-NU,Nuoro,46,674,701,49,5,0,0,0,1429,374,839,70,21,1,0,0,1305,2734
IT-NU,Nuoro,47,708,693,42,1,1,0,0,1445,400,889,89,24,0,0,0,1402,2847
IT-NU,Nuoro,48,673,734,47,4,3,0,0,1461,377,918,82,22,1,0,0,1400,2861
IT-NU,Nuoro,49,668,856,66,5,1,0,0,1596,348,937,80,36,0,0,0,1401,2997
IT-NU,Nuoro,50,588,852,71,5,1,0,0,1517,357,1014,84,45,0,0,0,1500,3017
IT-NU,Nuoro,51,599,839,86,7,0,0,0,1531,329,1015,100,54,0,0,0,1498,3029
IT-NU,Nuoro,52,537,961,69,7,0,0,0,1574,330,1057,99,31,1,0,0,1518,3092
IT-NU,Nuoro,53,536,926,89,5,0,0,0,1556,317,1061,99,46,0,0,0,1523,3079
IT-NU,Nuoro,54,545,996,111,10,1,0,0,1663,325,1126,99,66,0,0,0,1616,3279
IT-NU,Nuoro,55,528,1009,91,14,0,0,0,1642,307,1101,103,78,0,0,0,1589,3231
IT-NU,Nuoro,56,532,1091,88,13,1,0,0,1725,305,1175,107,91,1,0,0,1679,3404
IT-NU,Nuoro,57,478,1152,101,17,2,0,0,1750,297,1226,105,94,0,0,0,1722,3472
IT-NU,Nuoro,58,457,1104,72,17,2,0,0,1652,290,1149,84,111,0,0,0,1634,3286
IT-NU,Nuoro,59,378,1245,107,22,0,0,0,1752,302,1249,97,135,0,0,0,1783,3535
IT-NU,Nuoro,60,356,1134,81,23,0,0,0,1594,305,1151,69,133,0,0,0,1658,3252
IT-NU,Nuoro,61,341,1138,92,32,0,0,0,1603,284,1107,78,162,0,0,0,1631,3234
IT-NU,Nuoro,62,361,1073,88,29,0,0,0,1551,245,1172,70,178,0,0,0,1665,3216
IT-NU,Nuoro,63,312,1070,70,34,0,0,0,1486,225,1068,49,153,0,0,0,1495,2981
IT-NU,Nuoro,64,293,1088,73,31,0,0,0,1485,194,1082,73,163,0,0,0,1512,2997
IT-NU,Nuoro,65,286,1072,64,39,0,0,0,1461,217,989,54,197,0,0,0,1457,2918
IT-NU,Nuoro,66,248,1035,50,35,1,0,0,1369,224,1013,58,220,1,0,0,1516,2885
IT-NU,Nuoro,67,269,1024,53,54,0,0,0,1400,218,990,49,251,0,0,0,1508,2908
IT-NU,Nuoro,68,230,1011,45,44,0,0,0,1330,230,965,41,250,0,0,0,1486,2816
IT-NU,Nuoro,69,235,1014,64,48,0,0,0,1361,204,928,47,276,0,0,0,1455,2816
IT-NU,Nuoro,70,198,935,42,48,0,0,0,1223,209,813,39,263,0,0,0,1324,2547
IT-NU,Nuoro,71,211,992,39,55,0,0,0,1297,190,799,26,305,0,0,0,1320,2617
IT-NU,Nuoro,72,181,872,31,50,0,0,0,1134,164,730,36,337,1,0,0,1268,2402
IT-NU,Nuoro,73,167,861,28,77,0,0,0,1133,175,711,22,395,0,0,0,1303,2436
IT-NU,Nuoro,74,149,837,24,57,0,0,0,1067,159,663,20,366,0,0,0,1208,2275
IT-NU,Nuoro,75,154,849,38,66,0,0,0,1107,170,654,27,421,0,0,0,1272,2379
IT-NU,Nuoro,76,147,759,14,51,0,0,0,971,145,555,18,435,0,0,0,1153,2124
IT-NU,Nuoro,77,121,687,22,79,0,0,0,909,151,469,17,448,0,0,0,1085,1994
IT-NU,Nuoro,78,122,631,19,80,0,0,0,852,162,467,10,455,0,0,0,1094,1946
IT-NU,Nuoro,79,116,624,19,77,0,0,0,836,169,416,14,515,0,0,0,1114,1950
IT-NU,Nuoro,80,96,535,15,63,0,0,0,709,162,356,8,512,0,0,0,1038,1747
IT-NU,Nuoro,81,92,534,11,81,0,0,0,718,140,347,9,534,0,0,0,1030,1748
IT-NU,Nuoro,82,73,472,6,56,0,0,0,607,121,258,8,539,0,0,0,926,1533
IT-NU,Nuoro,83,86,491,9,76,0,0,0,662,155,261,9,614,0,0,0,1039,1701
IT-NU,Nuoro,84,64,433,7,89,0,0,0,593,157,200,1,576,0,0,0,934,1527
IT-NU,Nuoro,85,68,370,1,80,0,0,0,519,146,169,4,549,0,0,0,868,1387
IT-NU,Nuoro,86,49,259,2,93,0,0,0,403,126,117,5,469,0,0,0,717,1120
IT-NU,Nuoro,87,34,275,0,81,0,0,0,390,126,106,4,471,0,0,0,707,1097
IT-NU,Nuoro,88,32,220,5,56,0,0,0,313,117,76,1,425,0,0,0,619,932
IT-NU,Nuoro,89,29,169,1,73,0,0,0,272,112,43,5,378,0,0,0,538,810
IT-NU,Nuoro,90,17,161,4,64,0,0,0,246,90,35,7,339,0,0,0,471,717
IT-NU,Nuoro,91,21,119,0,49,0,0,0,189,81,35,0,316,0,0,0,432,621
IT-NU,Nuoro,92,14,96,0,50,0,0,0,160,52,13,2,257,0,0,0,324,484
IT-NU,Nuoro,93,9,65,0,58,0,0,0,132,50,18,2,229,0,0,0,299,431
IT-NU,Nuoro,94,12,47,0,35,0,0,0,94,54,14,0,162,0,0,0,230,324
IT-NU,Nuoro,95,9,40,0,30,0,0,0,79,39,4,1,150,0,0,0,194,273
IT-NU,Nuoro,96,5,23,1,13,0,0,0,42,23,3,0,88,0,0,0,114,156
IT-NU,Nuoro,97,0,13,0,23,0,0,0,36,17,2,0,87,0,0,0,106,142
IT-NU,Nuoro,98,3,7,0,18,0,0,0,28,9,1,0,60,0,0,0,70,98
IT-NU,Nuoro,99,0,2,0,12,0,0,0,14,5,3,0,39,0,0,0,47,61
IT-NU,Nuoro,100,2,5,0,18,0,0,0,25,15,3,0,68,0,0,0,86,111
IT-NU,Nuoro,999,51323,41330,2328,2278,27,0,0,97286,42346,41120,2604,13719,12,3,0,99804,197090
IT-OR,Oristano,0,357,0,0,0,0,0,0,357,322,0,0,0,0,0,0,322,679
IT-OR,Oristano,1,355,0,0,0,0,0,0,355,315,0,0,0,0,0,0,315,670
IT-OR,Oristano,2,391,0,0,0,0,0,0,391,366,0,0,0,0,0,0,366,757
IT-OR,Oristano,3,376,0,0,0,0,0,0,376,366,0,0,0,0,0,0,366,742
IT-OR,Oristano,4,408,0,0,0,0,0,0,408,377,0,0,0,0,0,0,377,785
IT-OR,Oristano,5,425,0,0,0,0,0,0,425,428,0,0,0,0,0,0,428,853
IT-OR,Oristano,6,494,0,0,0,0,0,0,494,445,0,0,0,0,0,0,445,939
IT-OR,Oristano,7,511,0,0,0,0,0,0,511,424,0,0,0,0,0,0,424,935
IT-OR,Oristano,8,473,0,0,0,0,0,0,473,472,0,0,0,0,0,0,472,945
IT-OR,Oristano,9,523,0,0,0,0,0,0,523,455,0,0,0,0,0,0,455,978
IT-OR,Oristano,10,510,0,0,0,0,0,0,510,521,0,0,0,0,0,0,521,1031
IT-OR,Oristano,11,516,0,0,0,0,0,0,516,469,0,0,0,0,0,0,469,985
IT-OR,Oristano,12,594,0,0,0,0,0,0,594,530,0,0,0,0,0,0,530,1124
IT-OR,Oristano,13,588,0,0,0,0,0,0,588,593,0,0,0,0,0,0,593,1181
IT-OR,Oristano,14,613,0,0,0,0,0,0,613,518,0,0,0,0,0,0,518,1131
IT-OR,Oristano,15,616,0,0,0,0,0,0,616,553,0,0,0,0,0,0,553,1169
IT-OR,Oristano,16,605,0,0,0,0,0,0,605,599,0,0,0,0,0,0,599,1204
IT-OR,Oristano,17,644,0,0,0,0,0,0,644,534,0,0,0,0,0,0,534,1178
IT-OR,Oristano,18,660,0,0,0,0,0,0,660,595,0,0,0,0,0,0,595,1255
IT-OR,Oristano,19,619,0,0,0,0,0,0,619,599,0,0,0,0,0,0,599,1218
IT-OR,Oristano,20,682,0,0,0,0,0,0,682,584,1,0,0,0,0,0,585,1267
IT-OR,Oristano,21,620,0,0,0,0,0,0,620,601,1,0,0,0,0,0,602,1222
IT-OR,Oristano,22,669,1,0,0,0,0,0,670,630,1,0,0,0,0,0,631,1301
IT-OR,Oristano,23,697,1,0,0,0,0,0,698,611,7,0,0,0,0,0,618,1316
IT-OR,Oristano,24,695,2,0,0,0,0,0,697,632,11,0,0,0,0,0,643,1340
IT-OR,Oristano,25,687,2,0,0,0,0,0,689,574,12,0,0,0,0,0,586,1275
IT-OR,Oristano,26,715,3,0,0,0,0,0,718,572,26,1,0,0,0,0,599,1317
IT-OR,Oristano,27,658,7,0,0,0,0,0,665,572,23,1,0,0,0,0,596,1261
IT-OR,Oristano,28,671,25,0,0,0,0,0,696,543,58,0,0,0,0,0,601,1297
IT-OR,Oristano,29,650,22,1,0,0,1,0,674,562,65,5,0,0,1,0,633,1307
IT-OR,Oristano,30,692,40,1,0,0,0,0,733,520,85,4,0,0,0,0,609,1342
IT-OR,Oristano,31,672,41,4,0,1,0,0,718,595,102,1,0,1,0,0,699,1417
IT-OR,Oristano,32,746,70,1,0,0,0,0,817,549,145,6,1,2,0,0,703,1520
IT-OR,Oristano,33,654,111,1,0,0,0,0,766,567,167,6,0,2,1,0,743,1509
IT-OR,Oristano,34,667,129,1,0,1,0,0,798,486,190,5,1,1,0,0,683,1481
IT-OR,Oristano,35,642,108,2,0,0,0,0,752,484,240,10,1,0,0,0,735,1487
IT-OR,Oristano,36,658,209,2,0,1,0,0,870,463,282,6,1,1,0,0,753,1623
IT-OR,Oristano,37,564,168,6,0,0,1,0,739,451,297,11,2,2,0,0,763,1502
IT-OR,Oristano,38,630,203,10,0,0,0,0,843,409,340,15,4,1,1,0,770,1613
IT-OR,Oristano,39,601,266,17,1,0,0,0,885,422,401,22,1,0,0,0,846,1731
IT-OR,Oristano,40,622,303,10,0,0,0,0,935,421,393,23,1,0,0,0,838,1773
IT-OR,Oristano,41,635,342,12,2,0,0,0,991,367,457,32,10,0,0,0,866,1857
IT-OR,Oristano,42,557,377,16,0,0,0,0,950,392,453,34,5,0,0,0,884,1834
IT-OR,Oristano,43,551,377,19,0,0,0,0,947,383,500,38,7,0,0,0,928,1875
IT-OR,Oristano,44,526,418,29,0,2,0,0,975,355,549,48,12,0,0,0,964,1939
IT-OR,Oristano,45,563,483,24,6,1,0,0,1077,332,618,42,7,2,0,0,1001,2078
IT-OR,Oristano,46,531,508,26,6,0,0,0,1071,339,639,43,15,0,0,0,1036,2107
IT-OR,Oristano,47,537,562,39,4,1,1,0,1144,327,635,47,11,0,0,0,1020,2164
IT-OR,Oristano,48,526,555,34,2,0,0,0,1117,340,705,71,22,0,0,0,1138,2255
IT-OR,Oristano,49,520,664,45,6,0,0,0,1235,321,731,67,16,1,0,0,1136,2371
IT-OR,Oristano,50,456,635,42,3,1,0,0,1137,293,757,76,26,0,0,0,1152,2289
IT-OR,Oristano,51,440,680,56,6,1,0,0,1183,280,776,69,26,0,0,0,1151,2334
IT-OR,Oristano,52,422,738,56,6,0,0,0,1222,279,856,79,31,0,0,0,1245,2467
IT-OR,Oristano,53,433,741,57,6,1,0,0,1238,258,811,66,30,1,0,0,1166,2404
IT-OR,Oristano,54,395,794,58,9,0,0,0,1256,243,863,71,39,0,0,0,1216,2472
IT-OR,Oristano,55,345,750,58,7,1,0,0,1161,249,862,74,34,0,0,0,1219,2380
IT-OR,Oristano,56,359,821,65,17,2,0,0,1264,226,899,89,57,0,0,0,1271,2535
IT-OR,Oristano,57,309,848,79,11,1,0,0,1248,226,981,94,51,0,0,0,1352,2600
IT-OR,Oristano,58,299,883,68,20,0,0,0,1270,200,919,92,90,0,0,0,1301,2571
IT-OR,Oristano,59,283,880,92,18,0,0,0,1273,209,1005,91,70,0,0,0,1375,2648
IT-OR,Oristano,60,257,846,71,24,0,0,0,1198,180,1015,74,65,0,0,0,1334,2532
IT-OR,Oristano,61,240,939,67,18,1,0,0,1265,191,934,56,103,0,0,0,1284,2549
IT-OR,Oristano,62,243,889,71,21,0,0,0,1224,178,914,68,102,0,0,0,1262,2486
IT-OR,Oristano,63,210,858,55,22,0,0,0,1145,141,892,53,114,0,0,0,1200,2345
IT-OR,Oristano,64,226,891,56,23,0,0,0,1196,115,857,55,141,0,0,0,1168,2364
IT-OR,Oristano,65,186,827,53,27,0,0,0,1093,127,880,56,157,0,0,0,1220,2313
IT-OR,Oristano,66,181,860,55,29,0,0,0,1125,145,841,44,163,0,0,0,1193,2318
IT-OR,Oristano,67,170,834,54,23,0,0,0,1081,148,776,44,177,1,0,0,1146,2227
IT-OR,Oristano,68,145,862,41,36,0,0,0,1084,120,781,43,179,1,0,0,1124,2208
IT-OR,Oristano,69,143,848,50,38,0,1,0,1080,112,754,37,217,0,0,0,1120,2200
IT-OR,Oristano,70,141,847,34,40,0,0,0,1062,122,711,47,207,0,0,0,1087,2149
IT-OR,Oristano,71,130,763,32,48,0,0,0,973,109,698,33,218,0,0,0,1058,2031
IT-OR,Oristano,72,129,779,37,52,0,0,0,997,122,617,31,275,0,0,0,1045,2042
IT-OR,Oristano,73,139,781,31,75,0,0,0,1026,125,608,29,266,0,0,0,1028,2054
IT-OR,Oristano,74,112,734,25,59,0,0,0,930,104,595,28,285,0,0,0,1012,1942
IT-OR,Oristano,75,94,691,24,73,0,0,0,882,122,557,18,283,0,0,0,980,1862
IT-OR,Oristano,76,97,652,15,71,0,0,0,835,108,519,25,315,0,0,0,967,1802
IT-OR,Oristano,77,78,609,22,65,0,0,0,774,106,439,19,320,0,0,0,884,1658
IT-OR,Oristano,78,84,556,15,70,0,0,0,725,102,369,13,314,0,0,0,798,1523
IT-OR,Oristano,79,79,552,13,86,0,0,0,730,117,396,10,424,0,0,0,947,1677
IT-OR,Oristano,80,60,481,11,63,0,0,0,615,99,353,12,397,0,0,0,861,1476
IT-OR,Oristano,81,64,456,9,80,0,0,0,609,98,310,10,394,0,0,0,812,1421
IT-OR,Oristano,82,58,387,13,66,0,0,0,524,78,219,8,353,0,0,0,658,1182
IT-OR,Oristano,83,70,388,10,98,0,0,0,566,127,229,7,487,0,0,0,850,1416
IT-OR,Oristano,84,62,387,14,108,0,0,0,571,100,197,8,418,0,0,0,723,1294
IT-OR,Oristano,85,36,297,6,86,0,0,0,425,83,172,6,395,0,0,0,656,1081
IT-OR,Oristano,86,34,254,1,70,0,0,0,359,86,109,2,383,0,0,0,580,939
IT-OR,Oristano,87,47,210,1,72,0,0,0,330,99,99,9,370,0,0,0,577,907
IT-OR,Oristano,88,31,163,1,68,0,0,0,263,76,72,6,357,0,0,0,511,774
IT-OR,Oristano,89,21,152,5,69,0,0,0,247,65,56,5,322,0,0,0,448,695
IT-OR,Oristano,90,24,126,1,71,0,0,0,222,48,35,5,339,0,0,0,427,649
IT-OR,Oristano,91,16,107,5,47,0,0,0,175,61,28,0,264,0,0,0,353,528
IT-OR,Oristano,92,9,65,1,51,0,0,0,126,36,30,1,217,0,0,0,284,410
IT-OR,Oristano,93,14,39,1,40,0,0,0,94,46,13,5,168,0,0,0,232,326
IT-OR,Oristano,94,5,35,0,36,0,0,0,76,28,8,0,150,0,0,0,186,262
IT-OR,Oristano,95,3,20,0,22,0,0,0,45,26,7,1,115,0,0,0,149,194
IT-OR,Oristano,96,4,12,0,17,0,0,0,33,15,5,0,86,0,0,0,106,139
IT-OR,Oristano,97,2,10,0,13,0,0,0,25,9,3,0,62,0,0,0,74,99
IT-OR,Oristano,98,1,4,0,6,0,0,0,11,10,0,2,41,0,0,0,53,64
IT-OR,Oristano,99,1,2,0,9,0,0,0,12,9,1,0,31,0,0,0,41,53
IT-OR,Oristano,100,2,2,0,6,0,0,0,10,8,2,0,40,0,0,0,50,60
IT-OR,Oristano,999,36505,32982,1831,2128,15,4,0,73465,30149,32964,2209,10285,16,3,0,75626,149091
IT-PD,Padova,0,2947,0,0,0,0,0,0,2947,2722,0,0,0,0,0,0,2722,5669
IT-PD,Padova,1,3165,0,0,0,0,0,0,3165,2917,0,0,0,0,0,0,2917,6082
IT-PD,Padova,2,3227,0,0,0,0,0,0,3227,3095,0,0,0,0,0,0,3095,6322
IT-PD,Padova,3,3264,0,0,0,0,0,0,3264,2903,0,0,0,0,0,0,2903,6167
IT-PD,Padova,4,3353,0,0,0,0,0,0,3353,3199,0,0,0,0,0,0,3199,6552
IT-PD,Padova,5,3491,0,0,0,0,0,0,3491,3410,0,0,0,0,0,0,3410,6901
IT-PD,Padova,6,3663,0,0,0,0,0,0,3663,3520,0,0,0,0,0,0,3520,7183
IT-PD,Padova,7,3806,0,0,0,0,0,0,3806,3586,0,0,0,0,0,0,3586,7392
IT-PD,Padova,8,3901,0,0,0,0,0,0,3901,3721,0,0,0,0,0,0,3721,7622
IT-PD,Padova,9,4031,0,0,0,0,0,0,4031,3927,0,0,0,0,0,0,3927,7958
IT-PD,Padova,10,4345,0,0,0,0,0,0,4345,3966,0,0,0,0,0,0,3966,8311
IT-PD,Padova,11,4377,0,0,0,0,0,0,4377,4147,0,0,0,0,0,0,4147,8524
IT-PD,Padova,12,4410,0,0,0,0,0,0,4410,4184,0,0,0,0,0,0,4184,8594
IT-PD,Padova,13,4527,0,0,0,0,0,0,4527,4340,0,0,0,0,0,0,4340,8867
IT-PD,Padova,14,4631,0,0,0,0,0,0,4631,4441,0,0,0,0,0,0,4441,9072
IT-PD,Padova,15,4736,0,0,0,0,0,0,4736,4386,0,0,0,0,0,0,4386,9122
IT-PD,Padova,16,4612,0,0,0,0,0,0,4612,4408,0,0,0,0,0,0,4408,9020
IT-PD,Padova,17,4644,0,0,0,0,0,0,4644,4418,0,0,0,0,0,0,4418,9062
IT-PD,Padova,18,4668,0,0,0,0,0,0,4668,4241,2,0,0,0,0,0,4243,8911
IT-PD,Padova,19,4739,0,0,0,0,0,0,4739,4339,12,0,0,1,0,0,4352,9091
IT-PD,Padova,20,4734,3,1,1,0,0,0,4739,4260,36,0,0,0,0,0,4296,9035
IT-PD,Padova,21,4554,2,0,0,1,0,0,4557,4097,45,0,0,0,0,0,4142,8699
IT-PD,Padova,22,4638,14,4,0,0,0,0,4656,4221,86,2,0,2,0,0,4311,8967
IT-PD,Padova,23,4860,24,0,0,0,0,0,4884,4338,133,1,0,0,0,0,4472,9356
IT-PD,Padova,24,4914,52,3,0,2,0,0,4971,4295,219,11,0,0,0,0,4525,9496
IT-PD,Padova,25,4905,80,2,0,0,0,0,4987,4264,282,7,0,1,0,0,4554,9541
IT-PD,Padova,26,4902,112,2,0,0,0,0,5016,4165,420,4,1,2,0,0,4592,9608
IT-PD,Padova,27,4755,185,5,0,0,0,0,4945,4097,506,6,1,2,0,0,4612,9557
IT-PD,Padova,28,4633,314,6,0,6,0,0,4959,3852,661,15,2,5,1,0,4536,9495
IT-PD,Padova,29,4537,414,10,0,0,0,0,4961,3641,873,18,2,3,1,0,4538,9499
IT-PD,Padova,30,4303,606,9,0,8,0,0,4926,3502,1120,29,0,5,0,0,4656,9582
IT-PD,Padova,31,4397,739,21,0,3,0,0,5160,3441,1411,32,5,6,0,0,4895,10055
IT-PD,Padova,32,4161,971,19,4,5,0,0,5160,3215,1598,39,7,4,0,0,4863,10023
IT-PD,Padova,33,3888,1239,28,2,6,2,0,5165,3004,1875,60,13,8,0,0,4960,10125
IT-PD,Padova,34,3625,1387,27,4,6,0,0,5049,2784,2090,73,3,7,0,0,4957,10006
IT-PD,Padova,35,3514,1609,47,5,10,0,0,5185,2691,2393,100,10,9,0,0,5203,10388
IT-PD,Padova,36,3215,1799,40,6,8,1,0,5069,2291,2426,91,7,25,0,0,4840,9909
IT-PD,Padova,37,2958,1998,74,4,13,0,0,5047,2204,2648,151,22,8,1,0,5034,10081
IT-PD,Padova,38,3016,2196,73,6,9,0,0,5300,2224,2863,176,17,16,0,0,5296,10596
IT-PD,Padova,39,2832,2319,84,5,8,0,0,5248,2164,3016,184,21,4,0,0,5389,10637
IT-PD,Padova,40,2774,2586,121,5,13,0,0,5499,2054,3081,202,28,7,0,0,5372,10871
IT-PD,Padova,41,2571,2724,115,6,6,0,0,5422,1951,3293,270,41,6,0,0,5561,10983
IT-PD,Padova,42,2572,2787,153,23,6,1,0,5542,1869,3386,272,42,8,0,0,5577,11119
IT-PD,Padova,43,2666,3071,210,13,2,2,0,5964,1827,3604,322,61,10,0,1,5825,11789
IT-PD,Padova,44,2603,3229,244,15,10,1,0,6102,1926,3769,353,52,5,0,0,6105,12207
IT-PD,Padova,45,2675,3360,246,25,13,0,1,6320,1900,3988,398,51,4,0,0,6341,12661
IT-PD,Padova,46,2622,3631,278,15,9,0,0,6555,1926,4315,473,84,5,0,0,6803,13358
IT-PD,Padova,47,2743,3990,337,15,8,0,0,7093,1829,4492,544,93,7,0,0,6965,14058
IT-PD,Padova,48,2744,4223,393,17,11,1,0,7389,1833,4621,552,123,4,0,0,7133,14522
IT-PD,Padova,49,2625,4526,426,28,8,0,0,7613,1875,5060,602,135,4,0,0,7676,15289
IT-PD,Padova,50,2538,4657,467,32,8,0,0,7702,1759,5049,649,134,6,0,0,7597,15299
IT-PD,Padova,51,2495,4765,463,47,8,0,0,7778,1700,5085,696,129,3,0,0,7613,15391
IT-PD,Padova,52,2285,4881,528,34,11,1,0,7740,1686,5283,605,180,8,1,0,7763,15503
IT-PD,Padova,53,2249,5064,529,53,8,0,0,7903,1554,5341,775,185,5,0,0,7860,15763
IT-PD,Padova,54,2098,5287,587,55,15,1,0,8043,1426,5571,754,230,5,0,0,7986,16029
IT-PD,Padova,55,1850,5427,576,54,10,0,0,7917,1401,5616,788,265,1,0,0,8071,15988
IT-PD,Padova,56,1893,5380,600,54,13,0,2,7942,1337,5673,774,238,2,2,0,8026,15968
IT-PD,Padova,57,1710,5465,637,70,10,0,0,7892,1245,5814,735,285,5,0,0,8084,15976
IT-PD,Padova,58,1541,5656,660,105,15,0,0,7977,1160,5841,792,349,5,0,0,8147,16124
IT-PD,Padova,59,1451,5764,626,101,9,0,0,7951,1173,5961,790,403,2,0,0,8329,16280
IT-PD,Padova,60,1245,5612,647,100,7,0,0,7611,1010,5551,666,374,2,0,0,7603,15214
IT-PD,Padova,61,1108,5429,535,106,9,0,0,7187,942,5434,625,463,2,0,0,7466,14653
IT-PD,Padova,62,1044,5177,509,122,13,0,0,6865,859,5211,668,475,3,0,0,7216,14081
IT-PD,Padova,63,843,4964,417,119,10,0,0,6353,738,4910,577,551,1,0,0,6777,13130
IT-PD,Padova,64,814,4978,445,145,4,0,0,6386,735,4833,534,571,2,0,0,6675,13061
IT-PD,Padova,65,730,4750,427,132,7,0,0,6046,660,4474,457,684,1,0,0,6276,12322
IT-PD,Padova,66,663,4687,360,177,5,0,0,5892,579,4277,452,710,0,1,0,6019,11911
IT-PD,Padova,67,582,4501,355,172,1,0,1,5612,542,4365,436,795,0,0,0,6138,11750
IT-PD,Padova,68,509,4208,305,174,2,0,0,5198,527,4008,374,829,0,0,0,5738,10936
IT-PD,Padova,69,529,4184,280,207,10,0,0,5210,438,3909,346,870,0,0,0,5563,10773
IT-PD,Padova,70,443,3968,216,218,3,0,0,4848,389,3770,347,918,0,0,0,5424,10272
IT-PD,Padova,71,431,3873,241,223,9,0,0,4777,360,3764,279,1033,0,0,0,5436,10213
IT-PD,Padova,72,396,3887,223,256,7,0,1,4770,333,3494,288,1107,1,0,0,5223,9993
IT-PD,Padova,73,376,3843,184,266,2,0,0,4671,333,3631,251,1233,0,0,0,5448,10119
IT-PD,Padova,74,330,3931,189,287,6,0,1,4744,333,3339,189,1404,0,0,0,5265,10009
IT-PD,Padova,75,348,3781,159,331,5,0,0,4624,315,3305,246,1503,0,0,0,5369,9993
IT-PD,Padova,76,306,3628,142,340,3,0,0,4419,302,2978,194,1588,0,0,0,5062,9481
IT-PD,Padova,77,318,3734,138,431,2,0,0,4623,300,3059,187,1848,0,0,0,5394,10017
IT-PD,Padova,78,195,2561,95,342,0,0,0,3193,250,2103,144,1488,1,0,0,3986,7179
IT-PD,Padova,79,218,2861,84,371,1,0,0,3535,252,2145,123,1752,0,0,0,4272,7807
IT-PD,Padova,80,225,2761,56,441,0,0,0,3483,253,2036,125,1950,0,0,0,4364,7847
IT-PD,Padova,81,208,2510,67,440,2,0,1,3228,266,1770,130,1975,0,0,0,4141,7369
IT-PD,Padova,82,216,2352,43,419,1,0,0,3031,250,1572,87,2159,0,0,0,4068,7099
IT-PD,Padova,83,201,2273,61,486,1,0,0,3022,243,1445,92,2427,0,0,0,4207,7229
IT-PD,Padova,84,160,2156,41,464,0,0,1,2822,233,1223,70,2279,0,0,0,3805,6627
IT-PD,Padova,85,134,1762,25,462,0,0,0,2383,260,961,75,2412,0,0,0,3708,6091
IT-PD,Padova,86,114,1426,37,416,1,0,0,1994,202,729,49,2130,0,0,0,3110,5104
IT-PD,Padova,87,112,1101,33,393,1,0,0,1640,191,499,43,2051,0,0,0,2784,4424
IT-PD,Padova,88,72,1003,6,399,0,0,0,1480,159,430,30,2088,0,0,0,2707,4187
IT-PD,Padova,89,53,850,8,337,0,0,0,1248,156,284,33,1911,0,0,0,2384,3632
IT-PD,Padova,90,47,595,8,295,0,0,0,945,146,191,21,1512,0,0,0,1870,2815
IT-PD,Padova,91,43,431,3,283,0,0,0,760,120,139,21,1378,0,0,0,1658,2418
IT-PD,Padova,92,24,288,2,213,0,0,0,527,121,101,8,1181,0,0,0,1411,1938
IT-PD,Padova,93,24,221,3,197,0,0,0,445,99,54,9,1000,0,0,0,1162,1607
IT-PD,Padova,94,12,160,4,118,0,0,0,294,66,34,9,773,0,0,0,882,1176
IT-PD,Padova,95,10,99,2,104,0,0,0,215,53,16,1,628,0,0,0,698,913
IT-PD,Padova,96,5,75,1,71,0,0,0,152,53,10,2,474,0,0,0,539,691
IT-PD,Padova,97,5,41,2,47,0,0,0,95,32,7,2,337,0,0,0,378,473
IT-PD,Padova,98,3,14,0,30,0,0,0,47,29,6,2,250,0,0,0,287,334
IT-PD,Padova,99,1,13,0,19,0,0,0,33,12,0,0,144,0,0,0,156,189
IT-PD,Padova,100,2,10,0,31,0,0,0,43,28,4,1,199,0,0,0,232,275
IT-PD,Padova,999,223682,207234,15004,10988,390,10,8,457316,191220,209629,20538,52673,223,7,1,474291,931607
IT-PA,Palermo,0,4732,0,0,0,0,0,0,4732,4616,0,0,0,0,0,0,4616,9348
IT-PA,Palermo,1,5136,0,0,0,0,0,0,5136,4639,0,0,0,0,0,0,4639,9775
IT-PA,Palermo,2,4948,0,0,0,0,0,0,4948,4752,0,0,0,0,0,0,4752,9700
IT-PA,Palermo,3,5205,0,0,0,0,0,0,5205,4845,0,0,0,0,0,0,4845,10050
IT-PA,Palermo,4,5311,0,0,0,0,0,0,5311,5102,0,0,0,0,0,0,5102,10413
IT-PA,Palermo,5,5529,0,0,0,0,0,0,5529,5178,0,0,0,0,0,0,5178,10707
IT-PA,Palermo,6,5603,0,0,0,0,0,0,5603,5295,0,0,0,0,0,0,5295,10898
IT-PA,Palermo,7,5492,0,0,0,0,0,0,5492,5223,0,0,0,0,0,0,5223,10715
IT-PA,Palermo,8,5749,0,0,0,0,0,0,5749,5542,0,0,0,0,0,0,5542,11291
IT-PA,Palermo,9,5986,0,0,0,0,0,0,5986,5625,0,0,0,0,0,0,5625,11611
IT-PA,Palermo,10,5808,0,0,0,0,0,0,5808,5486,0,0,0,0,0,0,5486,11294
IT-PA,Palermo,11,6107,0,0,0,0,0,0,6107,5844,0,0,0,0,0,0,5844,11951
IT-PA,Palermo,12,6136,0,0,0,0,0,0,6136,5806,0,0,0,0,0,0,5806,11942
IT-PA,Palermo,13,6287,0,0,0,0,0,0,6287,6044,0,0,0,0,0,0,6044,12331
IT-PA,Palermo,14,6474,0,0,0,0,0,0,6474,6157,0,0,0,0,0,0,6157,12631
IT-PA,Palermo,15,6524,0,0,0,0,0,0,6524,6134,0,0,0,0,0,0,6134,12658
IT-PA,Palermo,16,6466,0,1,0,0,0,0,6467,6217,0,1,0,0,0,0,6218,12685
IT-PA,Palermo,17,6632,0,0,0,0,0,0,6632,6210,0,0,0,0,0,0,6210,12842
IT-PA,Palermo,18,6772,2,0,0,0,0,0,6774,6410,5,0,0,0,0,0,6415,13189
IT-PA,Palermo,19,6977,1,0,0,0,0,0,6978,6426,33,0,0,0,0,0,6459,13437
IT-PA,Palermo,20,6510,8,1,0,0,0,0,6519,6118,53,0,0,0,0,0,6171,12690
IT-PA,Palermo,21,6505,24,0,0,0,0,0,6529,6118,94,0,0,0,0,0,6212,12741
IT-PA,Palermo,22,6517,37,1,0,0,0,0,6555,5963,163,1,0,1,0,0,6128,12683
IT-PA,Palermo,23,6477,75,4,0,0,0,0,6556,5814,270,1,0,0,0,0,6085,12641
IT-PA,Palermo,24,6432,131,1,0,1,0,0,6565,5707,419,3,0,2,0,0,6131,12696
IT-PA,Palermo,25,6125,206,1,0,0,0,0,6332,5360,638,5,1,2,0,0,6006,12338
IT-PA,Palermo,26,6046,364,0,0,1,0,0,6411,5238,927,5,0,2,0,0,6172,12583
IT-PA,Palermo,27,5711,509,3,0,2,0,0,6225,5031,1223,6,0,1,0,0,6261,12486
IT-PA,Palermo,28,5453,769,3,0,0,0,0,6225,4568,1548,11,2,3,0,0,6132,12357
IT-PA,Palermo,29,5344,1018,5,1,4,0,0,6372,4281,2061,18,2,3,2,0,6367,12739
IT-PA,Palermo,30,5108,1409,11,0,6,0,0,6534,4056,2466,36,4,4,1,0,6567,13101
IT-PA,Palermo,31,5052,1855,16,3,4,0,0,6930,4000,3015,29,6,4,0,0,7054,13984
IT-PA,Palermo,32,4536,2246,24,2,7,2,0,6817,3328,3360,56,7,6,1,0,6758,13575
IT-PA,Palermo,33,4315,2534,29,1,7,0,0,6886,3120,3652,71,5,2,0,0,6850,13736
IT-PA,Palermo,34,4030,2954,33,1,6,0,0,7024,2802,4054,78,12,9,0,0,6955,13979
IT-PA,Palermo,35,3742,3283,43,5,7,0,0,7080,2632,4309,92,14,9,0,0,7056,14136
IT-PA,Palermo,36,3304,3483,62,2,4,1,0,6856,2394,4398,132,26,12,0,0,6962,13818
IT-PA,Palermo,37,3036,3748,71,6,5,1,0,6867,2221,4632,159,22,8,0,0,7042,13909
IT-PA,Palermo,38,2839,3949,83,4,9,0,0,6884,2129,4881,145,26,7,0,0,7188,14072
IT-PA,Palermo,39,2862,4238,94,5,7,0,0,7206,1988,5149,204,29,5,2,0,7377,14583
IT-PA,Palermo,40,2552,4430,117,15,16,2,0,7132,1813,5345,207,35,9,0,0,7409,14541
IT-PA,Palermo,41,2449,4840,126,9,11,1,0,7436,1762,5544,262,51,8,2,0,7629,15065
IT-PA,Palermo,42,2348,4793,146,9,7,0,0,7303,1703,5647,265,54,12,0,0,7681,14984
IT-PA,Palermo,43,2329,5204,178,14,11,1,0,7737,1618,6100,335,75,5,0,0,8133,15870
IT-PA,Palermo,44,2272,5358,228,22,15,0,0,7895,1582,6233,351,80,9,1,0,8256,16151
IT-PA,Palermo,45,2171,5610,224,32,10,2,0,8049,1529,6356,390,84,6,1,0,8366,16415
IT-PA,Palermo,46,2099,5618,251,25,10,2,0,8005,1514,6504,418,113,10,0,0,8559,16564
IT-PA,Palermo,47,2040,6018,302,28,6,1,0,8395,1509,6782,466,109,3,0,0,8869,17264
IT-PA,Palermo,48,2070,6330,338,32,11,0,0,8781,1531,6891,479,142,7,0,0,9050,17831
IT-PA,Palermo,49,2080,6565,342,36,5,0,0,9028,1458,7157,521,186,5,0,0,9327,18355
IT-PA,Palermo,50,1811,6568,375,50,13,0,0,8817,1363,6946,534,188,5,0,0,9036,17853
IT-PA,Palermo,51,1767,6569,363,42,9,0,0,8750,1333,7112,585,234,4,0,0,9268,18018
IT-PA,Palermo,52,1626,6773,426,69,10,1,1,8906,1381,7194,587,272,6,0,0,9440,18346
IT-PA,Palermo,53,1582,6747,418,63,3,0,0,8813,1292,7113,586,336,3,1,0,9331,18144
IT-PA,Palermo,54,1501,7026,439,91,8,0,0,9065,1258,7385,611,350,6,0,0,9610,18675
IT-PA,Palermo,55,1381,7016,446,90,11,0,0,8944,1333,7204,638,373,3,0,0,9551,18495
IT-PA,Palermo,56,1347,7020,450,115,5,0,0,8937,1232,7192,602,416,3,1,0,9446,18383
IT-PA,Palermo,57,1196,7073,466,111,5,0,1,8852,1215,7278,642,484,3,0,0,9622,18474
IT-PA,Palermo,58,1177,7130,449,116,4,0,0,8876,1176,7219,603,597,1,1,0,9597,18473
IT-PA,Palermo,59,1136,7256,467,159,4,0,0,9022,1095,7362,632,645,0,0,1,9735,18757
IT-PA,Palermo,60,945,6936,429,157,10,0,0,8477,1103,7047,576,655,1,0,0,9382,17859
IT-PA,Palermo,61,873,6903,392,192,5,0,0,8365,1065,6839,537,806,1,0,0,9248,17613
IT-PA,Palermo,62,833,6730,388,190,3,0,0,8144,987,6627,500,764,2,0,0,8880,17024
IT-PA,Palermo,63,761,6580,348,188,5,0,0,7882,988,6520,442,846,4,0,0,8800,16682
IT-PA,Palermo,64,706,6315,331,240,2,0,0,7594,903,6032,453,1047,0,0,0,8435,16029
IT-PA,Palermo,65,701,6165,314,250,4,0,0,7434,815,5816,412,1114,1,0,0,8158,15592
IT-PA,Palermo,66,633,6117,315,251,5,0,0,7321,829,5753,381,1232,1,0,0,8196,15517
IT-PA,Palermo,67,559,6084,291,238,2,1,0,7175,818,5505,347,1271,3,0,0,7944,15119
IT-PA,Palermo,68,516,5793,295,275,1,1,1,6882,736,5205,339,1412,0,0,0,7692,14574
IT-PA,Palermo,69,465,5764,249,316,1,0,0,6795,755,5145,336,1648,0,0,0,7884,14679
IT-PA,Palermo,70,433,5437,212,328,6,0,0,6416,723,4620,296,1498,0,0,0,7137,13553
IT-PA,Palermo,71,390,5278,180,368,1,0,0,6217,673,4609,287,1740,0,0,0,7309,13526
IT-PA,Palermo,72,378,5094,167,383,5,0,0,6027,666,4190,296,1798,0,0,0,6950,12977
IT-PA,Palermo,73,396,5234,174,422,2,0,0,6228,661,4183,283,1988,1,0,0,7116,13344
IT-PA,Palermo,74,320,4922,141,436,0,0,1,5820,618,3948,220,2293,0,0,0,7079,12899
IT-PA,Palermo,75,367,5032,149,497,0,0,0,6045,688,3800,207,2457,0,0,0,7152,13197
IT-PA,Palermo,76,289,4738,125,514,0,0,0,5666,665,3468,220,2569,0,0,0,6922,12588
IT-PA,Palermo,77,243,4245,130,481,1,0,0,5100,565,2970,173,2638,3,0,0,6349,11449
IT-PA,Palermo,78,193,3543,90,493,1,0,1,4321,494,2431,140,2285,0,0,0,5350,9671
IT-PA,Palermo,79,177,3177,72,486,1,0,0,3913,450,2120,128,2496,0,0,0,5194,9107
IT-PA,Palermo,80,149,2716,63,435,0,0,0,3363,410,1749,117,2209,0,0,0,4485,7848
IT-PA,Palermo,81,136,2583,57,524,0,0,0,3300,416,1530,96,2404,0,0,0,4446,7746
IT-PA,Palermo,82,118,2435,38,546,0,0,0,3137,408,1336,89,2482,0,0,0,4315,7452
IT-PA,Palermo,83,127,2316,41,584,0,0,0,3068,427,1312,86,2797,0,0,0,4622,7690
IT-PA,Palermo,84,110,2189,45,559,0,0,0,2903,384,1046,71,2661,1,0,0,4163,7066
IT-PA,Palermo,85,105,1871,43,553,0,0,0,2572,337,904,71,2580,0,0,0,3892,6464
IT-PA,Palermo,86,94,1485,18,477,0,0,0,2074,315,647,55,2364,0,0,0,3381,5455
IT-PA,Palermo,87,63,1258,15,442,0,0,0,1778,276,478,48,2140,0,0,0,2942,4720
IT-PA,Palermo,88,58,984,17,455,0,0,0,1514,231,386,37,2077,0,0,0,2731,4245
IT-PA,Palermo,89,58,777,11,464,1,0,0,1311,215,276,36,1945,0,0,0,2472,3783
IT-PA,Palermo,90,38,708,5,430,0,0,0,1181,205,207,24,1671,0,0,0,2107,3288
IT-PA,Palermo,91,43,472,5,338,0,0,0,858,145,134,26,1362,0,0,0,1667,2525
IT-PA,Palermo,92,25,352,2,286,0,0,0,665,137,109,15,1166,0,0,0,1427,2092
IT-PA,Palermo,93,17,274,1,233,0,0,0,525,118,60,14,1073,0,0,0,1265,1790
IT-PA,Palermo,94,12,171,3,173,0,0,0,359,99,41,4,702,0,0,0,846,1205
IT-PA,Palermo,95,8,99,3,134,0,0,0,244,70,20,8,559,0,0,0,657,901
IT-PA,Palermo,96,4,64,3,95,0,0,0,166,52,9,3,419,0,0,0,483,649
IT-PA,Palermo,97,3,30,0,85,0,0,0,118,50,10,5,302,0,0,0,367,485
IT-PA,Palermo,98,4,20,0,52,0,0,0,76,23,5,4,217,0,0,0,249,325
IT-PA,Palermo,99,2,9,0,45,0,0,0,56,14,3,1,160,0,0,0,178,234
IT-PA,Palermo,100,6,16,0,39,0,0,0,61,32,4,2,219,0,0,0,257,318
IT-PA,Palermo,999,266110,287703,12199,14812,300,16,5,581145,242682,289008,18152,69046,206,13,1,619108,1200253
IT-PR,Parma,0,1676,0,0,0,0,0,0,1676,1526,0,0,0,0,0,0,1526,3202
IT-PR,Parma,1,1669,0,0,0,0,0,0,1669,1567,0,0,0,0,0,0,1567,3236
IT-PR,Parma,2,1782,0,0,0,0,0,0,1782,1633,0,0,0,0,0,0,1633,3415
IT-PR,Parma,3,1752,0,0,0,0,0,0,1752,1661,0,0,0,0,0,0,1661,3413
IT-PR,Parma,4,1855,0,0,0,0,0,0,1855,1743,0,0,0,0,0,0,1743,3598
IT-PR,Parma,5,1899,0,0,0,0,0,0,1899,1724,0,0,0,0,0,0,1724,3623
IT-PR,Parma,6,1955,0,0,0,0,0,0,1955,1807,0,0,0,0,0,0,1807,3762
IT-PR,Parma,7,2009,0,0,0,0,0,0,2009,1917,0,0,0,0,0,0,1917,3926
IT-PR,Parma,8,2072,0,0,0,0,0,0,2072,1917,0,0,0,0,0,0,1917,3989
IT-PR,Parma,9,2075,0,0,0,0,0,0,2075,1972,0,0,0,0,0,0,1972,4047
IT-PR,Parma,10,2150,0,0,0,0,0,0,2150,1920,0,0,0,0,0,0,1920,4070
IT-PR,Parma,11,2126,0,0,0,0,0,0,2126,1990,0,0,0,0,0,0,1990,4116
IT-PR,Parma,12,2139,0,0,0,0,0,0,2139,2054,0,0,0,0,0,0,2054,4193
IT-PR,Parma,13,2278,0,0,0,0,0,0,2278,2122,0,0,0,0,0,0,2122,4400
IT-PR,Parma,14,2258,0,0,0,0,0,0,2258,2183,0,0,0,0,0,0,2183,4441
IT-PR,Parma,15,2280,0,0,0,0,0,0,2280,2053,0,0,0,0,0,0,2053,4333
IT-PR,Parma,16,2337,0,0,0,0,0,0,2337,2071,0,0,0,0,0,0,2071,4408
IT-PR,Parma,17,2190,0,0,0,0,0,0,2190,2021,0,0,0,0,0,0,2021,4211
IT-PR,Parma,18,2242,0,0,0,0,0,0,2242,2058,1,0,0,0,0,0,2059,4301
IT-PR,Parma,19,2198,1,0,0,0,0,0,2199,2004,10,0,0,0,0,0,2014,4213
IT-PR,Parma,20,2226,3,0,0,0,0,0,2229,1904,20,0,0,0,0,0,1924,4153
IT-PR,Parma,21,2183,4,0,0,0,0,0,2187,1938,33,0,0,0,0,0,1971,4158
IT-PR,Parma,22,2230,10,1,0,0,0,0,2241,1969,62,3,0,0,0,0,2034,4275
IT-PR,Parma,23,2391,11,2,0,0,0,0,2404,1967,98,3,0,0,0,0,2068,4472
IT-PR,Parma,24,2286,34,4,0,0,0,0,2324,2096,153,7,0,0,0,0,2256,4580
IT-PR,Parma,25,2436,60,7,0,1,0,0,2504,1964,190,6,0,0,0,0,2160,4664
IT-PR,Parma,26,2501,100,7,0,2,0,0,2610,2023,253,8,1,0,0,0,2285,4895
IT-PR,Parma,27,2411,137,8,0,1,0,0,2557,1859,341,9,1,1,0,0,2211,4768
IT-PR,Parma,28,2390,222,12,0,2,0,0,2626,1862,448,11,1,0,1,0,2323,4949
IT-PR,Parma,29,2268,267,10,0,0,0,0,2545,1763,559,10,0,2,0,0,2334,4879
IT-PR,Parma,30,2248,392,10,0,2,0,0,2652,1711,686,14,2,4,1,0,2418,5070
IT-PR,Parma,31,2291,496,27,0,4,0,0,2818,1706,835,23,4,3,0,0,2571,5389
IT-PR,Parma,32,2168,601,18,2,1,0,0,2790,1603,988,38,2,4,0,0,2635,5425
IT-PR,Parma,33,2050,660,28,3,2,0,0,2743,1575,1139,38,4,4,0,0,2760,5503
IT-PR,Parma,34,1915,862,18,1,1,0,0,2797,1392,1181,57,4,3,1,0,2638,5435
IT-PR,Parma,35,1736,976,40,4,5,1,0,2762,1289,1344,60,9,9,0,0,2711,5473
IT-PR,Parma,36,1528,1084,35,3,3,0,0,2653,1229,1405,70,3,5,0,0,2712,5365
IT-PR,Parma,37,1529,1178,41,5,3,0,0,2756,1087,1480,92,23,4,0,0,2686,5442
IT-PR,Parma,38,1513,1249,39,3,3,0,0,2807,1078,1525,103,9,9,0,0,2724,5531
IT-PR,Parma,39,1410,1372,71,6,1,0,0,2860,992,1579,123,20,5,0,0,2719,5579
IT-PR,Parma,40,1386,1375,72,1,7,0,0,2841,1018,1681,132,25,9,0,0,2865,5706
IT-PR,Parma,41,1324,1552,84,3,3,0,0,2966,1003,1745,140,20,3,0,0,2911,5877
IT-PR,Parma,42,1177,1590,96,9,5,0,0,2877,948,1701,147,27,7,0,0,2830,5707
IT-PR,Parma,43,1234,1633,105,11,6,0,0,2989,900,1761,178,27,4,1,0,2871,5860
IT-PR,Parma,44,1266,1668,135,17,3,0,1,3090,920,1886,205,35,8,0,0,3054,6144
IT-PR,Parma,45,1345,1719,137,20,7,0,0,3228,964,1973,185,37,4,1,0,3164,6392
IT-PR,Parma,46,1271,1866,153,11,4,0,0,3305,895,2074,226,48,5,1,0,3249,6554
IT-PR,Parma,47,1286,1985,184,17,5,0,0,3477,918,2137,254,55,2,2,0,3368,6845
IT-PR,Parma,48,1262,2200,205,14,4,0,0,3685,929,2327,291,56,5,0,0,3608,7293
IT-PR,Parma,49,1255,2220,200,16,11,0,0,3702,882,2390,316,75,11,0,0,3674,7376
IT-PR,Parma,50,1157,2261,223,19,4,0,0,3664,966,2325,332,75,6,0,0,3704,7368
IT-PR,Parma,51,1186,2277,234,21,4,0,0,3722,790,2445,383,75,1,0,0,3694,7416
IT-PR,Parma,52,1027,2286,290,26,6,0,0,3635,807,2443,386,100,1,0,0,3737,7372
IT-PR,Parma,53,1046,2384,259,28,11,0,0,3728,740,2381,399,117,2,0,0,3639,7367
IT-PR,Parma,54,973,2458,291,22,3,0,0,3747,717,2485,421,108,4,0,0,3735,7482
IT-PR,Parma,55,1005,2468,288,27,10,0,0,3798,672,2453,442,132,3,0,0,3702,7500
IT-PR,Parma,56,836,2456,325,35,7,0,0,3659,624,2577,416,150,4,0,0,3771,7430
IT-PR,Parma,57,811,2484,352,42,3,0,0,3692,636,2468,416,184,4,0,1,3709,7401
IT-PR,Parma,58,753,2505,331,48,5,0,0,3642,590,2479,392,179,4,0,0,3644,7286
IT-PR,Parma,59,682,2593,344,37,6,0,0,3662,512,2503,420,212,1,0,0,3648,7310
IT-PR,Parma,60,589,2397,305,47,7,0,0,3345,467,2375,392,208,2,0,0,3444,6789
IT-PR,Parma,61,472,2316,298,52,8,0,0,3146,435,2307,373,230,1,0,0,3346,6492
IT-PR,Parma,62,495,2249,282,80,4,0,0,3110,404,2117,320,289,1,0,0,3131,6241
IT-PR,Parma,63,422,2198,273,82,3,0,0,2978,407,2027,303,311,0,0,0,3048,6026
IT-PR,Parma,64,401,2075,242,61,2,0,0,2781,349,2101,243,312,1,0,0,3006,5787
IT-PR,Parma,65,336,1991,219,81,2,0,0,2629,333,1898,277,341,2,0,0,2851,5480
IT-PR,Parma,66,348,1921,197,74,3,0,0,2543,271,1926,235,359,0,0,0,2791,5334
IT-PR,Parma,67,298,1902,171,95,2,0,0,2468,255,1823,261,405,1,0,0,2745,5213
IT-PR,Parma,68,276,1854,177,95,6,0,0,2408,249,1735,229,406,2,0,0,2621,5029
IT-PR,Parma,69,213,1808,134,105,0,0,0,2260,218,1719,202,457,0,0,0,2596,4856
IT-PR,Parma,70,228,1710,139,109,1,0,0,2187,174,1592,192,446,0,0,0,2404,4591
IT-PR,Parma,71,192,1641,120,140,3,0,0,2096,150,1573,146,482,0,0,0,2351,4447
IT-PR,Parma,72,201,1578,121,133,2,0,0,2035,159,1505,152,530,1,0,0,2347,4382
IT-PR,Parma,73,184,1707,112,134,1,0,1,2139,179,1593,150,656,0,0,0,2578,4717
IT-PR,Parma,74,187,1616,118,142,2,0,1,2066,179,1514,130,651,0,0,0,2474,4540
IT-PR,Parma,75,192,1892,93,192,1,0,0,2370,158,1521,130,735,0,0,0,2544,4914
IT-PR,Parma,76,196,1768,94,214,3,0,0,2275,143,1432,128,843,0,0,0,2546,4821
IT-PR,Parma,77,181,1661,69,206,1,0,0,2118,142,1326,133,911,0,0,0,2512,4630
IT-PR,Parma,78,138,1136,56,164,0,0,0,1494,82,999,71,735,0,0,0,1887,3381
IT-PR,Parma,79,135,1269,52,206,0,0,0,1662,125,1002,72,845,0,0,0,2044,3706
IT-PR,Parma,80,134,1128,40,206,0,0,0,1508,101,870,65,915,0,1,0,1952,3460
IT-PR,Parma,81,140,1107,35,208,2,0,0,1492,105,817,67,932,0,0,0,1921,3413
IT-PR,Parma,82,128,1043,52,235,0,0,0,1458,118,783,49,1042,0,0,0,1992,3450
IT-PR,Parma,83,131,1081,42,236,0,0,0,1490,105,730,46,1222,0,0,0,2103,3593
IT-PR,Parma,84,142,971,26,251,0,0,0,1390,110,609,53,1185,0,0,0,1957,3347
IT-PR,Parma,85,96,909,25,263,0,0,0,1293,116,534,48,1193,0,0,0,1891,3184
IT-PR,Parma,86,98,737,21,286,0,0,0,1142,103,378,38,1019,0,0,0,1538,2680
IT-PR,Parma,87,77,533,9,198,0,0,0,817,65,292,26,985,0,0,0,1368,2185
IT-PR,Parma,88,69,491,4,215,0,0,0,779,84,219,18,1016,0,0,0,1337,2116
IT-PR,Parma,89,54,402,9,180,0,0,0,645,69,167,14,930,0,0,0,1180,1825
IT-PR,Parma,90,42,279,5,164,0,0,0,490,54,127,13,789,0,0,0,983,1473
IT-PR,Parma,91,37,240,4,122,0,0,0,403,49,83,11,737,0,0,0,880,1283
IT-PR,Parma,92,28,169,4,110,0,0,0,311,43,57,8,621,0,0,0,729,1040
IT-PR,Parma,93,17,123,1,113,0,0,0,254,36,42,7,517,0,0,0,602,856
IT-PR,Parma,94,9,81,2,81,0,0,0,173,27,18,7,441,0,0,0,493,666
IT-PR,Parma,95,10,50,0,55,0,0,0,115,20,10,2,314,0,0,0,346,461
IT-PR,Parma,96,6,32,1,45,0,0,0,84,26,7,1,255,0,0,0,289,373
IT-PR,Parma,97,11,15,0,20,0,0,0,46,12,8,1,175,0,0,0,196,242
IT-PR,Parma,98,1,11,0,18,0,0,0,30,12,0,2,139,0,0,0,153,183
IT-PR,Parma,99,3,4,0,25,0,0,0,32,8,3,0,96,0,0,0,107,139
IT-PR,Parma,100,2,5,0,23,0,0,0,30,13,3,3,167,0,0,0,186,216
IT-PR,Parma,999,111853,97799,8238,5917,198,1,3,224009,93536,98406,11374,26662,152,9,1,230140,454149
IT-PV,Pavia,0,1711,0,0,0,0,0,0,1711,1580,0,0,0,0,0,0,1580,3291
IT-PV,Pavia,1,1745,0,0,0,0,0,0,1745,1737,0,0,0,0,0,0,1737,3482
IT-PV,Pavia,2,1793,0,0,0,0,0,0,1793,1701,0,0,0,0,0,0,1701,3494
IT-PV,Pavia,3,1828,0,0,0,0,0,0,1828,1767,0,0,0,0,0,0,1767,3595
IT-PV,Pavia,4,1915,0,0,0,0,0,0,1915,1900,0,0,0,0,0,0,1900,3815
IT-PV,Pavia,5,2087,0,0,0,0,0,0,2087,1911,0,0,0,0,0,0,1911,3998
IT-PV,Pavia,6,2132,0,0,0,0,0,0,2132,1939,0,0,0,0,0,0,1939,4071
IT-PV,Pavia,7,2192,0,0,0,0,0,0,2192,2080,0,0,0,0,0,0,2080,4272
IT-PV,Pavia,8,2291,0,0,0,0,0,0,2291,2187,0,0,0,0,0,0,2187,4478
IT-PV,Pavia,9,2321,0,0,0,0,0,0,2321,2080,0,0,0,0,0,0,2080,4401
IT-PV,Pavia,10,2331,0,0,0,0,0,0,2331,2194,0,0,0,0,0,0,2194,4525
IT-PV,Pavia,11,2335,0,0,0,0,0,0,2335,2334,0,0,0,0,0,0,2334,4669
IT-PV,Pavia,12,2409,0,0,0,0,0,0,2409,2298,0,0,0,0,0,0,2298,4707
IT-PV,Pavia,13,2492,0,0,0,0,0,0,2492,2361,0,0,0,0,0,0,2361,4853
IT-PV,Pavia,14,2662,0,0,0,0,0,0,2662,2412,0,0,0,0,0,0,2412,5074
IT-PV,Pavia,15,2560,0,0,0,0,0,0,2560,2529,0,0,0,0,0,0,2529,5089
IT-PV,Pavia,16,2516,0,0,0,0,0,0,2516,2391,0,0,0,0,0,0,2391,4907
IT-PV,Pavia,17,2580,0,0,0,0,0,0,2580,2353,0,0,0,0,0,0,2353,4933
IT-PV,Pavia,18,2611,2,0,0,0,0,0,2613,2370,1,0,0,0,0,0,2371,4984
IT-PV,Pavia,19,2623,0,0,0,0,0,0,2623,2305,9,0,0,0,0,0,2314,4937
IT-PV,Pavia,20,2602,5,0,0,0,0,0,2607,2182,23,0,0,0,0,0,2205,4812
IT-PV,Pavia,21,2510,4,0,1,0,0,0,2515,2305,38,1,0,0,0,0,2344,4859
IT-PV,Pavia,22,2597,8,2,0,0,0,0,2607,2372,62,1,0,0,1,0,2436,5043
IT-PV,Pavia,23,2723,25,3,0,0,0,0,2751,2290,107,1,0,0,0,0,2398,5149
IT-PV,Pavia,24,2665,46,0,0,0,0,0,2711,2303,176,4,0,0,0,0,2483,5194
IT-PV,Pavia,25,2790,76,1,0,1,0,0,2868,2329,200,2,0,1,0,0,2532,5400
IT-PV,Pavia,26,2715,101,2,0,1,0,0,2819,2234,307,5,0,1,0,0,2547,5366
IT-PV,Pavia,27,2695,118,2,0,2,0,0,2817,2122,380,11,1,4,0,0,2518,5335
IT-PV,Pavia,28,2597,194,3,1,2,0,0,2797,2098,433,7,1,2,0,0,2541,5338
IT-PV,Pavia,29,2472,276,5,0,0,0,0,2753,1983,597,19,1,6,0,0,2606,5359
IT-PV,Pavia,30,2428,394,6,1,1,0,0,2830,1941,723,17,1,8,0,0,2690,5520
IT-PV,Pavia,31,2441,472,15,2,4,2,0,2936,1818,885,24,2,5,0,0,2734,5670
IT-PV,Pavia,32,2340,558,19,4,2,0,0,2923,1704,1009,29,6,5,0,0,2753,5676
IT-PV,Pavia,33,2318,789,25,2,5,0,1,3140,1669,1132,52,10,6,0,0,2869,6009
IT-PV,Pavia,34,2096,860,25,3,5,0,0,2989,1479,1265,52,2,8,0,0,2806,5795
IT-PV,Pavia,35,1951,1053,29,3,3,1,0,3040,1389,1433,76,14,9,1,0,2922,5962
IT-PV,Pavia,36,1905,1081,49,6,4,0,0,3045,1287,1539,88,9,3,1,0,2927,5972
IT-PV,Pavia,37,1750,1243,46,2,2,0,0,3043,1200,1570,105,9,5,0,0,2889,5932
IT-PV,Pavia,38,1608,1271,67,3,6,0,0,2955,1192,1663,120,14,8,0,0,2997,5952
IT-PV,Pavia,39,1559,1447,82,1,4,0,0,3093,1140,1704,144,17,3,0,0,3008,6101
IT-PV,Pavia,40,1564,1509,62,3,5,0,0,3143,1113,1859,152,20,8,0,0,3152,6295
IT-PV,Pavia,41,1556,1656,114,7,3,0,0,3336,1057,1892,187,18,4,1,0,3159,6495
IT-PV,Pavia,42,1498,1653,112,6,3,1,0,3273,1082,1944,208,40,3,1,0,3278,6551
IT-PV,Pavia,43,1474,1754,127,8,2,0,0,3365,962,2104,228,25,8,0,0,3327,6692
IT-PV,Pavia,44,1503,1941,151,6,9,0,0,3610,1051,2158,256,43,1,0,0,3509,7119
IT-PV,Pavia,45,1558,2017,201,7,3,0,0,3786,1024,2294,265,44,4,0,0,3631,7417
IT-PV,Pavia,46,1524,2236,219,12,6,1,1,3999,1054,2290,296,45,6,0,0,3691,7690
IT-PV,Pavia,47,1570,2368,228,16,12,0,0,4194,975,2604,354,58,2,0,0,3993,8187
IT-PV,Pavia,48,1616,2381,258,19,10,0,0,4284,1058,2675,396,64,8,0,1,4202,8486
IT-PV,Pavia,49,1523,2696,317,21,5,0,0,4562,1014,2845,448,90,2,0,0,4399,8961
IT-PV,Pavia,50,1435,2698,353,30,8,0,0,4524,1004,2960,460,91,5,0,0,4520,9044
IT-PV,Pavia,51,1425,2751,371,18,5,2,1,4573,882,2961,476,106,9,0,0,4434,9007
IT-PV,Pavia,52,1408,2783,393,25,5,0,0,4614,816,2894,495,103,3,0,0,4311,8925
IT-PV,Pavia,53,1306,2866,342,24,12,0,2,4552,788,2924,493,139,3,0,0,4347,8899
IT-PV,Pavia,54,1147,2972,414,51,7,0,1,4592,784,3085,575,153,3,0,0,4600,9192
IT-PV,Pavia,55,1186,2957,419,42,13,0,0,4617,707,3081,485,181,4,0,0,4458,9075
IT-PV,Pavia,56,1109,3115,456,48,4,0,0,4732,719,3054,571,198,2,0,0,4544,9276
IT-PV,Pavia,57,1077,3179,438,63,8,0,0,4765,693,3192,517,226,1,0,0,4629,9394
IT-PV,Pavia,58,966,3103,485,54,7,0,0,4615,619,3029,518,247,1,0,0,4414,9029
IT-PV,Pavia,59,811,3143,476,65,2,0,0,4497,567,3256,467,262,1,0,0,4553,9050
IT-PV,Pavia,60,802,3007,422,77,6,0,1,4315,521,3090,463,288,1,0,0,4363,8678
IT-PV,Pavia,61,719,3004,385,58,6,0,0,4172,469,2952,437,332,3,0,0,4193,8365
IT-PV,Pavia,62,620,2884,348,85,6,0,0,3943,458,2788,409,384,1,0,0,4040,7983
IT-PV,Pavia,63,554,2696,335,85,6,0,0,3676,449,2734,383,391,0,0,0,3957,7633
IT-PV,Pavia,64,534,2756,331,105,3,0,1,3730,364,2650,346,424,2,0,0,3786,7516
IT-PV,Pavia,65,473,2620,294,112,1,0,0,3500,336,2518,321,458,2,0,1,3636,7136
IT-PV,Pavia,66,405,2597,291,112,1,0,0,3406,364,2465,288,521,1,0,0,3639,7045
IT-PV,Pavia,67,410,2586,275,116,0,0,0,3387,294,2389,278,553,0,0,0,3514,6901
IT-PV,Pavia,68,350,2445,237,137,5,0,0,3174,306,2264,275,587,0,0,0,3432,6606
IT-PV,Pavia,69,328,2292,248,149,1,0,0,3018,255,2219,233,657,1,0,0,3365,6383
IT-PV,Pavia,70,331,2340,205,146,2,0,1,3025,211,2030,231,682,0,0,1,3155,6180
IT-PV,Pavia,71,304,2216,161,173,2,0,0,2856,223,1969,206,706,1,0,0,3105,5961
IT-PV,Pavia,72,267,2260,180,167,4,0,0,2878,187,1973,188,819,0,0,0,3167,6045
IT-PV,Pavia,73,296,2282,169,221,3,0,0,2971,213,2038,192,891,0,0,0,3334,6305
IT-PV,Pavia,74,261,2197,136,210,2,0,0,2806,182,1877,167,982,0,0,0,3208,6014
IT-PV,Pavia,75,263,2233,130,241,3,0,0,2870,208,1893,166,1118,0,0,0,3385,6255
IT-PV,Pavia,76,214,2186,110,257,2,0,0,2769,182,1747,168,1136,0,0,0,3233,6002
IT-PV,Pavia,77,199,1964,103,282,1,0,0,2549,181,1580,150,1256,0,0,0,3167,5716
IT-PV,Pavia,78,142,1383,70,202,0,0,1,1798,122,1048,97,1012,0,0,0,2279,4077
IT-PV,Pavia,79,138,1471,56,229,0,0,1,1895,115,1083,84,1165,0,0,0,2447,4342
IT-PV,Pavia,80,137,1391,60,253,0,0,0,1841,137,969,92,1227,0,0,0,2425,4266
IT-PV,Pavia,81,132,1319,50,270,0,0,0,1771,140,966,73,1241,0,0,0,2420,4191
IT-PV,Pavia,82,120,1227,48,295,0,0,0,1690,120,863,62,1365,0,0,0,2410,4100
IT-PV,Pavia,83,149,1317,50,344,0,0,0,1860,161,801,67,1607,0,0,0,2636,4496
IT-PV,Pavia,84,136,1142,29,340,0,0,0,1647,125,708,50,1559,1,0,0,2443,4090
IT-PV,Pavia,85,112,994,34,344,0,0,0,1484,139,570,60,1636,0,0,0,2405,3889
IT-PV,Pavia,86,81,777,23,308,1,0,0,1190,109,388,38,1507,0,0,0,2042,3232
IT-PV,Pavia,87,81,585,22,274,0,0,0,962,95,300,35,1374,0,0,0,1804,2766
IT-PV,Pavia,88,69,519,17,301,0,0,0,906,90,267,34,1348,0,0,0,1739,2645
IT-PV,Pavia,89,53,416,13,244,0,0,0,726,71,204,17,1238,0,0,0,1530,2256
IT-PV,Pavia,90,35,327,5,205,0,0,0,572,76,132,24,1106,0,0,0,1338,1910
IT-PV,Pavia,91,39,233,7,185,0,0,0,464,79,85,18,991,0,0,0,1173,1637
IT-PV,Pavia,92,25,170,2,148,0,0,0,345,61,76,11,904,0,0,0,1052,1397
IT-PV,Pavia,93,14,122,5,133,1,0,0,275,65,42,7,734,0,0,0,848,1123
IT-PV,Pavia,94,10,77,4,83,0,0,0,174,50,28,6,501,0,0,0,585,759
IT-PV,Pavia,95,12,50,3,65,0,0,0,130,27,22,3,415,0,0,0,467,597
IT-PV,Pavia,96,5,33,0,56,0,0,0,94,31,11,0,295,0,0,0,337,431
IT-PV,Pavia,97,2,17,1,41,0,0,0,61,13,7,4,236,0,0,0,260,321
IT-PV,Pavia,98,0,12,0,16,0,0,0,28,14,4,3,147,0,0,0,168,196
IT-PV,Pavia,99,2,2,0,14,0,0,0,18,13,3,2,128,0,0,0,146,164
IT-PV,Pavia,100,2,4,0,25,0,0,0,31,11,3,0,175,0,0,0,189,220
IT-PV,Pavia,999,127978,117954,11176,7662,227,7,11,265015,104702,118113,14293,36336,165,5,3,273617,538632
IT-PG,Perugia,0,1886,0,0,0,0,0,0,1886,1771,0,0,0,0,0,0,1771,3657
IT-PG,Perugia,1,1973,0,0,0,0,0,0,1973,1855,0,0,0,0,0,0,1855,3828
IT-PG,Perugia,2,2067,0,0,0,0,0,0,2067,2016,0,0,0,0,0,0,2016,4083
IT-PG,Perugia,3,2120,0,0,0,0,0,0,2120,1979,0,0,0,0,0,0,1979,4099
IT-PG,Perugia,4,2221,0,0,0,0,0,0,2221,2185,0,0,0,0,0,0,2185,4406
IT-PG,Perugia,5,2397,0,0,0,0,0,0,2397,2149,0,0,0,0,0,0,2149,4546
IT-PG,Perugia,6,2466,0,0,0,0,0,0,2466,2316,0,0,0,0,0,0,2316,4782
IT-PG,Perugia,7,2601,0,0,0,0,0,0,2601,2463,0,0,0,0,0,0,2463,5064
IT-PG,Perugia,8,2638,0,0,0,0,0,0,2638,2477,0,0,0,0,0,0,2477,5115
IT-PG,Perugia,9,2734,0,0,0,0,0,0,2734,2656,0,0,0,0,0,0,2656,5390
IT-PG,Perugia,10,2867,0,0,0,0,0,0,2867,2689,0,0,0,0,0,0,2689,5556
IT-PG,Perugia,11,2912,0,0,0,0,0,0,2912,2918,0,0,0,0,0,0,2918,5830
IT-PG,Perugia,12,3005,0,0,0,0,0,0,3005,2881,0,0,0,0,0,0,2881,5886
IT-PG,Perugia,13,3078,0,0,0,0,0,0,3078,2859,0,0,0,0,0,0,2859,5937
IT-PG,Perugia,14,3143,0,0,0,0,0,0,3143,2870,0,0,0,0,0,0,2870,6013
IT-PG,Perugia,15,3160,0,0,0,0,0,0,3160,3149,0,0,0,0,0,0,3149,6309
IT-PG,Perugia,16,3210,0,0,0,0,0,0,3210,2958,0,0,0,0,0,0,2958,6168
IT-PG,Perugia,17,3198,0,0,0,0,0,0,3198,2959,0,0,0,0,0,0,2959,6157
IT-PG,Perugia,18,3194,0,0,0,0,0,0,3194,2985,1,0,0,0,0,0,2986,6180
IT-PG,Perugia,19,3111,1,0,0,0,0,0,3112,2928,5,0,0,0,0,0,2933,6045
IT-PG,Perugia,20,3211,2,1,0,0,0,0,3214,2799,20,0,0,0,0,0,2819,6033
IT-PG,Perugia,21,3044,7,0,0,0,0,0,3051,2847,39,1,0,0,0,0,2887,5938
IT-PG,Perugia,22,3170,10,0,0,0,0,0,3180,2817,57,0,0,0,0,0,2874,6054
IT-PG,Perugia,23,3105,20,1,0,0,0,0,3126,2840,88,0,0,0,0,0,2928,6054
IT-PG,Perugia,24,3247,37,4,0,1,0,0,3289,2604,131,2,0,0,0,0,2737,6026
IT-PG,Perugia,25,3171,68,3,0,0,0,0,3242,2657,187,4,0,0,0,0,2848,6090
IT-PG,Perugia,26,3073,92,3,0,3,0,0,3171,2624,262,1,0,0,0,0,2887,6058
IT-PG,Perugia,27,3061,127,1,0,1,0,0,3190,2516,342,11,0,2,0,0,2871,6061
IT-PG,Perugia,28,2955,212,4,0,3,0,0,3174,2482,417,7,0,1,0,0,2907,6081
IT-PG,Perugia,29,2819,235,1,1,1,0,0,3057,2300,560,7,0,1,0,0,2868,5925
IT-PG,Perugia,30,2932,364,6,1,1,0,0,3304,2266,703,11,2,2,0,0,2984,6288
IT-PG,Perugia,31,2886,487,8,0,3,0,0,3384,2202,909,25,1,6,1,0,3144,6528
IT-PG,Perugia,32,2690,598,13,0,6,0,0,3307,2034,1032,30,7,1,0,0,3104,6411
IT-PG,Perugia,33,2625,694,16,1,3,1,0,3340,2034,1189,37,5,5,0,1,3271,6611
IT-PG,Perugia,34,2493,940,20,2,4,0,0,3459,1906,1345,57,7,1,0,0,3316,6775
IT-PG,Perugia,35,2388,1084,33,1,7,0,0,3513,1938,1562,68,8,7,0,0,3583,7096
IT-PG,Perugia,36,2201,1107,47,1,5,0,0,3361,1646,1662,71,11,3,0,0,3393,6754
IT-PG,Perugia,37,2039,1294,60,2,6,0,0,3401,1638,1744,112,11,2,0,0,3507,6908
IT-PG,Perugia,38,2064,1371,65,1,6,0,1,3508,1587,1927,124,15,2,0,0,3655,7163
IT-PG,Perugia,39,1930,1583,69,1,6,0,1,3590,1546,2048,136,19,4,0,0,3753,7343
IT-PG,Perugia,40,2007,1857,75,8,6,1,0,3954,1482,2316,182,18,5,0,0,4003,7957
IT-PG,Perugia,41,1879,1859,97,5,5,0,0,3845,1419,2193,170,27,6,0,0,3815,7660
IT-PG,Perugia,42,1756,1985,123,7,7,0,0,3878,1364,2454,211,28,11,0,0,4068,7946
IT-PG,Perugia,43,1710,2142,121,8,5,0,0,3986,1290,2515,242,40,3,0,0,4090,8076
IT-PG,Perugia,44,1712,2279,161,7,7,0,0,4166,1200,2682,261,51,5,0,0,4199,8365
IT-PG,Perugia,45,1690,2412,181,12,6,0,0,4301,1312,2797,287,47,4,0,0,4447,8748
IT-PG,Perugia,46,1607,2682,183,10,5,0,0,4487,1254,2976,331,53,4,0,0,4618,9105
IT-PG,Perugia,47,1648,2665,225,14,4,0,0,4556,1219,3219,331,69,6,0,0,4844,9400
IT-PG,Perugia,48,1616,2849,263,16,5,0,0,4749,1231,3313,384,82,3,1,0,5014,9763
IT-PG,Perugia,49,1599,3158,274,12,8,0,0,5051,1172,3522,376,99,3,0,0,5172,10223
IT-PG,Perugia,50,1489,3169,268,25,5,1,0,4957,1026,3518,407,108,2,0,0,5061,10018
IT-PG,Perugia,51,1346,3154,323,28,8,0,0,4859,1041,3528,432,103,3,0,0,5107,9966
IT-PG,Perugia,52,1285,3286,308,25,9,0,0,4913,967,3623,437,135,3,0,0,5165,10078
IT-PG,Perugia,53,1169,3373,345,26,6,0,0,4919,866,3556,448,165,2,0,0,5037,9956
IT-PG,Perugia,54,1104,3398,337,35,2,0,0,4876,852,3749,468,147,1,0,0,5217,10093
IT-PG,Perugia,55,1026,3386,351,40,5,0,0,4808,842,3720,515,234,0,0,0,5311,10119
IT-PG,Perugia,56,957,3428,378,41,5,0,0,4809,811,3749,466,197,3,0,0,5226,10035
IT-PG,Perugia,57,968,3537,360,47,11,0,0,4923,729,3712,454,221,2,0,0,5118,10041
IT-PG,Perugia,58,910,3731,342,75,6,0,0,5064,706,3858,462,283,4,0,0,5313,10377
IT-PG,Perugia,59,831,3816,421,70,3,0,0,5141,649,3879,521,308,2,1,0,5360,10501
IT-PG,Perugia,60,712,3371,358,75,13,0,0,4529,624,3784,448,307,0,0,0,5163,9692
IT-PG,Perugia,61,674,3447,341,63,5,0,1,4531,507,3718,423,338,1,0,0,4987,9518
IT-PG,Perugia,62,610,3581,334,97,1,0,0,4623,500,3597,389,404,0,0,0,4890,9513
IT-PG,Perugia,63,570,3529,319,97,3,0,0,4518,478,3586,403,414,0,0,0,4881,9399
IT-PG,Perugia,64,504,3425,297,104,5,0,0,4335,471,3359,344,456,1,0,0,4631,8966
IT-PG,Perugia,65,481,3169,215,96,7,0,0,3968,402,3146,317,455,1,0,0,4321,8289
IT-PG,Perugia,66,446,3107,230,115,1,0,0,3899,375,3066,274,564,1,0,0,4280,8179
IT-PG,Perugia,67,375,3210,223,138,4,0,0,3950,359,3047,265,564,0,0,0,4235,8185
IT-PG,Perugia,68,382,3070,198,148,1,0,0,3799,298,3012,261,569,0,0,0,4140,7939
IT-PG,Perugia,69,317,3016,208,130,0,0,0,3671,302,2920,225,687,1,0,0,4135,7806
IT-PG,Perugia,70,338,2988,149,167,3,0,0,3645,280,2751,214,753,1,0,0,3999,7644
IT-PG,Perugia,71,268,2782,128,149,3,0,0,3330,257,2518,186,754,0,0,0,3715,7045
IT-PG,Perugia,72,278,2868,143,175,2,0,1,3467,233,2654,190,837,0,0,0,3914,7381
IT-PG,Perugia,73,250,2938,142,220,4,0,0,3554,251,2576,167,925,0,0,0,3919,7473
IT-PG,Perugia,74,223,2975,129,240,2,0,0,3569,228,2593,187,1048,0,0,0,4056,7625
IT-PG,Perugia,75,242,3108,106,262,2,0,0,3720,227,2626,145,1219,1,0,0,4218,7938
IT-PG,Perugia,76,252,2761,85,258,1,0,0,3357,215,2284,132,1240,0,0,0,3871,7228
IT-PG,Perugia,77,214,2529,90,286,1,0,0,3120,176,2120,117,1318,0,0,0,3731,6851
IT-PG,Perugia,78,170,2035,52,223,0,0,0,2480,152,1559,87,1146,0,0,0,2944,5424
IT-PG,Perugia,79,178,2025,59,269,1,0,0,2532,165,1572,75,1374,0,0,0,3186,5718
IT-PG,Perugia,80,169,2073,45,313,1,0,0,2601,151,1466,75,1515,0,0,0,3207,5808
IT-PG,Perugia,81,156,1741,53,283,0,0,0,2233,128,1246,63,1432,1,0,0,2870,5103
IT-PG,Perugia,82,151,1735,43,331,0,0,0,2260,140,1105,60,1556,0,0,0,2861,5121
IT-PG,Perugia,83,150,1809,50,350,0,0,0,2359,148,1095,68,1832,0,0,0,3143,5502
IT-PG,Perugia,84,126,1586,28,357,0,0,0,2097,155,1023,56,1886,0,0,0,3120,5217
IT-PG,Perugia,85,130,1519,40,402,1,0,0,2092,124,860,42,1937,0,0,0,2963,5055
IT-PG,Perugia,86,90,1157,18,335,1,0,0,1601,98,592,47,1827,0,0,0,2564,4165
IT-PG,Perugia,87,79,966,13,322,0,0,0,1380,107,458,29,1725,0,0,0,2319,3699
IT-PG,Perugia,88,70,852,15,308,0,0,0,1245,97,354,20,1616,0,0,0,2087,3332
IT-PG,Perugia,89,74,718,14,292,0,0,0,1098,97,248,9,1616,0,0,0,1970,3068
IT-PG,Perugia,90,50,569,7,276,0,0,0,902,74,176,17,1351,0,0,0,1618,2520
IT-PG,Perugia,91,34,397,4,224,0,0,0,659,64,129,12,1208,0,0,0,1413,2072
IT-PG,Perugia,92,28,309,5,228,0,0,0,570,57,79,9,1092,0,0,0,1237,1807
IT-PG,Perugia,93,24,246,1,189,1,0,0,461,36,63,8,944,0,0,0,1051,1512
IT-PG,Perugia,94,15,148,1,130,0,0,0,294,36,27,8,711,0,0,0,782,1076
IT-PG,Perugia,95,11,99,0,90,0,0,0,200,29,19,7,543,0,0,0,598,798
IT-PG,Perugia,96,11,63,1,73,0,0,0,148,27,22,2,455,0,0,0,506,654
IT-PG,Perugia,97,1,34,1,53,0,0,0,89,17,6,7,316,0,0,0,346,435
IT-PG,Perugia,98,4,20,1,28,0,0,0,53,16,4,2,240,0,0,0,262,315
IT-PG,Perugia,99,5,15,0,33,0,0,0,53,10,1,1,151,0,0,0,163,216
IT-PG,Perugia,100,2,13,0,26,0,0,0,41,18,5,1,194,0,0,0,218,259
IT-PG,Perugia,999,146258,144502,9637,8477,237,3,4,309118,125907,146575,13481,42020,117,3,1,328104,637222
IT-PS,Pesaro e Urbino,0,1040,0,0,0,0,0,0,1040,991,0,0,0,0,0,0,991,2031
IT-PU,Pesaro e Urbino,0,1040,0,0,0,0,0,0,1040,991,0,0,0,0,0,0,991,2031
IT-PS,Pesaro e Urbino,1,1113,0,0,0,0,0,0,1113,1046,0,0,0,0,0,0,1046,2159
IT-PU,Pesaro e Urbino,1,1113,0,0,0,0,0,0,1113,1046,0,0,0,0,0,0,1046,2159
IT-PS,Pesaro e Urbino,2,1151,0,0,0,0,0,0,1151,1130,0,0,0,0,0,0,1130,2281
IT-PU,Pesaro e Urbino,2,1151,0,0,0,0,0,0,1151,1130,0,0,0,0,0,0,1130,2281
IT-PS,Pesaro e Urbino,3,1177,0,0,0,0,0,0,1177,1088,0,0,0,0,0,0,1088,2265
IT-PU,Pesaro e Urbino,3,1177,0,0,0,0,0,0,1177,1088,0,0,0,0,0,0,1088,2265
IT-PS,Pesaro e Urbino,4,1250,0,0,0,0,0,0,1250,1136,0,0,0,0,0,0,1136,2386
IT-PU,Pesaro e Urbino,4,1250,0,0,0,0,0,0,1250,1136,0,0,0,0,0,0,1136,2386
IT-PS,Pesaro e Urbino,5,1230,0,0,0,0,0,0,1230,1233,0,0,0,0,0,0,1233,2463
IT-PU,Pesaro e Urbino,5,1230,0,0,0,0,0,0,1230,1233,0,0,0,0,0,0,1233,2463
IT-PS,Pesaro e Urbino,6,1359,0,0,0,0,0,0,1359,1276,0,0,0,0,0,0,1276,2635
IT-PU,Pesaro e Urbino,6,1359,0,0,0,0,0,0,1359,1276,0,0,0,0,0,0,1276,2635
IT-PS,Pesaro e Urbino,7,1470,0,0,0,0,0,0,1470,1314,0,0,0,0,0,0,1314,2784
IT-PU,Pesaro e Urbino,7,1470,0,0,0,0,0,0,1470,1314,0,0,0,0,0,0,1314,2784
IT-PS,Pesaro e Urbino,8,1452,0,0,0,0,0,0,1452,1453,0,0,0,0,0,0,1453,2905
IT-PU,Pesaro e Urbino,8,1452,0,0,0,0,0,0,1452,1453,0,0,0,0,0,0,1453,2905
IT-PS,Pesaro e Urbino,9,1539,0,0,0,0,0,0,1539,1418,0,0,0,0,0,0,1418,2957
IT-PU,Pesaro e Urbino,9,1539,0,0,0,0,0,0,1539,1418,0,0,0,0,0,0,1418,2957
IT-PS,Pesaro e Urbino,10,1625,0,0,0,0,0,0,1625,1513,0,0,0,0,0,0,1513,3138
IT-PU,Pesaro e Urbino,10,1625,0,0,0,0,0,0,1625,1513,0,0,0,0,0,0,1513,3138
IT-PS,Pesaro e Urbino,11,1624,0,0,0,0,0,0,1624,1503,0,0,0,0,0,0,1503,3127
IT-PU,Pesaro e Urbino,11,1624,0,0,0,0,0,0,1624,1503,0,0,0,0,0,0,1503,3127
IT-PS,Pesaro e Urbino,12,1729,0,0,0,0,0,0,1729,1669,0,0,0,0,0,0,1669,3398
IT-PU,Pesaro e Urbino,12,1729,0,0,0,0,0,0,1729,1669,0,0,0,0,0,0,1669,3398
IT-PS,Pesaro e Urbino,13,1674,0,0,0,0,0,0,1674,1608,0,0,0,0,0,0,1608,3282
IT-PU,Pesaro e Urbino,13,1674,0,0,0,0,0,0,1674,1608,0,0,0,0,0,0,1608,3282
IT-PS,Pesaro e Urbino,14,1688,0,0,0,0,0,0,1688,1681,0,0,0,0,0,0,1681,3369
IT-PU,Pesaro e Urbino,14,1688,0,0,0,0,0,0,1688,1681,0,0,0,0,0,0,1681,3369
IT-PS,Pesaro e Urbino,15,1790,0,0,0,0,0,0,1790,1671,0,0,0,0,0,0,1671,3461
IT-PU,Pesaro e Urbino,15,1790,0,0,0,0,0,0,1790,1671,0,0,0,0,0,0,1671,3461
IT-PS,Pesaro e Urbino,16,1776,0,0,0,0,0,0,1776,1602,0,0,0,0,0,0,1602,3378
IT-PU,Pesaro e Urbino,16,1776,0,0,0,0,0,0,1776,1602,0,0,0,0,0,0,1602,3378
IT-PS,Pesaro e Urbino,17,1807,0,0,0,0,0,0,1807,1631,0,0,0,0,0,0,1631,3438
IT-PU,Pesaro e Urbino,17,1807,0,0,0,0,0,0,1807,1631,0,0,0,0,0,0,1631,3438
IT-PS,Pesaro e Urbino,18,1892,0,0,0,0,0,0,1892,1671,0,0,0,0,0,0,1671,3563
IT-PU,Pesaro e Urbino,18,1892,0,0,0,0,0,0,1892,1671,0,0,0,0,0,0,1671,3563
IT-PS,Pesaro e Urbino,19,1864,0,0,0,0,0,0,1864,1598,5,0,0,0,0,0,1603,3467
IT-PU,Pesaro e Urbino,19,1864,0,0,0,0,0,0,1864,1598,5,0,0,0,0,0,1603,3467
IT-PS,Pesaro e Urbino,20,1772,0,0,0,0,0,0,1772,1686,15,0,0,0,0,0,1701,3473
IT-PU,Pesaro e Urbino,20,1772,0,0,0,0,0,0,1772,1686,15,0,0,0,0,0,1701,3473
IT-PS,Pesaro e Urbino,21,1825,4,0,0,0,0,0,1829,1610,23,1,0,0,0,0,1634,3463
IT-PU,Pesaro e Urbino,21,1825,4,0,0,0,0,0,1829,1610,23,1,0,0,0,0,1634,3463
IT-PS,Pesaro e Urbino,22,1790,6,0,0,0,0,0,1796,1616,28,1,0,0,0,0,1645,3441
IT-PU,Pesaro e Urbino,22,1790,6,0,0,0,0,0,1796,1616,28,1,0,0,0,0,1645,3441
IT-PS,Pesaro e Urbino,23,1950,8,0,0,0,0,0,1958,1616,53,0,0,0,0,0,1669,3627
IT-PU,Pesaro e Urbino,23,1950,8,0,0,0,0,0,1958,1616,53,0,0,0,0,0,1669,3627
IT-PS,Pesaro e Urbino,24,1820,32,1,0,0,0,0,1853,1513,61,2,1,0,0,0,1577,3430
IT-PU,Pesaro e Urbino,24,1820,32,1,0,0,0,0,1853,1513,61,2,1,0,0,0,1577,3430
IT-PS,Pesaro e Urbino,25,1853,32,0,0,0,0,0,1885,1493,109,2,0,0,0,0,1604,3489
IT-PU,Pesaro e Urbino,25,1853,32,0,0,0,0,0,1885,1493,109,2,0,0,0,0,1604,3489
IT-PS,Pesaro e Urbino,26,1759,50,2,0,0,0,0,1811,1409,142,5,0,1,0,0,1557,3368
IT-PU,Pesaro e Urbino,26,1759,50,2,0,0,0,0,1811,1409,142,5,0,1,0,0,1557,3368
IT-PS,Pesaro e Urbino,27,1738,66,5,0,1,0,0,1810,1378,190,5,0,1,0,0,1574,3384
IT-PU,Pesaro e Urbino,27,1738,66,5,0,1,0,0,1810,1378,190,5,0,1,0,0,1574,3384
IT-PS,Pesaro e Urbino,28,1687,117,6,0,0,0,0,1810,1349,236,4,0,2,0,0,1591,3401
IT-PU,Pesaro e Urbino,28,1687,117,6,0,0,0,0,1810,1349,236,4,0,2,0,0,1591,3401
IT-PS,Pesaro e Urbino,29,1603,149,2,0,0,0,0,1754,1271,287,7,0,1,0,0,1566,3320
IT-PU,Pesaro e Urbino,29,1603,149,2,0,0,0,0,1754,1271,287,7,0,1,0,0,1566,3320
IT-PS,Pesaro e Urbino,30,1508,193,4,0,0,0,0,1705,1263,347,6,1,2,0,0,1619,3324
IT-PU,Pesaro e Urbino,30,1508,193,4,0,0,0,0,1705,1263,347,6,1,2,0,0,1619,3324
IT-PS,Pesaro e Urbino,31,1610,233,7,1,0,0,0,1851,1189,468,16,1,1,1,0,1676,3527
IT-PU,Pesaro e Urbino,31,1610,233,7,1,0,0,0,1851,1189,468,16,1,1,1,0,1676,3527
IT-PS,Pesaro e Urbino,32,1517,313,9,0,2,0,0,1841,1103,567,19,1,1,0,0,1691,3532
IT-PU,Pesaro e Urbino,32,1517,313,9,0,2,0,0,1841,1103,567,19,1,1,0,0,1691,3532
IT-PS,Pesaro e Urbino,33,1405,382,8,1,1,0,0,1797,1093,637,27,1,1,0,0,1759,3556
IT-PU,Pesaro e Urbino,33,1405,382,8,1,1,0,0,1797,1093,637,27,1,1,0,0,1759,3556
IT-PS,Pesaro e Urbino,34,1355,482,10,2,1,0,0,1850,1018,747,38,5,2,0,0,1810,3660
IT-PU,Pesaro e Urbino,34,1355,482,10,2,1,0,0,1850,1018,747,38,5,2,0,0,1810,3660
IT-PS,Pesaro e Urbino,35,1350,548,22,0,3,0,0,1923,984,830,45,3,3,0,0,1865,3788
IT-PU,Pesaro e Urbino,35,1350,548,22,0,3,0,0,1923,984,830,45,3,3,0,0,1865,3788
IT-PS,Pesaro e Urbino,36,1297,596,17,2,1,0,0,1913,895,867,50,5,8,1,0,1826,3739
IT-PU,Pesaro e Urbino,36,1297,596,17,2,1,0,0,1913,895,867,50,5,8,1,0,1826,3739
IT-PS,Pesaro e Urbino,37,1158,698,27,3,0,0,0,1886,847,928,60,10,1,0,0,1846,3732
IT-PU,Pesaro e Urbino,37,1158,698,27,3,0,0,0,1886,847,928,60,10,1,0,0,1846,3732
IT-PS,Pesaro e Urbino,38,1117,716,34,1,3,0,0,1871,887,931,69,13,2,0,0,1902,3773
IT-PU,Pesaro e Urbino,38,1117,716,34,1,3,0,0,1871,887,931,69,13,2,0,0,1902,3773
IT-PS,Pesaro e Urbino,39,1057,793,32,1,2,0,0,1885,797,1041,71,8,5,0,0,1922,3807
IT-PU,Pesaro e Urbino,39,1057,793,32,1,2,0,0,1885,797,1041,71,8,5,0,0,1922,3807
IT-PS,Pesaro e Urbino,40,1157,947,55,0,4,0,0,2163,791,1134,85,13,4,1,0,2028,4191
IT-PU,Pesaro e Urbino,40,1157,947,55,0,4,0,0,2163,791,1134,85,13,4,1,0,2028,4191
IT-PS,Pesaro e Urbino,41,1053,988,60,0,2,0,0,2103,831,1209,104,13,1,1,0,2159,4262
IT-PU,Pesaro e Urbino,41,1053,988,60,0,2,0,0,2103,831,1209,104,13,1,1,0,2159,4262
IT-PS,Pesaro e Urbino,42,1036,1033,55,3,2,0,0,2129,740,1276,120,18,1,1,0,2156,4285
IT-PU,Pesaro e Urbino,42,1036,1033,55,3,2,0,0,2129,740,1276,120,18,1,1,0,2156,4285
IT-PS,Pesaro e Urbino,43,1002,1126,60,2,0,0,0,2190,729,1368,135,15,3,0,0,2250,4440
IT-PU,Pesaro e Urbino,43,1002,1126,60,2,0,0,0,2190,729,1368,135,15,3,0,0,2250,4440
IT-PS,Pesaro e Urbino,44,1004,1131,92,8,0,0,0,2235,702,1406,157,31,2,0,0,2298,4533
IT-PU,Pesaro e Urbino,44,1004,1131,92,8,0,0,0,2235,702,1406,157,31,2,0,0,2298,4533
IT-PS,Pesaro e Urbino,45,1107,1345,113,4,2,0,0,2571,733,1552,182,29,2,0,0,2498,5069
IT-PU,Pesaro e Urbino,45,1107,1345,113,4,2,0,0,2571,733,1552,182,29,2,0,0,2498,5069
IT-PS,Pesaro e Urbino,46,1007,1358,124,6,1,1,0,2497,769,1662,202,38,2,0,0,2673,5170
IT-PU,Pesaro e Urbino,46,1007,1358,124,6,1,1,0,2497,769,1662,202,38,2,0,0,2673,5170
IT-PS,Pesaro e Urbino,47,1035,1529,136,11,3,1,0,2715,724,1750,206,44,2,1,0,2727,5442
IT-PU,Pesaro e Urbino,47,1035,1529,136,11,3,1,0,2715,724,1750,206,44,2,1,0,2727,5442
IT-PS,Pesaro e Urbino,48,1000,1556,139,15,4,0,0,2714,684,1849,208,40,1,0,0,2782,5496
IT-PU,Pesaro e Urbino,48,1000,1556,139,15,4,0,0,2714,684,1849,208,40,1,0,0,2782,5496
IT-PS,Pesaro e Urbino,49,961,1735,160,12,4,0,0,2872,712,1876,245,48,2,0,0,2883,5755
IT-PU,Pesaro e Urbino,49,961,1735,160,12,4,0,0,2872,712,1876,245,48,2,0,0,2883,5755
IT-PS,Pesaro e Urbino,50,916,1694,177,12,1,1,0,2801,673,1908,248,71,2,0,0,2902,5703
IT-PU,Pesaro e Urbino,50,916,1694,177,12,1,1,0,2801,673,1908,248,71,2,0,0,2902,5703
IT-PS,Pesaro e Urbino,51,853,1753,202,12,5,1,0,2826,536,1918,266,54,0,0,1,2775,5601
IT-PU,Pesaro e Urbino,51,853,1753,202,12,5,1,0,2826,536,1918,266,54,0,0,1,2775,5601
IT-PS,Pesaro e Urbino,52,817,1824,209,19,1,0,0,2870,574,2018,278,71,2,0,0,2943,5813
IT-PU,Pesaro e Urbino,52,817,1824,209,19,1,0,0,2870,574,2018,278,71,2,0,0,2943,5813
IT-PS,Pesaro e Urbino,53,740,1838,228,18,6,0,0,2830,484,1919,302,77,1,0,0,2783,5613
IT-PU,Pesaro e Urbino,53,740,1838,228,18,6,0,0,2830,484,1919,302,77,1,0,0,2783,5613
IT-PS,Pesaro e Urbino,54,748,1843,243,22,3,1,1,2861,549,2067,308,70,1,0,0,2995,5856
IT-PU,Pesaro e Urbino,54,748,1843,243,22,3,1,1,2861,549,2067,308,70,1,0,0,2995,5856
IT-PS,Pesaro e Urbino,55,629,1991,203,27,1,0,0,2851,485,2010,275,108,1,0,0,2879,5730
IT-PU,Pesaro e Urbino,55,629,1991,203,27,1,0,0,2851,485,2010,275,108,1,0,0,2879,5730
IT-PS,Pesaro e Urbino,56,634,1982,262,27,4,0,0,2909,466,2025,335,111,1,0,0,2938,5847
IT-PU,Pesaro e Urbino,56,634,1982,262,27,4,0,0,2909,466,2025,335,111,1,0,0,2938,5847
IT-PS,Pesaro e Urbino,57,600,1999,251,32,2,1,0,2885,361,2156,280,127,0,0,0,2924,5809
IT-PU,Pesaro e Urbino,57,600,1999,251,32,2,1,0,2885,361,2156,280,127,0,0,0,2924,5809
IT-PS,Pesaro e Urbino,58,527,2058,218,40,4,0,0,2847,382,2016,302,140,1,0,0,2841,5688
IT-PU,Pesaro e Urbino,58,527,2058,218,40,4,0,0,2847,382,2016,302,140,1,0,0,2841,5688
IT-PS,Pesaro e Urbino,59,520,2112,253,33,4,0,0,2922,350,2159,259,177,0,0,0,2945,5867
IT-PU,Pesaro e Urbino,59,520,2112,253,33,4,0,0,2922,350,2159,259,177,0,0,0,2945,5867
IT-PS,Pesaro e Urbino,60,445,2064,236,42,3,0,0,2790,317,2024,233,145,1,0,0,2720,5510
IT-PU,Pesaro e Urbino,60,445,2064,236,42,3,0,0,2790,317,2024,233,145,1,0,0,2720,5510
IT-PS,Pesaro e Urbino,61,340,2011,199,36,1,0,0,2587,306,1953,255,165,0,0,0,2679,5266
IT-PU,Pesaro e Urbino,61,340,2011,199,36,1,0,0,2587,306,1953,255,165,0,0,0,2679,5266
IT-PS,Pesaro e Urbino,62,342,1944,224,41,5,0,0,2556,304,1950,227,212,0,0,0,2693,5249
IT-PU,Pesaro e Urbino,62,342,1944,224,41,5,0,0,2556,304,1950,227,212,0,0,0,2693,5249
IT-PS,Pesaro e Urbino,63,353,1868,188,52,4,0,0,2465,237,1926,199,242,0,0,0,2604,5069
IT-PU,Pesaro e Urbino,63,353,1868,188,52,4,0,0,2465,237,1926,199,242,0,0,0,2604,5069
IT-PS,Pesaro e Urbino,64,301,1836,173,60,2,0,0,2372,262,1828,195,226,1,0,0,2512,4884
IT-PU,Pesaro e Urbino,64,301,1836,173,60,2,0,0,2372,262,1828,195,226,1,0,0,2512,4884
IT-PS,Pesaro e Urbino,65,267,1759,170,61,3,0,0,2260,194,1735,210,247,0,1,0,2387,4647
IT-PU,Pesaro e Urbino,65,267,1759,170,61,3,0,0,2260,194,1735,210,247,0,1,0,2387,4647
IT-PS,Pesaro e Urbino,66,260,1704,150,54,0,0,0,2168,186,1634,190,273,0,0,0,2283,4451
IT-PU,Pesaro e Urbino,66,260,1704,150,54,0,0,0,2168,186,1634,190,273,0,0,0,2283,4451
IT-PS,Pesaro e Urbino,67,222,1667,133,65,3,0,0,2090,183,1647,166,304,0,0,0,2300,4390
IT-PU,Pesaro e Urbino,67,222,1667,133,65,3,0,0,2090,183,1647,166,304,0,0,0,2300,4390
IT-PS,Pesaro e Urbino,68,194,1578,108,93,2,0,0,1975,159,1568,156,304,1,0,0,2188,4163
IT-PU,Pesaro e Urbino,68,194,1578,108,93,2,0,0,1975,159,1568,156,304,1,0,0,2188,4163
IT-PS,Pesaro e Urbino,69,197,1560,120,69,0,0,0,1946,142,1469,139,343,0,0,0,2093,4039
IT-PU,Pesaro e Urbino,69,197,1560,120,69,0,0,0,1946,142,1469,139,343,0,0,0,2093,4039
IT-PS,Pesaro e Urbino,70,164,1533,100,85,0,0,0,1882,138,1454,105,345,0,0,0,2042,3924
IT-PU,Pesaro e Urbino,70,164,1533,100,85,0,0,0,1882,138,1454,105,345,0,0,0,2042,3924
IT-PS,Pesaro e Urbino,71,141,1483,107,100,1,0,0,1832,119,1370,109,378,1,0,0,1977,3809
IT-PU,Pesaro e Urbino,71,141,1483,107,100,1,0,0,1832,119,1370,109,378,1,0,0,1977,3809
IT-PS,Pesaro e Urbino,72,140,1573,82,85,0,0,0,1880,118,1379,102,428,0,0,0,2027,3907
IT-PU,Pesaro e Urbino,72,140,1573,82,85,0,0,0,1880,118,1379,102,428,0,0,0,2027,3907
IT-PS,Pesaro e Urbino,73,148,1547,68,119,1,0,0,1883,112,1477,95,485,0,0,0,2169,4052
IT-PU,Pesaro e Urbino,73,148,1547,68,119,1,0,0,1883,112,1477,95,485,0,0,0,2169,4052
IT-PS,Pesaro e Urbino,74,159,1515,84,119,0,0,0,1877,95,1388,94,572,1,0,0,2150,4027
IT-PU,Pesaro e Urbino,74,159,1515,84,119,0,0,0,1877,95,1388,94,572,1,0,0,2150,4027
IT-PS,Pesaro e Urbino,75,123,1525,75,146,0,0,0,1869,100,1331,81,627,0,0,0,2139,4008
IT-PU,Pesaro e Urbino,75,123,1525,75,146,0,0,0,1869,100,1331,81,627,0,0,0,2139,4008
IT-PS,Pesaro e Urbino,76,131,1443,72,153,0,0,0,1799,75,1194,70,662,0,0,0,2001,3800
IT-PU,Pesaro e Urbino,76,131,1443,72,153,0,0,0,1799,75,1194,70,662,0,0,0,2001,3800
IT-PS,Pesaro e Urbino,77,133,1439,68,168,1,0,0,1809,90,1223,90,709,0,0,1,2113,3922
IT-PU,Pesaro e Urbino,77,133,1439,68,168,1,0,0,1809,90,1223,90,709,0,0,1,2113,3922
IT-PS,Pesaro e Urbino,78,80,1073,50,154,0,0,0,1357,73,875,69,620,0,0,0,1637,2994
IT-PU,Pesaro e Urbino,78,80,1073,50,154,0,0,0,1357,73,875,69,620,0,0,0,1637,2994
IT-PS,Pesaro e Urbino,79,88,1086,26,140,0,0,0,1340,58,843,64,713,0,0,0,1678,3018
IT-PU,Pesaro e Urbino,79,88,1086,26,140,0,0,0,1340,58,843,64,713,0,0,0,1678,3018
IT-PS,Pesaro e Urbino,80,80,1086,31,157,0,0,0,1354,79,781,39,749,0,0,0,1648,3002
IT-PU,Pesaro e Urbino,80,80,1086,31,157,0,0,0,1354,79,781,39,749,0,0,0,1648,3002
IT-PS,Pesaro e Urbino,81,85,935,29,155,0,0,0,1204,71,634,35,737,0,0,0,1477,2681
IT-PU,Pesaro e Urbino,81,85,935,29,155,0,0,0,1204,71,634,35,737,0,0,0,1477,2681
IT-PS,Pesaro e Urbino,82,83,866,24,149,1,0,0,1123,62,595,39,816,0,0,0,1512,2635
IT-PU,Pesaro e Urbino,82,83,866,24,149,1,0,0,1123,62,595,39,816,0,0,0,1512,2635
IT-PS,Pesaro e Urbino,83,63,949,23,168,0,0,0,1203,78,587,34,952,0,0,0,1651,2854
IT-PU,Pesaro e Urbino,83,63,949,23,168,0,0,0,1203,78,587,34,952,0,0,0,1651,2854
IT-PS,Pesaro e Urbino,84,70,886,20,192,0,0,0,1168,68,468,21,970,0,0,0,1527,2695
IT-PU,Pesaro e Urbino,84,70,886,20,192,0,0,0,1168,68,468,21,970,0,0,0,1527,2695
IT-PS,Pesaro e Urbino,85,80,743,20,194,0,0,0,1037,62,414,24,1076,0,0,0,1576,2613
IT-PU,Pesaro e Urbino,85,80,743,20,194,0,0,0,1037,62,414,24,1076,0,0,0,1576,2613
IT-PS,Pesaro e Urbino,86,53,582,10,171,0,0,0,816,63,280,16,890,0,0,0,1249,2065
IT-PU,Pesaro e Urbino,86,53,582,10,171,0,0,0,816,63,280,16,890,0,0,0,1249,2065
IT-PS,Pesaro e Urbino,87,30,530,7,156,0,0,0,723,48,227,15,832,0,0,0,1122,1845
IT-PU,Pesaro e Urbino,87,30,530,7,156,0,0,0,723,48,227,15,832,0,0,0,1122,1845
IT-PS,Pesaro e Urbino,88,44,390,6,176,0,0,0,616,51,176,11,871,0,0,0,1109,1725
IT-PU,Pesaro e Urbino,88,44,390,6,176,0,0,0,616,51,176,11,871,0,0,0,1109,1725
IT-PS,Pesaro e Urbino,89,28,339,6,155,0,0,0,528,29,149,11,789,0,0,0,978,1506
IT-PU,Pesaro e Urbino,89,28,339,6,155,0,0,0,528,29,149,11,789,0,0,0,978,1506
IT-PS,Pesaro e Urbino,90,27,255,8,142,0,0,0,432,35,86,13,685,0,0,0,819,1251
IT-PU,Pesaro e Urbino,90,27,255,8,142,0,0,0,432,35,86,13,685,0,0,0,819,1251
IT-PS,Pesaro e Urbino,91,23,202,1,121,0,0,0,347,41,49,5,590,0,0,0,685,1032
IT-PU,Pesaro e Urbino,91,23,202,1,121,0,0,0,347,41,49,5,590,0,0,0,685,1032
IT-PS,Pesaro e Urbino,92,11,161,2,121,0,0,0,295,32,43,3,551,0,0,0,629,924
IT-PU,Pesaro e Urbino,92,11,161,2,121,0,0,0,295,32,43,3,551,0,0,0,629,924
IT-PS,Pesaro e Urbino,93,9,119,3,79,0,0,0,210,19,28,5,424,0,0,0,476,686
IT-PU,Pesaro e Urbino,93,9,119,3,79,0,0,0,210,19,28,5,424,0,0,0,476,686
IT-PS,Pesaro e Urbino,94,3,79,1,54,0,0,0,137,12,23,3,294,0,0,0,332,469
IT-PU,Pesaro e Urbino,94,3,79,1,54,0,0,0,137,12,23,3,294,0,0,0,332,469
IT-PS,Pesaro e Urbino,95,8,49,0,42,0,0,0,99,10,7,2,272,0,0,0,291,390
IT-PU,Pesaro e Urbino,95,8,49,0,42,0,0,0,99,10,7,2,272,0,0,0,291,390
IT-PS,Pesaro e Urbino,96,2,26,1,45,0,0,0,74,11,9,1,210,0,0,0,231,305
IT-PU,Pesaro e Urbino,96,2,26,1,45,0,0,0,74,11,9,1,210,0,0,0,231,305
IT-PS,Pesaro e Urbino,97,3,14,0,22,0,0,0,39,9,6,1,158,0,0,0,174,213
IT-PU,Pesaro e Urbino,97,3,14,0,22,0,0,0,39,9,6,1,158,0,0,0,174,213
IT-PS,Pesaro e Urbino,98,1,13,0,13,0,0,0,27,10,3,1,106,0,0,0,120,147
IT-PU,Pesaro e Urbino,98,1,13,0,13,0,0,0,27,10,3,1,106,0,0,0,120,147
IT-PS,Pesaro e Urbino,99,1,3,0,13,0,0,0,17,6,1,1,72,0,0,0,80,97
IT-PU,Pesaro e Urbino,99,1,3,0,13,0,0,0,17,6,1,1,72,0,0,0,80,97
IT-PS,Pesaro e Urbino,100,0,8,1,13,0,0,0,22,6,1,0,98,0,0,0,105,127
IT-PU,Pesaro e Urbino,100,0,8,1,13,0,0,0,22,6,1,0,98,0,0,0,105,127
IT-PS,Pesaro e Urbino,999,83699,77703,6052,4494,94,6,1,172049,69594,78625,8054,21486,65,7,2,177833,349882
IT-PU,Pesaro e Urbino,999,83699,77703,6052,4494,94,6,1,172049,69594,78625,8054,21486,65,7,2,177833,349882
IT-PE,Pescara,0,913,0,0,0,0,0,0,913,919,0,0,0,0,0,0,919,1832
IT-PE,Pescara,1,1087,0,0,0,0,0,0,1087,1004,0,0,0,0,0,0,1004,2091
IT-PE,Pescara,2,1122,0,0,0,0,0,0,1122,1097,0,0,0,0,0,0,1097,2219
IT-PE,Pescara,3,1154,0,0,0,0,0,0,1154,1072,0,0,0,0,0,0,1072,2226
IT-PE,Pescara,4,1158,0,0,0,0,0,0,1158,1105,0,0,0,0,0,0,1105,2263
IT-PE,Pescara,5,1187,0,0,0,0,0,0,1187,1138,0,0,0,0,0,0,1138,2325
IT-PE,Pescara,6,1259,0,0,0,0,0,0,1259,1194,0,0,0,0,0,0,1194,2453
IT-PE,Pescara,7,1364,0,0,0,0,0,0,1364,1258,0,0,0,0,0,0,1258,2622
IT-PE,Pescara,8,1375,0,0,0,0,0,0,1375,1268,0,0,0,0,0,0,1268,2643
IT-PE,Pescara,9,1432,0,0,0,0,0,0,1432,1342,0,0,0,0,0,0,1342,2774
IT-PE,Pescara,10,1397,0,0,0,0,0,0,1397,1359,0,0,0,0,0,0,1359,2756
IT-PE,Pescara,11,1429,0,0,0,0,0,0,1429,1388,0,0,0,0,0,0,1388,2817
IT-PE,Pescara,12,1552,0,0,0,0,0,0,1552,1395,0,0,0,0,0,0,1395,2947
IT-PE,Pescara,13,1551,0,0,0,0,0,0,1551,1418,0,0,0,0,0,0,1418,2969
IT-PE,Pescara,14,1501,0,0,0,0,0,0,1501,1433,0,0,0,0,0,0,1433,2934
IT-PE,Pescara,15,1623,0,0,0,0,0,0,1623,1533,0,0,0,0,0,0,1533,3156
IT-PE,Pescara,16,1552,0,0,0,0,0,0,1552,1492,1,0,0,0,0,0,1493,3045
IT-PE,Pescara,17,1639,0,0,0,0,0,0,1639,1463,0,0,0,0,0,0,1463,3102
IT-PE,Pescara,18,1582,1,0,0,0,0,0,1583,1434,2,0,0,0,0,0,1436,3019
IT-PE,Pescara,19,1668,1,0,0,0,0,0,1669,1443,7,0,0,0,0,0,1450,3119
IT-PE,Pescara,20,1544,1,0,0,0,0,0,1545,1473,9,0,0,0,0,0,1482,3027
IT-PE,Pescara,21,1557,2,0,0,0,0,0,1559,1408,8,0,0,0,0,0,1416,2975
IT-PE,Pescara,22,1514,7,0,0,0,0,0,1521,1471,18,0,0,0,0,0,1489,3010
IT-PE,Pescara,23,1621,10,0,0,0,0,0,1631,1391,21,1,0,0,0,0,1413,3044
IT-PE,Pescara,24,1545,15,0,0,0,0,0,1560,1370,32,0,0,0,0,0,1402,2962
IT-PE,Pescara,25,1622,29,0,0,2,0,0,1653,1381,72,1,0,0,0,0,1454,3107
IT-PE,Pescara,26,1565,39,0,0,0,0,0,1604,1296,109,1,0,0,0,0,1406,3010
IT-PE,Pescara,27,1461,52,0,0,1,0,0,1514,1290,136,2,0,1,0,0,1429,2943
IT-PE,Pescara,28,1484,85,1,0,0,0,0,1570,1224,181,5,0,2,0,0,1412,2982
IT-PE,Pescara,29,1449,124,1,0,0,0,0,1574,1210,286,9,0,0,1,0,1506,3080
IT-PE,Pescara,30,1517,170,2,1,3,0,0,1693,1197,338,10,0,0,0,0,1545,3238
IT-PE,Pescara,31,1462,214,2,0,0,0,0,1678,1230,422,12,1,0,0,0,1665,3343
IT-PE,Pescara,32,1308,310,5,2,2,0,0,1627,1103,498,11,1,2,0,0,1615,3242
IT-PE,Pescara,33,1296,393,9,0,1,1,0,1700,1063,619,14,2,1,0,0,1699,3399
IT-PE,Pescara,34,1280,420,14,1,2,0,0,1717,976,639,27,2,1,0,0,1645,3362
IT-PE,Pescara,35,1202,506,16,3,2,0,0,1729,926,737,25,2,0,0,0,1690,3419
IT-PE,Pescara,36,1075,573,17,3,3,0,0,1671,888,813,47,2,2,0,0,1752,3423
IT-PE,Pescara,37,1084,649,20,2,2,0,0,1757,824,898,40,7,3,0,0,1772,3529
IT-PE,Pescara,38,1049,759,21,0,1,0,0,1830,781,913,59,6,1,0,0,1760,3590
IT-PE,Pescara,39,939,861,39,3,5,0,0,1847,723,1052,89,6,2,1,0,1873,3720
IT-PE,Pescara,40,897,869,35,2,1,0,0,1804,700,1087,56,3,1,0,0,1847,3651
IT-PE,Pescara,41,835,883,58,3,3,1,0,1783,684,1203,88,11,1,1,0,1988,3771
IT-PE,Pescara,42,818,962,49,6,3,0,0,1838,589,1263,107,17,0,0,0,1976,3814
IT-PE,Pescara,43,821,1051,61,5,1,0,0,1939,576,1256,112,29,1,1,0,1975,3914
IT-PE,Pescara,44,784,1096,87,9,0,1,0,1977,567,1350,147,23,1,0,0,2088,4065
IT-PE,Pescara,45,796,1223,75,7,3,0,0,2104,522,1463,166,14,2,0,0,2167,4271
IT-PE,Pescara,46,809,1225,81,7,2,0,0,2124,521,1500,156,37,3,0,0,2217,4341
IT-PE,Pescara,47,799,1317,99,5,2,0,0,2222,538,1633,172,34,1,0,0,2378,4600
IT-PE,Pescara,48,743,1386,137,11,2,0,0,2279,517,1648,218,46,0,0,0,2429,4708
IT-PE,Pescara,49,786,1577,137,11,0,0,0,2511,467,1713,209,44,4,0,0,2437,4948
IT-PE,Pescara,50,684,1602,156,16,1,0,0,2459,458,1810,258,50,2,0,0,2578,5037
IT-PE,Pescara,51,647,1703,155,15,1,0,0,2521,439,1914,234,54,1,0,0,2642,5163
IT-PE,Pescara,52,632,1645,179,17,1,0,0,2474,456,1972,206,64,1,0,0,2699,5173
IT-PE,Pescara,53,614,1749,173,20,3,0,0,2559,391,1915,215,69,1,0,0,2591,5150
IT-PE,Pescara,54,590,1845,182,10,3,0,0,2630,417,1963,305,85,3,0,0,2773,5403
IT-PE,Pescara,55,540,1754,183,20,2,0,0,2499,381,1933,255,94,2,0,0,2665,5164
IT-PE,Pescara,56,475,1716,172,25,2,0,0,2390,348,1965,256,119,3,0,0,2691,5081
IT-PE,Pescara,57,446,1879,171,32,4,0,0,2532,351,1988,255,134,2,0,0,2730,5262
IT-PE,Pescara,58,457,1864,221,43,3,0,0,2588,308,1979,238,131,2,0,0,2658,5246
IT-PE,Pescara,59,407,1966,212,38,4,0,0,2627,279,1986,256,165,0,0,0,2686,5313
IT-PE,Pescara,60,328,1903,185,35,1,0,0,2452,258,1843,238,176,0,0,0,2515,4967
IT-PE,Pescara,61,335,1729,180,37,0,0,0,2281,258,1832,196,188,0,0,0,2474,4755
IT-PE,Pescara,62,269,1697,147,41,1,0,0,2155,235,1747,188,213,1,0,0,2384,4539
IT-PE,Pescara,63,230,1640,160,48,1,0,0,2079,213,1625,196,251,2,0,0,2287,4366
IT-PE,Pescara,64,217,1625,128,55,1,0,0,2026,169,1627,189,246,2,0,0,2233,4259
IT-PE,Pescara,65,199,1562,126,38,0,0,0,1925,189,1549,156,258,1,0,0,2153,4078
IT-PE,Pescara,66,166,1585,117,57,2,0,0,1927,173,1549,137,277,0,0,0,2136,4063
IT-PE,Pescara,67,156,1528,111,45,0,0,0,1840,150,1468,102,330,0,0,0,2050,3890
IT-PE,Pescara,68,142,1486,105,73,1,0,0,1807,171,1486,139,311,0,0,0,2107,3914
IT-PE,Pescara,69,143,1410,91,81,1,0,0,1726,140,1358,113,386,1,0,0,1998,3724
IT-PE,Pescara,70,118,1368,76,65,0,0,0,1627,140,1270,117,339,1,0,0,1867,3494
IT-PE,Pescara,71,115,1286,65,72,0,0,0,1538,129,1165,122,432,1,0,0,1849,3387
IT-PE,Pescara,72,81,1297,73,84,0,0,0,1535,116,1320,98,446,0,0,0,1980,3515
IT-PE,Pescara,73,77,1353,57,83,1,0,0,1571,112,1279,82,489,0,0,0,1962,3533
IT-PE,Pescara,74,100,1328,61,84,1,0,0,1574,107,1187,91,533,0,0,0,1918,3492
IT-PE,Pescara,75,91,1348,43,111,0,0,0,1593,126,1118,73,634,0,0,0,1951,3544
IT-PE,Pescara,76,90,1298,50,110,0,0,0,1548,82,1068,80,658,0,0,0,1888,3436
IT-PE,Pescara,77,69,1249,42,124,1,0,0,1485,89,969,63,693,0,0,0,1814,3299
IT-PE,Pescara,78,43,897,24,108,0,0,0,1072,64,667,59,560,0,0,0,1350,2422
IT-PE,Pescara,79,60,955,40,106,0,0,0,1161,64,693,48,651,0,0,0,1456,2617
IT-PE,Pescara,80,54,877,23,108,0,0,0,1062,62,619,40,686,0,0,0,1407,2469
IT-PE,Pescara,81,33,783,23,146,0,0,0,985,68,566,40,671,0,0,0,1345,2330
IT-PE,Pescara,82,52,754,15,133,0,0,0,954,69,496,29,699,0,0,0,1293,2247
IT-PE,Pescara,83,46,778,27,161,1,0,0,1013,64,506,35,846,0,0,0,1451,2464
IT-PE,Pescara,84,34,763,21,157,0,0,0,975,77,472,30,926,0,0,0,1505,2480
IT-PE,Pescara,85,33,617,16,171,0,0,0,837,74,306,20,790,0,0,0,1190,2027
IT-PE,Pescara,86,28,561,11,174,0,0,0,774,63,267,15,762,0,0,0,1107,1881
IT-PE,Pescara,87,15,450,8,160,0,0,0,633,60,199,19,709,0,0,0,987,1620
IT-PE,Pescara,88,17,388,8,160,0,0,0,573,47,179,15,665,0,0,0,906,1479
IT-PE,Pescara,89,11,318,1,122,0,0,0,452,35,140,9,619,0,0,0,803,1255
IT-PE,Pescara,90,15,230,8,103,0,0,0,356,46,110,9,585,0,0,0,750,1106
IT-PE,Pescara,91,8,189,2,116,0,0,0,315,32,71,3,495,0,0,0,601,916
IT-PE,Pescara,92,4,141,2,88,0,0,0,235,25,47,6,434,0,0,0,512,747
IT-PE,Pescara,93,10,108,1,68,0,0,0,187,42,48,6,348,0,0,0,444,631
IT-PE,Pescara,94,4,75,0,49,0,0,0,128,19,19,4,280,0,0,0,322,450
IT-PE,Pescara,95,2,45,2,44,0,0,0,93,11,27,0,189,0,0,0,227,320
IT-PE,Pescara,96,2,38,0,29,0,0,0,69,18,11,3,153,0,0,0,185,254
IT-PE,Pescara,97,1,16,0,17,0,0,0,34,10,8,2,99,0,0,0,119,153
IT-PE,Pescara,98,0,12,0,19,0,0,0,31,8,5,0,86,0,0,0,99,130
IT-PE,Pescara,99,0,12,0,12,0,0,0,24,6,6,0,40,0,0,0,52,76
IT-PE,Pescara,100,3,6,0,12,0,0,0,21,9,3,0,92,0,0,0,104,125
IT-PE,Pescara,999,72100,70238,4819,3823,77,3,0,151060,62319,72277,7034,19497,55,4,0,161186,312246
IT-PC,Piacenza,0,1053,0,0,0,0,0,0,1053,962,0,0,0,0,0,0,962,2015
IT-PC,Piacenza,1,1002,0,0,0,0,0,0,1002,981,0,0,0,0,0,0,981,1983
IT-PC,Piacenza,2,959,0,0,0,0,0,0,959,926,0,0,0,0,0,0,926,1885
IT-PC,Piacenza,3,1049,0,0,0,0,0,0,1049,978,0,0,0,0,0,0,978,2027
IT-PC,Piacenza,4,1090,0,0,0,0,0,0,1090,1095,0,0,0,0,0,0,1095,2185
IT-PC,Piacenza,5,1199,0,0,0,0,0,0,1199,1073,0,0,0,0,0,0,1073,2272
IT-PC,Piacenza,6,1176,0,0,0,0,0,0,1176,1039,0,0,0,0,0,0,1039,2215
IT-PC,Piacenza,7,1235,0,0,0,0,0,0,1235,1128,0,0,0,0,0,0,1128,2363
IT-PC,Piacenza,8,1233,0,0,0,0,0,0,1233,1177,0,0,0,0,0,0,1177,2410
IT-PC,Piacenza,9,1333,0,0,0,0,0,0,1333,1181,0,0,0,0,0,0,1181,2514
IT-PC,Piacenza,10,1250,0,0,0,0,0,0,1250,1252,0,0,0,0,0,0,1252,2502
IT-PC,Piacenza,11,1332,0,0,0,0,0,0,1332,1230,0,0,0,0,0,0,1230,2562
IT-PC,Piacenza,12,1271,0,0,0,0,0,0,1271,1216,0,0,0,0,0,0,1216,2487
IT-PC,Piacenza,13,1368,0,0,0,0,0,0,1368,1232,0,0,0,0,0,0,1232,2600
IT-PC,Piacenza,14,1380,0,0,0,0,0,0,1380,1296,0,0,0,0,0,0,1296,2676
IT-PC,Piacenza,15,1351,0,0,0,0,0,0,1351,1233,0,0,0,0,0,0,1233,2584
IT-PC,Piacenza,16,1374,0,0,0,0,0,0,1374,1262,0,0,0,0,0,0,1262,2636
IT-PC,Piacenza,17,1321,0,0,0,0,0,0,1321,1323,0,0,0,0,0,0,1323,2644
IT-PC,Piacenza,18,1325,0,0,0,0,0,0,1325,1285,2,0,0,0,0,0,1287,2612
IT-PC,Piacenza,19,1362,2,0,0,0,0,0,1364,1264,10,0,0,0,0,0,1274,2638
IT-PC,Piacenza,20,1392,0,0,0,0,0,0,1392,1225,23,0,0,0,0,0,1248,2640
IT-PC,Piacenza,21,1417,6,0,0,0,0,0,1423,1233,30,0,0,0,0,0,1263,2686
IT-PC,Piacenza,22,1404,15,0,0,0,0,0,1419,1190,51,0,0,0,0,0,1241,2660
IT-PC,Piacenza,23,1461,21,2,0,0,0,0,1484,1234,102,6,0,0,0,0,1342,2826
IT-PC,Piacenza,24,1488,37,2,0,0,0,0,1527,1158,134,1,0,1,0,0,1294,2821
IT-PC,Piacenza,25,1533,69,5,0,0,0,0,1607,1172,173,4,0,0,0,0,1349,2956
IT-PC,Piacenza,26,1580,90,0,0,0,0,0,1670,1171,234,5,0,0,0,0,1410,3080
IT-PC,Piacenza,27,1399,123,8,0,0,0,0,1530,1098,259,9,1,0,0,0,1367,2897
IT-PC,Piacenza,28,1393,151,10,0,1,0,0,1555,1021,403,12,0,0,0,0,1436,2991
IT-PC,Piacenza,29,1323,213,10,0,0,0,0,1546,992,427,15,0,1,0,0,1435,2981
IT-PC,Piacenza,30,1294,266,5,0,1,0,0,1566,931,512,23,1,0,0,0,1467,3033
IT-PC,Piacenza,31,1256,364,8,0,1,0,0,1629,954,601,15,1,1,0,0,1572,3201
IT-PC,Piacenza,32,1201,448,10,1,3,0,0,1663,823,654,25,3,2,1,0,1508,3171
IT-PC,Piacenza,33,1139,534,17,0,0,1,0,1691,780,778,28,0,5,0,0,1591,3282
IT-PC,Piacenza,34,1056,568,15,2,6,0,0,1647,700,795,43,2,5,0,0,1545,3192
IT-PC,Piacenza,35,1001,612,17,0,3,0,0,1633,640,817,39,7,5,0,0,1508,3141
IT-PC,Piacenza,36,898,676,23,0,4,1,0,1602,642,880,56,9,3,0,0,1590,3192
IT-PC,Piacenza,37,825,700,30,0,3,0,0,1558,591,906,57,9,2,0,0,1565,3123
IT-PC,Piacenza,38,789,739,38,4,0,0,0,1570,539,962,60,15,2,0,0,1578,3148
IT-PC,Piacenza,39,810,874,41,5,3,0,0,1733,531,978,63,9,1,0,0,1582,3315
IT-PC,Piacenza,40,777,819,46,0,4,0,0,1646,504,951,66,13,6,0,0,1540,3186
IT-PC,Piacenza,41,779,908,60,3,3,0,0,1753,505,978,93,11,3,0,0,1590,3343
IT-PC,Piacenza,42,706,932,61,3,7,1,0,1710,476,1073,80,18,3,0,0,1650,3360
IT-PC,Piacenza,43,698,949,78,7,2,0,0,1734,470,1092,115,24,0,0,0,1701,3435
IT-PC,Piacenza,44,741,1013,64,6,3,0,0,1827,479,1113,125,27,3,0,0,1747,3574
IT-PC,Piacenza,45,760,1088,59,7,4,0,0,1918,546,1234,123,16,1,1,0,1921,3839
IT-PC,Piacenza,46,738,1063,94,15,2,1,0,1913,528,1252,141,18,1,0,0,1940,3853
IT-PC,Piacenza,47,749,1287,109,15,2,0,0,2162,515,1259,160,28,0,0,0,1962,4124
IT-PC,Piacenza,48,787,1282,129,13,2,0,0,2213,545,1392,172,40,2,0,0,2151,4364
IT-PC,Piacenza,49,783,1432,139,12,4,0,0,2370,559,1504,193,53,0,0,0,2309,4679
IT-PC,Piacenza,50,739,1344,123,14,2,0,0,2222,538,1546,211,54,1,1,0,2351,4573
IT-PC,Piacenza,51,674,1419,155,12,5,0,0,2265,493,1514,185,66,4,0,0,2262,4527
IT-PC,Piacenza,52,640,1475,164,7,1,0,0,2287,486,1524,230,73,1,0,0,2314,4601
IT-PC,Piacenza,53,664,1429,182,17,4,0,0,2296,438,1584,212,62,0,0,0,2296,4592
IT-PC,Piacenza,54,605,1543,192,11,3,0,0,2354,450,1572,215,93,0,0,0,2330,4684
IT-PC,Piacenza,55,628,1529,191,19,6,0,0,2373,408,1602,236,105,2,0,0,2353,4726
IT-PC,Piacenza,56,585,1637,175,21,2,0,1,2421,382,1537,245,107,1,0,0,2272,4693
IT-PC,Piacenza,57,512,1633,176,25,4,0,0,2350,358,1692,237,131,0,0,0,2418,4768
IT-PC,Piacenza,58,539,1598,204,23,3,0,1,2368,319,1651,220,143,1,0,0,2334,4702
IT-PC,Piacenza,59,451,1644,205,32,5,0,0,2337,351,1588,223,170,0,0,0,2332,4669
IT-PC,Piacenza,60,404,1591,163,25,4,0,0,2187,323,1578,224,159,0,0,0,2284,4471
IT-PC,Piacenza,61,358,1495,190,23,3,0,1,2070,284,1512,221,144,0,0,0,2161,4231
IT-PC,Piacenza,62,355,1526,169,50,2,0,0,2102,239,1515,183,172,2,0,1,2112,4214
IT-PC,Piacenza,63,313,1484,147,52,0,0,0,1996,222,1450,202,197,1,0,0,2072,4068
IT-PC,Piacenza,64,280,1409,159,53,4,0,1,1906,214,1383,149,213,2,0,0,1961,3867
IT-PC,Piacenza,65,262,1442,139,61,0,0,0,1904,190,1302,174,238,0,0,0,1904,3808
IT-PC,Piacenza,66,282,1355,139,57,2,0,0,1835,207,1302,149,225,0,0,0,1883,3718
IT-PC,Piacenza,67,223,1373,141,63,2,0,0,1802,160,1304,141,270,1,0,0,1876,3678
IT-PC,Piacenza,68,210,1271,106,74,3,0,0,1664,163,1267,127,294,1,0,0,1852,3516
IT-PC,Piacenza,69,186,1220,121,89,2,0,0,1618,150,1157,110,316,0,0,0,1733,3351
IT-PC,Piacenza,70,174,1142,77,68,0,0,0,1461,140,1011,107,336,1,0,0,1595,3056
IT-PC,Piacenza,71,155,1127,87,77,1,0,0,1447,127,1023,95,320,0,1,0,1566,3013
IT-PC,Piacenza,72,163,1071,66,87,0,0,0,1387,111,904,92,378,0,0,0,1485,2872
IT-PC,Piacenza,73,161,1146,70,101,1,0,0,1479,95,1004,96,423,0,0,0,1618,3097
IT-PC,Piacenza,74,162,1141,70,98,1,0,1,1473,116,955,73,495,0,0,0,1639,3112
IT-PC,Piacenza,75,155,1099,54,119,0,0,0,1427,96,993,86,540,0,0,0,1715,3142
IT-PC,Piacenza,76,193,1093,67,125,2,0,0,1480,103,882,83,563,0,0,0,1631,3111
IT-PC,Piacenza,77,154,1109,64,144,0,0,0,1471,102,931,54,633,0,0,0,1720,3191
IT-PC,Piacenza,78,104,733,44,108,0,0,0,989,73,641,46,544,0,0,0,1304,2293
IT-PC,Piacenza,79,104,807,45,128,0,0,0,1084,83,623,47,614,0,0,0,1367,2451
IT-PC,Piacenza,80,107,761,34,147,1,1,0,1051,86,575,51,643,0,0,0,1355,2406
IT-PC,Piacenza,81,121,794,23,142,2,0,0,1082,101,522,26,718,1,0,0,1368,2450
IT-PC,Piacenza,82,118,704,23,150,1,1,0,997,86,503,29,737,0,0,0,1355,2352
IT-PC,Piacenza,83,106,711,17,176,0,0,0,1010,97,416,28,815,0,1,0,1357,2367
IT-PC,Piacenza,84,95,603,14,191,0,0,0,903,94,378,27,844,0,0,0,1343,2246
IT-PC,Piacenza,85,88,537,16,186,0,0,0,827,66,332,26,895,0,0,0,1319,2146
IT-PC,Piacenza,86,77,447,12,189,0,0,0,725,67,209,19,791,0,0,0,1086,1811
IT-PC,Piacenza,87,69,337,9,119,0,0,0,534,56,157,17,701,0,0,0,931,1465
IT-PC,Piacenza,88,56,314,7,146,0,0,0,523,51,120,8,689,0,0,0,868,1391
IT-PC,Piacenza,89,37,258,4,130,0,0,0,429,61,104,9,616,0,0,0,790,1219
IT-PC,Piacenza,90,31,173,10,114,0,0,0,328,45,78,7,561,0,0,0,691,1019
IT-PC,Piacenza,91,35,133,2,86,0,0,0,256,42,51,5,519,0,0,0,617,873
IT-PC,Piacenza,92,21,114,3,80,0,0,0,218,38,30,6,420,0,0,0,494,712
IT-PC,Piacenza,93,20,98,3,80,0,0,0,201,31,16,4,420,0,0,0,471,672
IT-PC,Piacenza,94,13,59,0,59,0,0,0,131,27,11,4,283,0,0,0,325,456
IT-PC,Piacenza,95,12,37,0,27,0,0,0,76,18,7,2,219,0,0,0,246,322
IT-PC,Piacenza,96,3,13,0,39,0,0,0,55,20,6,0,183,0,0,0,209,264
IT-PC,Piacenza,97,2,15,0,23,0,0,0,40,13,4,1,124,0,0,0,142,182
IT-PC,Piacenza,98,4,6,0,10,0,0,0,20,15,0,0,84,0,0,0,99,119
IT-PC,Piacenza,99,2,3,0,7,0,0,0,12,9,1,4,63,0,0,0,77,89
IT-PC,Piacenza,100,3,3,0,16,0,0,0,22,13,1,0,94,0,0,0,108,130
IT-PC,Piacenza,999,68295,63286,5142,3993,124,6,5,140851,55342,63647,6675,18802,66,5,1,144538,285389
IT-PI,Pisa,0,1390,0,0,0,0,0,0,1390,1255,0,0,0,0,0,0,1255,2645
IT-PI,Pisa,1,1348,0,0,0,0,0,0,1348,1265,0,0,0,0,0,0,1265,2613
IT-PI,Pisa,2,1441,0,0,0,0,0,0,1441,1328,0,0,0,0,0,0,1328,2769
IT-PI,Pisa,3,1477,0,0,0,0,0,0,1477,1358,0,0,0,0,0,0,1358,2835
IT-PI,Pisa,4,1437,0,0,0,0,0,0,1437,1438,0,0,0,0,0,0,1438,2875
IT-PI,Pisa,5,1560,0,0,0,0,0,0,1560,1516,0,0,0,0,0,0,1516,3076
IT-PI,Pisa,6,1657,0,0,0,0,0,0,1657,1553,0,0,0,0,0,0,1553,3210
IT-PI,Pisa,7,1726,0,0,0,0,0,0,1726,1647,0,0,0,0,0,0,1647,3373
IT-PI,Pisa,8,1825,0,0,0,0,0,0,1825,1663,0,0,0,0,0,0,1663,3488
IT-PI,Pisa,9,1833,0,0,0,0,0,0,1833,1831,0,0,0,0,0,0,1831,3664
IT-PI,Pisa,10,1853,0,0,0,0,0,0,1853,1816,0,0,0,0,0,0,1816,3669
IT-PI,Pisa,11,1936,0,0,0,0,0,0,1936,1798,0,0,0,0,0,0,1798,3734
IT-PI,Pisa,12,1954,0,0,0,0,0,0,1954,1882,0,0,0,0,0,0,1882,3836
IT-PI,Pisa,13,2039,0,0,0,0,0,0,2039,1967,0,0,0,0,0,0,1967,4006
IT-PI,Pisa,14,2030,0,0,0,0,0,0,2030,1931,0,0,0,0,0,0,1931,3961
IT-PI,Pisa,15,2080,0,0,0,0,0,0,2080,1949,0,0,0,0,0,0,1949,4029
IT-PI,Pisa,16,2065,1,0,0,0,0,0,2066,1925,0,0,0,0,0,0,1925,3991
IT-PI,Pisa,17,2000,0,0,0,0,0,0,2000,1846,0,0,0,0,0,0,1846,3846
IT-PI,Pisa,18,2063,0,0,0,0,0,0,2063,1815,2,0,0,0,0,0,1817,3880
IT-PI,Pisa,19,2065,0,0,0,0,0,0,2065,1851,6,0,0,0,0,0,1857,3922
IT-PI,Pisa,20,1988,2,0,0,0,0,0,1990,1796,18,0,0,0,0,0,1814,3804
IT-PI,Pisa,21,2044,2,0,0,2,0,0,2048,1768,34,0,0,0,0,0,1802,3850
IT-PI,Pisa,22,2014,9,0,0,0,0,0,2023,1748,37,3,0,0,0,0,1788,3811
IT-PI,Pisa,23,2079,18,0,0,0,0,0,2097,1823,62,0,0,1,0,0,1886,3983
IT-PI,Pisa,24,2047,30,3,0,1,0,0,2081,1729,99,4,1,0,0,0,1833,3914
IT-PI,Pisa,25,2049,51,3,0,0,0,0,2103,1658,122,3,0,1,0,0,1784,3887
IT-PI,Pisa,26,2080,52,3,1,0,0,0,2136,1734,185,9,0,1,0,0,1929,4065
IT-PI,Pisa,27,2028,68,4,0,1,0,0,2101,1689,214,5,0,3,1,0,1912,4013
IT-PI,Pisa,28,2006,132,1,0,2,0,0,2141,1693,325,4,0,2,0,0,2024,4165
IT-PI,Pisa,29,2000,140,5,0,3,0,0,2148,1584,415,3,3,2,1,0,2008,4156
IT-PI,Pisa,30,1931,270,5,1,4,0,0,2211,1560,532,4,2,5,0,0,2103,4314
IT-PI,Pisa,31,1996,365,8,1,1,0,0,2371,1573,638,14,1,2,0,0,2228,4599
IT-PI,Pisa,32,1863,440,5,0,4,0,0,2312,1402,731,20,3,6,0,0,2162,4474
IT-PI,Pisa,33,1868,554,15,3,8,0,0,2448,1429,861,36,3,7,0,0,2336,4784
IT-PI,Pisa,34,1647,650,21,0,5,0,0,2323,1302,928,37,1,3,1,0,2272,4595
IT-PI,Pisa,35,1595,736,23,1,3,0,0,2358,1145,1056,40,8,6,0,0,2255,4613
IT-PI,Pisa,36,1458,782,25,2,6,0,0,2273,1125,1011,44,2,4,0,0,2186,4459
IT-PI,Pisa,37,1325,831,37,2,7,1,0,2203,1039,1156,82,13,4,0,0,2294,4497
IT-PI,Pisa,38,1338,972,41,3,3,2,0,2359,1063,1246,91,6,13,2,0,2421,4780
IT-PI,Pisa,39,1283,1105,46,4,3,0,0,2441,1023,1322,79,10,2,0,0,2436,4877
IT-PI,Pisa,40,1191,1163,60,1,7,0,0,2422,968,1446,91,13,5,0,0,2523,4945
IT-PI,Pisa,41,1269,1336,63,3,7,0,0,2678,921,1393,116,14,5,1,0,2450,5128
IT-PI,Pisa,42,1242,1381,82,9,9,0,0,2723,889,1541,139,28,7,0,0,2604,5327
IT-PI,Pisa,43,1200,1395,91,16,9,0,0,2711,909,1609,156,21,11,1,0,2707,5418
IT-PI,Pisa,44,1222,1536,112,7,7,0,0,2884,884,1739,158,30,5,2,0,2818,5702
IT-PI,Pisa,45,1215,1636,120,9,3,1,0,2984,890,1889,215,33,7,0,0,3034,6018
IT-PI,Pisa,46,1222,1740,153,9,14,0,0,3138,922,1830,228,34,3,0,0,3017,6155
IT-PI,Pisa,47,1213,1819,169,19,9,0,0,3229,883,2147,230,58,7,0,0,3325,6554
IT-PI,Pisa,48,1144,1976,162,17,9,0,1,3309,855,2152,269,51,1,0,0,3328,6637
IT-PI,Pisa,49,1254,2098,187,13,2,0,0,3554,882,2441,302,55,5,0,0,3685,7239
IT-PI,Pisa,50,1047,2159,229,25,5,0,0,3465,807,2344,300,58,5,0,0,3514,6979
IT-PI,Pisa,51,1028,2346,231,16,5,1,0,3627,739,2286,369,64,3,0,0,3461,7088
IT-PI,Pisa,52,933,2311,209,15,6,0,0,3474,706,2419,366,82,6,1,0,3580,7054
IT-PI,Pisa,53,877,2135,278,14,6,0,1,3311,640,2263,324,83,0,0,0,3310,6621
IT-PI,Pisa,54,802,2302,294,25,4,0,0,3427,560,2371,376,103,4,0,0,3414,6841
IT-PI,Pisa,55,744,2245,254,23,3,0,0,3269,532,2326,359,124,5,0,0,3346,6615
IT-PI,Pisa,56,677,2311,287,33,6,0,0,3314,507,2387,369,147,4,0,1,3415,6729
IT-PI,Pisa,57,612,2334,321,37,4,0,0,3308,456,2401,371,153,3,0,0,3384,6692
IT-PI,Pisa,58,649,2300,304,40,5,0,0,3298,428,2369,369,147,1,0,0,3314,6612
IT-PI,Pisa,59,510,2392,315,42,4,0,0,3263,402,2548,360,162,3,0,0,3475,6738
IT-PI,Pisa,60,466,2244,248,52,3,0,0,3013,380,2372,352,165,4,0,0,3273,6286
IT-PI,Pisa,61,392,2175,238,53,4,0,0,2862,311,2353,325,207,2,0,0,3198,6060
IT-PI,Pisa,62,352,2196,263,52,8,0,0,2871,295,2263,317,259,1,0,0,3135,6006
IT-PI,Pisa,63,335,2168,243,77,3,0,0,2826,283,2144,308,256,1,0,0,2992,5818
IT-PI,Pisa,64,294,2196,231,98,3,0,0,2822,230,2089,223,291,2,0,0,2835,5657
IT-PI,Pisa,65,268,2065,222,68,10,1,0,2634,215,1998,244,315,0,0,0,2772,5406
IT-PI,Pisa,66,239,1996,150,86,3,0,0,2474,230,1923,224,353,0,0,0,2730,5204
IT-PI,Pisa,67,205,1956,168,103,7,0,0,2439,190,1921,188,417,1,0,0,2717,5156
IT-PI,Pisa,68,203,1876,153,103,3,0,0,2338,164,1855,179,362,1,0,0,2561,4899
IT-PI,Pisa,69,175,1890,125,101,1,0,0,2292,147,1867,181,440,2,0,0,2637,4929
IT-PI,Pisa,70,179,1754,138,123,2,0,0,2196,154,1700,155,445,1,0,0,2455,4651
IT-PI,Pisa,71,154,1738,108,111,2,0,0,2113,123,1665,150,475,0,0,0,2413,4526
IT-PI,Pisa,72,125,1738,88,143,2,0,0,2096,109,1595,134,461,2,0,1,2302,4398
IT-PI,Pisa,73,122,1763,109,145,1,0,0,2140,129,1691,132,602,3,0,0,2557,4697
IT-PI,Pisa,74,124,1829,101,161,3,0,0,2218,122,1643,156,665,1,0,0,2587,4805
IT-PI,Pisa,75,135,1884,87,210,2,0,0,2318,105,1693,131,752,0,0,0,2681,4999
IT-PI,Pisa,76,104,1832,78,202,0,0,0,2216,118,1684,122,783,0,0,0,2707,4923
IT-PI,Pisa,77,106,1829,75,222,0,0,0,2232,107,1576,119,965,1,0,0,2768,5000
IT-PI,Pisa,78,85,1405,50,207,0,0,0,1747,89,1124,74,798,0,0,0,2085,3832
IT-PI,Pisa,79,65,1304,41,182,0,0,0,1592,86,977,70,906,1,0,0,2040,3632
IT-PI,Pisa,80,61,1251,36,192,0,0,0,1540,75,956,71,943,0,0,0,2045,3585
IT-PI,Pisa,81,66,1125,36,206,1,0,0,1434,68,889,45,922,0,0,0,1924,3358
IT-PI,Pisa,82,63,1005,30,209,1,0,0,1308,64,726,46,972,0,0,0,1808,3116
IT-PI,Pisa,83,67,1121,23,247,0,0,0,1458,74,731,46,1173,0,0,0,2024,3482
IT-PI,Pisa,84,63,1006,23,235,1,0,0,1328,68,630,41,1127,0,0,0,1866,3194
IT-PI,Pisa,85,49,913,19,280,0,0,0,1261,67,528,26,1241,0,0,0,1862,3123
IT-PI,Pisa,86,42,737,19,258,0,0,0,1056,54,373,23,1143,0,0,0,1593,2649
IT-PI,Pisa,87,38,576,11,228,0,0,0,853,54,287,16,994,0,0,0,1351,2204
IT-PI,Pisa,88,29,541,8,238,0,0,0,816,49,217,8,925,0,0,0,1199,2015
IT-PI,Pisa,89,33,408,9,167,1,0,0,618,50,148,19,861,0,0,0,1078,1696
IT-PI,Pisa,90,14,301,5,173,0,0,0,493,31,88,17,772,0,0,0,908,1401
IT-PI,Pisa,91,18,205,2,140,0,0,0,365,30,74,7,661,0,0,0,772,1137
IT-PI,Pisa,92,7,165,4,130,0,0,0,306,41,33,5,586,0,0,0,665,971
IT-PI,Pisa,93,11,111,3,113,0,0,0,238,31,40,4,476,0,0,0,551,789
IT-PI,Pisa,94,3,61,2,80,0,0,0,146,21,21,3,393,0,0,0,438,584
IT-PI,Pisa,95,4,50,1,61,0,0,0,116,13,12,3,298,0,0,0,326,442
IT-PI,Pisa,96,2,34,0,46,0,0,0,82,11,7,2,185,0,0,0,205,287
IT-PI,Pisa,97,3,18,0,33,0,0,0,54,9,10,3,144,0,0,0,166,220
IT-PI,Pisa,98,1,6,0,15,0,0,0,22,4,1,0,108,0,0,0,113,135
IT-PI,Pisa,99,0,2,0,14,0,0,0,16,5,0,0,80,0,0,0,85,101
IT-PI,Pisa,100,1,4,0,22,0,0,0,27,8,4,1,107,0,0,0,120,147
IT-PI,Pisa,999,97172,93603,7313,5977,238,6,2,204311,82711,94809,10115,25541,175,10,2,213363,417674
IT-PT,Pistoia,0,835,0,0,0,0,0,0,835,848,0,0,0,0,0,0,848,1683
IT-PT,Pistoia,1,917,0,0,0,0,0,0,917,851,0,0,0,0,0,0,851,1768
IT-PT,Pistoia,2,938,0,0,0,0,0,0,938,885,0,0,0,0,0,0,885,1823
IT-PT,Pistoia,3,947,0,0,0,0,0,0,947,903,0,0,0,0,0,0,903,1850
IT-PT,Pistoia,4,1006,0,0,0,0,0,0,1006,948,0,0,0,0,0,0,948,1954
IT-PT,Pistoia,5,1106,0,0,0,0,0,0,1106,1034,0,0,0,0,0,0,1034,2140
IT-PT,Pistoia,6,1136,0,0,0,0,0,0,1136,1050,0,0,0,0,0,0,1050,2186
IT-PT,Pistoia,7,1134,0,0,0,0,0,0,1134,1054,0,0,0,0,0,0,1054,2188
IT-PT,Pistoia,8,1227,0,0,0,0,0,0,1227,1135,0,0,0,0,0,0,1135,2362
IT-PT,Pistoia,9,1246,0,0,0,0,0,0,1246,1205,0,0,0,0,0,0,1205,2451
IT-PT,Pistoia,10,1221,0,0,0,0,0,0,1221,1177,0,0,0,0,0,0,1177,2398
IT-PT,Pistoia,11,1371,0,0,0,0,0,0,1371,1218,0,0,0,0,0,0,1218,2589
IT-PT,Pistoia,12,1397,0,0,0,0,0,0,1397,1262,0,0,0,0,0,0,1262,2659
IT-PT,Pistoia,13,1336,0,0,0,0,0,0,1336,1305,0,0,0,0,0,0,1305,2641
IT-PT,Pistoia,14,1398,0,0,0,0,0,0,1398,1286,0,0,0,0,0,0,1286,2684
IT-PT,Pistoia,15,1483,0,0,0,0,0,0,1483,1332,0,0,0,0,0,0,1332,2815
IT-PT,Pistoia,16,1444,0,0,0,0,0,0,1444,1292,0,0,0,0,0,0,1292,2736
IT-PT,Pistoia,17,1384,0,0,0,0,0,0,1384,1346,0,0,0,0,0,0,1346,2730
IT-PT,Pistoia,18,1396,0,0,0,0,0,0,1396,1276,2,0,0,0,0,0,1278,2674
IT-PT,Pistoia,19,1428,0,0,0,0,0,0,1428,1309,4,0,0,0,0,0,1313,2741
IT-PT,Pistoia,20,1379,4,0,0,0,0,0,1383,1248,11,0,0,0,0,0,1259,2642
IT-PT,Pistoia,21,1490,4,0,0,0,0,0,1494,1210,19,0,0,0,0,0,1229,2723
IT-PT,Pistoia,22,1376,6,0,0,0,0,0,1382,1292,39,1,0,0,0,0,1332,2714
IT-PT,Pistoia,23,1453,12,0,0,0,0,0,1465,1294,55,1,0,0,0,0,1350,2815
IT-PT,Pistoia,24,1370,8,0,0,1,0,0,1379,1157,74,1,0,0,0,0,1232,2611
IT-PT,Pistoia,25,1456,22,1,0,0,0,0,1479,1212,107,0,0,0,0,0,1319,2798
IT-PT,Pistoia,26,1335,44,6,0,0,0,0,1385,1182,139,3,0,0,0,0,1324,2709
IT-PT,Pistoia,27,1347,49,3,0,0,0,0,1399,1126,190,1,0,0,0,0,1317,2716
IT-PT,Pistoia,28,1296,83,1,0,0,0,0,1380,1016,240,10,0,2,0,0,1268,2648
IT-PT,Pistoia,29,1257,120,4,1,1,0,0,1383,1032,242,9,0,2,0,0,1285,2668
IT-PT,Pistoia,30,1229,167,2,0,2,0,0,1400,1006,322,8,0,0,1,0,1337,2737
IT-PT,Pistoia,31,1198,236,7,3,1,0,0,1445,937,480,16,0,2,1,0,1436,2881
IT-PT,Pistoia,32,1214,271,9,2,5,0,0,1501,859,494,21,2,5,0,0,1381,2882
IT-PT,Pistoia,33,1112,383,4,1,1,0,0,1501,864,572,18,3,3,0,1,1461,2962
IT-PT,Pistoia,34,1078,425,10,2,2,0,0,1517,861,598,22,4,7,0,0,1492,3009
IT-PT,Pistoia,35,1057,474,17,4,1,0,0,1553,777,735,27,5,3,0,0,1547,3100
IT-PT,Pistoia,36,936,568,18,0,4,0,0,1526,768,740,42,7,2,0,0,1559,3085
IT-PT,Pistoia,37,874,606,32,4,2,0,0,1518,704,841,66,4,2,0,0,1617,3135
IT-PT,Pistoia,38,900,635,33,2,3,0,0,1573,696,885,59,4,5,0,0,1649,3222
IT-PT,Pistoia,39,906,688,43,1,5,0,0,1643,634,841,72,7,2,1,0,1557,3200
IT-PT,Pistoia,40,827,818,42,1,2,0,0,1690,634,918,74,7,2,0,0,1635,3325
IT-PT,Pistoia,41,807,810,54,6,5,1,0,1683,640,1018,94,11,3,0,0,1766,3449
IT-PT,Pistoia,42,722,899,54,3,1,0,0,1679,600,1058,135,19,2,0,0,1814,3493
IT-PT,Pistoia,43,720,996,66,8,2,0,0,1792,587,1165,112,16,5,1,0,1886,3678
IT-PT,Pistoia,44,778,1042,86,5,1,0,0,1912,611,1184,143,21,3,0,0,1962,3874
IT-PT,Pistoia,45,783,1123,96,8,3,0,0,2013,588,1244,159,23,2,0,0,2016,4029
IT-PT,Pistoia,46,754,1172,118,7,4,0,0,2055,646,1353,156,31,1,0,0,2187,4242
IT-PT,Pistoia,47,782,1146,119,9,4,0,0,2060,626,1359,181,31,2,0,0,2199,4259
IT-PT,Pistoia,48,792,1327,146,8,3,0,0,2276,592,1514,227,35,4,1,0,2373,4649
IT-PT,Pistoia,49,755,1429,146,11,9,0,0,2350,564,1568,218,47,5,0,0,2402,4752
IT-PT,Pistoia,50,728,1460,164,7,5,0,0,2364,518,1597,265,53,3,0,0,2436,4800
IT-PT,Pistoia,51,723,1465,181,19,3,0,0,2391,484,1515,264,52,4,0,0,2319,4710
IT-PT,Pistoia,52,649,1523,196,22,2,0,0,2392,452,1718,284,54,3,0,0,2511,4903
IT-PT,Pistoia,53,612,1565,195,21,1,0,1,2395,422,1621,284,59,2,0,1,2389,4784
IT-PT,Pistoia,54,574,1651,208,21,2,0,0,2456,406,1718,251,68,3,0,0,2446,4902
IT-PT,Pistoia,55,523,1528,208,13,3,0,0,2275,397,1714,266,94,3,0,0,2474,4749
IT-PT,Pistoia,56,478,1591,188,17,5,0,0,2279,376,1703,285,85,3,0,0,2452,4731
IT-PT,Pistoia,57,441,1621,219,27,3,0,0,2311,337,1693,292,102,6,0,0,2430,4741
IT-PT,Pistoia,58,407,1672,221,31,4,0,0,2335,304,1661,281,109,2,0,0,2357,4692
IT-PT,Pistoia,59,391,1719,237,41,0,0,0,2388,267,1805,290,131,2,0,0,2495,4883
IT-PT,Pistoia,60,295,1656,205,23,6,0,0,2185,274,1684,260,137,2,0,0,2357,4542
IT-PT,Pistoia,61,283,1642,216,42,4,1,0,2188,236,1589,258,149,0,0,0,2232,4420
IT-PT,Pistoia,62,274,1622,151,45,1,0,1,2094,181,1639,241,191,1,0,0,2253,4347
IT-PT,Pistoia,63,214,1564,206,45,0,0,0,2029,174,1620,186,195,0,0,0,2175,4204
IT-PT,Pistoia,64,228,1535,159,42,1,0,0,1965,174,1501,207,203,1,0,0,2086,4051
IT-PT,Pistoia,65,195,1458,149,59,1,0,0,1862,159,1420,183,229,1,0,0,1992,3854
IT-PT,Pistoia,66,146,1427,138,55,1,0,0,1767,151,1435,166,273,0,0,0,2025,3792
IT-PT,Pistoia,67,133,1382,135,59,0,0,0,1709,113,1330,161,264,1,0,0,1869,3578
IT-PT,Pistoia,68,163,1385,118,72,1,0,0,1739,135,1281,154,303,1,0,0,1874,3613
IT-PT,Pistoia,69,126,1322,97,81,1,0,0,1627,112,1256,126,307,1,0,0,1802,3429
IT-PT,Pistoia,70,129,1254,97,80,0,0,0,1560,110,1137,127,344,0,0,0,1718,3278
IT-PT,Pistoia,71,99,1251,89,91,2,0,0,1532,98,1219,142,312,0,0,0,1771,3303
IT-PT,Pistoia,72,116,1290,98,89,0,0,0,1593,96,1150,108,384,1,0,0,1739,3332
IT-PT,Pistoia,73,89,1258,92,109,0,0,0,1548,83,1065,113,430,1,0,0,1692,3240
IT-PT,Pistoia,74,100,1219,75,115,1,0,0,1510,95,1135,81,455,1,0,0,1767,3277
IT-PT,Pistoia,75,109,1311,69,134,0,0,0,1623,95,1187,99,513,0,0,0,1894,3517
IT-PT,Pistoia,76,84,1370,56,131,1,0,0,1642,82,1138,113,591,0,0,0,1924,3566
IT-PT,Pistoia,77,94,1264,43,166,0,0,0,1567,89,1102,83,646,0,0,0,1920,3487
IT-PT,Pistoia,78,63,988,40,131,1,0,0,1223,65,785,58,594,0,0,0,1502,2725
IT-PT,Pistoia,79,59,911,41,129,0,0,0,1140,52,724,58,635,0,0,0,1469,2609
IT-PT,Pistoia,80,58,943,21,136,1,0,0,1159,58,710,51,641,0,0,0,1460,2619
IT-PT,Pistoia,81,59,770,31,137,1,0,0,998,53,609,42,654,0,0,0,1358,2356
IT-PT,Pistoia,82,50,754,22,162,1,0,0,989,54,579,47,702,0,0,0,1382,2371
IT-PT,Pistoia,83,47,744,24,193,0,0,0,1008,60,526,47,842,0,0,0,1475,2483
IT-PT,Pistoia,84,56,739,18,188,0,0,0,1001,52,436,31,819,0,0,0,1338,2339
IT-PT,Pistoia,85,41,614,16,187,0,0,0,858,47,375,24,822,0,0,0,1268,2126
IT-PT,Pistoia,86,39,548,15,191,0,0,0,793,63,286,28,839,0,0,0,1216,2009
IT-PT,Pistoia,87,36,415,8,174,0,0,0,633,59,219,24,764,0,0,0,1066,1699
IT-PT,Pistoia,88,26,399,8,142,0,0,0,575,45,175,16,724,0,0,0,960,1535
IT-PT,Pistoia,89,21,296,5,149,1,0,0,472,37,114,9,653,0,0,0,813,1285
IT-PT,Pistoia,90,14,215,4,117,0,0,0,350,31,77,10,572,0,0,0,690,1040
IT-PT,Pistoia,91,25,169,1,92,0,0,0,287,28,62,8,546,0,0,0,644,931
IT-PT,Pistoia,92,9,131,2,95,0,0,0,237,25,35,4,404,0,0,0,468,705
IT-PT,Pistoia,93,1,104,3,80,0,0,0,188,19,33,6,396,0,0,0,454,642
IT-PT,Pistoia,94,6,62,1,66,0,0,0,135,9,20,4,313,0,0,0,346,481
IT-PT,Pistoia,95,6,46,0,45,0,0,0,97,14,14,1,251,0,0,0,280,377
IT-PT,Pistoia,96,1,20,0,33,0,0,0,54,7,2,1,163,0,0,0,173,227
IT-PT,Pistoia,97,2,16,0,24,0,0,0,42,8,6,0,129,0,0,0,143,185
IT-PT,Pistoia,98,0,6,0,12,0,0,0,18,5,3,1,101,0,0,0,110,128
IT-PT,Pistoia,99,1,5,0,11,0,0,0,17,3,3,1,65,0,0,0,72,89
IT-PT,Pistoia,100,0,5,0,16,0,0,0,21,5,0,1,97,0,0,0,103,124
IT-PT,Pistoia,999,65356,65472,5587,4253,115,2,2,140787,55898,66437,7918,18736,106,5,2,149102,289889
IT-PN,Pordenone,0,973,0,0,0,0,0,0,973,1015,0,0,0,0,0,0,1015,1988
IT-PN,Pordenone,1,1076,0,0,0,0,0,0,1076,961,0,0,0,0,0,0,961,2037
IT-PN,Pordenone,2,1097,0,0,0,0,0,0,1097,1066,0,0,0,0,0,0,1066,2163
IT-PN,Pordenone,3,1096,0,0,0,0,0,0,1096,1075,0,0,0,0,0,0,1075,2171
IT-PN,Pordenone,4,1149,0,0,0,0,0,0,1149,1112,0,0,0,0,0,0,1112,2261
IT-PN,Pordenone,5,1224,0,0,0,0,0,0,1224,1110,0,0,0,0,0,0,1110,2334
IT-PN,Pordenone,6,1257,0,0,0,0,0,0,1257,1174,0,0,0,0,0,0,1174,2431
IT-PN,Pordenone,7,1317,0,0,0,0,0,0,1317,1267,0,0,0,0,0,0,1267,2584
IT-PN,Pordenone,8,1329,0,0,0,0,0,0,1329,1246,0,0,0,0,0,0,1246,2575
IT-PN,Pordenone,9,1426,0,0,0,0,0,0,1426,1318,0,0,0,0,0,0,1318,2744
IT-PN,Pordenone,10,1406,0,0,0,0,0,0,1406,1422,0,0,0,0,0,0,1422,2828
IT-PN,Pordenone,11,1469,0,0,0,0,0,0,1469,1358,0,0,0,0,0,0,1358,2827
IT-PN,Pordenone,12,1577,0,0,0,0,0,0,1577,1368,0,0,0,0,0,0,1368,2945
IT-PN,Pordenone,13,1564,0,0,0,0,0,0,1564,1453,0,0,0,0,0,0,1453,3017
IT-PN,Pordenone,14,1646,0,0,0,0,0,0,1646,1503,0,0,0,0,0,0,1503,3149
IT-PN,Pordenone,15,1613,0,0,0,0,0,0,1613,1490,0,0,0,0,0,0,1490,3103
IT-PN,Pordenone,16,1627,0,0,0,0,0,0,1627,1530,0,0,0,0,0,0,1530,3157
IT-PN,Pordenone,17,1594,0,0,0,0,0,0,1594,1482,0,0,0,0,0,0,1482,3076
IT-PN,Pordenone,18,1537,0,0,0,0,0,0,1537,1437,1,0,0,0,0,0,1438,2975
IT-PN,Pordenone,19,1557,0,0,0,1,0,0,1558,1519,6,0,0,0,0,0,1525,3083
IT-PN,Pordenone,20,1541,1,0,0,0,0,0,1542,1392,12,0,0,0,0,0,1404,2946
IT-PN,Pordenone,21,1527,2,0,0,0,0,0,1529,1376,22,0,0,0,0,0,1398,2927
IT-PN,Pordenone,22,1626,4,0,0,0,0,0,1630,1347,46,0,0,0,0,0,1393,3023
IT-PN,Pordenone,23,1617,17,3,0,0,0,0,1637,1427,79,1,0,0,0,0,1507,3144
IT-PN,Pordenone,24,1614,25,1,0,0,0,0,1640,1341,99,4,0,0,0,0,1444,3084
IT-PN,Pordenone,25,1580,50,1,0,1,0,0,1632,1273,155,1,1,1,0,0,1431,3063
IT-PN,Pordenone,26,1526,78,3,0,1,0,0,1608,1229,175,1,0,0,1,0,1406,3014
IT-PN,Pordenone,27,1615,86,2,0,0,0,0,1703,1193,249,6,0,0,0,0,1448,3151
IT-PN,Pordenone,28,1411,150,3,0,1,0,0,1565,1046,286,4,1,1,1,0,1339,2904
IT-PN,Pordenone,29,1461,188,3,0,1,0,0,1653,1022,355,8,4,0,0,0,1389,3042
IT-PN,Pordenone,30,1338,253,5,0,0,0,0,1596,986,426,6,0,1,1,0,1420,3016
IT-PN,Pordenone,31,1350,335,6,0,4,0,0,1695,967,526,14,0,2,0,0,1509,3204
IT-PN,Pordenone,32,1303,365,8,2,2,0,0,1680,890,658,20,2,0,0,0,1570,3250
IT-PN,Pordenone,33,1230,466,11,6,0,0,0,1713,849,698,16,1,2,0,0,1566,3279
IT-PN,Pordenone,34,1143,514,10,4,1,0,0,1672,791,741,22,1,3,0,0,1558,3230
IT-PN,Pordenone,35,1092,572,15,3,1,0,0,1683,755,863,33,3,2,0,0,1656,3339
IT-PN,Pordenone,36,967,670,17,1,3,0,0,1658,641,866,49,6,0,0,0,1562,3220
IT-PN,Pordenone,37,910,720,34,0,1,0,0,1665,647,947,64,10,1,0,0,1669,3334
IT-PN,Pordenone,38,905,764,32,0,1,0,0,1702,657,1015,54,7,0,0,0,1733,3435
IT-PN,Pordenone,39,866,899,33,1,5,0,0,1804,615,1002,73,4,3,1,0,1698,3502
IT-PN,Pordenone,40,887,854,41,5,0,0,0,1787,595,1054,79,8,0,0,0,1736,3523
IT-PN,Pordenone,41,853,999,49,1,0,0,0,1902,629,1182,116,13,1,0,0,1941,3843
IT-PN,Pordenone,42,876,1061,58,8,0,0,0,2003,578,1190,110,13,0,0,0,1891,3894
IT-PN,Pordenone,43,833,1115,69,8,3,0,0,2028,600,1211,125,19,0,1,0,1956,3984
IT-PN,Pordenone,44,840,1168,85,8,0,0,0,2101,553,1276,114,30,3,0,0,1976,4077
IT-PN,Pordenone,45,933,1278,89,6,1,0,0,2307,592,1341,163,33,1,0,0,2130,4437
IT-PN,Pordenone,46,851,1342,115,7,1,0,0,2316,551,1415,158,21,2,0,0,2147,4463
IT-PN,Pordenone,47,898,1389,107,6,3,0,0,2403,572,1496,165,46,1,1,0,2281,4684
IT-PN,Pordenone,48,901,1410,133,10,5,0,0,2459,591,1574,186,37,0,0,0,2388,4847
IT-PN,Pordenone,49,857,1552,155,18,3,0,0,2585,557,1729,267,49,0,0,0,2602,5187
IT-PN,Pordenone,50,832,1574,134,9,2,0,0,2551,520,1665,241,44,1,0,0,2471,5022
IT-PN,Pordenone,51,723,1577,174,11,1,0,0,2486,475,1855,239,53,0,0,0,2622,5108
IT-PN,Pordenone,52,728,1618,202,24,1,0,0,2573,483,1738,245,66,0,0,0,2532,5105
IT-PN,Pordenone,53,693,1567,211,13,1,0,0,2485,493,1791,266,77,0,0,0,2627,5112
IT-PN,Pordenone,54,676,1682,207,19,3,0,0,2587,459,1785,257,75,0,0,0,2576,5163
IT-PN,Pordenone,55,624,1798,197,28,1,0,0,2648,461,1798,256,96,2,0,0,2613,5261
IT-PN,Pordenone,56,561,1767,210,29,3,0,0,2570,415,1827,292,96,0,1,0,2631,5201
IT-PN,Pordenone,57,497,1683,216,34,3,0,0,2433,396,1756,287,122,0,0,0,2561,4994
IT-PN,Pordenone,58,519,1743,202,19,2,0,0,2485,345,1740,269,117,1,0,0,2472,4957
IT-PN,Pordenone,59,470,1803,221,29,2,0,0,2525,369,1827,272,129,1,0,0,2598,5123
IT-PN,Pordenone,60,425,1711,203,36,1,0,0,2376,302,1795,238,152,0,0,0,2487,4863
IT-PN,Pordenone,61,376,1600,202,40,1,0,0,2219,281,1679,220,175,0,0,0,2355,4574
IT-PN,Pordenone,62,355,1633,175,53,1,0,0,2217,202,1637,217,164,0,0,0,2220,4437
IT-PN,Pordenone,63,293,1533,179,34,2,0,0,2041,200,1545,218,188,0,0,0,2151,4192
IT-PN,Pordenone,64,297,1523,163,52,0,0,0,2035,186,1535,219,237,0,0,0,2177,4212
IT-PN,Pordenone,65,237,1400,161,45,1,0,0,1844,185,1453,188,217,1,0,0,2044,3888
IT-PN,Pordenone,66,259,1420,121,55,2,0,0,1857,174,1451,181,246,1,0,0,2053,3910
IT-PN,Pordenone,67,219,1420,122,68,0,0,0,1829,156,1301,155,303,0,0,0,1915,3744
IT-PN,Pordenone,68,200,1346,118,60,0,0,0,1724,140,1309,132,305,1,0,0,1887,3611
IT-PN,Pordenone,69,182,1338,106,74,1,0,0,1701,148,1318,157,335,0,0,0,1958,3659
IT-PN,Pordenone,70,176,1344,110,80,0,0,0,1710,121,1249,125,328,0,0,0,1823,3533
IT-PN,Pordenone,71,174,1312,88,82,0,0,0,1656,120,1303,127,378,0,0,0,1928,3584
IT-PN,Pordenone,72,175,1281,65,102,0,0,0,1623,125,1195,111,415,0,0,0,1846,3469
IT-PN,Pordenone,73,162,1352,76,120,0,0,0,1710,109,1210,103,459,1,0,0,1882,3592
IT-PN,Pordenone,74,147,1287,79,102,0,0,0,1615,95,1096,82,490,0,0,0,1763,3378
IT-PN,Pordenone,75,128,1402,74,129,0,0,0,1733,97,1176,91,536,0,0,0,1900,3633
IT-PN,Pordenone,76,117,1274,45,138,0,0,0,1574,95,1080,63,608,0,0,0,1846,3420
IT-PN,Pordenone,77,128,1350,51,153,0,0,0,1682,107,1087,68,673,0,0,0,1935,3617
IT-PN,Pordenone,78,84,913,37,110,0,0,0,1144,64,669,50,502,0,0,0,1285,2429
IT-PN,Pordenone,79,105,1010,32,151,0,0,0,1298,72,739,47,698,0,0,0,1556,2854
IT-PN,Pordenone,80,99,931,34,152,1,0,0,1217,68,718,49,679,0,0,0,1514,2731
IT-PN,Pordenone,81,94,887,36,147,0,0,0,1164,89,648,49,750,0,0,0,1536,2700
IT-PN,Pordenone,82,80,834,12,159,0,0,0,1085,61,539,38,770,0,0,0,1408,2493
IT-PN,Pordenone,83,75,788,28,197,0,0,0,1088,72,488,36,865,0,0,0,1461,2549
IT-PN,Pordenone,84,53,735,12,162,0,0,1,963,76,408,25,878,0,0,0,1387,2350
IT-PN,Pordenone,85,50,622,13,172,0,0,0,857,52,339,22,844,0,0,0,1257,2114
IT-PN,Pordenone,86,42,545,12,144,0,0,0,743,50,254,26,784,0,0,0,1114,1857
IT-PN,Pordenone,87,28,374,9,145,0,0,0,556,53,181,16,705,0,0,0,955,1511
IT-PN,Pordenone,88,32,335,8,143,0,0,0,518,27,137,19,630,0,0,0,813,1331
IT-PN,Pordenone,89,26,232,5,104,0,0,0,367,49,105,13,615,0,0,0,782,1149
IT-PN,Pordenone,90,17,202,1,105,0,0,0,325,39,70,8,535,0,0,0,652,977
IT-PN,Pordenone,91,11,161,2,92,0,0,0,266,24,51,10,517,0,0,0,602,868
IT-PN,Pordenone,92,13,127,5,55,0,0,0,200,37,35,4,433,0,0,0,509,709
IT-PN,Pordenone,93,8,90,4,73,0,0,0,175,25,28,3,374,0,0,0,430,605
IT-PN,Pordenone,94,4,50,1,56,0,0,0,111,22,10,3,339,0,0,0,374,485
IT-PN,Pordenone,95,5,37,1,33,0,0,0,76,20,8,3,237,0,0,0,268,344
IT-PN,Pordenone,96,2,19,1,30,0,0,0,52,16,4,3,180,0,0,0,203,255
IT-PN,Pordenone,97,1,9,0,20,0,0,0,30,12,3,1,163,0,0,0,179,209
IT-PN,Pordenone,98,1,13,0,19,0,0,0,33,7,2,1,104,0,0,0,114,147
IT-PN,Pordenone,99,0,5,0,12,0,0,0,17,4,1,0,71,0,0,0,76,93
IT-PN,Pordenone,100,2,8,0,20,0,0,0,30,7,1,1,108,0,0,0,117,147
IT-PN,Pordenone,999,74090,69592,5453,4033,68,0,1,153237,60373,70334,7605,19174,33,7,0,157526,310763
IT-PZ,Potenza,0,982,0,0,0,0,0,0,982,984,0,0,0,0,0,0,984,1966
IT-PZ,Potenza,1,1107,0,0,0,0,0,0,1107,949,0,0,0,0,0,0,949,2056
IT-PZ,Potenza,2,1060,0,0,0,0,0,0,1060,988,0,0,0,0,0,0,988,2048
IT-PZ,Potenza,3,1191,0,0,0,0,0,0,1191,1032,0,0,0,0,0,0,1032,2223
IT-PZ,Potenza,4,1212,0,0,0,0,0,0,1212,1103,0,0,0,0,0,0,1103,2315
IT-PZ,Potenza,5,1209,0,0,0,0,0,0,1209,1123,0,0,0,0,0,0,1123,2332
IT-PZ,Potenza,6,1308,0,0,0,0,0,0,1308,1194,0,0,0,0,0,0,1194,2502
IT-PZ,Potenza,7,1287,0,0,0,0,0,0,1287,1200,0,0,0,0,0,0,1200,2487
IT-PZ,Potenza,8,1314,0,0,0,0,0,0,1314,1273,0,0,0,0,0,0,1273,2587
IT-PZ,Potenza,9,1322,0,0,0,0,0,0,1322,1228,0,0,0,0,0,0,1228,2550
IT-PZ,Potenza,10,1298,0,0,0,0,0,0,1298,1215,0,0,0,0,0,0,1215,2513
IT-PZ,Potenza,11,1496,0,0,0,0,0,0,1496,1321,0,0,0,0,0,0,1321,2817
IT-PZ,Potenza,12,1449,0,0,0,0,0,0,1449,1326,0,0,0,0,0,0,1326,2775
IT-PZ,Potenza,13,1479,0,0,0,0,0,0,1479,1392,0,0,0,0,0,0,1392,2871
IT-PZ,Potenza,14,1590,0,0,0,0,0,0,1590,1435,0,0,0,0,0,0,1435,3025
IT-PZ,Potenza,15,1618,0,0,0,0,0,0,1618,1474,0,0,0,0,0,0,1474,3092
IT-PZ,Potenza,16,1650,0,0,0,0,0,0,1650,1492,0,0,0,0,0,0,1492,3142
IT-PZ,Potenza,17,1648,0,0,0,0,0,0,1648,1546,0,0,0,0,0,0,1546,3194
IT-PZ,Potenza,18,1704,0,0,0,0,0,0,1704,1527,0,0,0,0,0,0,1527,3231
IT-PZ,Potenza,19,1783,0,0,0,0,0,0,1783,1634,2,0,0,1,0,0,1637,3420
IT-PZ,Potenza,20,1797,1,0,0,0,0,0,1798,1574,5,1,0,0,0,0,1580,3378
IT-PZ,Potenza,21,1846,0,0,0,0,0,0,1846,1638,7,1,0,0,0,0,1646,3492
IT-PZ,Potenza,22,1880,2,0,0,0,0,0,1882,1627,11,0,0,0,0,0,1638,3520
IT-PZ,Potenza,23,1879,9,0,0,0,0,0,1888,1670,20,0,0,0,0,0,1690,3578
IT-PZ,Potenza,24,1894,13,1,0,0,0,0,1908,1688,40,1,0,0,0,0,1729,3637
IT-PZ,Potenza,25,1936,17,1,0,0,0,0,1954,1545,95,2,0,1,0,0,1643,3597
IT-PZ,Potenza,26,1847,45,0,0,0,0,0,1892,1477,128,1,0,0,0,0,1606,3498
IT-PZ,Potenza,27,1810,64,0,0,0,0,0,1874,1397,220,1,1,0,0,0,1619,3493
IT-PZ,Potenza,28,1756,91,1,0,0,0,0,1848,1427,272,1,1,0,0,0,1701,3549
IT-PZ,Potenza,29,1725,166,1,0,0,0,0,1892,1372,354,4,2,0,0,0,1732,3624
IT-PZ,Potenza,30,1684,239,3,0,1,0,0,1927,1241,435,5,0,0,0,0,1681,3608
IT-PZ,Potenza,31,1721,293,5,0,1,0,0,2020,1284,576,8,5,1,0,0,1874,3894
IT-PZ,Potenza,32,1477,417,7,1,0,0,0,1902,1106,686,11,2,0,0,0,1805,3707
IT-PZ,Potenza,33,1479,514,3,0,1,0,0,1997,1035,809,14,0,0,0,0,1858,3855
IT-PZ,Potenza,34,1431,596,9,3,1,0,0,2040,907,903,22,4,0,0,0,1836,3876
IT-PZ,Potenza,35,1286,729,8,3,1,0,0,2027,839,958,31,3,1,0,0,1832,3859
IT-PZ,Potenza,36,1247,745,17,0,0,0,0,2009,764,1031,34,4,2,0,0,1835,3844
IT-PZ,Potenza,37,1123,845,14,2,2,0,0,1986,683,1109,25,7,1,0,0,1825,3811
IT-PZ,Potenza,38,1147,949,17,2,1,0,0,2116,666,1152,38,5,0,0,0,1861,3977
IT-PZ,Potenza,39,1019,1032,31,1,0,0,0,2083,665,1244,50,9,0,0,0,1968,4051
IT-PZ,Potenza,40,984,1023,24,2,0,0,0,2033,587,1296,61,17,0,0,0,1961,3994
IT-PZ,Potenza,41,911,1103,33,0,1,0,0,2048,595,1430,49,16,0,0,0,2090,4138
IT-PZ,Potenza,42,844,1138,27,6,0,0,0,2015,480,1431,63,13,0,0,0,1987,4002
IT-PZ,Potenza,43,814,1204,48,5,0,0,0,2071,479,1453,72,11,0,0,0,2015,4086
IT-PZ,Potenza,44,826,1289,39,4,0,0,0,2158,428,1515,79,27,2,0,0,2051,4209
IT-PZ,Potenza,45,799,1394,53,2,0,0,0,2248,422,1629,76,21,0,0,0,2148,4396
IT-PZ,Potenza,46,772,1428,59,11,0,0,0,2270,405,1754,93,24,0,0,0,2276,4546
IT-PZ,Potenza,47,795,1594,68,10,1,0,0,2468,468,1828,106,44,0,0,0,2446,4914
IT-PZ,Potenza,48,726,1604,79,10,0,0,0,2419,455,1971,102,38,0,0,0,2566,4985
IT-PZ,Potenza,49,740,1739,78,6,1,0,0,2564,437,1941,101,52,0,0,0,2531,5095
IT-PZ,Potenza,50,663,1767,82,15,2,0,0,2529,423,2002,121,57,1,0,0,2604,5133
IT-PZ,Potenza,51,644,1805,97,19,0,0,0,2565,430,2084,136,69,1,0,0,2720,5285
IT-PZ,Potenza,52,587,1922,85,21,0,0,0,2615,388,2126,119,72,0,0,0,2705,5320
IT-PZ,Potenza,53,540,1977,104,24,1,0,0,2646,376,2203,122,93,0,0,0,2794,5440
IT-PZ,Potenza,54,568,2213,105,24,1,0,0,2911,371,2247,120,110,0,0,0,2848,5759
IT-PZ,Potenza,55,547,2125,93,24,0,0,0,2789,349,2228,136,139,0,0,0,2852,5641
IT-PZ,Potenza,56,496,2246,107,40,0,0,0,2889,346,2385,135,158,1,0,0,3025,5914
IT-PZ,Potenza,57,470,2118,80,36,1,0,0,2705,335,2333,117,169,0,0,0,2954,5659
IT-PZ,Potenza,58,489,2246,97,40,0,0,0,2872,337,2298,131,170,0,0,0,2936,5808
IT-PZ,Potenza,59,429,2332,110,55,0,0,0,2926,336,2399,134,203,0,0,0,3072,5998
IT-PZ,Potenza,60,381,2228,118,51,0,0,0,2778,327,2276,103,208,1,0,0,2915,5693
IT-PZ,Potenza,61,388,2395,97,46,0,0,0,2926,295,2240,118,239,0,0,0,2892,5818
IT-PZ,Potenza,62,315,2240,93,61,0,0,0,2709,272,2163,104,295,0,0,0,2834,5543
IT-PZ,Potenza,63,278,2227,82,58,0,0,0,2645,269,2126,112,303,0,0,0,2810,5455
IT-PZ,Potenza,64,304,2048,74,61,0,0,0,2487,253,1964,81,330,0,0,0,2628,5115
IT-PZ,Potenza,65,247,2035,79,61,2,0,0,2424,257,1867,76,318,0,0,0,2518,4942
IT-PZ,Potenza,66,237,1886,81,63,0,0,0,2267,213,1906,66,391,0,0,0,2576,4843
IT-PZ,Potenza,67,203,1974,80,83,0,0,0,2340,214,1824,75,431,0,0,0,2544,4884
IT-PZ,Potenza,68,194,1987,72,100,1,0,0,2354,175,1706,59,392,0,0,0,2332,4686
IT-PZ,Potenza,69,181,1917,52,88,0,0,0,2238,195,1691,72,480,0,0,0,2438,4676
IT-PZ,Potenza,70,171,1794,53,99,0,0,0,2117,188,1478,58,472,0,0,0,2196,4313
IT-PZ,Potenza,71,132,1689,44,112,0,0,0,1977,189,1467,47,492,0,0,0,2195,4172
IT-PZ,Potenza,72,114,1640,48,116,0,0,0,1918,131,1397,31,571,0,0,0,2130,4048
IT-PZ,Potenza,73,110,1733,38,130,0,0,0,2011,150,1308,41,623,0,0,0,2122,4133
IT-PZ,Potenza,74,114,1726,36,123,0,0,0,1999,137,1233,48,692,0,0,0,2110,4109
IT-PZ,Potenza,75,107,1629,33,140,0,0,0,1909,149,1226,33,837,0,0,0,2245,4154
IT-PZ,Potenza,76,108,1411,21,141,0,0,0,1681,136,1088,27,808,0,0,0,2059,3740
IT-PZ,Potenza,77,84,1274,27,143,0,0,0,1528,114,945,22,764,0,0,0,1845,3373
IT-PZ,Potenza,78,53,890,19,111,0,0,0,1073,102,643,19,647,0,0,0,1411,2484
IT-PZ,Potenza,79,52,903,13,112,0,0,0,1080,83,550,12,649,0,0,0,1294,2374
IT-PZ,Potenza,80,49,842,8,151,0,0,0,1050,80,542,15,654,0,0,0,1291,2341
IT-PZ,Potenza,81,35,777,10,139,0,0,0,961,68,492,14,736,0,0,0,1310,2271
IT-PZ,Potenza,82,44,756,8,165,0,0,0,973,72,466,10,734,0,0,0,1282,2255
IT-PZ,Potenza,83,54,842,16,192,0,0,0,1104,68,423,16,930,0,0,0,1437,2541
IT-PZ,Potenza,84,31,820,9,188,0,0,0,1048,80,452,8,955,0,0,0,1495,2543
IT-PZ,Potenza,85,25,738,12,225,0,0,0,1000,90,332,6,967,0,0,0,1395,2395
IT-PZ,Potenza,86,32,578,8,217,0,0,0,835,79,288,11,946,0,0,0,1324,2159
IT-PZ,Potenza,87,29,510,6,210,0,0,0,755,61,202,3,896,0,0,0,1162,1917
IT-PZ,Potenza,88,22,447,3,161,0,0,0,633,70,183,7,797,0,0,0,1057,1690
IT-PZ,Potenza,89,16,334,2,183,0,0,0,535,60,152,4,820,0,0,0,1036,1571
IT-PZ,Potenza,90,11,268,3,172,0,0,0,454,39,98,4,703,0,0,0,844,1298
IT-PZ,Potenza,91,6,195,0,161,0,0,0,362,39,72,4,550,0,0,0,665,1027
IT-PZ,Potenza,92,11,141,0,111,0,0,0,263,35,45,5,494,0,0,0,579,842
IT-PZ,Potenza,93,10,85,1,99,0,0,0,195,30,26,1,452,0,0,0,509,704
IT-PZ,Potenza,94,4,79,0,92,0,0,0,175,29,25,2,342,0,0,0,398,573
IT-PZ,Potenza,95,5,39,1,66,0,0,0,111,20,14,0,233,0,0,0,267,378
IT-PZ,Potenza,96,1,38,0,52,0,0,0,91,11,12,1,192,0,0,0,216,307
IT-PZ,Potenza,97,2,14,0,27,0,0,0,43,9,4,1,136,0,0,0,150,193
IT-PZ,Potenza,98,0,6,0,25,0,0,0,31,10,5,1,89,0,0,0,105,136
IT-PZ,Potenza,99,1,2,0,13,0,0,0,16,4,6,0,62,0,0,0,72,88
IT-PZ,Potenza,100,2,7,0,32,0,0,0,41,7,5,0,99,0,0,0,111,152
IT-PZ,Potenza,999,77498,84178,2833,4946,19,0,0,169474,63298,83552,3640,23275,13,0,0,173778,343252
IT-PO,Prato,0,805,0,0,0,0,0,0,805,702,0,0,0,0,0,0,702,1507
IT-PO,Prato,1,770,0,0,0,0,0,0,770,727,0,0,0,0,0,0,727,1497
IT-PO,Prato,2,870,0,0,0,0,0,0,870,784,0,0,0,0,0,0,784,1654
IT-PO,Prato,3,885,0,0,0,0,0,0,885,831,0,0,0,0,0,0,831,1716
IT-PO,Prato,4,959,0,0,0,0,0,0,959,876,0,0,0,0,0,0,876,1835
IT-PO,Prato,5,1012,0,0,0,0,0,0,1012,943,0,0,0,0,0,0,943,1955
IT-PO,Prato,6,1126,0,0,0,0,0,0,1126,1000,0,0,0,0,0,0,1000,2126
IT-PO,Prato,7,1120,0,0,0,0,0,0,1120,1078,0,0,0,0,0,0,1078,2198
IT-PO,Prato,8,1126,0,0,0,0,0,0,1126,1029,0,0,0,0,0,0,1029,2155
IT-PO,Prato,9,1205,0,0,0,0,0,0,1205,1092,0,0,0,0,0,0,1092,2297
IT-PO,Prato,10,1198,0,0,0,0,0,0,1198,1108,0,0,0,0,0,0,1108,2306
IT-PO,Prato,11,1267,0,0,0,0,0,0,1267,1231,0,0,0,0,0,0,1231,2498
IT-PO,Prato,12,1285,0,0,0,0,0,0,1285,1233,0,0,0,0,0,0,1233,2518
IT-PO,Prato,13,1440,0,0,0,0,0,0,1440,1243,0,0,0,0,0,0,1243,2683
IT-PO,Prato,14,1430,0,0,0,0,0,0,1430,1297,0,0,0,0,0,0,1297,2727
IT-PO,Prato,15,1442,0,0,0,0,0,0,1442,1319,0,0,0,0,0,0,1319,2761
IT-PO,Prato,16,1433,0,0,0,0,0,0,1433,1338,0,0,0,0,0,0,1338,2771
IT-PO,Prato,17,1486,0,0,0,0,0,0,1486,1376,0,0,0,0,0,0,1376,2862
IT-PO,Prato,18,1500,0,0,0,0,0,0,1500,1342,1,0,0,0,0,0,1343,2843
IT-PO,Prato,19,1371,0,0,0,0,0,0,1371,1297,1,0,0,0,0,0,1298,2669
IT-PO,Prato,20,1378,1,0,0,0,0,0,1379,1235,6,0,0,0,0,0,1241,2620
IT-PO,Prato,21,1381,0,0,0,0,0,0,1381,1224,9,0,0,0,0,0,1233,2614
IT-PO,Prato,22,1355,0,3,0,0,0,0,1358,1172,24,2,0,0,0,0,1198,2556
IT-PO,Prato,23,1397,5,8,0,0,0,0,1410,1209,29,2,0,0,0,0,1240,2650
IT-PO,Prato,24,1321,17,4,0,0,0,0,1342,1093,36,5,0,0,0,0,1134,2476
IT-PO,Prato,25,1321,19,3,0,0,0,0,1343,1155,54,1,0,0,0,0,1210,2553
IT-PO,Prato,26,1304,17,4,0,0,0,0,1325,1031,78,1,1,0,0,0,1111,2436
IT-PO,Prato,27,1248,39,1,0,0,0,0,1288,995,136,3,0,1,0,0,1135,2423
IT-PO,Prato,28,1230,64,6,0,1,0,0,1301,972,165,3,0,0,0,0,1140,2441
IT-PO,Prato,29,1141,90,0,0,0,0,0,1231,940,245,7,1,1,0,0,1194,2425
IT-PO,Prato,30,1165,140,4,0,2,0,0,1311,937,266,10,0,1,0,0,1214,2525
IT-PO,Prato,31,1176,187,7,0,0,0,0,1370,964,350,11,3,3,0,0,1331,2701
IT-PO,Prato,32,1112,261,7,3,0,0,0,1383,863,441,16,3,3,0,0,1326,2709
IT-PO,Prato,33,1262,338,6,4,4,0,0,1614,828,470,19,2,2,0,0,1321,2935
IT-PO,Prato,34,1150,348,10,10,1,0,0,1519,877,575,22,0,2,0,0,1476,2995
IT-PO,Prato,35,1110,424,12,5,1,0,0,1552,869,631,33,1,3,0,0,1537,3089
IT-PO,Prato,36,1045,554,20,4,0,0,0,1623,779,751,47,8,4,0,0,1589,3212
IT-PO,Prato,37,941,560,39,7,3,1,0,1551,773,794,65,12,2,1,0,1647,3198
IT-PO,Prato,38,938,671,40,3,0,0,0,1652,674,843,76,13,3,0,0,1609,3261
IT-PO,Prato,39,902,708,40,9,3,0,0,1662,687,943,62,14,2,0,0,1708,3370
IT-PO,Prato,40,922,757,42,7,5,0,0,1733,670,947,73,8,1,0,0,1699,3432
IT-PO,Prato,41,874,873,55,0,1,0,0,1803,715,1022,78,20,5,1,0,1841,3644
IT-PO,Prato,42,799,975,63,18,2,0,0,1857,638,1017,109,25,4,0,0,1793,3650
IT-PO,Prato,43,850,909,65,12,3,0,0,1839,628,1014,95,33,1,2,0,1773,3612
IT-PO,Prato,44,769,966,70,15,4,0,0,1824,544,1190,113,38,0,1,0,1886,3710
IT-PO,Prato,45,832,1050,92,21,4,0,0,1999,648,1120,123,44,2,0,0,1937,3936
IT-PO,Prato,46,819,1074,63,20,4,0,0,1980,608,1193,172,38,2,0,0,2013,3993
IT-PO,Prato,47,795,1150,116,18,4,0,0,2083,622,1348,165,46,3,0,0,2184,4267
IT-PO,Prato,48,845,1216,118,28,3,0,0,2210,591,1352,158,58,2,1,0,2162,4372
IT-PO,Prato,49,779,1276,111,21,7,1,1,2196,535,1417,189,54,2,0,0,2197,4393
IT-PO,Prato,50,773,1335,148,23,10,0,0,2289,581,1461,235,48,4,0,0,2329,4618
IT-PO,Prato,51,750,1345,143,20,4,0,0,2262,494,1401,214,61,0,0,0,2170,4432
IT-PO,Prato,52,601,1434,150,15,11,0,0,2211,471,1491,212,85,2,0,0,2261,4472
IT-PO,Prato,53,624,1470,137,10,6,0,0,2247,414,1424,196,93,0,0,0,2127,4374
IT-PO,Prato,54,550,1507,149,13,3,0,0,2222,416,1453,209,77,3,0,0,2158,4380
IT-PO,Prato,55,504,1453,150,17,4,0,0,2128,383,1499,206,88,1,0,0,2177,4305
IT-PO,Prato,56,462,1344,159,21,1,1,0,1988,335,1488,202,89,2,0,0,2116,4104
IT-PO,Prato,57,446,1423,201,27,8,0,0,2105,339,1480,213,98,3,0,0,2133,4238
IT-PO,Prato,58,406,1460,180,33,5,0,0,2084,281,1504,216,119,1,0,0,2121,4205
IT-PO,Prato,59,353,1478,155,35,5,0,0,2026,234,1538,193,135,2,0,0,2102,4128
IT-PO,Prato,60,311,1356,171,32,4,0,0,1874,236,1372,196,133,1,0,0,1938,3812
IT-PO,Prato,61,245,1359,148,34,0,0,0,1786,193,1374,197,143,0,0,0,1907,3693
IT-PO,Prato,62,202,1237,134,29,3,0,0,1605,187,1297,195,123,1,0,0,1803,3408
IT-PO,Prato,63,182,1260,117,45,0,0,0,1604,163,1238,175,157,0,0,0,1733,3337
IT-PO,Prato,64,198,1172,106,58,0,0,0,1534,153,1164,146,141,1,0,0,1605,3139
IT-PO,Prato,65,161,1138,125,48,1,0,0,1473,125,1170,143,184,0,0,0,1622,3095
IT-PO,Prato,66,148,1185,96,51,0,0,0,1480,136,1115,125,184,0,0,0,1560,3040
IT-PO,Prato,67,115,1155,70,58,0,0,0,1398,128,1113,116,224,0,0,0,1581,2979
IT-PO,Prato,68,110,1137,76,58,1,0,0,1382,100,1097,97,231,0,0,0,1525,2907
IT-PO,Prato,69,85,1009,90,82,1,0,0,1267,94,1014,114,251,1,0,0,1474,2741
IT-PO,Prato,70,72,1011,56,78,0,0,0,1217,90,961,81,244,1,0,0,1377,2594
IT-PO,Prato,71,87,980,59,74,1,0,0,1201,75,983,89,275,0,0,0,1422,2623
IT-PO,Prato,72,73,985,47,68,1,0,0,1174,62,911,66,305,0,0,0,1344,2518
IT-PO,Prato,73,60,996,45,79,1,0,0,1181,57,936,73,334,0,0,0,1400,2581
IT-PO,Prato,74,80,1022,54,76,0,0,0,1232,72,963,63,398,0,0,0,1496,2728
IT-PO,Prato,75,69,1078,39,97,1,0,0,1284,68,899,70,431,0,0,0,1468,2752
IT-PO,Prato,76,60,1017,42,105,0,0,0,1224,63,882,62,465,0,0,1,1473,2697
IT-PO,Prato,77,66,1010,33,101,2,0,0,1212,70,819,66,490,0,0,0,1445,2657
IT-PO,Prato,78,53,757,24,81,0,0,0,915,44,641,39,416,0,0,0,1140,2055
IT-PO,Prato,79,23,696,16,108,0,0,0,843,56,574,41,466,0,0,0,1137,1980
IT-PO,Prato,80,35,718,16,114,1,0,0,884,48,552,30,496,0,0,0,1126,2010
IT-PO,Prato,81,43,603,13,100,0,0,0,759,44,442,35,487,0,0,0,1008,1767
IT-PO,Prato,82,33,600,13,122,0,0,0,768,43,428,25,528,0,0,0,1024,1792
IT-PO,Prato,83,49,610,12,147,0,0,0,818,40,438,30,667,0,0,0,1175,1993
IT-PO,Prato,84,44,573,10,153,0,0,0,780,49,357,27,630,0,0,0,1063,1843
IT-PO,Prato,85,30,547,9,149,0,0,0,735,49,289,20,726,0,0,0,1084,1819
IT-PO,Prato,86,23,383,12,129,0,0,0,547,35,213,20,611,0,0,0,879,1426
IT-PO,Prato,87,22,332,7,140,0,0,0,501,29,173,10,528,0,0,0,740,1241
IT-PO,Prato,88,18,267,6,117,0,0,0,408,30,126,12,540,0,0,0,708,1116
IT-PO,Prato,89,14,203,7,97,0,0,0,321,21,82,4,478,0,0,0,585,906
IT-PO,Prato,90,11,162,2,87,0,0,0,262,32,65,9,430,0,0,0,536,798
IT-PO,Prato,91,13,133,4,76,0,0,0,226,17,46,7,392,0,0,0,462,688
IT-PO,Prato,92,8,100,4,60,0,0,0,172,11,42,2,323,0,0,0,378,550
IT-PO,Prato,93,7,71,1,64,0,0,0,143,25,25,2,282,0,0,0,334,477
IT-PO,Prato,94,5,46,1,35,0,0,0,87,8,5,2,215,0,0,0,230,317
IT-PO,Prato,95,3,34,0,31,0,0,0,68,8,3,0,182,0,0,0,193,261
IT-PO,Prato,96,1,15,1,35,0,0,0,52,6,7,1,110,0,0,0,124,176
IT-PO,Prato,97,1,13,0,16,0,0,0,30,7,0,0,91,0,0,0,98,128
IT-PO,Prato,98,0,6,0,9,0,0,0,15,5,0,0,59,0,0,0,64,79
IT-PO,Prato,99,0,1,1,10,0,0,0,12,8,1,0,53,0,0,0,62,74
IT-PO,Prato,100,0,3,0,11,0,0,0,14,8,0,0,70,0,0,0,78,92
IT-PO,Prato,999,64120,55918,4248,3483,126,3,1,127899,53965,57024,6146,14808,72,6,1,132022,259921
IT-RG,Ragusa,0,1300,0,0,0,0,0,0,1300,1216,0,0,0,0,0,0,1216,2516
IT-RG,Ragusa,1,1416,0,0,0,0,0,0,1416,1280,0,0,0,0,0,0,1280,2696
IT-RG,Ragusa,2,1388,0,0,0,0,0,0,1388,1387,0,0,0,0,0,0,1387,2775
IT-RG,Ragusa,3,1407,0,0,0,0,0,0,1407,1298,0,0,0,0,0,0,1298,2705
IT-RG,Ragusa,4,1427,0,0,0,0,0,0,1427,1291,0,0,0,0,0,0,1291,2718
IT-RG,Ragusa,5,1445,0,0,0,0,0,0,1445,1404,0,0,0,0,0,0,1404,2849
IT-RG,Ragusa,6,1504,0,0,0,0,0,0,1504,1461,0,0,0,0,0,0,1461,2965
IT-RG,Ragusa,7,1541,0,0,0,0,0,0,1541,1425,0,0,0,0,0,0,1425,2966
IT-RG,Ragusa,8,1503,0,0,0,0,0,0,1503,1465,0,0,0,0,0,0,1465,2968
IT-RG,Ragusa,9,1523,0,0,0,0,0,0,1523,1425,0,0,0,0,0,0,1425,2948
IT-RG,Ragusa,10,1543,0,0,0,0,0,0,1543,1427,0,0,0,0,0,0,1427,2970
IT-RG,Ragusa,11,1549,0,0,0,0,0,0,1549,1524,0,0,0,0,0,0,1524,3073
IT-RG,Ragusa,12,1672,0,0,0,0,0,0,1672,1503,0,0,0,0,0,0,1503,3175
IT-RG,Ragusa,13,1642,0,0,0,0,0,0,1642,1536,0,0,0,0,0,0,1536,3178
IT-RG,Ragusa,14,1680,0,0,0,0,0,0,1680,1650,0,0,0,0,0,0,1650,3330
IT-RG,Ragusa,15,1710,0,0,0,0,0,0,1710,1624,0,0,0,0,0,0,1624,3334
IT-RG,Ragusa,16,1641,1,0,0,0,0,0,1642,1548,0,0,0,0,0,0,1548,3190
IT-RG,Ragusa,17,1801,0,0,0,0,0,0,1801,1572,0,0,0,0,0,0,1572,3373
IT-RG,Ragusa,18,1862,0,0,0,0,0,0,1862,1552,6,0,0,0,0,0,1558,3420
IT-RG,Ragusa,19,1863,1,0,0,0,0,0,1864,1603,11,0,0,0,0,0,1614,3478
IT-RG,Ragusa,20,1872,0,0,0,0,0,0,1872,1589,30,0,0,0,0,0,1619,3491
IT-RG,Ragusa,21,1812,7,0,0,0,0,0,1819,1571,43,0,0,0,0,0,1614,3433
IT-RG,Ragusa,22,1828,19,0,1,0,0,0,1848,1583,76,0,0,0,0,0,1659,3507
IT-RG,Ragusa,23,2001,24,1,0,0,0,0,2026,1527,106,0,0,0,0,0,1633,3659
IT-RG,Ragusa,24,2052,52,0,0,0,0,0,2104,1477,160,0,0,0,0,0,1637,3741
IT-RG,Ragusa,25,1882,53,0,0,0,0,0,1935,1433,196,1,0,0,0,0,1630,3565
IT-RG,Ragusa,26,1890,101,0,0,1,0,0,1992,1366,362,3,0,1,0,0,1732,3724
IT-RG,Ragusa,27,1741,160,3,0,0,0,0,1904,1299,425,0,0,0,0,0,1724,3628
IT-RG,Ragusa,28,1749,185,4,0,0,0,0,1938,1220,556,14,0,5,0,0,1795,3733
IT-RG,Ragusa,29,1682,310,3,1,1,0,0,1997,1112,549,6,0,1,0,0,1668,3665
IT-RG,Ragusa,30,1630,381,5,0,1,0,0,2017,1112,750,13,1,0,0,0,1876,3893
IT-RG,Ragusa,31,1541,517,8,0,0,0,0,2066,990,807,15,0,0,0,0,1812,3878
IT-RG,Ragusa,32,1367,580,12,1,0,0,0,1960,883,937,26,1,1,0,0,1848,3808
IT-RG,Ragusa,33,1359,741,10,0,1,0,0,2111,815,1008,29,2,1,0,0,1855,3966
IT-RG,Ragusa,34,1272,773,15,1,1,0,0,2062,722,1086,30,4,4,0,0,1846,3908
IT-RG,Ragusa,35,1212,971,23,0,3,0,0,2209,733,1131,27,6,1,0,0,1898,4107
IT-RG,Ragusa,36,1119,1000,23,3,0,0,0,2145,708,1252,46,6,2,0,0,2014,4159
IT-RG,Ragusa,37,1095,1036,25,2,5,0,0,2163,607,1290,45,8,1,0,0,1951,4114
IT-RG,Ragusa,38,915,1161,27,1,0,0,0,2104,540,1317,66,13,2,0,0,1938,4042
IT-RG,Ragusa,39,875,1178,34,1,3,0,0,2091,550,1361,64,13,1,0,0,1989,4080
IT-RG,Ragusa,40,837,1221,43,3,2,0,0,2106,494,1433,71,10,0,0,0,2008,4114
IT-RG,Ragusa,41,877,1353,42,3,6,0,0,2281,478,1490,80,12,1,0,0,2061,4342
IT-RG,Ragusa,42,819,1369,53,6,2,0,0,2249,390,1561,72,19,1,0,0,2043,4292
IT-RG,Ragusa,43,712,1491,62,4,0,0,0,2269,408,1579,87,19,1,0,0,2094,4363
IT-RG,Ragusa,44,696,1397,78,2,1,0,0,2174,399,1513,108,33,2,0,0,2055,4229
IT-RG,Ragusa,45,698,1506,73,7,1,0,0,2285,399,1662,118,22,0,0,0,2201,4486
IT-RG,Ragusa,46,641,1554,82,3,2,0,0,2282,375,1679,101,24,0,0,0,2179,4461
IT-RG,Ragusa,47,660,1670,75,6,1,0,0,2412,348,1832,130,31,0,0,0,2341,4753
IT-RG,Ragusa,48,613,1748,89,11,3,0,0,2464,371,1802,142,45,0,0,0,2360,4824
IT-RG,Ragusa,49,587,1815,101,6,1,0,0,2510,351,1901,155,50,0,0,0,2457,4967
IT-RG,Ragusa,50,537,1772,116,13,2,0,0,2440,343,1817,148,57,2,0,0,2367,4807
IT-RG,Ragusa,51,501,1735,108,15,0,0,0,2359,310,1785,143,54,1,0,0,2293,4652
IT-RG,Ragusa,52,469,1759,122,17,1,0,0,2368,313,1926,142,57,0,0,0,2438,4806
IT-RG,Ragusa,53,357,1850,118,21,1,0,0,2347,278,1826,149,74,0,0,0,2327,4674
IT-RG,Ragusa,54,392,1924,117,26,0,0,0,2459,258,1871,160,85,0,0,0,2374,4833
IT-RG,Ragusa,55,342,1845,121,27,3,0,0,2338,245,1967,163,102,0,0,0,2477,4815
IT-RG,Ragusa,56,315,1888,124,29,4,0,0,2360,254,1934,143,119,0,0,0,2450,4810
IT-RG,Ragusa,57,324,1899,115,29,1,0,0,2368,223,1862,148,132,0,0,0,2365,4733
IT-RG,Ragusa,58,309,1931,95,21,1,0,0,2357,214,1845,109,135,0,0,0,2303,4660
IT-RG,Ragusa,59,264,1898,106,36,0,0,0,2304,209,1778,126,147,0,0,0,2260,4564
IT-RG,Ragusa,60,235,1805,93,29,0,0,0,2162,203,1793,120,180,1,0,0,2297,4459
IT-RG,Ragusa,61,239,1817,130,36,2,0,0,2224,210,1734,116,176,0,0,0,2236,4460
IT-RG,Ragusa,62,204,1782,103,44,1,0,0,2134,194,1716,116,185,0,0,0,2211,4345
IT-RG,Ragusa,63,166,1763,81,50,0,0,0,2060,191,1718,107,246,0,0,0,2262,4322
IT-RG,Ragusa,64,171,1672,92,59,0,0,0,1994,158,1617,99,254,0,0,0,2128,4122
IT-RG,Ragusa,65,143,1540,79,55,0,0,0,1817,150,1457,95,287,0,0,0,1989,3806
IT-RG,Ragusa,66,125,1576,56,58,2,0,0,1817,147,1396,86,280,0,0,0,1909,3726
IT-RG,Ragusa,67,111,1540,62,62,2,0,0,1777,141,1451,59,321,0,0,0,1972,3749
IT-RG,Ragusa,68,110,1497,52,62,2,0,0,1723,114,1329,67,337,0,0,0,1847,3570
IT-RG,Ragusa,69,92,1504,58,76,0,0,0,1730,123,1403,71,365,0,0,0,1962,3692
IT-RG,Ragusa,70,85,1331,53,64,0,0,0,1533,105,1145,63,423,0,0,0,1736,3269
IT-RG,Ragusa,71,82,1259,44,58,1,0,0,1444,127,1115,51,413,0,0,0,1706,3150
IT-RG,Ragusa,72,93,1210,35,94,0,0,0,1432,99,1069,44,467,0,0,0,1679,3111
IT-RG,Ragusa,73,68,1267,34,93,0,0,0,1462,92,1034,42,492,0,0,0,1660,3122
IT-RG,Ragusa,74,72,1373,39,100,0,0,0,1584,114,1029,47,613,0,0,0,1803,3387
IT-RG,Ragusa,75,54,1251,36,124,2,0,0,1467,115,1020,44,653,0,0,0,1832,3299
IT-RG,Ragusa,76,69,1272,35,118,0,0,0,1494,117,957,42,735,0,0,0,1851,3345
IT-RG,Ragusa,77,48,1036,29,113,0,0,0,1226,100,780,41,645,0,0,0,1566,2792
IT-RG,Ragusa,78,34,924,18,97,0,0,0,1073,78,563,32,559,0,0,0,1232,2305
IT-RG,Ragusa,79,33,808,19,103,0,0,0,963,74,497,22,570,0,0,0,1163,2126
IT-RG,Ragusa,80,28,754,17,102,0,0,0,901,68,400,26,661,0,0,0,1155,2056
IT-RG,Ragusa,81,29,677,13,102,0,0,0,821,72,383,19,648,0,0,0,1122,1943
IT-RG,Ragusa,82,28,679,17,108,0,0,0,832,78,334,16,730,0,0,0,1158,1990
IT-RG,Ragusa,83,29,761,21,148,0,0,0,959,87,315,18,843,0,0,0,1263,2222
IT-RG,Ragusa,84,30,654,7,138,0,0,0,829,99,235,17,837,0,0,0,1188,2017
IT-RG,Ragusa,85,15,524,10,136,0,0,0,685,59,202,8,763,0,0,0,1032,1717
IT-RG,Ragusa,86,13,435,6,95,0,0,0,549,56,136,6,631,0,0,0,829,1378
IT-RG,Ragusa,87,13,380,5,127,0,0,0,525,55,112,12,621,0,0,0,800,1325
IT-RG,Ragusa,88,9,330,2,107,0,0,0,448,46,83,8,536,0,0,0,673,1121
IT-RG,Ragusa,89,11,247,2,102,0,0,0,362,39,58,5,493,0,0,0,595,957
IT-RG,Ragusa,90,8,171,4,101,0,0,0,284,36,29,8,432,0,0,0,505,789
IT-RG,Ragusa,91,5,128,2,81,0,0,0,216,35,20,3,404,0,0,0,462,678
IT-RG,Ragusa,92,5,106,0,70,0,0,0,181,32,20,3,318,0,0,0,373,554
IT-RG,Ragusa,93,3,61,0,71,0,0,0,135,21,6,2,240,0,0,0,269,404
IT-RG,Ragusa,94,4,43,1,43,0,0,0,91,14,9,3,179,0,0,0,205,296
IT-RG,Ragusa,95,3,35,0,34,0,0,0,72,13,4,6,133,0,0,0,156,228
IT-RG,Ragusa,96,2,19,0,25,0,0,0,46,12,0,2,93,0,0,0,107,153
IT-RG,Ragusa,97,2,11,1,20,0,0,0,34,10,5,0,74,0,0,0,89,123
IT-RG,Ragusa,98,2,4,0,10,0,0,0,16,11,0,1,56,0,0,0,68,84
IT-RG,Ragusa,99,0,3,0,5,0,0,0,8,3,1,0,43,0,0,0,47,55
IT-RG,Ragusa,100,0,4,0,9,0,0,0,13,3,3,0,57,0,0,0,63,76
IT-RG,Ragusa,999,75734,77129,3289,3425,60,0,0,159637,61189,75700,4407,18274,29,0,0,159599,319236
IT-RA,Ravenna,0,1139,0,0,0,0,0,0,1139,1161,0,0,0,0,0,0,1161,2300
IT-RA,Ravenna,1,1157,0,0,0,0,0,0,1157,1174,0,0,0,0,0,0,1174,2331
IT-RA,Ravenna,2,1314,0,0,0,0,0,0,1314,1208,0,0,0,0,0,0,1208,2522
IT-RA,Ravenna,3,1318,0,0,0,0,0,0,1318,1271,0,0,0,0,0,0,1271,2589
IT-RA,Ravenna,4,1378,0,0,0,0,0,0,1378,1248,0,0,0,0,0,0,1248,2626
IT-RA,Ravenna,5,1514,0,0,0,0,0,0,1514,1360,0,0,0,0,0,0,1360,2874
IT-RA,Ravenna,6,1537,0,0,0,0,0,0,1537,1388,0,0,0,0,0,0,1388,2925
IT-RA,Ravenna,7,1528,0,0,0,0,0,0,1528,1423,0,0,0,0,0,0,1423,2951
IT-RA,Ravenna,8,1601,0,0,0,0,0,0,1601,1498,0,0,0,0,0,0,1498,3099
IT-RA,Ravenna,9,1627,0,0,0,0,0,0,1627,1566,0,0,0,0,0,0,1566,3193
IT-RA,Ravenna,10,1647,0,0,0,0,0,0,1647,1622,0,0,0,0,0,0,1622,3269
IT-RA,Ravenna,11,1751,0,0,0,0,0,0,1751,1594,0,0,0,0,0,0,1594,3345
IT-RA,Ravenna,12,1854,0,0,0,0,0,0,1854,1665,0,0,0,0,0,0,1665,3519
IT-RA,Ravenna,13,1857,0,0,0,0,0,0,1857,1770,0,0,0,0,0,0,1770,3627
IT-RA,Ravenna,14,1945,0,0,0,0,0,0,1945,1776,0,0,0,0,0,0,1776,3721
IT-RA,Ravenna,15,1932,0,0,0,0,0,0,1932,1805,0,0,0,0,0,0,1805,3737
IT-RA,Ravenna,16,1888,0,0,0,0,0,0,1888,1780,0,0,0,0,0,0,1780,3668
IT-RA,Ravenna,17,1987,0,0,0,0,0,0,1987,1817,0,0,0,0,0,0,1817,3804
IT-RA,Ravenna,18,1934,0,0,0,0,0,0,1934,1670,1,0,0,0,0,0,1671,3605
IT-RA,Ravenna,19,1945,0,0,0,0,0,0,1945,1706,6,0,0,0,0,0,1712,3657
IT-RA,Ravenna,20,1981,1,0,0,0,0,0,1982,1647,14,0,0,0,0,0,1661,3643
IT-RA,Ravenna,21,1872,4,0,0,0,0,0,1876,1691,30,0,0,0,0,0,1721,3597
IT-RA,Ravenna,22,1940,9,0,0,0,0,0,1949,1664,47,3,0,0,0,0,1714,3663
IT-RA,Ravenna,23,2001,13,2,0,0,0,0,2016,1654,77,5,0,2,0,0,1738,3754
IT-RA,Ravenna,24,1921,31,0,0,0,0,0,1952,1505,109,1,0,1,0,0,1616,3568
IT-RA,Ravenna,25,1928,42,1,0,0,0,0,1971,1498,173,6,1,0,0,0,1678,3649
IT-RA,Ravenna,26,1892,74,4,0,1,0,0,1971,1490,242,5,0,2,0,0,1739,3710
IT-RA,Ravenna,27,1855,104,2,1,2,0,0,1964,1469,310,5,0,0,1,0,1785,3749
IT-RA,Ravenna,28,1757,158,4,0,3,0,0,1922,1359,348,16,0,1,1,0,1725,3647
IT-RA,Ravenna,29,1697,210,3,0,1,0,0,1911,1385,431,9,1,4,2,0,1832,3743
IT-RA,Ravenna,30,1603,282,11,0,2,0,0,1898,1254,531,11,1,5,0,0,1802,3700
IT-RA,Ravenna,31,1588,377,9,0,2,0,0,1976,1268,600,16,1,3,0,0,1888,3864
IT-RA,Ravenna,32,1544,458,17,6,2,0,0,2027,1158,689,30,0,5,0,0,1882,3909
IT-RA,Ravenna,33,1396,522,16,1,4,0,0,1939,1065,723,35,3,1,0,0,1827,3766
IT-RA,Ravenna,34,1343,592,18,0,2,0,0,1955,1080,813,42,3,5,0,0,1943,3898
IT-RA,Ravenna,35,1328,690,25,0,2,0,0,2045,966,840,50,7,4,0,0,1867,3912
IT-RA,Ravenna,36,1200,716,31,2,3,1,0,1953,958,939,62,5,4,0,0,1968,3921
IT-RA,Ravenna,37,1238,795,44,1,5,0,0,2083,980,1022,62,9,4,0,0,2077,4160
IT-RA,Ravenna,38,1150,826,45,2,4,0,0,2027,900,1062,104,12,1,1,0,2080,4107
IT-RA,Ravenna,39,1111,857,45,3,2,0,0,2018,833,1092,104,13,4,0,0,2046,4064
IT-RA,Ravenna,40,1078,976,69,6,3,0,0,2132,888,1144,114,11,6,0,0,2163,4295
IT-RA,Ravenna,41,1124,1033,71,4,6,0,0,2238,913,1240,149,22,7,1,0,2332,4570
IT-RA,Ravenna,42,1026,1057,84,2,5,0,0,2174,823,1307,135,9,2,1,0,2277,4451
IT-RA,Ravenna,43,1117,1167,98,8,4,0,0,2394,800,1411,152,23,4,0,0,2390,4784
IT-RA,Ravenna,44,1152,1232,101,6,4,0,0,2495,879,1412,169,29,3,0,0,2492,4987
IT-RA,Ravenna,45,1163,1335,131,5,5,1,0,2640,933,1499,205,28,4,0,0,2669,5309
IT-RA,Ravenna,46,1206,1432,149,3,4,0,0,2794,981,1689,233,26,4,0,0,2933,5727
IT-RA,Ravenna,47,1216,1557,149,10,5,0,0,2937,1010,1603,233,31,4,0,0,2881,5818
IT-RA,Ravenna,48,1286,1673,209,15,3,0,0,3186,1015,1793,277,37,5,0,0,3127,6313
IT-RA,Ravenna,49,1318,1714,209,8,4,0,0,3253,1005,1879,320,58,2,0,0,3264,6517
IT-RA,Ravenna,50,1223,1726,209,8,5,1,0,3172,991,1897,353,56,4,0,0,3301,6473
IT-RA,Ravenna,51,1211,1830,223,18,7,0,0,3289,943,1963,331,76,2,1,0,3316,6605
IT-RA,Ravenna,52,1152,1847,260,18,6,0,0,3283,871,1940,363,77,1,0,0,3252,6535
IT-RA,Ravenna,53,1067,1841,266,19,5,0,0,3198,901,1976,399,94,2,0,0,3372,6570
IT-RA,Ravenna,54,1025,1888,290,20,6,0,0,3229,781,2086,407,107,3,0,0,3384,6613
IT-RA,Ravenna,55,1028,1997,309,20,7,0,1,3362,779,1980,374,100,1,1,0,3235,6597
IT-RA,Ravenna,56,928,1994,327,25,6,0,1,3281,711,1943,411,120,1,0,0,3186,6467
IT-RA,Ravenna,57,863,2046,324,32,6,0,0,3271,735,2014,417,123,3,0,0,3292,6563
IT-RA,Ravenna,58,793,1982,322,27,4,0,0,3128,595,2022,434,178,2,0,0,3231,6359
IT-RA,Ravenna,59,791,2163,350,42,9,0,0,3355,617,2164,417,172,2,0,0,3372,6727
IT-RA,Ravenna,60,676,1983,334,53,4,0,0,3050,503,1950,380,188,1,0,0,3022,6072
IT-RA,Ravenna,61,536,2012,292,35,4,0,0,2879,477,1960,372,193,1,0,0,3003,5882
IT-RA,Ravenna,62,535,1918,305,62,3,0,0,2823,434,2000,358,200,3,0,0,2995,5818
IT-RA,Ravenna,63,461,1921,289,65,5,0,1,2742,394,1836,369,226,1,0,0,2826,5568
IT-RA,Ravenna,64,431,1890,280,69,3,0,0,2673,375,1770,319,269,1,0,0,2734,5407
IT-RA,Ravenna,65,362,1806,239,77,4,0,0,2488,343,1727,299,240,0,0,0,2609,5097
IT-RA,Ravenna,66,335,1743,213,75,4,0,0,2370,301,1746,325,301,1,0,0,2674,5044
IT-RA,Ravenna,67,316,1779,234,93,5,0,0,2427,281,1708,285,331,1,0,0,2606,5033
IT-RA,Ravenna,68,239,1752,196,89,1,0,0,2277,238,1619,263,304,0,0,0,2424,4701
IT-RA,Ravenna,69,223,1591,179,100,1,0,0,2094,199,1580,231,346,0,0,0,2356,4450
IT-RA,Ravenna,70,193,1561,186,94,0,0,1,2035,213,1402,214,362,1,0,0,2192,4227
IT-RA,Ravenna,71,212,1572,163,94,1,0,0,2042,196,1477,204,422,0,1,0,2300,4342
IT-RA,Ravenna,72,175,1558,152,98,3,0,1,1987,178,1400,185,442,0,0,0,2205,4192
IT-RA,Ravenna,73,170,1568,163,126,2,0,0,2029,148,1474,209,518,1,0,0,2350,4379
IT-RA,Ravenna,74,149,1565,144,134,2,0,0,1994,153,1476,164,590,2,0,0,2385,4379
IT-RA,Ravenna,75,139,1647,120,146,0,0,0,2052,151,1527,153,657,0,0,0,2488,4540
IT-RA,Ravenna,76,139,1641,113,176,0,0,0,2069,125,1320,120,704,0,0,0,2269,4338
IT-RA,Ravenna,77,145,1567,93,180,0,0,0,1985,121,1413,129,764,0,0,0,2427,4412
IT-RA,Ravenna,78,73,1046,76,157,0,0,0,1352,95,902,103,625,0,0,0,1725,3077
IT-RA,Ravenna,79,106,1178,78,168,0,0,0,1530,86,940,99,761,0,0,0,1886,3416
IT-RA,Ravenna,80,96,1076,51,174,0,0,0,1397,105,832,75,834,0,0,0,1846,3243
IT-RA,Ravenna,81,84,1017,54,186,1,0,0,1342,84,765,80,749,0,0,0,1678,3020
IT-RA,Ravenna,82,83,1003,48,206,1,0,0,1341,86,714,87,820,0,0,0,1707,3048
IT-RA,Ravenna,83,93,1019,34,215,0,0,0,1361,94,743,58,1024,0,0,0,1919,3280
IT-RA,Ravenna,84,85,996,35,253,0,0,0,1369,94,681,54,1051,0,0,0,1880,3249
IT-RA,Ravenna,85,84,902,42,253,0,0,0,1281,98,522,39,1082,0,0,0,1741,3022
IT-RA,Ravenna,86,74,738,21,236,1,0,0,1070,86,399,38,1046,0,0,0,1569,2639
IT-RA,Ravenna,87,48,567,15,211,0,0,0,841,80,303,29,973,0,0,0,1385,2226
IT-RA,Ravenna,88,56,532,13,219,0,0,0,820,49,260,36,1005,0,0,0,1350,2170
IT-RA,Ravenna,89,34,465,15,206,0,0,0,720,61,205,26,979,0,0,0,1271,1991
IT-RA,Ravenna,90,32,347,9,205,0,0,0,593,61,118,23,802,0,0,0,1004,1597
IT-RA,Ravenna,91,27,255,4,161,0,0,0,447,57,80,9,729,0,0,0,875,1322
IT-RA,Ravenna,92,18,190,3,147,0,0,0,358,45,59,7,588,0,0,0,699,1057
IT-RA,Ravenna,93,26,135,2,136,0,0,0,299,44,36,7,571,0,0,0,658,957
IT-RA,Ravenna,94,15,86,3,82,0,0,0,186,27,24,3,406,0,0,0,460,646
IT-RA,Ravenna,95,14,61,3,76,0,0,0,154,25,16,6,341,0,0,0,388,542
IT-RA,Ravenna,96,3,36,1,56,0,0,0,96,9,13,4,253,0,0,0,279,375
IT-RA,Ravenna,97,2,19,0,33,0,0,0,54,16,9,1,200,0,0,0,226,280
IT-RA,Ravenna,98,3,18,0,31,0,0,0,52,13,3,1,134,0,0,0,151,203
IT-RA,Ravenna,99,2,11,0,21,0,0,0,34,6,0,0,83,0,0,0,89,123
IT-RA,Ravenna,100,1,8,0,24,0,0,0,33,10,4,0,152,0,0,0,166,199
IT-RA,Ravenna,999,93460,82030,8629,5534,184,3,5,189845,79658,82074,11823,23698,121,10,0,197384,387229
IT-RC,Reggio di Calabria,0,2072,0,0,0,0,0,0,2072,1972,0,0,0,0,0,0,1972,4044
IT-RC,Reggio di Calabria,1,1982,0,0,0,0,0,0,1982,1937,0,0,0,0,0,0,1937,3919
IT-RC,Reggio di Calabria,2,1932,0,0,0,0,0,0,1932,1903,0,0,0,0,0,0,1903,3835
IT-RC,Reggio di Calabria,3,2095,0,0,0,0,0,0,2095,2007,0,0,0,0,0,0,2007,4102
IT-RC,Reggio di Calabria,4,2168,0,0,0,0,0,0,2168,2095,0,0,0,0,0,0,2095,4263
IT-RC,Reggio di Calabria,5,2268,0,0,0,0,0,0,2268,2151,0,0,0,0,0,0,2151,4419
IT-RC,Reggio di Calabria,6,2358,0,0,0,0,0,0,2358,2174,0,0,0,0,0,0,2174,4532
IT-RC,Reggio di Calabria,7,2292,0,0,0,0,0,0,2292,2164,0,0,0,0,0,0,2164,4456
IT-RC,Reggio di Calabria,8,2463,0,0,0,0,0,0,2463,2261,0,0,0,0,0,0,2261,4724
IT-RC,Reggio di Calabria,9,2463,0,0,0,0,0,0,2463,2262,0,0,0,0,0,0,2262,4725
IT-RC,Reggio di Calabria,10,2482,0,0,0,0,0,0,2482,2324,0,0,0,0,0,0,2324,4806
IT-RC,Reggio di Calabria,11,2481,0,0,0,0,0,0,2481,2326,0,0,0,0,0,0,2326,4807
IT-RC,Reggio di Calabria,12,2518,0,0,0,0,0,0,2518,2444,0,0,0,0,0,0,2444,4962
IT-RC,Reggio di Calabria,13,2728,0,0,0,0,0,0,2728,2491,0,0,0,0,0,0,2491,5219
IT-RC,Reggio di Calabria,14,2732,0,0,0,0,0,0,2732,2472,0,0,0,0,0,0,2472,5204
IT-RC,Reggio di Calabria,15,2659,0,0,0,0,0,0,2659,2591,0,0,0,0,0,0,2591,5250
IT-RC,Reggio di Calabria,16,2784,0,0,0,0,0,0,2784,2604,0,0,0,0,0,0,2604,5388
IT-RC,Reggio di Calabria,17,2832,0,0,0,0,0,0,2832,2639,0,0,0,0,0,0,2639,5471
IT-RC,Reggio di Calabria,18,2783,0,0,0,0,0,0,2783,2649,3,0,0,0,0,0,2652,5435
IT-RC,Reggio di Calabria,19,2893,0,0,0,0,0,0,2893,2596,8,0,0,0,0,0,2604,5497
IT-RC,Reggio di Calabria,20,2803,5,0,0,0,0,0,2808,2563,28,0,0,0,0,0,2591,5399
IT-RC,Reggio di Calabria,21,2734,8,1,0,0,0,0,2743,2521,48,0,0,0,0,0,2569,5312
IT-RC,Reggio di Calabria,22,2775,18,0,0,0,0,0,2793,2560,93,0,0,0,0,0,2653,5446
IT-RC,Reggio di Calabria,23,2843,29,0,0,0,0,0,2872,2587,135,1,0,0,0,0,2723,5595
IT-RC,Reggio di Calabria,24,2858,34,2,1,1,0,0,2896,2465,217,1,0,0,0,0,2683,5579
IT-RC,Reggio di Calabria,25,2712,104,0,0,0,0,0,2816,2373,328,0,2,0,0,0,2703,5519
IT-RC,Reggio di Calabria,26,2574,145,2,0,0,0,0,2721,2159,429,1,1,0,0,0,2590,5311
IT-RC,Reggio di Calabria,27,2526,203,1,1,0,0,0,2731,1985,626,6,0,0,0,0,2617,5348
IT-RC,Reggio di Calabria,28,2325,352,5,0,2,0,0,2684,1904,806,4,0,0,0,0,2714,5398
IT-RC,Reggio di Calabria,29,2283,499,2,0,1,0,0,2785,1696,896,11,1,0,0,0,2604,5389
IT-RC,Reggio di Calabria,30,2300,589,2,0,5,0,0,2896,1647,1134,16,2,0,0,0,2799,5695
IT-RC,Reggio di Calabria,31,2061,767,5,0,0,0,0,2833,1520,1364,18,2,1,0,0,2905,5738
IT-RC,Reggio di Calabria,32,1950,922,9,5,0,0,0,2886,1421,1451,24,5,0,0,0,2901,5787
IT-RC,Reggio di Calabria,33,1873,1133,11,3,0,0,0,3020,1298,1562,33,5,2,0,0,2900,5920
IT-RC,Reggio di Calabria,34,1873,1249,16,0,1,0,0,3139,1196,1788,36,4,3,0,0,3027,6166
IT-RC,Reggio di Calabria,35,1630,1446,19,4,1,0,0,3100,1105,1965,43,10,1,0,0,3124,6224
IT-RC,Reggio di Calabria,36,1530,1499,21,2,0,0,0,3052,1074,2096,41,9,0,0,0,3220,6272
IT-RC,Reggio di Calabria,37,1445,1649,27,6,1,0,0,3128,946,2043,73,18,0,0,0,3080,6208
IT-RC,Reggio di Calabria,38,1384,1706,29,1,0,0,0,3120,881,2164,58,17,0,0,0,3120,6240
IT-RC,Reggio di Calabria,39,1308,1842,41,8,0,0,0,3199,810,2223,74,17,0,0,0,3124,6323
IT-RC,Reggio di Calabria,40,1184,1875,44,9,1,0,0,3113,789,2301,90,19,0,0,0,3199,6312
IT-RC,Reggio di Calabria,41,1223,1972,49,6,3,0,0,3253,743,2414,106,21,0,0,0,3284,6537
IT-RC,Reggio di Calabria,42,1160,2057,58,5,0,0,0,3280,705,2394,121,27,1,0,0,3248,6528
IT-RC,Reggio di Calabria,43,1130,2190,63,12,2,0,0,3397,758,2485,108,31,1,0,0,3383,6780
IT-RC,Reggio di Calabria,44,1135,2214,65,9,0,1,0,3424,689,2685,126,31,1,0,0,3532,6956
IT-RC,Reggio di Calabria,45,1058,2285,68,12,0,0,0,3423,665,2573,125,59,0,0,0,3422,6845
IT-RC,Reggio di Calabria,46,984,2329,76,14,1,0,0,3404,703,2784,155,53,0,0,0,3695,7099
IT-RC,Reggio di Calabria,47,1028,2556,95,15,1,0,0,3695,698,2920,174,66,1,0,0,3859,7554
IT-RC,Reggio di Calabria,48,966,2472,99,22,1,0,0,3560,639,2989,188,86,1,0,0,3903,7463
IT-RC,Reggio di Calabria,49,992,2610,91,18,0,0,0,3711,644,2991,144,77,0,0,0,3856,7567
IT-RC,Reggio di Calabria,50,978,2620,109,21,0,0,0,3728,583,2943,171,118,0,0,0,3815,7543
IT-RC,Reggio di Calabria,51,838,2512,115,25,0,0,0,3490,625,2984,180,127,0,0,0,3916,7406
IT-RC,Reggio di Calabria,52,815,2698,122,25,0,0,0,3660,582,3030,195,136,0,0,0,3943,7603
IT-RC,Reggio di Calabria,53,740,2615,122,28,0,0,0,3505,545,2963,181,156,0,0,0,3845,7350
IT-RC,Reggio di Calabria,54,757,2789,131,29,0,0,0,3706,552,3202,184,168,1,0,0,4107,7813
IT-RC,Reggio di Calabria,55,714,2874,137,27,0,0,0,3752,585,3129,192,171,0,0,0,4077,7829
IT-RC,Reggio di Calabria,56,694,2877,144,45,2,0,0,3762,549,3112,176,232,0,0,0,4069,7831
IT-RC,Reggio di Calabria,57,640,2911,136,55,0,0,0,3742,484,3231,170,255,0,0,0,4140,7882
IT-RC,Reggio di Calabria,58,638,2954,156,59,0,0,0,3807,454,3147,186,312,0,0,0,4099,7906
IT-RC,Reggio di Calabria,59,583,3005,140,45,0,0,0,3773,500,3173,173,352,0,0,0,4198,7971
IT-RC,Reggio di Calabria,60,518,2893,123,60,0,0,0,3594,414,2989,181,357,0,0,0,3941,7535
IT-RC,Reggio di Calabria,61,517,2971,131,57,0,0,0,3676,407,2951,129,390,0,0,0,3877,7553
IT-RC,Reggio di Calabria,62,473,2857,108,62,1,0,0,3501,404,2997,158,454,1,0,0,4014,7515
IT-RC,Reggio di Calabria,63,450,2814,122,72,0,0,0,3458,403,2771,156,526,0,0,0,3856,7314
IT-RC,Reggio di Calabria,64,419,2849,122,89,0,0,0,3479,368,2671,123,530,0,0,0,3692,7171
IT-RC,Reggio di Calabria,65,341,2614,93,85,0,0,0,3133,318,2468,131,527,1,0,0,3445,6578
IT-RC,Reggio di Calabria,66,339,2740,119,104,0,0,0,3302,316,2489,118,643,0,0,0,3566,6868
IT-RC,Reggio di Calabria,67,291,2637,100,105,0,0,0,3133,269,2372,108,621,0,0,0,3370,6503
IT-RC,Reggio di Calabria,68,305,2652,90,106,0,0,0,3153,275,2256,111,674,0,0,0,3316,6469
IT-RC,Reggio di Calabria,69,287,2602,85,118,0,0,0,3092,245,2219,77,789,0,0,0,3330,6422
IT-RC,Reggio di Calabria,70,261,2376,79,134,0,0,0,2850,262,2000,93,714,0,0,0,3069,5919
IT-RC,Reggio di Calabria,71,222,2272,65,124,0,0,0,2683,225,1841,74,789,0,0,0,2929,5612
IT-RC,Reggio di Calabria,72,233,2294,68,161,0,0,0,2756,217,1792,85,919,0,0,0,3013,5769
IT-RC,Reggio di Calabria,73,167,2351,49,166,0,0,0,2733,217,1763,80,981,0,0,0,3041,5774
IT-RC,Reggio di Calabria,74,165,2294,58,190,0,0,0,2707,232,1601,63,1051,0,0,0,2947,5654
IT-RC,Reggio di Calabria,75,175,2304,56,201,0,0,0,2736,198,1568,55,1223,0,0,0,3044,5780
IT-RC,Reggio di Calabria,76,158,2159,45,197,0,0,0,2559,178,1523,56,1253,0,0,0,3010,5569
IT-RC,Reggio di Calabria,77,134,1927,39,193,0,0,0,2293,165,1209,51,1231,0,0,0,2656,4949
IT-RC,Reggio di Calabria,78,107,1449,37,170,0,0,0,1763,177,940,38,1005,0,0,0,2160,3923
IT-RC,Reggio di Calabria,79,103,1368,27,187,0,0,0,1685,134,819,35,1028,0,0,0,2016,3701
IT-RC,Reggio di Calabria,80,79,1332,19,192,0,0,0,1622,157,734,30,1124,0,0,0,2045,3667
IT-RC,Reggio di Calabria,81,68,1251,12,214,0,0,0,1545,136,582,18,1149,0,0,0,1885,3430
IT-RC,Reggio di Calabria,82,93,1190,15,208,0,0,0,1506,119,569,28,1220,0,0,0,1936,3442
IT-RC,Reggio di Calabria,83,74,1216,16,243,0,0,0,1549,133,527,22,1243,0,0,0,1925,3474
IT-RC,Reggio di Calabria,84,66,1018,19,247,0,0,0,1350,123,472,18,1276,0,0,0,1889,3239
IT-RC,Reggio di Calabria,85,42,822,11,230,0,0,0,1105,108,404,30,1194,0,0,0,1736,2841
IT-RC,Reggio di Calabria,86,55,700,5,222,0,0,0,982,96,258,12,1064,0,0,0,1430,2412
IT-RC,Reggio di Calabria,87,48,610,7,222,0,0,0,887,91,259,9,1107,0,0,0,1466,2353
IT-RC,Reggio di Calabria,88,34,526,5,240,0,0,0,805,105,209,10,977,0,0,0,1301,2106
IT-RC,Reggio di Calabria,89,26,422,5,218,0,0,0,671,80,137,13,943,0,0,0,1173,1844
IT-RC,Reggio di Calabria,90,20,345,1,223,0,0,0,589,70,112,10,853,0,0,0,1045,1634
IT-RC,Reggio di Calabria,91,18,255,0,153,0,0,0,426,64,64,5,734,0,0,0,867,1293
IT-RC,Reggio di Calabria,92,16,189,2,142,0,0,0,349,62,61,7,585,0,0,0,715,1064
IT-RC,Reggio di Calabria,93,13,128,1,130,0,0,0,272,48,33,2,480,0,0,0,563,835
IT-RC,Reggio di Calabria,94,6,107,2,85,0,0,0,200,40,27,6,351,0,0,0,424,624
IT-RC,Reggio di Calabria,95,7,53,2,76,0,0,0,138,33,16,3,294,0,0,0,346,484
IT-RC,Reggio di Calabria,96,5,39,1,54,0,0,0,99,22,15,4,233,0,0,0,274,373
IT-RC,Reggio di Calabria,97,2,24,0,40,0,0,0,66,19,7,1,163,0,0,0,190,256
IT-RC,Reggio di Calabria,98,3,16,1,28,0,0,0,48,10,3,1,104,0,0,0,118,166
IT-RC,Reggio di Calabria,99,0,12,1,21,0,0,0,34,14,5,0,95,0,0,0,114,148
IT-RC,Reggio di Calabria,100,2,16,0,31,0,0,0,49,12,7,3,117,0,0,0,139,188
IT-RC,Reggio di Calabria,999,117371,123308,3954,6312,24,1,0,250970,100231,124597,5739,33601,15,0,0,264183,515153
IT-RE,Reggio nell'Emilia,0,1827,0,0,0,0,0,0,1827,1748,0,0,0,0,0,0,1748,3575
IT-RE,Reggio nell'Emilia,1,1870,0,0,0,0,0,0,1870,1848,0,0,0,0,0,0,1848,3718
IT-RE,Reggio nell'Emilia,2,1977,0,0,0,0,0,0,1977,1888,0,0,0,0,0,0,1888,3865
IT-RE,Reggio nell'Emilia,3,2048,0,0,0,0,0,0,2048,1875,0,0,0,0,0,0,1875,3923
IT-RE,Reggio nell'Emilia,4,2045,0,0,0,0,0,0,2045,2003,0,0,0,0,0,0,2003,4048
IT-RE,Reggio nell'Emilia,5,2095,0,0,0,0,0,0,2095,2005,0,0,0,0,0,0,2005,4100
IT-RE,Reggio nell'Emilia,6,2277,0,0,0,0,0,0,2277,2079,0,0,0,0,0,0,2079,4356
IT-RE,Reggio nell'Emilia,7,2328,0,0,0,0,0,0,2328,2226,0,0,0,0,0,0,2226,4554
IT-RE,Reggio nell'Emilia,8,2500,0,0,0,0,0,0,2500,2334,0,0,0,0,0,0,2334,4834
IT-RE,Reggio nell'Emilia,9,2402,0,0,0,0,0,0,2402,2378,0,0,0,0,0,0,2378,4780
IT-RE,Reggio nell'Emilia,10,2631,0,0,0,0,0,0,2631,2430,0,0,0,0,0,0,2430,5061
IT-RE,Reggio nell'Emilia,11,2749,0,0,0,0,0,0,2749,2444,0,0,0,0,0,0,2444,5193
IT-RE,Reggio nell'Emilia,12,2620,0,0,0,0,0,0,2620,2658,0,0,0,0,0,0,2658,5278
IT-RE,Reggio nell'Emilia,13,2882,0,0,0,0,0,0,2882,2669,0,0,0,0,0,0,2669,5551
IT-RE,Reggio nell'Emilia,14,2862,0,0,0,0,0,0,2862,2656,0,0,0,0,0,0,2656,5518
IT-RE,Reggio nell'Emilia,15,2813,0,0,0,0,0,0,2813,2726,0,0,0,0,0,0,2726,5539
IT-RE,Reggio nell'Emilia,16,2903,0,0,0,0,0,0,2903,2615,0,0,0,0,0,0,2615,5518
IT-RE,Reggio nell'Emilia,17,2827,0,0,0,0,0,0,2827,2660,0,0,0,0,0,0,2660,5487
IT-RE,Reggio nell'Emilia,18,2885,0,0,0,0,0,0,2885,2597,1,0,0,0,0,0,2598,5483
IT-RE,Reggio nell'Emilia,19,2881,0,0,0,0,0,0,2881,2625,5,0,0,0,0,0,2630,5511
IT-RE,Reggio nell'Emilia,20,2827,1,0,0,0,0,0,2828,2478,11,0,0,0,0,0,2489,5317
IT-RE,Reggio nell'Emilia,21,2911,6,0,0,0,0,0,2917,2470,30,0,0,0,0,0,2500,5417
IT-RE,Reggio nell'Emilia,22,2817,10,4,0,0,0,0,2831,2408,55,0,0,0,0,0,2463,5294
IT-RE,Reggio nell'Emilia,23,2900,20,0,1,0,0,0,2921,2411,99,1,0,0,0,0,2511,5432
IT-RE,Reggio nell'Emilia,24,2855,41,2,0,0,0,0,2898,2379,137,3,0,2,0,0,2521,5419
IT-RE,Reggio nell'Emilia,25,2944,77,2,0,0,0,0,3023,2336,263,4,1,1,0,0,2605,5628
IT-RE,Reggio nell'Emilia,26,2730,102,1,0,0,0,0,2833,2314,334,3,0,3,0,0,2654,5487
IT-RE,Reggio nell'Emilia,27,2682,205,11,0,0,0,0,2898,2205,411,14,0,1,1,0,2632,5530
IT-RE,Reggio nell'Emilia,28,2631,244,2,0,1,0,0,2878,2032,548,16,0,4,0,0,2600,5478
IT-RE,Reggio nell'Emilia,29,2498,344,8,0,1,0,1,2852,1963,727,23,1,2,1,0,2717,5569
IT-RE,Reggio nell'Emilia,30,2524,446,20,1,0,0,0,2991,1866,847,18,0,4,0,0,2735,5726
IT-RE,Reggio nell'Emilia,31,2449,605,11,0,1,0,0,3066,1796,996,31,4,2,1,0,2830,5896
IT-RE,Reggio nell'Emilia,32,2222,742,18,4,2,0,0,2988,1651,1062,34,1,6,0,0,2754,5742
IT-RE,Reggio nell'Emilia,33,2205,854,25,1,4,1,0,3090,1605,1228,48,12,4,1,0,2898,5988
IT-RE,Reggio nell'Emilia,34,2008,933,28,1,5,0,0,2975,1468,1315,53,6,9,0,0,2851,5826
IT-RE,Reggio nell'Emilia,35,1959,1131,37,2,3,0,0,3132,1396,1483,55,5,9,0,0,2948,6080
IT-RE,Reggio nell'Emilia,36,1767,1227,40,2,4,0,0,3040,1270,1517,70,10,10,0,0,2877,5917
IT-RE,Reggio nell'Emilia,37,1758,1279,48,3,4,0,0,3092,1167,1530,106,7,7,0,0,2817,5909
IT-RE,Reggio nell'Emilia,38,1726,1397,66,6,3,0,0,3198,1163,1704,112,30,7,1,0,3017,6215
IT-RE,Reggio nell'Emilia,39,1628,1425,70,2,7,0,0,3132,1118,1863,141,26,6,1,0,3155,6287
IT-RE,Reggio nell'Emilia,40,1561,1544,85,1,8,0,0,3199,1073,1901,166,33,6,1,0,3180,6379
IT-RE,Reggio nell'Emilia,41,1501,1688,105,7,2,0,0,3303,1095,2084,150,22,9,1,0,3361,6664
IT-RE,Reggio nell'Emilia,42,1464,1751,111,13,2,0,0,3341,1014,2080,185,17,2,1,0,3299,6640
IT-RE,Reggio nell'Emilia,43,1533,1955,132,15,5,0,0,3640,1083,2058,175,46,4,0,0,3366,7006
IT-RE,Reggio nell'Emilia,44,1534,1880,162,12,8,0,0,3596,1016,2216,253,37,5,0,0,3527,7123
IT-RE,Reggio nell'Emilia,45,1559,2132,176,17,4,0,0,3888,1100,2435,289,47,8,2,0,3881,7769
IT-RE,Reggio nell'Emilia,46,1531,2287,195,19,13,0,0,4045,1091,2559,313,44,4,4,0,4015,8060
IT-RE,Reggio nell'Emilia,47,1526,2451,201,20,5,0,0,4203,1161,2709,341,58,11,0,0,4280,8483
IT-RE,Reggio nell'Emilia,48,1560,2514,261,14,9,0,0,4358,1062,2782,384,76,6,0,0,4310,8668
IT-RE,Reggio nell'Emilia,49,1543,2722,313,23,8,0,0,4609,1084,2887,369,79,7,1,0,4427,9036
IT-RE,Reggio nell'Emilia,50,1462,2797,286,25,5,0,0,4575,1037,2859,429,75,3,0,0,4403,8978
IT-RE,Reggio nell'Emilia,51,1397,2912,337,20,6,1,0,4673,935,2987,449,96,7,0,0,4474,9147
IT-RE,Reggio nell'Emilia,52,1312,2929,347,24,9,0,0,4621,895,2851,456,109,7,0,0,4318,8939
IT-RE,Reggio nell'Emilia,53,1159,2848,325,18,3,0,0,4353,842,2904,488,142,5,0,0,4381,8734
IT-RE,Reggio nell'Emilia,54,1147,2869,356,28,8,0,0,4408,807,2977,504,122,3,0,0,4413,8821
IT-RE,Reggio nell'Emilia,55,1030,2982,382,30,4,0,0,4428,747,2917,471,150,6,0,0,4291,8719
IT-RE,Reggio nell'Emilia,56,992,2843,365,40,5,0,0,4245,692,2851,474,175,2,0,0,4194,8439
IT-RE,Reggio nell'Emilia,57,909,2922,378,53,9,0,0,4271,680,2986,465,206,1,0,0,4338,8609
IT-RE,Reggio nell'Emilia,58,794,2949,356,46,7,0,0,4152,580,2892,463,221,6,0,0,4162,8314
IT-RE,Reggio nell'Emilia,59,705,3007,353,57,4,0,0,4126,570,2916,497,233,2,0,0,4218,8344
IT-RE,Reggio nell'Emilia,60,675,2762,375,62,4,0,0,3878,544,2661,432,246,4,0,0,3887,7765
IT-RE,Reggio nell'Emilia,61,610,2621,348,77,9,0,0,3665,501,2699,400,258,2,0,0,3860,7525
IT-RE,Reggio nell'Emilia,62,501,2583,309,61,1,0,0,3455,454,2559,392,275,4,0,0,3684,7139
IT-RE,Reggio nell'Emilia,63,468,2560,305,76,3,0,2,3414,359,2570,443,331,0,0,0,3703,7117
IT-RE,Reggio nell'Emilia,64,423,2507,273,71,4,0,0,3278,376,2375,378,368,2,0,0,3499,6777
IT-RE,Reggio nell'Emilia,65,354,2316,264,104,5,0,0,3043,341,2254,300,379,1,0,0,3275,6318
IT-RE,Reggio nell'Emilia,66,367,2360,244,94,2,1,0,3068,270,2342,278,409,1,0,0,3300,6368
IT-RE,Reggio nell'Emilia,67,301,2319,237,119,4,0,0,2980,257,2134,283,476,1,0,0,3151,6131
IT-RE,Reggio nell'Emilia,68,294,2249,194,91,6,0,0,2834,241,2068,254,509,0,0,0,3072,5906
IT-RE,Reggio nell'Emilia,69,261,2137,197,134,1,0,0,2730,207,2095,237,530,1,0,0,3070,5800
IT-RE,Reggio nell'Emilia,70,246,2044,179,112,1,0,0,2582,209,1938,211,528,1,0,0,2887,5469
IT-RE,Reggio nell'Emilia,71,217,1872,146,158,3,0,0,2396,187,1814,168,626,0,0,0,2795,5191
IT-RE,Reggio nell'Emilia,72,181,1964,126,153,3,0,0,2427,163,1824,164,618,1,0,0,2770,5197
IT-RE,Reggio nell'Emilia,73,191,1991,124,157,0,0,0,2463,147,1872,185,738,0,0,0,2942,5405
IT-RE,Reggio nell'Emilia,74,176,2051,131,165,0,0,1,2524,137,1755,167,798,0,0,0,2857,5381
IT-RE,Reggio nell'Emilia,75,202,2078,112,207,2,0,0,2601,167,1786,144,942,2,0,0,3041,5642
IT-RE,Reggio nell'Emilia,76,182,1997,92,211,0,0,0,2482,156,1689,155,889,1,0,0,2890,5372
IT-RE,Reggio nell'Emilia,77,138,1954,81,237,0,0,0,2410,128,1591,129,1046,0,0,0,2894,5304
IT-RE,Reggio nell'Emilia,78,102,1315,59,174,2,0,0,1652,95,1000,95,808,0,0,0,1998,3650
IT-RE,Reggio nell'Emilia,79,107,1413,55,218,0,0,0,1793,82,1046,85,965,0,0,0,2178,3971
IT-RE,Reggio nell'Emilia,80,119,1355,45,216,1,0,0,1736,80,959,76,989,0,0,0,2104,3840
IT-RE,Reggio nell'Emilia,81,119,1206,46,240,0,0,0,1611,81,914,49,1069,0,0,0,2113,3724
IT-RE,Reggio nell'Emilia,82,115,1183,50,252,2,0,0,1602,108,838,54,1098,0,0,0,2098,3700
IT-RE,Reggio nell'Emilia,83,111,1193,34,280,0,0,0,1618,111,765,45,1243,0,0,0,2164,3782
IT-RE,Reggio nell'Emilia,84,113,1070,22,271,0,0,0,1476,94,647,39,1294,0,0,0,2074,3550
IT-RE,Reggio nell'Emilia,85,91,981,24,297,0,0,0,1393,80,510,47,1256,0,0,0,1893,3286
IT-RE,Reggio nell'Emilia,86,81,741,19,261,0,0,0,1102,78,372,26,1185,0,0,0,1661,2763
IT-RE,Reggio nell'Emilia,87,60,580,10,235,0,0,0,885,58,299,25,1082,0,0,0,1464,2349
IT-RE,Reggio nell'Emilia,88,70,605,10,237,0,0,0,922,67,227,23,1092,0,0,0,1409,2331
IT-RE,Reggio nell'Emilia,89,61,433,14,218,0,0,0,726,51,136,14,1024,0,0,0,1225,1951
IT-RE,Reggio nell'Emilia,90,42,306,2,210,0,0,0,560,50,118,14,836,0,0,0,1018,1578
IT-RE,Reggio nell'Emilia,91,27,230,2,154,0,0,0,413,38,67,6,710,0,0,0,821,1234
IT-RE,Reggio nell'Emilia,92,39,167,4,152,0,0,0,362,44,44,5,642,0,0,0,735,1097
IT-RE,Reggio nell'Emilia,93,18,143,7,102,0,0,0,270,38,32,2,630,0,0,0,702,972
IT-RE,Reggio nell'Emilia,94,9,90,1,98,0,0,0,198,25,16,3,432,0,0,0,476,674
IT-RE,Reggio nell'Emilia,95,10,61,1,75,0,0,0,147,21,12,2,349,0,0,0,384,531
IT-RE,Reggio nell'Emilia,96,6,28,3,53,0,0,0,90,13,9,3,272,0,0,0,297,387
IT-RE,Reggio nell'Emilia,97,5,20,0,37,0,0,0,62,10,9,1,197,0,0,0,217,279
IT-RE,Reggio nell'Emilia,98,1,9,0,23,0,0,0,33,10,1,2,153,0,0,0,166,199
IT-RE,Reggio nell'Emilia,99,1,6,0,19,0,0,0,26,9,1,0,101,0,0,0,111,137
IT-RE,Reggio nell'Emilia,100,1,3,0,23,0,0,0,27,14,0,1,122,0,0,0,137,164
IT-RE,Reggio nell'Emilia,999,130777,114574,9764,6639,212,3,4,261973,108625,115065,13390,29606,202,16,0,266904,528877
IT-RI,Rieti,0,444,0,0,0,0,0,0,444,375,0,0,0,0,0,0,375,819
IT-RI,Rieti,1,430,0,0,0,0,0,0,430,432,0,0,0,0,0,0,432,862
IT-RI,Rieti,2,466,0,0,0,0,0,0,466,405,0,0,0,0,0,0,405,871
IT-RI,Rieti,3,461,0,0,0,0,0,0,461,454,0,0,0,0,0,0,454,915
IT-RI,Rieti,4,514,0,0,0,0,0,0,514,426,0,0,0,0,0,0,426,940
IT-RI,Rieti,5,508,0,0,0,0,0,0,508,425,0,0,0,0,0,0,425,933
IT-RI,Rieti,6,523,0,0,0,0,0,0,523,498,0,0,0,0,0,0,498,1021
IT-RI,Rieti,7,517,0,0,0,0,0,0,517,502,0,0,0,0,0,0,502,1019
IT-RI,Rieti,8,550,0,0,0,0,0,0,550,534,0,0,0,0,0,0,534,1084
IT-RI,Rieti,9,569,0,0,0,0,0,0,569,563,0,0,0,0,0,0,563,1132
IT-RI,Rieti,10,622,0,0,0,0,0,0,622,513,0,0,0,0,0,0,513,1135
IT-RI,Rieti,11,622,0,0,0,0,0,0,622,581,0,0,0,0,0,0,581,1203
IT-RI,Rieti,12,642,0,0,0,0,0,0,642,601,0,0,0,0,0,0,601,1243
IT-RI,Rieti,13,604,0,0,0,0,0,0,604,604,0,0,0,0,0,0,604,1208
IT-RI,Rieti,14,699,0,0,0,0,0,0,699,600,0,0,0,0,0,0,600,1299
IT-RI,Rieti,15,672,0,0,0,0,0,0,672,641,0,0,0,0,0,0,641,1313
IT-RI,Rieti,16,653,0,0,0,0,0,0,653,627,0,0,0,0,0,0,627,1280
IT-RI,Rieti,17,737,0,0,0,0,0,0,737,607,0,0,0,0,0,0,607,1344
IT-RI,Rieti,18,709,0,0,0,0,0,0,709,604,0,0,0,0,0,0,604,1313
IT-RI,Rieti,19,734,0,0,0,0,0,0,734,627,2,0,0,0,0,0,629,1363
IT-RI,Rieti,20,775,0,0,0,0,0,0,775,574,4,1,0,0,0,0,579,1354
IT-RI,Rieti,21,688,2,0,0,0,0,0,690,664,5,0,0,0,0,0,669,1359
IT-RI,Rieti,22,699,3,0,0,0,0,0,702,628,5,1,0,1,0,0,635,1337
IT-RI,Rieti,23,740,2,0,0,0,0,0,742,699,18,1,0,0,0,0,718,1460
IT-RI,Rieti,24,748,6,0,0,0,0,0,754,669,22,0,0,1,0,0,692,1446
IT-RI,Rieti,25,789,13,0,0,0,0,0,802,614,33,2,0,0,0,0,649,1451
IT-RI,Rieti,26,816,25,1,0,0,0,0,842,607,47,0,0,0,0,0,654,1496
IT-RI,Rieti,27,824,32,0,0,0,0,0,856,631,66,3,0,0,0,0,700,1556
IT-RI,Rieti,28,860,49,3,0,2,0,0,914,612,90,1,0,0,0,0,703,1617
IT-RI,Rieti,29,792,61,1,0,1,0,0,855,611,118,4,0,0,0,0,733,1588
IT-RI,Rieti,30,754,85,0,0,0,0,0,839,579,119,5,0,0,0,0,703,1542
IT-RI,Rieti,31,816,106,3,2,1,0,0,928,577,169,7,0,0,0,0,753,1681
IT-RI,Rieti,32,748,137,3,1,0,0,0,889,511,184,6,2,0,0,0,703,1592
IT-RI,Rieti,33,693,140,5,0,0,0,0,838,518,206,10,1,0,0,0,735,1573
IT-RI,Rieti,34,647,180,4,0,1,0,0,832,486,272,9,1,1,0,0,769,1601
IT-RI,Rieti,35,631,226,4,0,0,0,0,861,488,250,15,1,0,0,0,754,1615
IT-RI,Rieti,36,627,217,8,1,0,0,0,853,429,321,21,2,1,0,0,774,1627
IT-RI,Rieti,37,559,241,6,1,0,0,0,807,416,377,15,3,2,1,0,814,1621
IT-RI,Rieti,38,558,295,12,1,0,0,0,866,381,418,23,1,0,0,0,823,1689
IT-RI,Rieti,39,514,347,14,2,2,0,0,879,361,409,18,3,0,0,0,791,1670
IT-RI,Rieti,40,511,393,18,1,1,0,0,924,341,420,28,3,1,0,0,793,1717
IT-RI,Rieti,41,490,407,18,0,4,0,0,919,315,459,28,4,1,0,0,807,1726
IT-RI,Rieti,42,445,401,29,0,1,0,0,876,348,535,40,8,2,0,0,933,1809
IT-RI,Rieti,43,460,435,23,2,0,0,0,920,329,516,39,8,0,0,0,892,1812
IT-RI,Rieti,44,467,483,32,0,1,0,0,983,305,537,60,7,0,0,0,909,1892
IT-RI,Rieti,45,483,539,46,5,0,0,0,1073,314,648,54,13,0,1,0,1030,2103
IT-RI,Rieti,46,442,576,37,0,0,0,0,1055,301,662,66,16,0,0,0,1045,2100
IT-RI,Rieti,47,407,622,42,2,1,0,0,1074,316,673,67,17,1,0,0,1074,2148
IT-RI,Rieti,48,411,653,51,5,2,0,0,1122,289,746,78,18,0,0,0,1131,2253
IT-RI,Rieti,49,438,726,50,4,2,0,0,1220,256,812,80,25,2,0,0,1175,2395
IT-RI,Rieti,50,385,718,48,9,0,0,0,1160,294,788,75,24,1,0,0,1182,2342
IT-RI,Rieti,51,341,750,55,11,0,0,0,1157,240,807,95,32,0,0,0,1174,2331
IT-RI,Rieti,52,324,702,62,9,1,0,0,1098,214,861,93,34,0,0,0,1202,2300
IT-RI,Rieti,53,308,769,73,7,0,0,0,1157,196,920,101,34,2,0,0,1253,2410
IT-RI,Rieti,54,329,851,80,11,0,0,0,1271,184,870,100,46,0,0,0,1200,2471
IT-RI,Rieti,55,281,827,83,8,4,0,0,1203,208,909,107,53,0,0,0,1277,2480
IT-RI,Rieti,56,265,894,70,8,0,0,0,1237,185,929,87,50,0,0,0,1251,2488
IT-RI,Rieti,57,256,862,109,19,3,0,0,1249,157,927,100,76,0,0,0,1260,2509
IT-RI,Rieti,58,233,967,84,16,2,0,0,1302,176,964,88,78,0,0,0,1306,2608
IT-RI,Rieti,59,215,951,78,23,2,0,0,1269,166,920,113,84,0,0,0,1283,2552
IT-RI,Rieti,60,198,930,94,26,2,0,0,1250,124,909,99,89,0,0,0,1221,2471
IT-RI,Rieti,61,172,893,106,18,1,0,0,1190,149,872,94,119,1,0,0,1235,2425
IT-RI,Rieti,62,149,890,94,30,2,0,0,1165,134,854,77,106,0,0,0,1171,2336
IT-RI,Rieti,63,149,907,74,21,2,0,0,1153,113,853,71,125,0,0,0,1162,2315
IT-RI,Rieti,64,131,822,57,26,1,0,0,1037,109,808,73,128,0,0,0,1118,2155
IT-RI,Rieti,65,131,817,60,15,0,0,0,1023,100,781,75,134,0,0,0,1090,2113
IT-RI,Rieti,66,107,743,62,38,1,0,0,951,80,743,66,163,0,0,0,1052,2003
IT-RI,Rieti,67,121,796,56,37,1,0,0,1011,80,756,75,149,0,0,0,1060,2071
IT-RI,Rieti,68,107,789,61,36,1,0,0,994,77,718,56,165,0,0,0,1016,2010
IT-RI,Rieti,69,90,812,49,37,1,0,0,989,64,702,58,184,0,0,0,1008,1997
IT-RI,Rieti,70,81,763,53,43,1,0,0,941,78,700,40,200,1,0,0,1019,1960
IT-RI,Rieti,71,87,733,64,46,1,0,0,931,60,657,42,191,0,0,0,950,1881
IT-RI,Rieti,72,51,756,49,48,0,0,0,904,60,677,56,206,0,0,0,999,1903
IT-RI,Rieti,73,73,804,45,80,0,0,0,1002,57,619,52,236,0,0,0,964,1966
IT-RI,Rieti,74,56,759,40,71,0,0,0,926,59,604,38,242,1,0,0,944,1870
IT-RI,Rieti,75,63,782,31,79,0,0,0,955,60,646,35,338,0,0,0,1079,2034
IT-RI,Rieti,76,52,703,35,72,0,0,0,862,56,528,31,311,0,0,0,926,1788
IT-RI,Rieti,77,51,661,19,74,0,0,0,805,41,447,21,354,0,0,0,863,1668
IT-RI,Rieti,78,34,509,23,62,0,0,0,628,34,394,29,263,0,0,0,720,1348
IT-RI,Rieti,79,35,492,21,81,0,0,0,629,44,308,22,289,0,0,1,664,1293
IT-RI,Rieti,80,38,472,17,84,0,0,0,611,34,318,24,323,0,0,0,699,1310
IT-RI,Rieti,81,35,408,14,72,1,0,0,530,24,274,10,340,0,0,0,648,1178
IT-RI,Rieti,82,39,381,20,72,0,0,0,512,28,248,12,372,0,0,0,660,1172
IT-RI,Rieti,83,26,399,10,98,0,0,0,533,37,295,18,425,0,0,0,775,1308
IT-RI,Rieti,84,32,347,8,87,1,0,0,475,34,195,7,433,0,0,0,669,1144
IT-RI,Rieti,85,22,355,10,102,0,0,0,489,24,173,13,455,0,0,0,665,1154
IT-RI,Rieti,86,15,273,4,86,0,0,0,378,22,118,11,404,0,0,0,555,933
IT-RI,Rieti,87,7,220,4,73,0,0,0,304,14,99,4,285,0,0,0,402,706
IT-RI,Rieti,88,20,189,1,88,0,0,0,298,29,78,4,382,0,0,0,493,791
IT-RI,Rieti,89,14,136,3,77,0,0,0,230,20,75,3,303,0,0,0,401,631
IT-RI,Rieti,90,4,121,2,58,0,0,0,185,15,48,3,287,0,0,0,353,538
IT-RI,Rieti,91,12,76,2,51,0,0,0,141,11,32,3,201,0,0,0,247,388
IT-RI,Rieti,92,7,69,0,41,0,0,0,117,14,33,1,209,0,0,0,257,374
IT-RI,Rieti,93,5,59,1,46,0,0,0,111,13,17,2,188,0,0,0,220,331
IT-RI,Rieti,94,3,35,0,41,0,0,0,79,6,13,0,139,0,0,0,158,237
IT-RI,Rieti,95,3,18,0,21,0,0,0,42,9,6,0,97,0,0,0,112,154
IT-RI,Rieti,96,1,20,0,18,0,0,0,39,8,11,0,84,0,0,0,103,142
IT-RI,Rieti,97,0,8,0,13,0,0,0,21,0,2,2,71,0,0,0,75,96
IT-RI,Rieti,98,0,5,0,7,0,0,0,12,2,3,1,48,0,0,0,54,66
IT-RI,Rieti,99,0,4,0,6,0,0,0,10,2,0,1,34,0,0,0,37,47
IT-RI,Rieti,100,1,6,0,4,0,0,0,11,3,0,0,49,0,0,0,52,63
IT-RI,Rieti,999,35667,34655,2341,2233,47,0,0,74943,28736,33652,2870,9765,19,2,1,75045,149988
IT-RN,Rimini,0,1015,0,0,0,0,0,0,1015,938,0,0,0,0,0,0,938,1953
IT-RN,Rimini,1,1062,0,0,0,0,0,0,1062,1014,0,0,0,0,0,0,1014,2076
IT-RN,Rimini,2,1105,0,0,0,0,0,0,1105,989,0,0,0,0,0,0,989,2094
IT-RN,Rimini,3,1141,0,0,0,0,0,0,1141,1078,0,0,0,0,0,0,1078,2219
IT-RN,Rimini,4,1221,0,0,0,0,0,0,1221,1126,0,0,0,0,0,0,1126,2347
IT-RN,Rimini,5,1327,0,0,0,0,0,0,1327,1153,0,0,0,0,0,0,1153,2480
IT-RN,Rimini,6,1332,0,0,0,0,0,0,1332,1238,0,0,0,0,0,0,1238,2570
IT-RN,Rimini,7,1353,0,0,0,0,0,0,1353,1345,0,0,0,0,0,0,1345,2698
IT-RN,Rimini,8,1471,0,0,0,0,0,0,1471,1443,0,0,0,0,0,0,1443,2914
IT-RN,Rimini,9,1574,0,0,0,0,0,0,1574,1438,0,0,0,0,0,0,1438,3012
IT-RN,Rimini,10,1596,0,0,0,0,0,0,1596,1445,0,0,0,0,0,0,1445,3041
IT-RN,Rimini,11,1616,0,0,0,0,0,0,1616,1509,0,0,0,0,0,0,1509,3125
IT-RN,Rimini,12,1591,0,0,0,0,0,0,1591,1571,0,0,0,0,0,0,1571,3162
IT-RN,Rimini,13,1720,0,0,0,0,0,0,1720,1679,0,0,0,0,0,0,1679,3399
IT-RN,Rimini,14,1684,0,0,0,0,0,0,1684,1660,0,0,0,0,0,0,1660,3344
IT-RN,Rimini,15,1745,0,0,0,0,0,0,1745,1700,0,0,0,0,0,0,1700,3445
IT-RN,Rimini,16,1761,0,0,0,0,0,0,1761,1654,0,0,0,0,0,0,1654,3415
IT-RN,Rimini,17,1737,0,0,0,0,0,0,1737,1556,0,0,0,0,0,0,1556,3293
IT-RN,Rimini,18,1715,0,0,0,0,0,0,1715,1614,1,0,0,0,0,0,1615,3330
IT-RN,Rimini,19,1658,0,0,0,0,0,0,1658,1609,4,0,0,0,0,0,1613,3271
IT-RN,Rimini,20,1688,2,0,0,0,0,0,1690,1558,8,0,0,0,0,0,1566,3256
IT-RN,Rimini,21,1718,2,0,0,0,0,0,1720,1517,11,0,0,2,0,0,1530,3250
IT-RN,Rimini,22,1694,4,2,0,0,0,0,1700,1614,27,0,0,0,0,0,1641,3341
IT-RN,Rimini,23,1785,11,0,0,0,0,0,1796,1547,60,2,0,0,0,0,1609,3405
IT-RN,Rimini,24,1793,22,2,0,0,0,0,1817,1544,70,3,0,0,0,0,1617,3434
IT-RN,Rimini,25,1635,34,1,0,0,0,0,1670,1431,90,4,0,1,0,0,1526,3196
IT-RN,Rimini,26,1644,41,2,0,0,0,0,1687,1472,112,8,0,1,0,0,1593,3280
IT-RN,Rimini,27,1623,58,4,0,0,0,0,1685,1379,179,8,0,1,0,0,1567,3252
IT-RN,Rimini,28,1617,106,1,0,1,0,0,1725,1256,228,4,0,4,0,0,1492,3217
IT-RN,Rimini,29,1536,149,3,0,1,0,0,1689,1276,311,10,0,3,1,0,1601,3290
IT-RN,Rimini,30,1522,205,9,0,1,0,0,1737,1158,391,15,1,6,0,0,1571,3308
IT-RN,Rimini,31,1475,244,10,0,2,0,0,1731,1160,467,16,1,3,0,0,1647,3378
IT-RN,Rimini,32,1417,338,8,3,1,0,0,1767,1169,503,13,1,6,0,0,1692,3459
IT-RN,Rimini,33,1286,406,9,3,2,0,0,1706,1123,633,35,4,2,0,0,1797,3503
IT-RN,Rimini,34,1331,435,17,0,3,0,1,1787,1054,730,38,1,4,1,0,1828,3615
IT-RN,Rimini,35,1243,516,21,4,1,0,0,1785,990,788,48,4,6,0,0,1836,3621
IT-RN,Rimini,36,1134,532,20,0,3,0,1,1690,911,802,52,4,6,0,0,1775,3465
IT-RN,Rimini,37,1068,611,36,1,2,0,0,1718,917,915,75,11,4,1,0,1923,3641
IT-RN,Rimini,38,1129,725,40,3,8,0,0,1905,855,986,97,11,2,1,0,1952,3857
IT-RN,Rimini,39,1109,809,38,5,2,0,0,1963,901,1066,77,15,2,0,0,2061,4024
IT-RN,Rimini,40,1037,859,47,0,3,0,0,1946,940,1084,109,14,5,0,0,2152,4098
IT-RN,Rimini,41,1079,965,59,2,5,0,0,2110,890,1189,121,21,2,2,0,2225,4335
IT-RN,Rimini,42,1034,1059,71,7,3,0,0,2174,877,1183,112,19,4,2,0,2197,4371
IT-RN,Rimini,43,1048,996,73,4,3,0,0,2124,821,1239,155,26,2,0,0,2243,4367
IT-RN,Rimini,44,986,1171,115,8,8,0,0,2288,817,1377,132,31,2,0,0,2359,4647
IT-RN,Rimini,45,1047,1222,96,17,5,0,0,2387,852,1432,158,36,4,0,0,2482,4869
IT-RN,Rimini,46,1081,1352,118,9,4,1,0,2565,780,1593,195,35,2,0,0,2605,5170
IT-RN,Rimini,47,1013,1442,155,7,7,0,0,2624,849,1635,250,35,4,0,0,2773,5397
IT-RN,Rimini,48,1029,1518,164,13,5,0,0,2729,798,1778,247,56,3,0,0,2882,5611
IT-RN,Rimini,49,1072,1603,178,19,5,0,0,2877,862,1807,273,51,2,0,0,2995,5872
IT-RN,Rimini,50,971,1680,184,13,4,1,0,2853,719,1893,272,64,1,0,0,2949,5802
IT-RN,Rimini,51,918,1704,191,18,11,0,0,2842,699,1895,265,70,2,0,0,2931,5773
IT-RN,Rimini,52,891,1786,211,13,13,0,0,2914,692,1890,297,75,1,0,0,2955,5869
IT-RN,Rimini,53,770,1752,232,12,4,0,1,2771,684,1942,323,84,2,0,0,3035,5806
IT-RN,Rimini,54,812,1843,215,20,1,0,0,2891,632,1902,317,85,2,0,0,2938,5829
IT-RN,Rimini,55,692,1887,244,23,8,0,0,2854,590,1958,336,98,1,0,0,2983,5837
IT-RN,Rimini,56,686,1800,256,33,5,0,0,2780,581,1860,287,99,1,0,0,2828,5608
IT-RN,Rimini,57,621,1930,255,32,5,0,0,2843,496,1864,331,135,1,0,0,2827,5670
IT-RN,Rimini,58,613,1850,241,45,6,0,0,2755,458,1842,328,134,0,0,0,2762,5517
IT-RN,Rimini,59,554,1972,238,28,8,0,0,2800,467,2051,363,129,1,0,0,3011,5811
IT-RN,Rimini,60,472,1750,240,50,5,0,0,2517,425,1832,342,149,0,0,0,2748,5265
IT-RN,Rimini,61,445,1737,267,41,0,0,0,2490,318,1870,324,155,0,1,0,2668,5158
IT-RN,Rimini,62,377,1687,214,38,4,1,0,2321,305,1797,275,201,0,0,0,2578,4899
IT-RN,Rimini,63,342,1677,194,48,5,0,0,2266,282,1748,264,226,0,0,0,2520,4786
IT-RN,Rimini,64,327,1644,194,41,4,0,0,2210,246,1674,261,235,0,0,0,2416,4626
IT-RN,Rimini,65,264,1591,161,62,6,0,0,2084,292,1565,238,286,2,0,0,2383,4467
IT-RN,Rimini,66,262,1599,179,68,0,0,0,2108,226,1547,202,277,0,0,0,2252,4360
IT-RN,Rimini,67,247,1491,163,73,3,0,0,1977,191,1467,185,276,0,0,0,2119,4096
IT-RN,Rimini,68,199,1493,139,57,0,0,0,1888,192,1383,179,327,0,0,0,2081,3969
IT-RN,Rimini,69,167,1395,135,76,2,0,0,1775,162,1457,151,300,0,0,0,2070,3845
IT-RN,Rimini,70,180,1312,106,88,0,0,0,1686,162,1329,158,338,1,0,0,1988,3674
IT-RN,Rimini,71,146,1342,84,94,2,0,0,1668,148,1319,133,360,0,0,0,1960,3628
IT-RN,Rimini,72,134,1353,101,96,0,0,0,1684,121,1314,136,400,1,0,0,1972,3656
IT-RN,Rimini,73,114,1432,85,111,7,0,0,1749,110,1263,130,479,0,0,0,1982,3731
IT-RN,Rimini,74,126,1399,77,127,2,0,0,1731,115,1272,129,510,0,0,0,2026,3757
IT-RN,Rimini,75,117,1424,76,154,1,0,0,1772,112,1260,95,601,0,0,0,2068,3840
IT-RN,Rimini,76,108,1381,72,134,1,0,0,1696,86,1163,89,635,0,0,0,1973,3669
IT-RN,Rimini,77,91,1335,74,143,0,0,0,1643,114,1130,97,662,0,0,0,2003,3646
IT-RN,Rimini,78,87,1004,52,113,1,0,0,1257,74,810,71,579,0,0,0,1534,2791
IT-RN,Rimini,79,65,1002,47,134,0,0,0,1248,91,773,66,630,0,0,0,1560,2808
IT-RN,Rimini,80,73,1033,41,165,0,0,0,1312,79,744,57,669,0,0,0,1549,2861
IT-RN,Rimini,81,50,874,33,141,0,0,0,1098,82,568,54,679,0,0,0,1383,2481
IT-RN,Rimini,82,63,834,37,166,3,0,0,1103,51,565,51,741,0,0,0,1408,2511
IT-RN,Rimini,83,69,831,17,171,0,0,0,1088,65,581,49,851,0,0,0,1546,2634
IT-RN,Rimini,84,74,769,18,186,1,0,0,1048,58,458,43,822,0,0,0,1381,2429
IT-RN,Rimini,85,54,712,19,200,0,0,0,985,67,408,31,923,0,0,0,1429,2414
IT-RN,Rimini,86,45,566,12,180,0,0,0,803,57,282,25,794,0,0,0,1158,1961
IT-RN,Rimini,87,31,438,9,154,0,0,0,632,47,195,28,720,0,0,0,990,1622
IT-RN,Rimini,88,35,375,6,152,0,0,0,568,48,164,21,729,0,0,0,962,1530
IT-RN,Rimini,89,22,324,4,164,1,0,0,515,49,132,18,735,0,0,0,934,1449
IT-RN,Rimini,90,22,262,4,120,0,0,0,408,32,75,14,580,0,0,0,701,1109
IT-RN,Rimini,91,12,171,6,96,0,0,0,285,19,49,7,502,0,0,0,577,862
IT-RN,Rimini,92,17,164,0,92,0,0,0,273,32,39,4,456,0,0,0,531,804
IT-RN,Rimini,93,9,91,2,80,0,0,0,182,27,30,4,422,0,0,0,483,665
IT-RN,Rimini,94,3,64,2,60,0,0,0,129,23,12,5,282,0,0,0,322,451
IT-RN,Rimini,95,8,41,0,59,0,0,0,108,18,5,4,246,0,0,0,273,381
IT-RN,Rimini,96,1,24,0,31,0,0,0,56,9,4,1,182,0,0,0,196,252
IT-RN,Rimini,97,4,16,0,29,0,0,0,49,13,5,1,134,0,0,0,153,202
IT-RN,Rimini,98,0,8,0,11,0,0,0,19,4,1,0,79,0,0,0,84,103
IT-RN,Rimini,99,0,5,0,10,0,0,0,15,5,0,0,61,0,0,0,66,81
IT-RN,Rimini,100,3,5,0,11,0,0,0,19,5,1,0,100,0,0,0,106,125
IT-RN,Rimini,999,81690,72296,6436,4368,188,3,3,164984,71657,74087,9318,19683,99,9,0,174853,339837
IT-RM,Roma,0,13180,0,0,0,0,0,0,13180,12341,0,0,0,0,0,0,12341,25521
IT-RM,Roma,1,14108,0,0,0,0,0,0,14108,13345,0,0,0,0,0,0,13345,27453
IT-RM,Roma,2,14748,0,0,0,0,0,0,14748,14073,0,0,0,0,0,0,14073,28821
IT-RM,Roma,3,15023,0,0,0,0,0,0,15023,14216,0,0,0,0,0,0,14216,29239
IT-RM,Roma,4,15827,0,0,0,0,0,0,15827,14914,0,0,0,0,0,0,14914,30741
IT-RM,Roma,5,16710,0,0,0,0,0,0,16710,15958,0,0,0,0,0,0,15958,32668
IT-RM,Roma,6,17457,0,0,0,0,0,0,17457,16453,0,0,0,0,0,0,16453,33910
IT-RM,Roma,7,18237,0,0,0,0,0,0,18237,17372,0,0,0,0,0,0,17372,35609
IT-RM,Roma,8,18812,0,0,0,0,0,0,18812,17963,0,0,0,0,0,0,17963,36775
IT-RM,Roma,9,19806,0,0,0,0,0,0,19806,18331,0,0,0,0,0,0,18331,38137
IT-RM,Roma,10,19787,0,0,0,0,0,0,19787,18679,0,0,0,0,0,0,18679,38466
IT-RM,Roma,11,21028,0,0,0,0,0,0,21028,19923,0,0,0,0,0,0,19923,40951
IT-RM,Roma,12,21084,0,0,0,0,0,0,21084,19931,0,0,0,0,0,0,19931,41015
IT-RM,Roma,13,21553,0,0,0,0,0,0,21553,20203,0,0,0,0,0,0,20203,41756
IT-RM,Roma,14,21713,0,0,0,0,0,0,21713,20234,0,0,0,0,0,0,20234,41947
IT-RM,Roma,15,21699,0,0,0,0,0,0,21699,20700,0,0,0,0,0,0,20700,42399
IT-RM,Roma,16,22026,0,0,0,0,0,0,22026,20622,2,0,0,0,0,0,20624,42650
IT-RM,Roma,17,21875,0,0,0,0,0,0,21875,20485,0,0,0,0,0,0,20485,42360
IT-RM,Roma,18,21412,1,1,0,0,0,0,21414,19757,3,0,0,0,0,0,19760,41174
IT-RM,Roma,19,21495,0,0,0,0,0,0,21495,19978,22,0,0,0,0,0,20000,41495
IT-RM,Roma,20,20780,5,1,0,0,0,0,20786,19435,61,0,0,0,0,0,19496,40282
IT-RM,Roma,21,20494,17,0,0,0,0,0,20511,18904,87,0,1,0,0,0,18992,39503
IT-RM,Roma,22,20586,30,7,0,0,0,0,20623,18844,207,4,0,0,0,0,19055,39678
IT-RM,Roma,23,20932,65,7,0,3,0,0,21007,18890,305,8,0,1,0,0,19204,40211
IT-RM,Roma,24,20467,127,11,0,4,0,0,20609,18406,463,11,1,5,0,0,18886,39495
IT-RM,Roma,25,21029,236,14,0,5,0,0,21284,18653,772,19,1,6,0,0,19451,40735
IT-RM,Roma,26,20444,390,11,0,8,0,0,20853,18165,1106,14,1,6,0,0,19292,40145
IT-RM,Roma,27,20704,578,13,0,8,0,0,21303,18038,1598,17,2,9,1,0,19665,40968
IT-RM,Roma,28,20690,919,14,0,10,2,0,21635,17626,2152,45,4,15,3,0,19845,41480
IT-RM,Roma,29,20225,1423,32,1,29,0,0,21710,17305,2988,58,9,28,1,0,20389,42099
IT-RM,Roma,30,19884,1872,45,2,17,3,0,21823,17213,3883,95,6,30,3,0,21230,43053
IT-RM,Roma,31,20264,2688,38,5,29,1,0,23025,16981,5064,130,14,30,4,0,22223,45248
IT-RM,Roma,32,19056,3584,74,6,40,2,0,22762,16100,5983,155,16,30,2,0,22286,45048
IT-RM,Roma,33,19278,4382,97,10,43,6,0,23816,15609,7217,211,32,37,4,0,23110,46926
IT-RM,Roma,34,17903,5457,131,7,47,0,0,23545,14490,8261,267,31,44,2,0,23095,46640
IT-RM,Roma,35,17485,6701,153,20,66,1,0,24426,14041,9598,366,45,65,5,1,24121,48547
IT-RM,Roma,36,16367,7364,205,11,71,0,0,24018,13275,10537,400,49,60,7,0,24328,48346
IT-RM,Roma,37,15313,8395,227,26,58,3,0,24022,12324,11098,581,83,49,5,0,24140,48162
IT-RM,Roma,38,15113,9635,330,28,78,3,0,25187,12155,12408,631,104,58,4,0,25360,50547
IT-RM,Roma,39,14662,10939,361,29,63,1,1,26056,11891,13267,820,125,64,5,0,26172,52228
IT-RM,Roma,40,14092,11963,485,40,77,5,0,26662,11471,14142,879,127,55,1,0,26675,53337
IT-RM,Roma,41,13697,13080,583,38,93,5,0,27496,11489,15281,986,135,77,2,0,27970,55466
IT-RM,Roma,42,13120,13535,618,74,75,2,0,27424,10847,15920,1159,221,61,0,0,28208,55632
IT-RM,Roma,43,12589,14486,699,68,73,2,0,27917,10679,16505,1309,258,41,4,0,28796,56713
IT-RM,Roma,44,12348,15329,892,89,104,3,0,28765,10558,17433,1562,311,61,4,0,29929,58694
IT-RM,Roma,45,12642,16401,996,88,76,3,0,30206,10591,18767,1731,331,48,0,0,31468,61674
IT-RM,Roma,46,12420,16929,1127,92,83,0,0,30651,10198,19539,1979,376,54,1,0,32147,62798
IT-RM,Roma,47,12075,18077,1267,111,83,3,1,31617,10447,20630,2095,473,53,2,0,33700,65317
IT-RM,Roma,48,12329,19332,1458,146,96,1,0,33362,10529,22020,2466,509,50,1,0,35575,68937
IT-RM,Roma,49,12400,20278,1687,139,97,4,3,34608,10443,23537,2787,597,64,2,0,37430,72038
IT-RM,Roma,50,11462,21073,1868,160,107,1,1,34672,9912,23683,2922,678,46,1,0,37242,71914
IT-RM,Roma,51,11073,21928,1966,194,102,1,1,35265,9315,24512,3137,749,44,2,2,37761,73026
IT-RM,Roma,52,10234,22422,2090,190,94,1,1,35032,8689,24781,3393,897,46,2,0,37808,72840
IT-RM,Roma,53,9660,22693,2156,236,102,0,1,34848,8121,24707,3601,1043,41,2,0,37515,72363
IT-RM,Roma,54,9087,23375,2418,267,89,1,2,35239,7923,25234,3768,1141,41,0,0,38107,73346
IT-RM,Roma,55,8439,23225,2523,308,98,3,2,34598,7346,25034,3842,1278,35,4,0,37539,72137
IT-RM,Roma,56,7718,23528,2587,322,106,2,1,34264,7035,25151,4070,1381,28,1,0,37666,71930
IT-RM,Roma,57,7420,24118,2753,404,108,0,0,34803,6518,25224,4041,1579,24,2,0,37388,72191
IT-RM,Roma,58,6737,24387,2817,406,104,0,1,34452,6180,25135,4095,1703,40,1,1,37155,71607
IT-RM,Roma,59,6382,25041,2839,489,100,0,2,34853,5763,25757,4214,2026,40,2,3,37805,72658
IT-RM,Roma,60,5314,23679,2666,551,93,4,1,32308,5128,24283,3952,2181,32,3,1,35580,67888
IT-RM,Roma,61,4683,22675,2620,536,62,2,1,30579,4727,22887,3697,2244,29,1,1,33586,64165
IT-RM,Roma,62,4180,22220,2435,612,69,0,2,29518,4259,22159,3419,2589,27,1,0,32454,61972
IT-RM,Roma,63,3749,21026,2172,670,68,1,1,27687,3947,20868,3353,2786,26,1,1,30982,58669
IT-RM,Roma,64,3356,20271,2070,657,64,1,1,26420,3652,20151,3134,2903,15,1,0,29856,56276
IT-RM,Roma,65,2879,19274,1972,732,71,1,3,24932,3319,18973,2975,3113,19,0,0,28399,53331
IT-RM,Roma,66,2751,18914,1818,696,55,0,1,24235,3143,18653,2717,3386,23,0,0,27922,52157
IT-RM,Roma,67,2482,18538,1748,833,38,1,1,23641,2659,17819,2625,3718,18,0,1,26840,50481
IT-RM,Roma,68,2151,18174,1521,843,28,0,0,22717,2691,17225,2351,3909,8,0,0,26184,48901
IT-RM,Roma,69,1873,17280,1502,1001,36,0,1,21693,2547,16504,2303,4315,6,0,0,25675,47368
IT-RM,Roma,70,1769,16219,1282,987,27,0,0,20284,2288,15435,2013,4341,9,0,0,24086,44370
IT-RM,Roma,71,1496,15705,1190,1061,27,0,1,19480,2067,14616,2003,4699,10,0,0,23395,42875
IT-RM,Roma,72,1493,15181,1077,1084,31,1,1,18868,1967,13977,1859,5081,13,0,0,22897,41765
IT-RM,Roma,73,1363,15547,1001,1201,30,2,0,19144,1931,14012,1809,5639,7,0,0,23398,42542
IT-RM,Roma,74,1163,15092,962,1364,24,0,2,18607,1838,13380,1643,6125,6,0,0,22992,41599
IT-RM,Roma,75,1171,15433,906,1558,21,0,1,19090,1892,13734,1608,6958,8,0,0,24200,43290
IT-RM,Roma,76,1059,15173,865,1769,21,0,0,18887,1735,13041,1511,7577,7,0,0,23871,42758
IT-RM,Roma,77,1003,14423,758,1739,13,0,0,17936,1684,12160,1500,8013,6,0,0,23363,41299
IT-RM,Roma,78,756,11040,549,1567,11,0,0,13923,1428,9121,1113,6976,4,0,1,18643,32566
IT-RM,Roma,79,698,10658,517,1656,13,0,1,13543,1368,8303,1031,7378,3,0,1,18084,31627
IT-RM,Roma,80,689,10673,491,1750,11,0,0,13614,1395,8311,1014,8245,2,0,0,18967,32581
IT-RM,Roma,81,626,9769,445,1927,14,0,1,12782,1339,7261,912,8519,3,0,1,18035,30817
IT-RM,Roma,82,566,9501,359,2032,12,0,0,12470,1289,6645,834,8988,4,0,1,17761,30231
IT-RM,Roma,83,564,9428,350,2290,15,0,0,12647,1458,6440,783,10327,1,0,0,19009,31656
IT-RM,Roma,84,469,8591,271,2228,4,0,0,11563,1260,5381,642,10136,1,0,0,17420,28983
IT-RM,Roma,85,412,7478,245,2048,6,0,0,10189,1154,4428,596,9826,1,0,0,16005,26194
IT-RM,Roma,86,341,6056,207,2054,4,0,0,8662,1051,3333,433,9184,1,0,0,14002,22664
IT-RM,Roma,87,270,4912,166,1855,6,0,0,7209,937,2582,407,8393,0,0,0,12319,19528
IT-RM,Roma,88,234,4385,141,1851,1,0,1,6613,861,2035,309,8126,0,0,0,11331,17944
IT-RM,Roma,89,211,3412,108,1609,4,0,0,5344,777,1467,242,7436,0,0,0,9922,15266
IT-RM,Roma,90,155,2610,69,1371,1,0,1,4207,635,1061,194,6489,0,0,0,8379,12586
IT-RM,Roma,91,101,2040,52,1173,1,1,0,3368,567,765,146,5529,0,0,0,7007,10375
IT-RM,Roma,92,91,1471,34,1098,0,0,0,2694,489,513,132,4798,0,0,0,5932,8626
IT-RM,Roma,93,80,1136,17,936,0,0,0,2169,445,415,95,4259,0,0,0,5214,7383
IT-RM,Roma,94,62,691,13,677,0,0,0,1443,292,221,91,3098,0,0,0,3702,5145
IT-RM,Roma,95,42,447,10,444,0,0,0,943,275,145,45,2367,0,0,0,2832,3775
IT-RM,Roma,96,30,274,4,346,1,0,0,655,169,84,29,1892,0,0,0,2174,2829
IT-RM,Roma,97,21,186,7,249,0,0,0,463,145,51,25,1290,0,0,0,1511,1974
IT-RM,Roma,98,9,90,1,161,0,0,0,261,114,51,27,929,0,0,0,1121,1382
IT-RM,Roma,99,8,65,3,132,0,0,0,208,100,33,12,647,0,0,0,792,1000
IT-RM,Roma,100,37,67,4,182,0,0,0,290,154,52,27,1002,0,0,0,1235,1525
IT-RM,Roma,999,1025587,885812,68229,51536,3328,73,38,2034603,937053,908649,111479,231748,1775,87,15,2190806,4225409
IT-RO,Rovigo,0,605,0,0,0,0,0,0,605,582,0,0,0,0,0,0,582,1187
IT-RO,Rovigo,1,612,0,0,0,0,0,0,612,587,0,0,0,0,0,0,587,1199
IT-RO,Rovigo,2,665,0,0,0,0,0,0,665,567,0,0,0,0,0,0,567,1232
IT-RO,Rovigo,3,636,0,0,0,0,0,0,636,589,0,0,0,0,0,0,589,1225
IT-RO,Rovigo,4,657,0,0,0,0,0,0,657,635,0,0,0,0,0,0,635,1292
IT-RO,Rovigo,5,730,0,0,0,0,0,0,730,677,0,0,0,0,0,0,677,1407
IT-RO,Rovigo,6,853,0,0,0,0,0,0,853,743,0,0,0,0,0,0,743,1596
IT-RO,Rovigo,7,750,0,0,0,0,0,0,750,807,0,0,0,0,0,0,807,1557
IT-RO,Rovigo,8,796,0,0,0,0,0,0,796,832,0,0,0,0,0,0,832,1628
IT-RO,Rovigo,9,832,0,0,0,0,0,0,832,817,0,0,0,0,0,0,817,1649
IT-RO,Rovigo,10,913,0,0,0,0,0,0,913,835,0,0,0,0,0,0,835,1748
IT-RO,Rovigo,11,986,0,0,0,0,0,0,986,873,0,0,0,0,0,0,873,1859
IT-RO,Rovigo,12,914,0,0,0,0,0,0,914,929,0,0,0,0,0,0,929,1843
IT-RO,Rovigo,13,1033,0,0,0,0,0,0,1033,969,0,0,0,0,0,0,969,2002
IT-RO,Rovigo,14,1016,0,0,0,0,0,0,1016,953,0,0,0,0,0,0,953,1969
IT-RO,Rovigo,15,1051,0,0,0,0,0,0,1051,924,0,0,0,0,0,0,924,1975
IT-RO,Rovigo,16,959,0,1,0,0,0,0,960,946,0,0,0,0,0,0,946,1906
IT-RO,Rovigo,17,953,0,0,0,0,0,0,953,854,0,0,0,0,0,0,854,1807
IT-RO,Rovigo,18,999,0,0,0,0,0,0,999,909,0,0,0,0,0,0,909,1908
IT-RO,Rovigo,19,984,0,0,0,0,0,0,984,934,2,0,0,0,0,0,936,1920
IT-RO,Rovigo,20,930,0,0,0,0,0,0,930,896,2,0,0,0,0,0,898,1828
IT-RO,Rovigo,21,952,3,0,0,0,0,0,955,856,10,0,0,0,0,0,866,1821
IT-RO,Rovigo,22,1027,2,0,0,0,0,0,1029,844,29,0,0,0,0,0,873,1902
IT-RO,Rovigo,23,1010,10,1,0,0,0,0,1021,941,26,0,0,0,0,0,967,1988
IT-RO,Rovigo,24,995,9,0,0,0,0,0,1004,903,58,1,0,0,0,0,962,1966
IT-RO,Rovigo,25,1038,14,1,0,0,0,0,1053,900,76,3,0,0,0,0,979,2032
IT-RO,Rovigo,26,1045,24,0,0,1,0,0,1070,871,95,3,0,1,0,0,970,2040
IT-RO,Rovigo,27,1003,55,0,0,1,0,0,1059,818,126,5,0,0,0,0,949,2008
IT-RO,Rovigo,28,990,56,2,0,1,0,0,1049,776,152,2,0,0,0,0,930,1979
IT-RO,Rovigo,29,969,94,1,0,0,0,0,1064,717,208,5,1,0,0,0,931,1995
IT-RO,Rovigo,30,896,115,5,0,0,0,0,1016,690,237,13,0,1,0,0,941,1957
IT-RO,Rovigo,31,969,153,7,0,3,0,0,1132,707,264,11,0,1,0,0,983,2115
IT-RO,Rovigo,32,960,163,5,1,0,0,0,1129,705,373,15,1,1,0,0,1095,2224
IT-RO,Rovigo,33,924,234,10,0,2,0,0,1170,685,391,16,4,0,0,0,1096,2266
IT-RO,Rovigo,34,846,279,7,0,0,0,0,1132,637,407,16,1,1,0,0,1062,2194
IT-RO,Rovigo,35,816,322,13,1,3,0,0,1155,635,464,38,4,1,0,0,1142,2297
IT-RO,Rovigo,36,805,363,14,1,3,0,0,1186,570,489,31,1,3,0,0,1094,2280
IT-RO,Rovigo,37,769,394,23,1,6,0,0,1193,555,517,38,7,1,0,0,1118,2311
IT-RO,Rovigo,38,772,401,23,0,1,0,0,1197,588,614,44,7,2,0,0,1255,2452
IT-RO,Rovigo,39,727,492,23,1,3,0,0,1246,502,629,52,5,1,0,0,1189,2435
IT-RO,Rovigo,40,755,557,25,1,1,0,0,1339,467,636,54,8,3,0,0,1168,2507
IT-RO,Rovigo,41,675,562,44,0,2,0,0,1283,495,751,65,12,0,0,0,1323,2606
IT-RO,Rovigo,42,686,622,45,8,1,0,0,1362,524,777,87,28,0,0,0,1416,2778
IT-RO,Rovigo,43,732,652,53,7,2,0,0,1446,469,803,91,19,3,0,0,1385,2831
IT-RO,Rovigo,44,707,700,63,6,2,0,0,1478,469,875,91,20,1,0,0,1456,2934
IT-RO,Rovigo,45,747,803,72,6,2,0,0,1630,578,966,129,23,0,0,0,1696,3326
IT-RO,Rovigo,46,762,894,86,8,2,0,0,1752,523,970,132,24,2,0,0,1651,3403
IT-RO,Rovigo,47,782,926,104,8,2,1,0,1823,473,1029,138,27,1,0,0,1668,3491
IT-RO,Rovigo,48,717,974,121,7,3,0,0,1822,461,1110,158,31,2,0,0,1762,3584
IT-RO,Rovigo,49,739,1064,126,3,4,0,0,1936,468,1176,167,29,2,0,0,1842,3778
IT-RO,Rovigo,50,700,1024,133,8,2,1,0,1868,442,1229,187,44,1,0,0,1903,3771
IT-RO,Rovigo,51,685,1086,143,13,4,0,0,1931,393,1184,165,46,1,0,0,1789,3720
IT-RO,Rovigo,52,600,1151,149,6,2,0,0,1908,345,1276,173,42,1,0,0,1837,3745
IT-RO,Rovigo,53,586,1119,151,15,3,0,0,1874,301,1281,190,44,0,0,0,1816,3690
IT-RO,Rovigo,54,528,1209,174,13,1,0,0,1925,347,1289,186,73,0,0,0,1895,3820
IT-RO,Rovigo,55,491,1262,162,12,2,0,0,1929,277,1340,191,64,1,0,0,1873,3802
IT-RO,Rovigo,56,448,1297,167,25,2,0,0,1939,294,1381,158,80,1,0,0,1914,3853
IT-RO,Rovigo,57,403,1395,166,21,2,0,0,1987,292,1453,199,83,0,0,0,2027,4014
IT-RO,Rovigo,58,378,1365,173,30,2,0,0,1948,268,1419,179,95,0,0,0,1961,3909
IT-RO,Rovigo,59,366,1419,194,28,1,0,0,2008,257,1514,190,104,0,0,0,2065,4073
IT-RO,Rovigo,60,344,1387,153,36,0,0,0,1920,215,1477,161,138,0,0,0,1991,3911
IT-RO,Rovigo,61,307,1362,158,42,3,0,0,1872,207,1444,175,138,0,0,0,1964,3836
IT-RO,Rovigo,62,301,1388,158,42,1,0,0,1890,189,1465,172,170,0,0,0,1996,3886
IT-RO,Rovigo,63,281,1347,122,35,2,1,0,1788,142,1371,138,174,0,0,1,1826,3614
IT-RO,Rovigo,64,250,1372,134,58,2,0,0,1816,137,1409,140,197,0,0,0,1883,3699
IT-RO,Rovigo,65,191,1362,106,50,0,0,0,1709,127,1280,115,221,0,0,0,1743,3452
IT-RO,Rovigo,66,172,1344,105,59,2,0,0,1682,116,1321,117,231,0,0,0,1785,3467
IT-RO,Rovigo,67,180,1357,112,47,1,0,0,1697,130,1318,97,282,0,0,0,1827,3524
IT-RO,Rovigo,68,158,1293,78,60,0,0,0,1589,124,1273,85,274,0,0,0,1756,3345
IT-RO,Rovigo,69,133,1237,83,73,0,0,0,1526,102,1143,92,330,0,0,0,1667,3193
IT-RO,Rovigo,70,116,1282,66,77,1,0,0,1542,93,1152,83,362,0,0,0,1690,3232
IT-RO,Rovigo,71,111,1227,79,92,0,0,0,1509,95,1100,69,337,0,0,0,1601,3110
IT-RO,Rovigo,72,110,1152,55,108,0,0,0,1425,84,954,59,320,0,0,0,1417,2842
IT-RO,Rovigo,73,126,1203,62,99,0,0,0,1490,80,1025,54,401,0,0,0,1560,3050
IT-RO,Rovigo,74,115,1121,45,119,0,0,1,1401,89,999,45,406,0,0,0,1539,2940
IT-RO,Rovigo,75,100,1172,40,130,0,0,0,1442,82,919,55,510,0,0,0,1566,3008
IT-RO,Rovigo,76,99,1042,37,140,0,0,0,1318,76,834,51,505,0,0,0,1466,2784
IT-RO,Rovigo,77,75,1088,23,133,0,1,0,1320,60,806,40,573,0,0,0,1479,2799
IT-RO,Rovigo,78,52,618,23,90,0,0,0,783,29,441,22,411,0,0,0,903,1686
IT-RO,Rovigo,79,71,741,29,103,0,0,0,944,53,525,25,570,0,0,0,1173,2117
IT-RO,Rovigo,80,60,681,22,121,0,0,0,884,51,456,20,534,0,0,0,1061,1945
IT-RO,Rovigo,81,45,598,12,118,0,0,0,773,56,446,18,610,0,0,0,1130,1903
IT-RO,Rovigo,82,62,614,20,126,0,0,0,822,52,357,21,638,0,0,0,1068,1890
IT-RO,Rovigo,83,57,544,4,112,0,0,0,717,58,339,12,696,0,0,0,1105,1822
IT-RO,Rovigo,84,38,492,8,141,0,0,0,679,54,278,15,686,0,0,0,1033,1712
IT-RO,Rovigo,85,37,461,7,134,0,0,0,639,44,251,10,685,0,0,0,990,1629
IT-RO,Rovigo,86,31,343,0,147,0,0,0,521,44,174,11,645,0,0,0,874,1395
IT-RO,Rovigo,87,33,250,4,112,0,0,0,399,40,115,7,618,0,0,0,780,1179
IT-RO,Rovigo,88,28,256,7,124,0,0,0,415,28,100,3,606,0,0,0,737,1152
IT-RO,Rovigo,89,21,196,2,116,0,0,0,335,36,79,5,554,0,0,0,674,1009
IT-RO,Rovigo,90,13,150,3,86,0,0,0,252,39,62,4,475,0,0,0,580,832
IT-RO,Rovigo,91,13,103,4,81,0,0,0,201,27,38,4,388,0,0,0,457,658
IT-RO,Rovigo,92,4,89,1,59,0,0,0,153,28,26,1,365,0,0,0,420,573
IT-RO,Rovigo,93,10,60,0,55,0,0,0,125,23,19,2,314,0,0,0,358,483
IT-RO,Rovigo,94,5,30,0,43,0,0,0,78,20,9,2,236,0,0,0,267,345
IT-RO,Rovigo,95,1,28,0,32,0,0,0,61,18,6,0,174,0,0,0,198,259
IT-RO,Rovigo,96,1,10,1,28,0,0,0,40,11,6,1,127,0,0,0,145,185
IT-RO,Rovigo,97,0,6,0,14,0,0,0,20,7,3,0,103,0,0,0,113,133
IT-RO,Rovigo,98,1,3,0,11,0,0,0,15,3,2,1,59,0,0,0,65,80
IT-RO,Rovigo,99,1,1,0,9,0,0,0,11,3,1,0,43,0,0,0,47,58
IT-RO,Rovigo,100,1,1,0,4,0,0,0,6,7,0,2,62,0,0,0,71,77
IT-RO,Rovigo,999,51628,52275,4250,3496,78,4,1,111732,41780,52651,5157,16095,32,0,1,115716,227448
IT-SA,Salerno,0,3950,0,0,0,0,0,0,3950,3733,0,0,0,0,0,0,3733,7683
IT-SA,Salerno,1,3989,0,0,0,0,0,0,3989,3784,0,0,0,0,0,0,3784,7773
IT-SA,Salerno,2,4027,0,0,0,0,0,0,4027,3821,0,0,0,0,0,0,3821,7848
IT-SA,Salerno,3,4146,0,0,0,0,0,0,4146,3987,0,0,0,0,0,0,3987,8133
IT-SA,Salerno,4,4417,0,0,0,0,0,0,4417,4108,0,0,0,0,0,0,4108,8525
IT-SA,Salerno,5,4468,0,0,0,0,0,0,4468,4079,0,0,0,0,0,0,4079,8547
IT-SA,Salerno,6,4720,0,0,0,0,0,0,4720,4242,0,0,0,0,0,0,4242,8962
IT-SA,Salerno,7,4633,0,0,0,0,0,0,4633,4352,0,0,0,0,0,0,4352,8985
IT-SA,Salerno,8,4683,0,0,0,0,0,0,4683,4389,0,0,0,0,0,0,4389,9072
IT-SA,Salerno,9,4898,0,0,0,0,0,0,4898,4494,0,0,0,0,0,0,4494,9392
IT-SA,Salerno,10,4649,0,0,0,0,0,0,4649,4613,0,0,0,0,0,0,4613,9262
IT-SA,Salerno,11,5078,0,0,0,0,0,0,5078,4694,0,0,0,0,0,0,4694,9772
IT-SA,Salerno,12,5120,0,0,0,0,0,0,5120,4829,0,0,0,0,0,0,4829,9949
IT-SA,Salerno,13,5162,0,0,0,0,0,0,5162,4844,0,0,0,0,0,0,4844,10006
IT-SA,Salerno,14,5311,0,0,0,0,0,0,5311,4964,0,0,0,0,0,0,4964,10275
IT-SA,Salerno,15,5314,0,0,0,0,0,0,5314,5144,0,0,0,0,0,0,5144,10458
IT-SA,Salerno,16,5408,1,0,0,0,0,0,5409,5112,0,0,0,0,0,0,5112,10521
IT-SA,Salerno,17,5543,0,0,0,0,0,0,5543,5103,0,0,0,0,0,0,5103,10646
IT-SA,Salerno,18,5584,0,0,0,0,0,0,5584,5328,0,0,0,0,0,0,5328,10912
IT-SA,Salerno,19,5831,1,0,0,0,0,0,5832,5387,12,0,0,0,0,0,5399,11231
IT-SA,Salerno,20,5760,4,0,0,0,0,0,5764,5426,15,0,0,0,0,0,5441,11205
IT-SA,Salerno,21,5732,9,0,0,0,0,0,5741,5290,55,0,1,0,0,0,5346,11087
IT-SA,Salerno,22,5905,16,2,0,0,0,0,5923,5328,82,0,0,1,0,0,5411,11334
IT-SA,Salerno,23,6127,31,1,0,0,0,0,6159,5335,144,1,0,0,0,0,5480,11639
IT-SA,Salerno,24,6106,49,3,0,1,0,0,6159,5284,213,1,1,0,0,0,5499,11658
IT-SA,Salerno,25,5796,112,4,1,1,0,0,5914,5060,340,1,0,1,0,0,5402,11316
IT-SA,Salerno,26,5788,152,2,0,2,0,0,5944,4795,540,5,0,1,0,0,5341,11285
IT-SA,Salerno,27,5738,245,1,0,0,0,0,5984,4897,695,11,0,2,0,0,5605,11589
IT-SA,Salerno,28,5452,390,1,2,4,0,0,5849,4453,1016,8,0,2,0,0,5479,11328
IT-SA,Salerno,29,5254,592,6,0,3,0,0,5855,4236,1239,17,1,3,0,0,5496,11351
IT-SA,Salerno,30,5406,783,5,1,2,0,0,6197,4216,1683,19,2,4,0,0,5924,12121
IT-SA,Salerno,31,5242,1142,14,1,4,0,0,6403,3961,2121,32,6,2,0,0,6122,12525
IT-SA,Salerno,32,4757,1383,12,1,1,0,0,6154,3462,2567,41,3,2,0,0,6075,12229
IT-SA,Salerno,33,4588,1812,25,0,1,0,0,6426,3255,2890,58,13,6,0,0,6222,12648
IT-SA,Salerno,34,4311,2075,36,5,5,0,0,6432,2939,3106,53,10,1,0,0,6109,12541
IT-SA,Salerno,35,4061,2479,34,4,0,0,0,6578,2749,3694,85,17,6,0,0,6551,13129
IT-SA,Salerno,36,3768,2610,44,6,2,0,0,6430,2436,3746,83,13,5,0,0,6283,12713
IT-SA,Salerno,37,3452,2932,42,5,4,0,0,6435,2237,3906,94,30,4,1,0,6272,12707
IT-SA,Salerno,38,3126,3344,61,2,5,0,0,6538,2074,4067,116,29,3,0,0,6289,12827
IT-SA,Salerno,39,3086,3550,75,7,5,0,0,6723,1934,4451,139,46,1,0,0,6571,13294
IT-SA,Salerno,40,2967,3732,76,6,4,0,0,6785,1841,4525,177,33,2,0,0,6578,13363
IT-SA,Salerno,41,2782,3982,109,11,3,0,0,6887,1731,4776,142,44,0,0,0,6693,13580
IT-SA,Salerno,42,2615,4121,108,11,2,0,0,6857,1588,4889,196,48,2,0,0,6723,13580
IT-SA,Salerno,43,2517,4225,138,18,8,1,0,6907,1504,5045,209,47,3,0,0,6808,13715
IT-SA,Salerno,44,2306,4467,118,17,8,0,0,6916,1528,5137,249,62,2,0,0,6978,13894
IT-SA,Salerno,45,2394,4720,148,27,4,0,0,7293,1396,5275,287,99,4,0,0,7061,14354
IT-SA,Salerno,46,2188,4923,169,20,3,0,0,7303,1378,5485,266,108,4,0,0,7241,14544
IT-SA,Salerno,47,2185,5200,205,25,4,0,0,7619,1416,5819,306,142,2,0,0,7685,15304
IT-SA,Salerno,48,2170,5361,201,26,5,0,0,7763,1372,6026,332,142,2,0,0,7874,15637
IT-SA,Salerno,49,2034,5585,230,28,8,0,0,7885,1333,6324,357,172,4,0,0,8190,16075
IT-SA,Salerno,50,1952,5767,257,47,6,0,0,8029,1243,6396,370,182,1,0,0,8192,16221
IT-SA,Salerno,51,1771,5701,246,40,5,0,0,7763,1203,6484,366,223,3,0,0,8279,16042
IT-SA,Salerno,52,1751,6013,273,62,4,1,0,8104,1156,6607,403,249,0,0,0,8415,16519
IT-SA,Salerno,53,1597,5892,261,64,4,0,0,7818,1152,6502,393,271,3,0,0,8321,16139
IT-SA,Salerno,54,1474,6313,272,70,6,0,0,8135,1138,6766,419,306,1,0,0,8630,16765
IT-SA,Salerno,55,1439,6246,298,89,5,0,0,8077,1043,6733,414,408,0,0,0,8598,16675
IT-SA,Salerno,56,1358,6387,298,92,5,0,0,8140,1017,6717,439,402,3,0,0,8578,16718
IT-SA,Salerno,57,1285,6552,302,109,6,0,0,8254,1007,6770,423,469,0,1,0,8670,16924
IT-SA,Salerno,58,1196,6655,317,102,2,0,0,8272,992,6891,423,553,0,0,0,8859,17131
IT-SA,Salerno,59,1170,6789,303,139,4,0,0,8405,980,6754,392,658,0,0,0,8784,17189
IT-SA,Salerno,60,978,6384,286,133,4,0,0,7785,836,6571,402,601,1,0,0,8411,16196
IT-SA,Salerno,61,913,6214,271,166,5,0,0,7569,851,6549,370,743,1,0,0,8514,16083
IT-SA,Salerno,62,821,6404,260,171,3,0,0,7659,805,6217,341,855,0,0,0,8218,15877
IT-SA,Salerno,63,791,6252,258,194,3,0,0,7498,764,5998,324,866,0,0,0,7952,15450
IT-SA,Salerno,64,634,6290,231,236,0,0,0,7391,770,5659,316,979,0,0,0,7724,15115
IT-SA,Salerno,65,566,5860,209,223,2,0,0,6860,648,5375,316,985,0,0,0,7324,14184
IT-SA,Salerno,66,553,5658,245,246,5,0,0,6707,602,5275,284,1083,1,0,0,7245,13952
IT-SA,Salerno,67,442,5462,208,262,0,0,0,6374,563,4972,252,1160,0,0,0,6947,13321
IT-SA,Salerno,68,457,5526,164,268,2,0,0,6417,537,4713,234,1297,0,0,0,6781,13198
IT-SA,Salerno,69,421,5229,157,281,1,0,0,6089,530,4653,242,1390,0,0,0,6815,12904
IT-SA,Salerno,70,362,4944,159,312,2,0,0,5779,509,4115,195,1402,1,0,0,6222,12001
IT-SA,Salerno,71,315,4624,131,320,4,0,0,5394,412,3701,185,1499,0,0,0,5797,11191
IT-SA,Salerno,72,316,4667,139,347,1,0,0,5470,383,3804,157,1612,0,0,0,5956,11426
IT-SA,Salerno,73,302,4595,129,384,0,0,0,5410,419,3525,182,1738,0,0,0,5864,11274
IT-SA,Salerno,74,254,4444,105,413,0,0,0,5216,384,3462,172,1978,0,0,0,5996,11212
IT-SA,Salerno,75,244,4417,93,422,0,0,0,5176,422,3435,136,2159,1,0,0,6153,11329
IT-SA,Salerno,76,206,4165,101,460,1,0,0,4933,312,3041,97,2221,0,0,0,5671,10604
IT-SA,Salerno,77,190,3961,78,523,2,0,0,4754,331,2745,121,2199,0,0,0,5396,10150
IT-SA,Salerno,78,128,2845,64,385,0,0,0,3422,250,1871,78,1755,0,0,0,3954,7376
IT-SA,Salerno,79,112,2404,43,409,2,0,0,2970,211,1680,62,1800,0,0,0,3753,6723
IT-SA,Salerno,80,106,2521,39,426,0,0,1,3093,271,1569,60,2090,0,0,0,3990,7083
IT-SA,Salerno,81,100,2378,51,458,0,0,0,2987,230,1469,59,2102,0,0,0,3860,6847
IT-SA,Salerno,82,93,2063,37,429,0,0,0,2622,223,1208,43,2083,0,0,0,3557,6179
IT-SA,Salerno,83,79,2219,26,537,0,0,0,2861,227,1308,54,2411,0,0,0,4000,6861
IT-SA,Salerno,84,77,2084,37,587,1,0,0,2786,213,1130,44,2568,0,0,0,3955,6741
IT-SA,Salerno,85,62,1607,22,525,0,0,0,2216,205,890,35,2305,0,0,0,3435,5651
IT-SA,Salerno,86,63,1447,12,484,0,0,0,2006,184,655,35,2252,0,0,0,3126,5132
IT-SA,Salerno,87,67,1085,9,482,0,0,0,1643,146,503,35,2039,0,0,0,2723,4366
IT-SA,Salerno,88,56,1008,9,513,0,0,0,1586,152,464,20,1953,0,0,0,2589,4175
IT-SA,Salerno,89,48,739,7,423,0,0,0,1217,142,336,22,1713,0,0,0,2213,3430
IT-SA,Salerno,90,35,638,5,408,0,0,0,1086,130,261,12,1614,0,0,0,2017,3103
IT-SA,Salerno,91,26,446,3,328,0,0,0,803,90,148,19,1367,0,0,0,1624,2427
IT-SA,Salerno,92,24,351,3,278,0,0,0,656,73,127,13,1098,0,0,0,1311,1967
IT-SA,Salerno,93,23,257,0,255,0,0,0,535,75,92,6,1015,0,0,0,1188,1723
IT-SA,Salerno,94,11,140,0,192,0,0,0,343,56,57,8,735,0,0,0,856,1199
IT-SA,Salerno,95,6,89,3,122,0,0,0,220,46,35,5,588,0,0,0,674,894
IT-SA,Salerno,96,6,65,1,87,0,0,0,159,29,28,2,374,0,0,0,433,592
IT-SA,Salerno,97,4,28,1,62,0,0,0,95,31,16,2,272,0,0,0,321,416
IT-SA,Salerno,98,5,22,1,37,0,0,0,65,18,9,2,200,0,0,0,229,294
IT-SA,Salerno,99,1,15,1,30,0,0,0,47,11,9,2,144,0,0,0,166,213
IT-SA,Salerno,100,7,12,0,40,0,0,0,59,23,10,1,219,0,0,0,253,312
IT-SA,Salerno,999,245441,251902,8295,13896,174,2,1,519711,209506,254188,12272,62254,85,2,0,538307,1058018
IT-SS,Sassari,0,1167,0,0,0,0,0,0,1167,1138,0,0,0,0,0,0,1138,2305
IT-SS,Sassari,1,1293,0,0,0,0,0,0,1293,1213,0,0,0,0,0,0,1213,2506
IT-SS,Sassari,2,1284,0,0,0,0,0,0,1284,1340,0,0,0,0,0,0,1340,2624
IT-SS,Sassari,3,1326,0,0,0,0,0,0,1326,1278,0,0,0,0,0,0,1278,2604
IT-SS,Sassari,4,1425,0,0,0,0,0,0,1425,1452,0,0,0,0,0,0,1452,2877
IT-SS,Sassari,5,1549,0,0,0,0,0,0,1549,1468,0,0,0,0,0,0,1468,3017
IT-SS,Sassari,6,1712,0,0,0,0,0,0,1712,1569,0,0,0,0,0,0,1569,3281
IT-SS,Sassari,7,1710,0,0,0,0,0,0,1710,1637,0,0,0,0,0,0,1637,3347
IT-SS,Sassari,8,1822,0,0,0,0,0,0,1822,1664,0,0,0,0,0,0,1664,3486
IT-SS,Sassari,9,1837,0,0,0,0,0,0,1837,1737,0,0,0,0,0,0,1737,3574
IT-SS,Sassari,10,1869,0,0,0,0,0,0,1869,1732,0,0,0,0,0,0,1732,3601
IT-SS,Sassari,11,2018,0,0,0,0,0,0,2018,1858,0,0,0,0,0,0,1858,3876
IT-SS,Sassari,12,2099,0,0,0,0,0,0,2099,2005,0,0,0,0,0,0,2005,4104
IT-SS,Sassari,13,2210,0,0,0,0,0,0,2210,2036,0,0,0,0,0,0,2036,4246
IT-SS,Sassari,14,2165,0,0,0,0,0,0,2165,2002,0,0,0,0,0,0,2002,4167
IT-SS,Sassari,15,2212,0,0,0,0,0,0,2212,2059,0,0,0,0,0,0,2059,4271
IT-SS,Sassari,16,2207,0,0,0,0,0,0,2207,2077,0,0,0,0,0,0,2077,4284
IT-SS,Sassari,17,2141,0,0,0,0,0,0,2141,2027,0,0,0,0,0,0,2027,4168
IT-SS,Sassari,18,2178,0,0,0,0,0,0,2178,2074,0,0,0,0,0,0,2074,4252
IT-SS,Sassari,19,2180,2,1,0,0,0,0,2183,1990,4,0,0,0,0,0,1994,4177
IT-SS,Sassari,20,2244,0,0,0,0,0,0,2244,2090,4,0,0,0,0,0,2094,4338
IT-SS,Sassari,21,2133,3,0,0,0,0,0,2136,2072,11,0,0,0,0,0,2083,4219
IT-SS,Sassari,22,2133,2,0,0,0,0,0,2135,2032,11,1,0,0,0,0,2044,4179
IT-SS,Sassari,23,2306,5,0,0,1,0,0,2312,2006,15,0,0,0,0,0,2021,4333
IT-SS,Sassari,24,2333,20,0,0,0,0,0,2353,2018,45,2,0,0,0,0,2065,4418
IT-SS,Sassari,25,2209,19,1,0,1,0,0,2230,1974,51,1,0,0,0,0,2026,4256
IT-SS,Sassari,26,2266,26,1,0,0,0,0,2293,1938,95,1,0,0,0,0,2034,4327
IT-SS,Sassari,27,2248,45,2,0,0,0,0,2295,1936,139,2,0,0,0,0,2077,4372
IT-SS,Sassari,28,2245,86,0,1,2,0,0,2334,1829,193,6,0,1,0,0,2029,4363
IT-SS,Sassari,29,2231,123,4,0,1,0,0,2359,1834,259,3,0,0,0,0,2096,4455
IT-SS,Sassari,30,2173,173,4,0,0,0,0,2350,1869,331,11,0,3,1,0,2215,4565
IT-SS,Sassari,31,2247,211,5,0,1,0,0,2464,1858,488,16,0,1,0,0,2363,4827
IT-SS,Sassari,32,2212,293,12,0,1,0,0,2518,1755,561,15,4,4,1,0,2340,4858
IT-SS,Sassari,33,2088,426,9,1,7,1,0,2532,1724,680,27,3,2,0,0,2436,4968
IT-SS,Sassari,34,2122,471,19,1,4,0,0,2617,1581,844,36,6,1,0,0,2468,5085
IT-SS,Sassari,35,2000,545,17,0,4,0,0,2566,1528,949,59,5,4,1,0,2546,5112
IT-SS,Sassari,36,1973,683,17,1,3,1,0,2678,1490,1033,47,6,2,0,0,2578,5256
IT-SS,Sassari,37,1885,799,28,1,3,0,0,2716,1405,1103,89,7,1,0,0,2605,5321
IT-SS,Sassari,38,1819,886,43,0,4,0,0,2752,1337,1300,84,15,0,0,0,2736,5488
IT-SS,Sassari,39,1785,950,60,1,3,0,0,2799,1209,1373,110,11,2,1,0,2706,5505
IT-SS,Sassari,40,1625,1077,66,3,2,0,0,2773,1301,1417,111,14,2,0,0,2845,5618
IT-SS,Sassari,41,1703,1253,75,4,1,0,0,3036,1256,1512,149,27,1,0,0,2945,5981
IT-SS,Sassari,42,1684,1293,85,3,5,0,0,3070,1174,1625,181,21,0,0,0,3001,6071
IT-SS,Sassari,43,1647,1502,112,8,3,0,0,3272,1148,1723,195,23,4,0,0,3093,6365
IT-SS,Sassari,44,1558,1529,113,10,0,0,0,3210,1233,1847,205,25,1,0,0,3311,6521
IT-SS,Sassari,45,1702,1756,138,12,3,0,0,3611,1161,2075,217,30,3,0,0,3486,7097
IT-SS,Sassari,46,1664,1855,170,8,5,0,0,3702,1122,2133,243,30,1,1,0,3530,7232
IT-SS,Sassari,47,1636,2020,193,10,6,0,0,3865,1108,2281,299,54,4,0,0,3746,7611
IT-SS,Sassari,48,1704,2120,239,13,4,0,0,4080,1177,2440,295,62,5,0,0,3979,8059
IT-SS,Sassari,49,1680,2252,252,17,5,0,0,4206,1116,2540,315,78,2,1,0,4052,8258
IT-SS,Sassari,50,1629,2395,250,18,2,0,0,4294,1097,2605,370,80,1,0,0,4153,8447
IT-SS,Sassari,51,1445,2352,273,20,9,0,0,4099,986,2598,364,94,2,0,0,4044,8143
IT-SS,Sassari,52,1319,2372,248,23,2,0,0,3964,945,2692,397,104,1,0,0,4139,8103
IT-SS,Sassari,53,1242,2453,330,23,3,0,0,4051,886,2626,383,109,2,0,0,4006,8057
IT-SS,Sassari,54,1238,2489,333,38,3,0,0,4101,853,2690,367,166,1,0,0,4077,8178
IT-SS,Sassari,55,1078,2574,317,47,3,0,0,4019,790,2732,377,144,2,0,0,4045,8064
IT-SS,Sassari,56,1005,2613,334,33,4,0,0,3989,757,2785,354,186,2,0,0,4084,8073
IT-SS,Sassari,57,983,2663,333,48,1,0,0,4028,750,2856,377,181,3,0,0,4167,8195
IT-SS,Sassari,58,916,2847,336,48,2,0,0,4149,723,2845,364,206,0,0,0,4138,8287
IT-SS,Sassari,59,830,2793,360,50,2,0,0,4035,669,2947,378,244,2,0,0,4240,8275
IT-SS,Sassari,60,736,2681,333,52,2,0,0,3804,614,2808,323,327,1,0,0,4073,7877
IT-SS,Sassari,61,683,2709,330,73,2,1,0,3798,534,2639,312,312,1,0,0,3798,7596
IT-SS,Sassari,62,589,2670,281,71,4,0,0,3615,513,2666,289,320,0,0,0,3788,7403
IT-SS,Sassari,63,558,2663,271,97,3,0,0,3592,468,2577,267,386,2,0,0,3700,7292
IT-SS,Sassari,64,498,2527,216,87,4,1,0,3333,433,2450,264,404,0,0,0,3551,6884
IT-SS,Sassari,65,445,2522,206,99,0,0,0,3272,399,2489,221,426,1,0,0,3536,6808
IT-SS,Sassari,66,424,2532,197,93,3,0,1,3250,362,2365,222,477,0,0,0,3426,6676
IT-SS,Sassari,67,420,2416,178,125,5,0,0,3144,360,2225,209,485,1,0,0,3280,6424
IT-SS,Sassari,68,385,2354,190,132,5,0,0,3066,361,2151,175,551,3,0,0,3241,6307
IT-SS,Sassari,69,409,2351,176,142,3,0,0,3081,340,2130,176,581,0,0,0,3227,6308
IT-SS,Sassari,70,341,2216,170,118,1,0,0,2846,321,1959,150,521,0,0,0,2951,5797
IT-SS,Sassari,71,314,2129,132,141,0,0,0,2716,349,1905,130,643,0,0,0,3027,5743
IT-SS,Sassari,72,285,2076,113,155,2,0,0,2631,298,1866,108,743,0,0,0,3015,5646
IT-SS,Sassari,73,260,2147,98,169,1,0,0,2675,319,1744,115,774,0,0,0,2952,5627
IT-SS,Sassari,74,249,2047,104,193,0,0,1,2594,261,1690,96,792,0,0,0,2839,5433
IT-SS,Sassari,75,244,1947,102,192,0,0,0,2485,307,1675,100,856,0,0,0,2938,5423
IT-SS,Sassari,76,218,1931,92,196,0,0,0,2437,275,1463,84,927,1,0,0,2750,5187
IT-SS,Sassari,77,185,1790,88,201,0,0,0,2264,239,1313,87,935,0,0,0,2574,4838
IT-SS,Sassari,78,148,1562,53,177,0,0,0,1940,251,1148,60,950,0,0,0,2409,4349
IT-SS,Sassari,79,173,1489,44,206,2,0,0,1914,241,1077,59,995,0,0,0,2372,4286
IT-SS,Sassari,80,124,1354,37,203,3,0,0,1721,224,898,48,1063,0,0,0,2233,3954
IT-SS,Sassari,81,140,1288,36,222,0,0,0,1686,204,849,44,1145,0,0,0,2242,3928
IT-SS,Sassari,82,116,1109,30,216,0,0,0,1471,229,683,40,1121,0,0,0,2073,3544
IT-SS,Sassari,83,148,1128,37,260,1,0,0,1574,226,652,29,1237,0,0,0,2144,3718
IT-SS,Sassari,84,110,976,25,251,0,0,0,1362,197,542,38,1187,0,0,0,1964,3326
IT-SS,Sassari,85,95,815,22,223,0,0,0,1155,219,389,21,1099,0,0,0,1728,2883
IT-SS,Sassari,86,83,660,16,208,0,0,0,967,169,337,17,1043,0,0,0,1566,2533
IT-SS,Sassari,87,61,570,18,214,0,0,0,863,173,252,11,843,0,0,0,1279,2142
IT-SS,Sassari,88,67,419,6,175,0,0,0,667,162,162,12,848,0,0,0,1184,1851
IT-SS,Sassari,89,71,394,5,202,0,0,0,672,137,130,10,812,0,0,0,1089,1761
IT-SS,Sassari,90,55,288,3,161,0,0,0,507,118,100,11,705,0,0,0,934,1441
IT-SS,Sassari,91,39,248,2,135,0,0,0,424,116,72,5,552,0,0,0,745,1169
IT-SS,Sassari,92,32,174,4,119,0,0,0,329,97,37,4,491,0,0,0,629,958
IT-SS,Sassari,93,21,132,2,100,0,0,0,255,74,31,2,450,0,0,0,557,812
IT-SS,Sassari,94,13,74,0,85,0,0,0,172,74,24,0,331,0,0,0,429,601
IT-SS,Sassari,95,13,55,1,55,0,0,0,124,45,10,3,243,0,0,0,301,425
IT-SS,Sassari,96,6,36,1,36,0,0,0,79,28,10,0,172,0,0,0,210,289
IT-SS,Sassari,97,9,24,0,23,0,0,0,56,37,2,1,121,0,0,0,161,217
IT-SS,Sassari,98,0,16,0,15,0,0,0,31,22,2,0,80,0,0,0,104,135
IT-SS,Sassari,99,1,7,0,11,0,0,0,19,7,3,1,79,0,0,0,90,109
IT-SS,Sassari,100,1,6,0,15,0,0,0,22,16,2,1,105,0,0,0,124,146
IT-SS,Sassari,999,116113,102508,8399,6090,141,4,2,233257,99912,101985,10196,28067,70,6,0,240236,473493
IT-SV,Savona,0,703,0,0,0,0,0,0,703,658,0,0,0,0,0,0,658,1361
IT-SV,Savona,1,743,0,0,0,0,0,0,743,685,0,0,0,0,0,0,685,1428
IT-SV,Savona,2,726,0,0,0,0,0,0,726,694,0,0,0,0,0,0,694,1420
IT-SV,Savona,3,734,0,0,0,0,0,0,734,770,0,0,0,0,0,0,770,1504
IT-SV,Savona,4,750,0,0,0,0,0,0,750,740,0,0,0,0,0,0,740,1490
IT-SV,Savona,5,810,0,0,0,0,0,0,810,828,0,0,0,0,0,0,828,1638
IT-SV,Savona,6,896,0,0,0,0,0,0,896,775,0,0,0,0,0,0,775,1671
IT-SV,Savona,7,905,0,0,0,0,0,0,905,870,0,0,0,0,0,0,870,1775
IT-SV,Savona,8,949,0,0,0,0,0,0,949,965,0,0,0,0,0,0,965,1914
IT-SV,Savona,9,1072,0,0,0,0,0,0,1072,921,0,0,0,0,0,0,921,1993
IT-SV,Savona,10,1027,0,0,0,0,0,0,1027,935,0,0,0,0,0,0,935,1962
IT-SV,Savona,11,1107,0,0,0,0,0,0,1107,1057,0,0,0,0,0,0,1057,2164
IT-SV,Savona,12,1064,0,0,0,0,0,0,1064,1056,0,0,0,0,0,0,1056,2120
IT-SV,Savona,13,1116,0,0,0,0,0,0,1116,1032,0,0,0,0,0,0,1032,2148
IT-SV,Savona,14,1156,0,0,0,0,0,0,1156,1109,0,0,0,0,0,0,1109,2265
IT-SV,Savona,15,1220,0,0,0,0,0,0,1220,1132,0,0,0,0,0,0,1132,2352
IT-SV,Savona,16,1218,0,0,0,0,0,0,1218,1119,0,0,0,0,0,0,1119,2337
IT-SV,Savona,17,1231,0,0,0,0,0,0,1231,1128,0,0,0,0,0,0,1128,2359
IT-SV,Savona,18,1297,0,0,0,0,0,0,1297,1124,2,0,0,0,0,0,1126,2423
IT-SV,Savona,19,1239,0,0,0,0,0,0,1239,1139,3,0,0,0,0,0,1142,2381
IT-SV,Savona,20,1282,0,0,0,0,0,0,1282,1130,9,0,0,0,0,0,1139,2421
IT-SV,Savona,21,1268,0,0,0,0,0,0,1268,1133,20,0,0,0,0,0,1153,2421
IT-SV,Savona,22,1221,5,0,0,0,0,0,1226,1087,32,2,0,0,0,0,1121,2347
IT-SV,Savona,23,1302,6,0,0,0,0,0,1308,1150,56,1,1,1,0,0,1209,2517
IT-SV,Savona,24,1249,15,1,0,2,0,0,1267,1059,63,2,0,2,0,0,1126,2393
IT-SV,Savona,25,1288,20,0,0,1,0,0,1309,1087,90,0,0,2,0,0,1179,2488
IT-SV,Savona,26,1242,30,1,0,2,0,0,1275,1015,121,3,0,1,0,0,1140,2415
IT-SV,Savona,27,1231,41,1,0,0,0,0,1273,955,140,5,0,0,0,0,1100,2373
IT-SV,Savona,28,1151,81,0,0,0,0,0,1232,875,187,4,0,0,0,0,1066,2298
IT-SV,Savona,29,1080,99,1,0,2,0,0,1182,866,246,12,0,0,0,0,1124,2306
IT-SV,Savona,30,1044,158,5,0,2,0,0,1209,830,306,11,0,0,0,0,1147,2356
IT-SV,Savona,31,1130,199,3,0,1,0,0,1333,812,342,9,0,0,0,0,1163,2496
IT-SV,Savona,32,998,204,8,2,1,0,0,1213,731,425,14,1,2,0,0,1173,2386
IT-SV,Savona,33,1020,278,13,1,2,0,0,1314,679,475,19,3,3,0,0,1179,2493
IT-SV,Savona,34,959,312,10,1,3,0,0,1285,702,522,23,2,2,0,0,1251,2536
IT-SV,Savona,35,860,427,23,1,1,0,0,1312,644,576,36,6,4,0,0,1266,2578
IT-SV,Savona,36,804,436,24,2,1,0,0,1267,552,561,34,2,3,0,0,1152,2419
IT-SV,Savona,37,760,475,16,1,1,0,0,1253,524,599,48,5,5,0,0,1181,2434
IT-SV,Savona,38,719,495,35,2,2,0,0,1253,510,660,68,11,2,0,0,1251,2504
IT-SV,Savona,39,705,596,44,1,0,0,0,1346,507,669,85,7,2,0,0,1270,2616
IT-SV,Savona,40,712,609,36,2,3,0,0,1362,502,702,73,4,1,0,0,1282,2644
IT-SV,Savona,41,675,672,56,1,2,0,0,1406,477,740,82,18,2,0,0,1319,2725
IT-SV,Savona,42,670,622,48,8,1,0,0,1349,512,762,82,16,3,0,0,1375,2724
IT-SV,Savona,43,608,680,43,7,2,0,0,1340,483,769,99,10,1,0,0,1362,2702
IT-SV,Savona,44,633,744,67,17,0,0,0,1461,514,864,101,11,6,0,0,1496,2957
IT-SV,Savona,45,657,776,72,12,1,0,0,1518,520,947,139,23,2,0,0,1631,3149
IT-SV,Savona,46,692,871,106,7,2,0,0,1678,510,1021,151,26,4,0,0,1712,3390
IT-SV,Savona,47,767,917,105,7,2,0,0,1798,542,1105,154,28,1,0,0,1830,3628
IT-SV,Savona,48,745,1046,106,9,3,0,0,1909,591,1179,194,34,1,0,0,1999,3908
IT-SV,Savona,49,772,1105,147,11,2,0,0,2037,541,1289,205,38,2,0,0,2075,4112
IT-SV,Savona,50,793,1121,142,3,6,0,0,2065,518,1305,219,44,2,0,0,2088,4153
IT-SV,Savona,51,784,1228,157,14,5,0,0,2188,505,1403,266,55,0,0,0,2229,4417
IT-SV,Savona,52,740,1285,181,20,4,0,0,2230,502,1416,277,76,1,0,0,2272,4502
IT-SV,Savona,53,670,1379,208,18,7,0,0,2282,508,1446,284,62,1,0,1,2302,4584
IT-SV,Savona,54,678,1418,211,20,4,0,0,2331,456,1587,332,62,1,0,0,2438,4769
IT-SV,Savona,55,633,1468,258,25,3,0,0,2387,485,1544,307,81,1,0,0,2418,4805
IT-SV,Savona,56,631,1391,266,21,3,0,0,2312,459,1557,347,91,0,0,0,2454,4766
IT-SV,Savona,57,542,1494,258,21,3,0,0,2318,433,1645,331,101,0,0,0,2510,4828
IT-SV,Savona,58,564,1571,265,33,3,0,0,2436,398,1636,341,130,0,0,0,2505,4941
IT-SV,Savona,59,523,1614,296,30,3,0,0,2466,367,1605,318,136,5,0,0,2431,4897
IT-SV,Savona,60,428,1616,265,25,1,0,1,2336,290,1539,338,139,1,0,0,2307,4643
IT-SV,Savona,61,399,1497,227,39,4,0,0,2166,272,1524,284,174,1,0,0,2255,4421
IT-SV,Savona,62,368,1432,218,38,4,0,0,2060,241,1522,283,172,0,0,1,2219,4279
IT-SV,Savona,63,307,1347,202,39,2,0,0,1897,237,1363,256,197,1,0,0,2054,3951
IT-SV,Savona,64,276,1397,198,43,1,0,0,1915,221,1407,250,243,3,0,0,2124,4039
IT-SV,Savona,65,264,1340,213,52,1,0,0,1870,196,1337,227,221,2,0,0,1983,3853
IT-SV,Savona,66,240,1361,171,58,0,0,0,1830,163,1297,206,253,0,0,1,1920,3750
IT-SV,Savona,67,221,1291,168,71,3,0,0,1754,170,1246,199,284,1,0,0,1900,3654
IT-SV,Savona,68,188,1310,172,83,3,0,0,1756,163,1209,192,293,0,0,0,1857,3613
IT-SV,Savona,69,207,1265,147,64,3,0,0,1686,137,1152,171,332,0,0,0,1792,3478
IT-SV,Savona,70,164,1179,149,77,1,0,0,1570,137,1108,152,331,0,0,0,1728,3298
IT-SV,Savona,71,156,1171,127,76,1,0,0,1531,127,1070,154,350,0,0,0,1701,3232
IT-SV,Savona,72,117,1165,121,81,1,0,0,1485,87,1111,136,409,1,0,0,1744,3229
IT-SV,Savona,73,116,1201,120,106,1,0,0,1544,109,1118,156,477,0,0,0,1860,3404
IT-SV,Savona,74,143,1173,106,111,1,0,0,1534,115,1112,145,503,0,0,0,1875,3409
IT-SV,Savona,75,134,1232,93,150,4,0,0,1613,91,1091,122,538,0,0,0,1842,3455
IT-SV,Savona,76,123,1242,83,135,1,0,0,1584,106,1132,128,639,0,0,0,2005,3589
IT-SV,Savona,77,105,1256,84,136,1,0,1,1583,107,1008,125,719,0,0,0,1959,3542
IT-SV,Savona,78,94,886,68,140,0,0,1,1189,76,730,76,639,0,0,0,1521,2710
IT-SV,Savona,79,99,938,63,168,0,0,0,1268,92,788,90,698,0,0,0,1668,2936
IT-SV,Savona,80,86,860,50,174,0,0,1,1171,88,658,86,735,0,0,0,1567,2738
IT-SV,Savona,81,77,826,37,159,0,0,0,1099,87,699,60,841,0,0,0,1687,2786
IT-SV,Savona,82,65,861,41,188,1,0,0,1156,103,590,62,818,0,0,0,1573,2729
IT-SV,Savona,83,68,857,47,202,0,0,0,1174,68,585,60,929,0,0,0,1642,2816
IT-SV,Savona,84,71,796,35,203,0,0,0,1105,84,481,48,918,0,0,0,1531,2636
IT-SV,Savona,85,72,654,32,222,0,0,0,980,91,411,53,972,0,0,0,1527,2507
IT-SV,Savona,86,43,534,22,208,0,0,0,807,91,334,35,919,0,0,0,1379,2186
IT-SV,Savona,87,34,435,23,188,0,0,0,680,54,260,29,822,0,0,0,1165,1845
IT-SV,Savona,88,38,387,23,165,0,0,0,613,58,193,29,784,0,0,0,1064,1677
IT-SV,Savona,89,33,328,11,136,1,0,0,509,64,128,25,726,0,0,0,943,1452
IT-SV,Savona,90,23,239,10,151,0,0,0,423,59,93,27,638,0,0,0,817,1240
IT-SV,Savona,91,18,191,3,131,0,0,0,343,48,75,10,583,0,0,0,716,1059
IT-SV,Savona,92,14,130,7,115,0,0,0,266,36,54,12,516,0,0,0,618,884
IT-SV,Savona,93,8,97,3,90,0,0,0,198,44,30,9,449,0,0,0,532,730
IT-SV,Savona,94,8,64,2,59,0,0,0,133,22,27,2,344,0,0,0,395,528
IT-SV,Savona,95,2,48,0,48,0,0,0,98,23,12,6,245,0,0,0,286,384
IT-SV,Savona,96,1,29,0,39,0,0,0,69,13,6,4,189,0,0,0,212,281
IT-SV,Savona,97,6,13,0,27,0,0,0,46,10,3,3,137,0,0,0,153,199
IT-SV,Savona,98,1,10,0,20,0,0,0,31,7,4,0,99,0,0,0,110,141
IT-SV,Savona,99,1,3,1,4,0,0,0,9,13,1,2,62,0,0,0,78,87
IT-SV,Savona,100,1,2,0,8,0,0,0,11,11,2,2,102,0,0,0,117,128
IT-SV,Savona,999,59584,58551,6555,4526,115,0,4,129335,49619,59136,8932,20523,73,0,3,138286,267621
IT-SI,Siena,0,787,0,0,0,0,0,0,787,728,0,0,0,0,0,0,728,1515
IT-SI,Siena,1,791,0,0,0,0,0,0,791,804,0,0,0,0,0,0,804,1595
IT-SI,Siena,2,875,0,0,0,0,0,0,875,827,0,0,0,0,0,0,827,1702
IT-SI,Siena,3,835,0,0,0,0,0,0,835,781,0,0,0,0,0,0,781,1616
IT-SI,Siena,4,879,0,0,0,0,0,0,879,898,0,0,0,0,0,0,898,1777
IT-SI,Siena,5,900,0,0,0,0,0,0,900,914,0,0,0,0,0,0,914,1814
IT-SI,Siena,6,961,0,0,0,0,0,0,961,955,0,0,0,0,0,0,955,1916
IT-SI,Siena,7,998,0,0,0,0,0,0,998,979,0,0,0,0,0,0,979,1977
IT-SI,Siena,8,1050,0,0,0,0,0,0,1050,1017,0,0,0,0,0,0,1017,2067
IT-SI,Siena,9,1147,0,0,0,0,0,0,1147,1010,0,0,0,0,0,0,1010,2157
IT-SI,Siena,10,1121,0,0,0,0,0,0,1121,1083,0,0,0,0,0,0,1083,2204
IT-SI,Siena,11,1142,0,0,0,0,0,0,1142,1164,0,0,0,0,0,0,1164,2306
IT-SI,Siena,12,1217,0,0,0,0,0,0,1217,1118,0,0,0,0,0,0,1118,2335
IT-SI,Siena,13,1237,0,0,0,0,0,0,1237,1193,0,0,0,0,0,0,1193,2430
IT-SI,Siena,14,1220,0,0,0,0,0,0,1220,1230,0,0,0,0,0,0,1230,2450
IT-SI,Siena,15,1231,0,0,0,0,0,0,1231,1143,0,0,0,0,0,0,1143,2374
IT-SI,Siena,16,1230,0,0,0,0,0,0,1230,1214,0,0,0,0,0,0,1214,2444
IT-SI,Siena,17,1248,0,0,0,0,0,0,1248,1118,0,0,0,0,0,0,1118,2366
IT-SI,Siena,18,1318,0,0,0,0,0,0,1318,1083,2,0,0,0,0,0,1085,2403
IT-SI,Siena,19,1306,1,0,0,0,0,0,1307,1114,9,0,0,0,0,0,1123,2430
IT-SI,Siena,20,1298,4,0,0,0,0,0,1302,1093,12,0,0,0,0,0,1105,2407
IT-SI,Siena,21,1240,10,0,0,0,0,0,1250,1076,31,0,0,0,0,0,1107,2357
IT-SI,Siena,22,1296,13,0,0,0,0,0,1309,1118,49,0,0,0,0,0,1167,2476
IT-SI,Siena,23,1346,28,0,0,0,0,0,1374,1134,54,0,0,0,0,0,1188,2562
IT-SI,Siena,24,1328,22,4,0,0,0,0,1354,1062,66,0,0,0,0,0,1128,2482
IT-SI,Siena,25,1365,28,0,0,0,0,0,1393,1019,113,1,0,0,0,0,1133,2526
IT-SI,Siena,26,1304,56,1,0,0,0,0,1361,1057,141,3,0,0,0,0,1201,2562
IT-SI,Siena,27,1363,90,4,0,0,0,0,1457,1039,125,5,0,0,0,0,1169,2626
IT-SI,Siena,28,1251,106,2,0,0,0,0,1359,954,235,3,0,0,0,0,1192,2551
IT-SI,Siena,29,1182,133,3,0,0,0,0,1318,984,232,2,0,0,0,0,1218,2536
IT-SI,Siena,30,1180,194,2,0,1,0,0,1377,925,305,4,0,1,0,0,1235,2612
IT-SI,Siena,31,1201,218,9,0,1,0,0,1429,938,415,9,2,0,0,0,1364,2793
IT-SI,Siena,32,1067,281,3,4,1,0,0,1356,787,415,10,2,0,0,0,1214,2570
IT-SI,Siena,33,1103,364,5,0,0,0,0,1472,826,499,16,2,1,0,0,1344,2816
IT-SI,Siena,34,1048,387,13,1,1,0,0,1450,732,553,20,5,1,0,0,1311,2761
IT-SI,Siena,35,958,431,10,0,1,0,0,1400,752,601,28,3,0,0,0,1384,2784
IT-SI,Siena,36,867,461,18,1,0,1,0,1348,714,603,21,2,2,0,0,1342,2690
IT-SI,Siena,37,869,521,21,0,3,1,0,1415,608,680,45,5,0,0,0,1338,2753
IT-SI,Siena,38,789,601,18,0,2,0,0,1410,645,702,52,10,3,0,0,1412,2822
IT-SI,Siena,39,781,641,27,0,2,0,0,1451,633,817,44,7,0,0,0,1501,2952
IT-SI,Siena,40,749,659,18,0,2,0,0,1428,646,865,49,7,4,0,0,1571,2999
IT-SI,Siena,41,772,716,34,4,3,0,0,1529,611,898,74,12,2,0,0,1597,3126
IT-SI,Siena,42,689,720,44,5,3,0,0,1461,622,865,66,13,2,0,0,1568,3029
IT-SI,Siena,43,721,836,37,7,1,0,0,1602,545,899,78,11,1,0,0,1534,3136
IT-SI,Siena,44,691,840,57,1,6,0,0,1595,575,1014,100,17,4,0,0,1710,3305
IT-SI,Siena,45,702,954,50,9,4,0,0,1719,614,1101,101,16,3,0,0,1835,3554
IT-SI,Siena,46,748,1042,76,5,4,0,0,1875,550,1224,127,22,2,0,0,1925,3800
IT-SI,Siena,47,673,1055,73,9,1,0,0,1811,570,1206,138,36,0,1,0,1951,3762
IT-SI,Siena,48,722,1088,93,9,3,0,0,1915,567,1255,161,34,1,0,0,2018,3933
IT-SI,Siena,49,712,1181,102,3,2,0,0,2000,541,1344,170,31,3,0,0,2089,4089
IT-SI,Siena,50,659,1186,100,11,2,0,0,1958,496,1364,143,36,6,0,0,2045,4003
IT-SI,Siena,51,708,1245,107,9,1,0,0,2070,499,1406,171,45,2,0,0,2123,4193
IT-SI,Siena,52,608,1299,119,11,2,0,0,2039,470,1350,177,58,1,0,0,2056,4095
IT-SI,Siena,53,579,1259,116,15,0,0,0,1969,446,1404,207,57,3,0,0,2117,4086
IT-SI,Siena,54,538,1373,140,14,1,0,0,2066,386,1549,222,57,2,0,0,2216,4282
IT-SI,Siena,55,472,1419,173,14,3,1,0,2082,391,1477,209,66,0,0,0,2143,4225
IT-SI,Siena,56,462,1447,176,21,2,0,0,2108,396,1566,192,72,1,0,0,2227,4335
IT-SI,Siena,57,450,1538,139,26,1,0,0,2154,339,1574,228,100,1,0,0,2242,4396
IT-SI,Siena,58,402,1463,175,18,2,0,0,2060,308,1521,199,100,2,0,0,2130,4190
IT-SI,Siena,59,329,1544,180,23,5,0,0,2081,290,1575,252,130,3,0,0,2250,4331
IT-SI,Siena,60,320,1446,166,30,1,0,0,1963,236,1442,203,101,1,0,0,1983,3946
IT-SI,Siena,61,277,1347,150,27,2,0,0,1803,256,1409,176,162,1,0,0,2004,3807
IT-SI,Siena,62,246,1372,153,34,2,0,0,1807,212,1445,169,156,0,0,0,1982,3789
IT-SI,Siena,63,243,1315,123,44,2,0,0,1727,171,1296,179,178,2,0,0,1826,3553
IT-SI,Siena,64,208,1432,115,46,5,0,0,1806,158,1362,163,195,1,0,0,1879,3685
IT-SI,Siena,65,195,1244,103,55,3,0,0,1600,158,1358,147,232,1,0,0,1896,3496
IT-SI,Siena,66,161,1226,123,44,2,0,0,1556,144,1243,134,186,0,0,0,1707,3263
IT-SI,Siena,67,154,1251,93,58,2,0,0,1558,141,1186,120,250,1,0,0,1698,3256
IT-SI,Siena,68,147,1134,109,60,4,0,0,1454,132,1226,123,269,0,0,0,1750,3204
IT-SI,Siena,69,128,1240,81,68,0,0,0,1517,106,1168,124,283,0,0,0,1681,3198
IT-SI,Siena,70,121,1166,75,66,0,0,0,1428,88,1125,106,308,0,0,0,1627,3055
IT-SI,Siena,71,96,1116,50,83,1,0,0,1346,84,1096,101,309,0,0,0,1590,2936
IT-SI,Siena,72,127,1117,57,83,0,0,0,1384,75,1028,93,315,0,0,0,1511,2895
IT-SI,Siena,73,102,1174,67,76,0,0,1,1420,65,1022,80,354,0,0,0,1521,2941
IT-SI,Siena,74,117,1196,50,85,0,0,0,1448,81,1123,72,414,0,0,0,1690,3138
IT-SI,Siena,75,93,1259,58,133,0,0,0,1543,79,1139,73,503,0,0,0,1794,3337
IT-SI,Siena,76,113,1231,49,124,1,0,0,1518,74,1046,63,527,0,0,0,1710,3228
IT-SI,Siena,77,86,1135,51,120,1,0,0,1393,66,928,48,570,0,0,0,1612,3005
IT-SI,Siena,78,66,801,24,108,1,0,0,1000,56,732,35,491,0,0,0,1314,2314
IT-SI,Siena,79,78,811,35,109,0,0,0,1033,49,626,29,518,0,0,0,1222,2255
IT-SI,Siena,80,56,810,23,123,1,0,0,1013,51,597,42,578,0,0,0,1268,2281
IT-SI,Siena,81,69,678,22,144,1,0,0,914,64,474,22,591,0,0,0,1151,2065
IT-SI,Siena,82,62,700,18,119,0,0,0,899,46,517,29,639,0,0,0,1231,2130
IT-SI,Siena,83,69,775,25,165,2,0,0,1036,47,528,22,819,0,0,0,1416,2452
IT-SI,Siena,84,63,628,14,188,0,0,0,893,38,398,14,817,0,0,0,1267,2160
IT-SI,Siena,85,51,634,13,143,0,0,0,841,47,346,22,846,0,0,0,1261,2102
IT-SI,Siena,86,43,529,7,134,0,0,0,713,38,258,17,786,0,0,0,1099,1812
IT-SI,Siena,87,31,403,5,149,0,0,0,588,28,160,16,665,0,0,0,869,1457
IT-SI,Siena,88,40,381,4,126,0,0,0,551,33,176,14,720,0,0,0,943,1494
IT-SI,Siena,89,32,323,5,131,0,0,0,491,33,112,8,631,0,0,0,784,1275
IT-SI,Siena,90,35,236,5,114,0,0,0,390,30,84,4,574,0,0,0,692,1082
IT-SI,Siena,91,17,164,2,124,0,0,0,307,26,60,1,470,0,0,0,557,864
IT-SI,Siena,92,15,152,1,108,0,0,0,276,23,38,5,471,0,0,0,537,813
IT-SI,Siena,93,9,88,2,68,0,0,0,167,16,29,3,401,0,0,0,449,616
IT-SI,Siena,94,11,73,4,58,0,0,0,146,16,21,1,287,0,0,0,325,471
IT-SI,Siena,95,5,43,1,49,0,0,0,98,13,9,1,243,0,0,0,266,364
IT-SI,Siena,96,3,18,0,44,0,0,0,65,9,8,2,187,0,0,0,206,271
IT-SI,Siena,97,3,20,0,39,0,0,0,62,4,4,2,148,0,0,0,158,220
IT-SI,Siena,98,0,7,1,11,0,0,0,19,5,4,2,107,0,0,0,118,137
IT-SI,Siena,99,0,5,0,11,0,0,0,16,4,0,0,65,0,0,0,69,85
IT-SI,Siena,100,0,9,0,21,0,0,0,30,6,4,0,115,0,0,0,125,155
IT-SI,Siena,999,60407,58143,4033,3742,91,3,1,126420,51339,58943,5792,17439,58,1,0,133572,259992
IT-SR,Siracusa,0,1368,0,0,0,0,0,0,1368,1245,0,0,0,0,0,0,1245,2613
IT-SR,Siracusa,1,1511,0,0,0,0,0,0,1511,1309,0,0,0,0,0,0,1309,2820
IT-SR,Siracusa,2,1490,0,0,0,0,0,0,1490,1475,0,0,0,0,0,0,1475,2965
IT-SR,Siracusa,3,1525,0,0,0,0,0,0,1525,1441,0,0,0,0,0,0,1441,2966
IT-SR,Siracusa,4,1605,0,0,0,0,0,0,1605,1444,0,0,0,0,0,0,1444,3049
IT-SR,Siracusa,5,1598,0,0,0,0,0,0,1598,1533,0,0,0,0,0,0,1533,3131
IT-SR,Siracusa,6,1682,0,0,0,0,0,0,1682,1484,0,0,0,0,0,0,1484,3166
IT-SR,Siracusa,7,1660,0,0,0,0,0,0,1660,1618,0,0,0,0,0,0,1618,3278
IT-SR,Siracusa,8,1729,0,0,0,0,0,0,1729,1588,0,0,0,0,0,0,1588,3317
IT-SR,Siracusa,9,1765,0,0,0,0,0,0,1765,1682,0,0,0,0,0,0,1682,3447
IT-SR,Siracusa,10,1751,0,0,0,0,0,0,1751,1658,0,0,0,0,0,0,1658,3409
IT-SR,Siracusa,11,1926,0,0,0,0,0,0,1926,1729,0,0,0,0,0,0,1729,3655
IT-SR,Siracusa,12,1918,0,0,0,0,0,0,1918,1708,0,0,0,0,0,0,1708,3626
IT-SR,Siracusa,13,1868,0,0,0,0,0,0,1868,1852,0,0,0,0,0,0,1852,3720
IT-SR,Siracusa,14,1995,0,0,0,0,0,0,1995,1790,0,0,0,0,0,0,1790,3785
IT-SR,Siracusa,15,1977,0,0,0,0,0,0,1977,1907,0,0,0,0,0,0,1907,3884
IT-SR,Siracusa,16,2022,0,0,0,0,0,0,2022,1757,0,0,0,0,0,0,1757,3779
IT-SR,Siracusa,17,2099,0,0,0,0,0,0,2099,1843,0,0,0,0,0,0,1843,3942
IT-SR,Siracusa,18,2087,0,0,0,0,0,0,2087,1917,3,0,0,0,0,0,1920,4007
IT-SR,Siracusa,19,2165,1,0,0,0,0,0,2166,1912,11,0,0,1,0,0,1924,4090
IT-SR,Siracusa,20,2145,3,0,0,0,0,0,2148,1907,17,1,0,0,0,0,1925,4073
IT-SR,Siracusa,21,2062,6,0,0,0,0,0,2068,1850,19,0,0,1,0,0,1870,3938
IT-SR,Siracusa,22,2102,11,0,0,0,0,0,2113,1812,55,0,0,1,0,0,1868,3981
IT-SR,Siracusa,23,2096,17,1,0,0,0,0,2114,1845,65,0,1,0,0,0,1911,4025
IT-SR,Siracusa,24,2030,39,0,0,0,0,0,2069,1829,97,4,1,1,0,0,1932,4001
IT-SR,Siracusa,25,2008,54,2,0,0,0,0,2064,1735,195,2,0,1,0,0,1933,3997
IT-SR,Siracusa,26,1908,79,2,0,0,0,0,1989,1684,209,1,0,0,0,0,1894,3883
IT-SR,Siracusa,27,1865,110,2,0,0,0,0,1977,1641,270,5,1,2,0,0,1919,3896
IT-SR,Siracusa,28,1910,168,0,0,0,0,0,2078,1560,358,2,0,2,0,0,1922,4000
IT-SR,Siracusa,29,1823,221,2,0,3,0,0,2049,1336,493,6,2,2,0,0,1839,3888
IT-SR,Siracusa,30,1821,290,1,0,2,0,0,2114,1439,604,16,1,3,0,0,2063,4177
IT-SR,Siracusa,31,1808,413,5,0,3,0,0,2229,1369,736,13,1,2,0,0,2121,4350
IT-SR,Siracusa,32,1625,522,12,0,1,0,0,2160,1256,847,19,4,2,0,0,2128,4288
IT-SR,Siracusa,33,1606,591,16,0,1,0,0,2214,1164,975,26,3,6,1,0,2175,4389
IT-SR,Siracusa,34,1464,700,11,0,2,0,0,2177,1063,1127,31,2,3,0,0,2226,4403
IT-SR,Siracusa,35,1486,808,13,1,5,0,0,2313,999,1155,22,7,2,0,0,2185,4498
IT-SR,Siracusa,36,1365,930,22,3,2,0,0,2322,892,1195,50,4,3,0,0,2144,4466
IT-SR,Siracusa,37,1251,1035,32,3,3,0,1,2325,865,1319,50,5,5,0,1,2245,4570
IT-SR,Siracusa,38,1235,1079,35,2,4,0,0,2355,758,1448,68,5,4,0,0,2283,4638
IT-SR,Siracusa,39,1116,1238,39,2,3,0,0,2398,764,1494,70,13,1,0,0,2342,4740
IT-SR,Siracusa,40,1055,1306,59,1,1,0,0,2422,691,1584,73,14,2,0,0,2364,4786
IT-SR,Siracusa,41,1051,1428,61,3,3,0,0,2546,643,1682,92,21,2,0,1,2441,4987
IT-SR,Siracusa,42,989,1453,63,3,1,0,0,2509,609,1691,92,25,6,0,0,2423,4932
IT-SR,Siracusa,43,914,1595,73,10,3,0,0,2595,548,1807,137,25,0,0,0,2517,5112
IT-SR,Siracusa,44,931,1550,91,7,2,0,0,2581,553,1879,141,22,3,0,0,2598,5179
IT-SR,Siracusa,45,917,1668,90,14,2,0,0,2691,557,1989,164,38,2,0,0,2750,5441
IT-SR,Siracusa,46,812,1808,110,7,2,1,0,2740,507,2056,160,31,4,0,0,2758,5498
IT-SR,Siracusa,47,900,1936,131,10,2,0,0,2979,489,2083,176,40,2,0,0,2790,5769
IT-SR,Siracusa,48,809,1967,125,14,4,0,0,2919,470,2178,210,53,3,0,0,2914,5833
IT-SR,Siracusa,49,797,2067,153,15,4,0,0,3036,490,2389,205,73,3,0,0,3160,6196
IT-SR,Siracusa,50,741,2155,147,16,4,0,0,3063,414,2289,223,60,4,0,0,2990,6053
IT-SR,Siracusa,51,721,2040,187,21,3,0,0,2972,410,2337,221,88,0,0,0,3056,6028
IT-SR,Siracusa,52,650,2183,163,20,2,0,0,3018,389,2384,222,99,1,0,0,3095,6113
IT-SR,Siracusa,53,567,2162,187,23,3,0,0,2942,370,2399,230,122,0,0,0,3121,6063
IT-SR,Siracusa,54,553,2315,211,33,2,0,0,3114,337,2335,264,119,0,0,0,3055,6169
IT-SR,Siracusa,55,510,2190,184,42,0,0,0,2926,324,2275,224,111,0,0,0,2934,5860
IT-SR,Siracusa,56,447,2289,180,39,1,0,0,2956,313,2432,196,132,2,0,0,3075,6031
IT-SR,Siracusa,57,432,2254,183,45,3,0,0,2917,254,2380,222,171,0,0,0,3027,5944
IT-SR,Siracusa,58,383,2300,174,50,1,0,0,2908,260,2263,204,174,0,0,0,2901,5809
IT-SR,Siracusa,59,399,2412,144,49,0,0,0,3004,251,2313,199,212,1,0,0,2976,5980
IT-SR,Siracusa,60,330,2306,173,44,0,0,0,2853,261,2351,182,226,0,0,0,3020,5873
IT-SR,Siracusa,61,275,2281,165,53,3,0,0,2777,244,2271,175,262,0,0,0,2952,5729
IT-SR,Siracusa,62,297,2168,145,56,0,0,0,2666,211,2238,158,288,0,0,0,2895,5561
IT-SR,Siracusa,63,246,2185,140,63,1,1,0,2636,203,2119,178,298,0,0,0,2798,5434
IT-SR,Siracusa,64,242,2143,149,87,2,0,0,2623,192,2040,122,357,0,0,0,2711,5334
IT-SR,Siracusa,65,213,2037,99,78,0,0,0,2427,159,1962,103,388,0,0,0,2612,5039
IT-SR,Siracusa,66,214,2005,107,75,4,1,0,2406,177,1866,120,445,0,0,0,2608,5014
IT-SR,Siracusa,67,167,1889,103,88,1,0,0,2248,146,1703,89,424,0,0,0,2362,4610
IT-SR,Siracusa,68,181,1944,89,110,0,0,0,2324,156,1800,103,503,2,0,0,2564,4888
IT-SR,Siracusa,69,152,1871,54,122,2,0,0,2201,152,1776,92,488,0,0,0,2508,4709
IT-SR,Siracusa,70,120,1704,71,105,0,0,0,2000,138,1510,70,556,0,0,0,2274,4274
IT-SR,Siracusa,71,129,1709,50,115,1,0,0,2004,122,1438,72,564,0,0,0,2196,4200
IT-SR,Siracusa,72,122,1645,69,129,0,0,0,1965,124,1395,55,601,0,0,0,2175,4140
IT-SR,Siracusa,73,105,1676,61,148,0,0,0,1990,143,1414,75,721,0,0,0,2353,4343
IT-SR,Siracusa,74,73,1704,48,117,0,0,0,1942,113,1348,55,755,0,0,0,2271,4213
IT-SR,Siracusa,75,111,1768,42,163,0,0,0,2084,124,1321,69,888,1,0,0,2403,4487
IT-SR,Siracusa,76,85,1858,52,175,0,0,0,2170,128,1296,45,972,0,0,0,2441,4611
IT-SR,Siracusa,77,81,1512,31,181,0,0,0,1805,118,1082,39,934,0,0,0,2173,3978
IT-SR,Siracusa,78,55,1303,17,174,0,0,0,1549,113,884,46,837,0,0,0,1880,3429
IT-SR,Siracusa,79,47,1130,22,145,0,0,0,1344,71,683,28,867,1,0,0,1650,2994
IT-SR,Siracusa,80,56,982,16,155,0,0,0,1209,77,612,18,820,1,0,0,1528,2737
IT-SR,Siracusa,81,39,875,19,159,0,0,0,1092,99,504,22,869,0,0,0,1494,2586
IT-SR,Siracusa,82,34,829,16,179,0,0,0,1058,85,465,28,865,0,0,0,1443,2501
IT-SR,Siracusa,83,41,878,18,195,0,0,0,1132,82,436,14,1046,0,0,0,1578,2710
IT-SR,Siracusa,84,36,731,16,184,1,0,0,968,68,346,19,946,0,0,0,1379,2347
IT-SR,Siracusa,85,25,635,13,179,0,0,0,852,63,246,14,957,0,0,0,1280,2132
IT-SR,Siracusa,86,17,441,8,182,0,0,0,648,63,160,6,695,0,0,0,924,1572
IT-SR,Siracusa,87,17,422,7,150,0,0,0,596,40,118,11,669,0,0,0,838,1434
IT-SR,Siracusa,88,14,352,3,175,0,0,0,544,48,128,7,654,0,0,0,837,1381
IT-SR,Siracusa,89,13,255,4,148,0,0,0,420,42,60,5,573,0,0,0,680,1100
IT-SR,Siracusa,90,9,214,2,116,0,0,0,341,29,49,6,481,0,0,0,565,906
IT-SR,Siracusa,91,6,162,2,86,0,0,0,256,26,32,5,420,0,0,0,483,739
IT-SR,Siracusa,92,4,92,1,97,0,0,0,194,33,25,1,370,0,0,0,429,623
IT-SR,Siracusa,93,4,74,1,72,0,0,0,151,23,14,4,319,0,0,0,360,511
IT-SR,Siracusa,94,4,46,0,56,0,0,0,106,10,11,0,200,0,0,0,221,327
IT-SR,Siracusa,95,3,26,0,36,0,0,0,65,13,8,0,135,0,0,0,156,221
IT-SR,Siracusa,96,3,16,0,25,0,0,0,44,10,1,1,105,0,0,0,117,161
IT-SR,Siracusa,97,0,14,0,16,0,0,0,30,9,1,2,91,0,0,0,103,133
IT-SR,Siracusa,98,0,1,0,11,0,0,0,12,5,1,0,56,0,0,0,62,74
IT-SR,Siracusa,99,1,6,1,10,0,0,0,18,5,1,0,42,0,0,0,48,66
IT-SR,Siracusa,100,1,7,0,16,0,0,0,24,8,5,1,66,0,0,0,80,104
IT-SR,Siracusa,999,88617,91289,4725,4908,87,3,1,189630,73472,91157,6081,23433,82,1,2,194228,383858
IT-SO,Sondrio,0,582,0,0,0,0,0,0,582,560,0,0,0,0,0,0,560,1142
IT-SO,Sondrio,1,609,0,0,0,0,0,0,609,595,0,0,0,0,0,0,595,1204
IT-SO,Sondrio,2,608,0,0,0,0,0,0,608,614,0,0,0,0,0,0,614,1222
IT-SO,Sondrio,3,622,0,0,0,0,0,0,622,604,0,0,0,0,0,0,604,1226
IT-SO,Sondrio,4,694,0,0,0,0,0,0,694,649,0,0,0,0,0,0,649,1343
IT-SO,Sondrio,5,718,0,0,0,0,0,0,718,673,0,0,0,0,0,0,673,1391
IT-SO,Sondrio,6,747,0,0,0,0,0,0,747,720,0,0,0,0,0,0,720,1467
IT-SO,Sondrio,7,800,0,0,0,0,0,0,800,694,0,0,0,0,0,0,694,1494
IT-SO,Sondrio,8,746,0,0,0,0,0,0,746,736,0,0,0,0,0,0,736,1482
IT-SO,Sondrio,9,825,0,0,0,0,0,0,825,741,0,0,0,0,0,0,741,1566
IT-SO,Sondrio,10,804,0,0,0,0,0,0,804,731,0,0,0,0,0,0,731,1535
IT-SO,Sondrio,11,862,0,0,0,0,0,0,862,769,0,0,0,0,0,0,769,1631
IT-SO,Sondrio,12,868,0,0,0,0,0,0,868,795,0,0,0,0,0,0,795,1663
IT-SO,Sondrio,13,901,0,0,0,0,0,0,901,773,0,0,0,0,0,0,773,1674
IT-SO,Sondrio,14,800,0,0,0,0,0,0,800,772,0,0,0,0,0,0,772,1572
IT-SO,Sondrio,15,925,0,0,0,0,0,0,925,801,0,0,0,0,0,0,801,1726
IT-SO,Sondrio,16,836,0,0,0,0,0,0,836,804,0,0,0,0,0,0,804,1640
IT-SO,Sondrio,17,910,0,0,0,0,0,0,910,845,0,0,0,0,0,0,845,1755
IT-SO,Sondrio,18,855,1,0,0,0,0,0,856,831,2,0,0,0,0,0,833,1689
IT-SO,Sondrio,19,879,1,0,0,0,0,0,880,831,3,0,0,0,0,0,834,1714
IT-SO,Sondrio,20,903,0,0,0,1,0,0,904,865,4,0,0,0,0,0,869,1773
IT-SO,Sondrio,21,933,0,0,0,0,0,0,933,802,11,0,0,0,0,0,813,1746
IT-SO,Sondrio,22,894,3,0,0,1,0,0,898,807,24,0,0,0,0,0,831,1729
IT-SO,Sondrio,23,967,5,0,0,0,0,0,972,872,27,1,0,1,0,0,901,1873
IT-SO,Sondrio,24,979,13,0,0,1,0,0,993,830,35,0,0,0,0,0,865,1858
IT-SO,Sondrio,25,965,38,2,0,0,0,0,1005,807,64,0,0,0,0,0,871,1876
IT-SO,Sondrio,26,974,30,0,0,0,0,0,1004,786,107,3,0,0,0,0,896,1900
IT-SO,Sondrio,27,973,45,1,0,0,0,0,1019,797,149,2,1,0,0,0,949,1968
IT-SO,Sondrio,28,907,103,3,0,0,0,0,1013,660,164,3,0,0,0,0,827,1840
IT-SO,Sondrio,29,834,97,2,0,1,0,0,934,650,194,6,0,0,1,0,851,1785
IT-SO,Sondrio,30,826,137,0,0,1,0,0,964,631,260,5,1,0,0,0,897,1861
IT-SO,Sondrio,31,804,186,6,0,0,0,0,996,551,323,7,1,1,0,0,883,1879
IT-SO,Sondrio,32,806,188,3,1,0,0,0,998,513,312,12,2,0,0,0,839,1837
IT-SO,Sondrio,33,745,263,7,0,0,0,0,1015,542,363,12,0,2,0,0,919,1934
IT-SO,Sondrio,34,655,306,9,0,2,1,0,973,455,397,17,1,1,0,0,871,1844
IT-SO,Sondrio,35,606,313,9,1,0,0,0,929,431,442,22,3,1,1,0,900,1829
IT-SO,Sondrio,36,572,340,11,0,2,0,0,925,400,478,17,3,2,0,0,900,1825
IT-SO,Sondrio,37,547,411,21,0,0,0,0,979,370,529,24,1,1,0,0,925,1904
IT-SO,Sondrio,38,551,371,18,0,1,0,0,941,372,527,36,3,0,0,0,938,1879
IT-SO,Sondrio,39,527,444,22,2,0,0,0,995,355,569,48,4,1,0,0,977,1972
IT-SO,Sondrio,40,547,480,29,2,2,0,0,1060,350,542,51,6,1,0,0,950,2010
IT-SO,Sondrio,41,512,496,27,1,0,0,0,1036,344,633,44,5,2,0,0,1028,2064
IT-SO,Sondrio,42,483,547,28,1,4,0,0,1063,340,600,61,8,1,0,0,1010,2073
IT-SO,Sondrio,43,480,582,44,5,2,0,0,1113,302,656,67,9,2,0,0,1036,2149
IT-SO,Sondrio,44,456,546,42,1,1,0,0,1046,287,690,76,18,1,0,0,1072,2118
IT-SO,Sondrio,45,465,654,54,4,0,0,0,1177,281,737,81,15,1,0,0,1115,2292
IT-SO,Sondrio,46,492,629,59,3,2,0,0,1185,297,765,82,11,0,1,0,1156,2341
IT-SO,Sondrio,47,480,731,52,9,2,0,0,1274,279,845,96,25,1,0,0,1246,2520
IT-SO,Sondrio,48,476,754,77,5,1,0,0,1313,324,913,128,27,1,0,0,1393,2706
IT-SO,Sondrio,49,471,792,102,7,0,0,0,1372,310,849,138,24,1,0,0,1322,2694
IT-SO,Sondrio,50,482,821,79,4,2,0,0,1388,267,978,125,39,0,0,0,1409,2797
IT-SO,Sondrio,51,451,866,95,5,3,0,0,1420,289,955,118,34,1,0,1,1398,2818
IT-SO,Sondrio,52,422,891,108,9,1,0,0,1431,262,1013,135,39,2,0,0,1451,2882
IT-SO,Sondrio,53,377,927,104,12,0,0,0,1420,257,982,122,38,2,0,0,1401,2821
IT-SO,Sondrio,54,393,915,122,11,1,0,0,1442,269,1028,145,54,0,0,0,1496,2938
IT-SO,Sondrio,55,405,988,109,10,1,0,0,1513,231,1033,149,59,2,0,0,1474,2987
IT-SO,Sondrio,56,363,1007,122,12,0,0,0,1504,226,1056,154,67,2,0,0,1505,3009
IT-SO,Sondrio,57,355,1028,133,28,2,0,0,1546,235,1115,129,80,1,0,0,1560,3106
IT-SO,Sondrio,58,342,1026,143,19,0,0,0,1530,201,1061,159,83,2,0,0,1506,3036
IT-SO,Sondrio,59,305,1075,128,20,0,0,0,1528,213,1069,152,107,0,0,0,1541,3069
IT-SO,Sondrio,60,260,1063,136,17,1,0,0,1477,184,1059,127,111,2,0,0,1483,2960
IT-SO,Sondrio,61,222,989,118,17,2,0,0,1348,165,1037,110,115,0,0,0,1427,2775
IT-SO,Sondrio,62,239,965,128,22,0,0,0,1354,173,1025,127,132,1,0,0,1458,2812
IT-SO,Sondrio,63,219,950,105,33,0,0,0,1307,157,957,136,140,1,0,0,1391,2698
IT-SO,Sondrio,64,214,966,101,34,0,0,0,1315,127,974,86,184,0,0,0,1371,2686
IT-SO,Sondrio,65,175,939,112,44,0,0,0,1270,133,874,90,187,1,0,0,1285,2555
IT-SO,Sondrio,66,147,914,78,39,1,0,0,1179,115,848,79,194,0,0,0,1236,2415
IT-SO,Sondrio,67,182,869,92,39,0,0,0,1182,118,801,76,188,0,0,0,1183,2365
IT-SO,Sondrio,68,140,824,67,45,1,0,0,1077,108,790,76,214,0,0,0,1188,2265
IT-SO,Sondrio,69,139,834,72,46,2,0,0,1093,98,754,84,226,0,0,0,1162,2255
IT-SO,Sondrio,70,115,819,53,54,0,0,0,1041,104,728,57,235,0,0,0,1124,2165
IT-SO,Sondrio,71,120,787,53,51,1,0,0,1012,80,667,66,246,0,0,0,1059,2071
IT-SO,Sondrio,72,112,809,51,74,0,0,0,1046,83,677,48,284,0,0,0,1092,2138
IT-SO,Sondrio,73,107,824,46,60,0,0,0,1037,71,646,51,332,0,0,0,1100,2137
IT-SO,Sondrio,74,97,806,41,77,0,0,0,1021,69,590,30,306,0,0,0,995,2016
IT-SO,Sondrio,75,81,726,32,66,0,0,0,905,66,617,43,375,0,0,0,1101,2006
IT-SO,Sondrio,76,91,658,25,96,0,0,0,870,80,525,31,370,0,0,0,1006,1876
IT-SO,Sondrio,77,85,633,33,107,0,0,0,858,84,534,32,423,0,0,0,1073,1931
IT-SO,Sondrio,78,58,492,20,66,0,0,0,636,32,339,23,361,0,0,0,755,1391
IT-SO,Sondrio,79,56,501,21,66,0,0,0,644,45,336,24,401,0,0,0,806,1450
IT-SO,Sondrio,80,65,461,21,82,0,0,0,629,59,306,21,400,0,0,0,786,1415
IT-SO,Sondrio,81,49,479,11,74,0,0,0,613,57,274,16,447,0,0,0,794,1407
IT-SO,Sondrio,82,57,406,16,99,0,0,0,578,39,283,19,450,0,0,0,791,1369
IT-SO,Sondrio,83,54,405,8,89,0,0,0,556,42,225,17,512,0,0,0,796,1352
IT-SO,Sondrio,84,47,362,10,89,0,0,0,508,52,212,9,503,0,0,0,776,1284
IT-SO,Sondrio,85,46,311,8,101,0,0,0,466,40,186,13,470,0,0,0,709,1175
IT-SO,Sondrio,86,31,255,7,84,0,0,0,377,33,124,12,448,0,0,0,617,994
IT-SO,Sondrio,87,25,213,4,87,0,0,0,329,39,91,12,411,0,0,0,553,882
IT-SO,Sondrio,88,27,187,4,77,0,0,0,295,27,82,7,425,0,0,0,541,836
IT-SO,Sondrio,89,22,137,4,80,0,0,0,243,30,60,5,362,0,0,0,457,700
IT-SO,Sondrio,90,9,115,3,58,0,0,0,185,40,34,8,345,0,0,0,427,612
IT-SO,Sondrio,91,11,84,2,60,0,0,0,157,33,34,3,295,0,0,0,365,522
IT-SO,Sondrio,92,10,67,1,36,0,0,0,114,23,20,5,275,0,0,0,323,437
IT-SO,Sondrio,93,5,28,1,41,0,0,0,75,18,15,4,242,0,0,0,279,354
IT-SO,Sondrio,94,4,33,2,24,0,0,0,63,14,9,1,165,0,0,0,189,252
IT-SO,Sondrio,95,2,19,0,23,0,0,0,44,10,2,1,145,0,0,0,158,202
IT-SO,Sondrio,96,1,8,0,16,0,0,0,25,12,2,0,111,0,0,0,125,150
IT-SO,Sondrio,97,2,4,0,14,0,0,0,20,7,2,0,75,0,0,0,84,104
IT-SO,Sondrio,98,1,3,0,6,0,0,0,10,8,1,0,43,0,0,0,52,62
IT-SO,Sondrio,99,0,2,0,4,0,0,0,6,1,1,1,40,0,0,0,43,49
IT-SO,Sondrio,100,1,2,0,4,0,0,0,7,8,1,0,54,0,0,0,63,70
IT-SO,Sondrio,999,43644,38999,3257,2373,42,1,0,88316,35282,39246,3977,12010,38,3,1,90557,178873
 IT-SU,Sud Sardegna,0,725,0,0,0,0,0,0,725,691,0,0,0,0,0,0,691,1416
 IT-SU,Sud Sardegna,1,791,0,0,0,0,0,0,791,711,0,0,0,0,0,0,711,1502
 IT-SU,Sud Sardegna,2,873,0,0,0,0,0,0,873,776,0,0,0,0,0,0,776,1649
 IT-SU,Sud Sardegna,3,968,0,0,0,0,0,0,968,783,0,0,0,0,0,0,783,1751
 IT-SU,Sud Sardegna,4,908,0,0,0,0,0,0,908,841,0,0,0,0,0,0,841,1749
 IT-SU,Sud Sardegna,5,1023,0,0,0,0,0,0,1023,914,0,0,0,0,0,0,914,1937
 IT-SU,Sud Sardegna,6,984,0,0,0,0,0,0,984,972,0,0,0,0,0,0,972,1956
 IT-SU,Sud Sardegna,7,1059,0,0,0,0,0,0,1059,1025,0,0,0,0,0,0,1025,2084
 IT-SU,Sud Sardegna,8,1168,0,0,0,0,0,0,1168,1063,0,0,0,0,0,0,1063,2231
 IT-SU,Sud Sardegna,9,1192,0,0,0,0,0,0,1192,1127,0,0,0,0,0,0,1127,2319
 IT-SU,Sud Sardegna,10,1242,0,0,0,0,0,0,1242,1191,0,0,0,0,0,0,1191,2433
 IT-SU,Sud Sardegna,11,1239,0,0,0,0,0,0,1239,1180,0,0,0,0,0,0,1180,2419
 IT-SU,Sud Sardegna,12,1376,0,0,0,0,0,0,1376,1261,0,0,0,0,0,0,1261,2637
 IT-SU,Sud Sardegna,13,1389,0,0,0,0,0,0,1389,1265,0,0,0,0,0,0,1265,2654
 IT-SU,Sud Sardegna,14,1362,0,0,0,0,0,0,1362,1350,0,0,0,0,0,0,1350,2712
 IT-SU,Sud Sardegna,15,1383,0,0,0,0,0,0,1383,1301,0,0,0,0,0,0,1301,2684
 IT-SU,Sud Sardegna,16,1388,0,0,0,0,0,0,1388,1299,0,0,0,0,0,0,1299,2687
 IT-SU,Sud Sardegna,17,1373,0,0,0,0,0,0,1373,1341,0,0,0,0,0,0,1341,2714
 IT-SU,Sud Sardegna,18,1480,0,0,0,0,0,0,1480,1243,0,1,0,0,0,0,1244,2724
 IT-SU,Sud Sardegna,19,1472,4,0,0,0,0,0,1476,1244,1,0,0,0,0,0,1245,2721
 IT-SU,Sud Sardegna,20,1403,3,0,0,0,0,0,1406,1268,3,0,0,0,0,0,1271,2677
 IT-SU,Sud Sardegna,21,1510,2,0,0,0,0,0,1512,1330,5,0,0,0,0,0,1335,2847
 IT-SU,Sud Sardegna,22,1449,1,0,0,0,0,0,1450,1318,13,0,0,0,0,0,1331,2781
 IT-SU,Sud Sardegna,23,1558,5,0,2,0,0,0,1565,1454,16,1,0,0,0,0,1471,3036
 IT-SU,Sud Sardegna,24,1486,11,0,0,0,0,0,1497,1263,17,0,0,0,0,0,1280,2777
 IT-SU,Sud Sardegna,25,1476,9,0,0,0,0,0,1485,1204,22,0,0,0,0,0,1226,2711
 IT-SU,Sud Sardegna,26,1476,21,1,0,0,0,0,1498,1214,45,0,0,1,0,0,1260,2758
 IT-SU,Sud Sardegna,27,1529,24,0,0,0,0,0,1553,1194,72,3,0,0,0,0,1269,2822
 IT-SU,Sud Sardegna,28,1453,38,1,1,0,0,0,1493,1207,103,1,0,1,0,0,1312,2805
 IT-SU,Sud Sardegna,29,1421,78,1,1,0,0,0,1501,1168,148,3,2,0,0,0,1321,2822
 IT-SU,Sud Sardegna,30,1418,82,3,0,1,0,0,1504,1240,180,7,0,1,0,0,1428,2932
 IT-SU,Sud Sardegna,31,1471,111,3,0,0,0,0,1585,1259,234,11,1,3,0,0,1508,3093
 IT-SU,Sud Sardegna,32,1496,166,5,0,3,0,0,1670,1184,316,16,2,0,0,0,1518,3188
 IT-SU,Sud Sardegna,33,1429,194,8,0,0,0,0,1631,1160,428,19,1,0,0,0,1608,3239
 IT-SU,Sud Sardegna,34,1513,264,11,0,1,0,0,1789,1122,468,18,1,1,0,0,1610,3399
 IT-SU,Sud Sardegna,35,1378,302,10,1,2,0,0,1693,1046,498,27,2,2,0,0,1575,3268
 IT-SU,Sud Sardegna,36,1380,379,8,0,0,0,0,1767,1015,590,34,3,1,0,0,1643,3410
 IT-SU,Sud Sardegna,37,1375,412,23,2,0,0,0,1812,978,611,31,6,0,0,0,1626,3438
 IT-SU,Sud Sardegna,38,1353,523,21,0,0,0,0,1897,993,750,55,11,2,0,0,1811,3708
 IT-SU,Sud Sardegna,39,1354,613,48,1,3,0,0,2019,946,847,83,9,1,1,0,1887,3906
 IT-SU,Sud Sardegna,40,1354,603,32,1,1,0,0,1991,945,940,62,10,3,0,0,1960,3951
 IT-SU,Sud Sardegna,41,1333,793,34,3,2,0,0,2165,905,1025,96,7,1,0,0,2034,4199
 IT-SU,Sud Sardegna,42,1280,848,58,3,2,0,0,2191,852,1107,75,12,2,0,0,2048,4239
 IT-SU,Sud Sardegna,43,1268,907,61,4,0,0,0,2240,836,1171,95,15,0,0,0,2117,4357
 IT-SU,Sud Sardegna,44,1160,976,90,1,1,0,0,2228,769,1251,133,20,1,0,0,2174,4402
 IT-SU,Sud Sardegna,45,1308,1136,89,3,1,0,0,2537,774,1347,142,28,0,0,0,2291,4828
 IT-SU,Sud Sardegna,46,1168,1258,99,4,3,0,0,2532,740,1428,164,29,2,0,0,2363,4895
 IT-SU,Sud Sardegna,47,1164,1267,117,5,1,0,0,2554,757,1551,160,32,0,0,0,2500,5054
 IT-SU,Sud Sardegna,48,1175,1327,132,10,4,0,0,2648,700,1623,188,51,0,0,0,2562,5210
 IT-SU,Sud Sardegna,49,1144,1538,138,12,3,0,0,2835,679,1793,170,49,0,0,0,2691,5526
 IT-SU,Sud Sardegna,50,1114,1523,155,10,0,0,0,2802,659,1743,193,42,1,0,0,2638,5440
 IT-SU,Sud Sardegna,51,1079,1569,160,23,1,0,0,2832,559,1829,164,61,0,0,0,2613,5445
 IT-SU,Sud Sardegna,52,946,1531,203,10,0,0,0,2690,545,1809,227,77,0,0,0,2658,5348
 IT-SU,Sud Sardegna,53,905,1587,184,17,0,0,0,2693,504,1817,193,88,2,0,0,2604,5297
 IT-SU,Sud Sardegna,54,836,1693,192,24,1,0,0,2746,521,1963,233,98,0,0,0,2815,5561
 IT-SU,Sud Sardegna,55,774,1642,194,20,0,0,0,2630,445,1926,226,119,1,0,0,2717,5347
 IT-SU,Sud Sardegna,56,738,1878,189,38,0,0,0,2843,464,2023,179,125,0,0,0,2791,5634
 IT-SU,Sud Sardegna,57,682,1943,212,26,4,0,0,2867,432,2064,190,144,0,0,0,2830,5697
 IT-SU,Sud Sardegna,58,600,1972,180,33,1,0,0,2786,411,2007,184,161,0,0,0,2763,5549
 IT-SU,Sud Sardegna,59,675,2028,181,37,0,0,1,2922,359,2093,190,196,0,0,0,2838,5760
 IT-SU,Sud Sardegna,60,534,2015,183,42,1,0,0,2775,353,2141,156,206,1,0,0,2857,5632
 IT-SU,Sud Sardegna,61,515,1940,171,40,0,0,0,2666,363,2162,172,221,1,0,0,2919,5585
 IT-SU,Sud Sardegna,62,487,1995,164,53,1,0,0,2700,311,2121,140,271,0,0,0,2843,5543
 IT-SU,Sud Sardegna,63,469,1977,166,66,0,0,0,2678,299,1989,138,283,1,0,0,2710,5388
 IT-SU,Sud Sardegna,64,404,1985,136,76,0,0,0,2601,286,1954,112,274,0,0,0,2626,5227
 IT-SU,Sud Sardegna,65,443,1955,129,79,0,0,0,2606,266,1909,130,346,0,0,0,2651,5257
 IT-SU,Sud Sardegna,66,389,2020,129,74,0,0,0,2612,275,1935,107,390,1,0,0,2708,5320
 IT-SU,Sud Sardegna,67,321,1949,126,74,2,0,0,2472,263,1867,95,429,0,0,0,2654,5126
 IT-SU,Sud Sardegna,68,303,1897,126,105,0,0,0,2431,229,1775,80,456,1,0,0,2541,4972
 IT-SU,Sud Sardegna,69,297,1946,122,120,0,0,0,2485,245,1722,80,480,1,0,0,2528,5013
 IT-SU,Sud Sardegna,70,273,1921,105,115,0,0,0,2414,249,1620,91,526,0,0,0,2486,4900
 IT-SU,Sud Sardegna,71,263,1869,74,112,0,0,0,2318,224,1635,72,528,0,0,0,2459,4777
 IT-SU,Sud Sardegna,72,252,1827,91,120,0,0,0,2290,204,1544,61,611,0,0,0,2420,4710
 IT-SU,Sud Sardegna,73,233,1766,82,122,0,0,0,2203,213,1485,75,575,0,0,0,2348,4551
 IT-SU,Sud Sardegna,74,223,1690,70,140,0,0,0,2123,223,1318,55,687,0,0,0,2283,4406
 IT-SU,Sud Sardegna,75,224,1727,62,160,0,0,0,2173,214,1327,53,680,0,0,0,2274,4447
 IT-SU,Sud Sardegna,76,191,1588,59,156,0,0,0,1994,195,1156,54,738,0,0,0,2143,4137
 IT-SU,Sud Sardegna,77,158,1407,53,141,0,0,0,1759,184,983,39,715,0,0,0,1921,3680
 IT-SU,Sud Sardegna,78,152,1196,33,148,0,0,0,1529,190,810,36,719,0,0,0,1755,3284
 IT-SU,Sud Sardegna,79,127,1087,32,173,0,0,0,1419,174,758,30,733,0,0,0,1695,3114
 IT-SU,Sud Sardegna,80,126,1069,26,151,0,0,0,1372,161,731,33,752,0,0,0,1677,3049
 IT-SU,Sud Sardegna,81,116,1014,24,170,0,0,0,1324,155,616,24,840,0,0,0,1635,2959
 IT-SU,Sud Sardegna,82,101,835,15,156,0,0,0,1107,157,515,25,850,0,0,0,1547,2654
 IT-SU,Sud Sardegna,83,121,858,22,200,0,0,0,1201,165,494,22,973,0,0,0,1654,2855
 IT-SU,Sud Sardegna,84,97,812,14,182,0,0,0,1105,164,424,11,907,0,0,0,1506,2611
 IT-SU,Sud Sardegna,85,79,616,12,180,0,0,0,887,139,312,14,865,0,0,0,1330,2217
 IT-SU,Sud Sardegna,86,61,513,13,155,0,0,0,742,145,250,9,754,0,0,0,1158,1900
 IT-SU,Sud Sardegna,87,59,424,6,125,0,0,0,614,103,176,12,751,0,0,0,1042,1656
 IT-SU,Sud Sardegna,88,41,354,1,146,0,0,0,542,105,124,5,697,0,0,0,931,1473
 IT-SU,Sud Sardegna,89,48,326,3,147,0,0,0,524,90,119,4,690,0,0,0,903,1427
 IT-SU,Sud Sardegna,90,46,255,4,126,0,0,0,431,90,81,11,656,0,0,0,838,1269
 IT-SU,Sud Sardegna,91,22,185,4,117,0,0,0,328,75,61,4,574,0,0,0,714,1042
 IT-SU,Sud Sardegna,92,17,154,0,115,0,0,0,286,56,26,5,434,0,0,0,521,807
 IT-SU,Sud Sardegna,93,22,110,0,83,0,0,0,215,66,29,1,407,0,0,0,503,718
 IT-SU,Sud Sardegna,94,17,63,1,66,0,0,0,147,40,14,1,348,0,0,0,403,550
 IT-SU,Sud Sardegna,95,9,48,0,45,0,0,0,102,35,14,3,249,0,0,0,301,403
 IT-SU,Sud Sardegna,96,5,31,0,31,0,0,0,67,23,4,1,184,0,0,0,212,279
 IT-SU,Sud Sardegna,97,5,12,0,23,0,0,0,40,21,6,0,120,0,0,0,147,187
 IT-SU,Sud Sardegna,98,4,8,0,14,0,0,0,26,12,2,0,86,0,0,0,100,126
 IT-SU,Sud Sardegna,99,1,9,0,12,0,0,0,22,9,1,0,67,0,0,0,77,99
 IT-SU,Sud Sardegna,100,4,7,0,21,0,0,0,32,8,2,0,90,0,0,0,100,132
 IT-SU,Sud Sardegna,999,80285,74721,5101,4673,39,0,1,164820,64776,74089,5535,22564,32,1,0,166997,331817
IT-TA,Taranto,0,1774,0,0,0,0,0,0,1774,1616,0,0,0,0,0,0,1616,3390
IT-TA,Taranto,1,1807,0,0,0,0,0,0,1807,1676,0,0,0,0,0,0,1676,3483
IT-TA,Taranto,2,1843,0,0,0,0,0,0,1843,1782,0,0,0,0,0,0,1782,3625
IT-TA,Taranto,3,1885,0,0,0,0,0,0,1885,1753,0,0,0,0,0,0,1753,3638
IT-TA,Taranto,4,2002,0,0,0,0,0,0,2002,1832,0,0,0,0,0,0,1832,3834
IT-TA,Taranto,5,2033,0,0,0,0,0,0,2033,1940,0,0,0,0,0,0,1940,3973
IT-TA,Taranto,6,2233,0,0,0,0,0,0,2233,2033,0,0,0,0,0,0,2033,4266
IT-TA,Taranto,7,2168,0,0,0,0,0,0,2168,2176,0,0,0,0,0,0,2176,4344
IT-TA,Taranto,8,2290,0,0,0,0,0,0,2290,2201,0,0,0,0,0,0,2201,4491
IT-TA,Taranto,9,2461,0,0,0,0,0,0,2461,2370,0,0,0,0,0,0,2370,4831
IT-TA,Taranto,10,2423,0,0,0,0,0,0,2423,2332,0,0,0,0,0,0,2332,4755
IT-TA,Taranto,11,2674,0,0,0,0,0,0,2674,2437,0,0,0,0,0,0,2437,5111
IT-TA,Taranto,12,2671,0,0,0,0,0,0,2671,2592,0,0,0,0,0,0,2592,5263
IT-TA,Taranto,13,2845,0,0,0,0,0,0,2845,2567,0,0,0,0,0,0,2567,5412
IT-TA,Taranto,14,2764,0,0,0,0,0,0,2764,2627,0,0,0,0,0,0,2627,5391
IT-TA,Taranto,15,2784,0,0,0,0,0,0,2784,2645,0,0,0,0,0,0,2645,5429
IT-TA,Taranto,16,2819,0,0,0,0,0,0,2819,2711,0,0,0,0,0,0,2711,5530
IT-TA,Taranto,17,2808,0,0,0,0,0,0,2808,2758,0,0,0,0,0,0,2758,5566
IT-TA,Taranto,18,2948,0,0,0,0,0,0,2948,2772,0,0,0,0,0,0,2772,5720
IT-TA,Taranto,19,2933,0,0,0,0,0,0,2933,2888,2,0,0,0,0,0,2890,5823
IT-TA,Taranto,20,2975,0,0,0,0,0,0,2975,2933,7,0,0,0,0,0,2940,5915
IT-TA,Taranto,21,2995,3,0,0,0,0,0,2998,2781,9,0,0,0,0,0,2790,5788
IT-TA,Taranto,22,3023,3,0,0,1,0,0,3027,2734,32,0,0,0,0,0,2766,5793
IT-TA,Taranto,23,3031,9,0,0,2,0,0,3042,2740,46,0,0,1,0,0,2787,5829
IT-TA,Taranto,24,3056,21,2,0,1,0,0,3080,2619,58,0,0,1,0,0,2678,5758
IT-TA,Taranto,25,2997,35,1,0,0,0,0,3033,2532,111,0,1,4,0,0,2648,5681
IT-TA,Taranto,26,2840,54,0,0,1,0,0,2895,2486,194,0,0,4,0,0,2684,5579
IT-TA,Taranto,27,2752,112,0,1,3,0,0,2868,2384,250,0,0,2,0,0,2636,5504
IT-TA,Taranto,28,2635,158,2,0,1,0,0,2796,2253,359,5,2,0,0,0,2619,5415
IT-TA,Taranto,29,2603,215,0,0,1,0,0,2819,2119,490,7,0,2,0,0,2618,5437
IT-TA,Taranto,30,2563,335,4,0,3,0,0,2905,2086,648,14,0,2,0,0,2750,5655
IT-TA,Taranto,31,2611,373,5,2,1,0,0,2992,1951,872,14,3,2,0,0,2842,5834
IT-TA,Taranto,32,2354,505,6,1,2,0,0,2868,1837,1007,21,3,2,0,0,2870,5738
IT-TA,Taranto,33,2284,630,10,3,1,1,0,2929,1717,1155,26,7,2,0,0,2907,5836
IT-TA,Taranto,34,2134,753,9,4,2,0,0,2902,1632,1254,39,10,2,0,0,2937,5839
IT-TA,Taranto,35,2082,1030,11,5,4,0,0,3132,1431,1507,50,8,1,0,0,2997,6129
IT-TA,Taranto,36,1852,1140,28,2,2,0,0,3024,1293,1604,59,7,4,0,0,2967,5991
IT-TA,Taranto,37,1794,1317,28,4,0,0,0,3143,1252,1797,67,12,3,0,0,3131,6274
IT-TA,Taranto,38,1642,1386,50,1,3,0,0,3082,1158,1937,86,11,2,0,0,3194,6276
IT-TA,Taranto,39,1617,1537,47,4,2,0,0,3207,1130,2030,108,14,1,2,0,3285,6492
IT-TA,Taranto,40,1544,1712,50,3,3,0,0,3312,1025,2101,121,16,4,0,0,3267,6579
IT-TA,Taranto,41,1459,1791,69,5,1,1,0,3326,940,2164,113,22,3,0,0,3242,6568
IT-TA,Taranto,42,1349,1963,63,6,0,0,1,3382,953,2465,157,18,0,0,0,3593,6975
IT-TA,Taranto,43,1356,2181,103,10,3,0,0,3653,878,2467,151,32,2,0,0,3530,7183
IT-TA,Taranto,44,1335,2304,136,10,3,0,0,3788,843,2820,166,37,2,0,0,3868,7656
IT-TA,Taranto,45,1285,2468,128,10,1,0,0,3892,862,2882,212,36,1,0,0,3993,7885
IT-TA,Taranto,46,1314,2778,132,18,3,1,0,4246,826,3022,222,48,0,0,0,4118,8364
IT-TA,Taranto,47,1275,2868,149,19,1,0,0,4312,814,3158,242,66,0,0,0,4280,8592
IT-TA,Taranto,48,1229,2996,149,25,5,0,0,4404,829,3329,250,74,0,0,0,4482,8886
IT-TA,Taranto,49,1199,3036,183,23,3,0,0,4444,754,3482,250,84,3,0,0,4573,9017
IT-TA,Taranto,50,1002,3100,190,17,2,0,0,4311,687,3267,253,95,1,0,0,4303,8614
IT-TA,Taranto,51,974,3032,184,23,4,0,0,4217,640,3339,252,104,0,0,0,4335,8552
IT-TA,Taranto,52,883,3094,207,27,2,0,0,4213,591,3343,273,139,0,0,0,4346,8559
IT-TA,Taranto,53,799,2999,206,39,3,0,0,4046,571,3246,254,116,1,0,0,4188,8234
IT-TA,Taranto,54,792,3134,244,41,5,0,0,4216,563,3437,296,155,0,0,0,4451,8667
IT-TA,Taranto,55,692,3112,213,48,2,0,0,4067,554,3503,284,200,0,0,0,4541,8608
IT-TA,Taranto,56,653,3240,222,37,4,1,0,4157,547,3407,282,198,3,0,0,4437,8594
IT-TA,Taranto,57,619,3310,208,56,2,1,0,4196,495,3536,284,230,0,0,0,4545,8741
IT-TA,Taranto,58,561,3445,213,66,5,0,0,4290,505,3575,270,261,1,0,0,4612,8902
IT-TA,Taranto,59,458,3439,211,76,3,0,0,4187,524,3568,254,255,0,0,0,4601,8788
IT-TA,Taranto,60,437,3188,204,71,1,0,0,3901,422,3296,239,281,0,0,0,4238,8139
IT-TA,Taranto,61,421,3114,171,69,0,0,0,3775,405,3264,236,352,1,0,0,4258,8033
IT-TA,Taranto,62,384,3220,173,79,0,0,0,3856,360,3381,215,398,0,0,0,4354,8210
IT-TA,Taranto,63,301,3247,185,88,0,0,0,3821,370,3117,198,421,0,0,0,4106,7927
IT-TA,Taranto,64,303,3106,180,96,0,0,0,3685,320,3024,191,472,0,0,0,4007,7692
IT-TA,Taranto,65,266,2958,143,94,1,0,0,3462,357,2883,149,503,1,0,0,3893,7355
IT-TA,Taranto,66,271,2973,141,120,1,0,0,3506,342,2962,164,552,0,0,0,4020,7526
IT-TA,Taranto,67,218,2944,112,114,0,0,0,3388,289,2721,162,601,0,0,0,3773,7161
IT-TA,Taranto,68,208,2959,117,117,0,0,0,3401,305,2808,151,674,0,0,0,3938,7339
IT-TA,Taranto,69,193,2720,113,123,1,0,0,3150,243,2615,137,642,0,0,0,3637,6787
IT-TA,Taranto,70,173,2808,86,147,2,0,0,3216,235,2440,122,736,0,0,0,3533,6749
IT-TA,Taranto,71,147,2551,74,169,3,0,0,2944,228,2318,98,775,0,0,0,3419,6363
IT-TA,Taranto,72,141,2712,84,188,0,0,0,3125,273,2303,99,828,0,0,1,3504,6629
IT-TA,Taranto,73,135,2727,65,188,2,0,0,3117,242,2297,94,943,0,0,0,3576,6693
IT-TA,Taranto,74,120,2709,65,224,1,0,0,3119,247,2119,90,1007,0,0,0,3463,6582
IT-TA,Taranto,75,122,2757,60,238,1,0,0,3178,260,2065,80,1173,0,0,0,3578,6756
IT-TA,Taranto,76,114,2560,51,253,0,0,0,2978,252,1946,74,1171,0,0,0,3443,6421
IT-TA,Taranto,77,93,2310,47,252,1,0,0,2703,228,1811,64,1301,0,0,0,3404,6107
IT-TA,Taranto,78,67,2033,37,240,0,0,0,2377,216,1438,52,1102,0,0,0,2808,5185
IT-TA,Taranto,79,68,1700,23,251,0,0,0,2042,152,1198,47,1167,0,0,0,2564,4606
IT-TA,Taranto,80,72,1566,29,243,0,0,0,1910,155,1049,57,1168,0,0,0,2429,4339
IT-TA,Taranto,81,58,1474,18,280,1,0,0,1831,168,999,46,1225,0,0,0,2438,4269
IT-TA,Taranto,82,54,1387,33,273,0,0,0,1747,161,817,24,1202,0,0,0,2204,3951
IT-TA,Taranto,83,46,1409,19,338,0,0,0,1812,203,830,36,1390,0,0,0,2459,4271
IT-TA,Taranto,84,40,1248,3,290,0,0,0,1581,167,694,20,1407,0,0,0,2288,3869
IT-TA,Taranto,85,24,1040,11,301,0,0,0,1376,145,529,25,1299,0,0,0,1998,3374
IT-TA,Taranto,86,28,864,10,277,0,0,0,1179,129,425,15,1283,0,0,0,1852,3031
IT-TA,Taranto,87,24,670,7,272,0,0,0,973,114,309,12,1097,0,0,0,1532,2505
IT-TA,Taranto,88,32,583,3,252,0,0,0,870,116,208,6,1088,0,0,0,1418,2288
IT-TA,Taranto,89,16,446,5,260,0,0,0,727,107,158,7,969,0,0,0,1241,1968
IT-TA,Taranto,90,13,331,1,216,0,0,0,561,93,111,3,754,0,0,0,961,1522
IT-TA,Taranto,91,12,251,0,171,0,0,0,434,76,73,4,690,0,0,0,843,1277
IT-TA,Taranto,92,10,186,1,135,0,0,0,332,54,53,5,597,0,0,0,709,1041
IT-TA,Taranto,93,2,127,3,145,0,0,0,277,55,38,3,551,0,0,0,647,924
IT-TA,Taranto,94,4,80,3,86,0,0,0,173,31,20,0,393,0,0,0,444,617
IT-TA,Taranto,95,4,58,0,70,0,0,0,132,40,11,0,271,0,0,0,322,454
IT-TA,Taranto,96,5,35,1,49,0,0,0,90,22,6,1,210,0,0,0,239,329
IT-TA,Taranto,97,3,11,0,31,0,0,0,45,17,6,0,138,0,0,0,161,206
IT-TA,Taranto,98,1,8,0,25,0,0,0,34,9,5,1,97,0,0,0,112,146
IT-TA,Taranto,99,0,9,0,20,0,0,0,29,10,3,0,46,0,0,0,59,88
IT-TA,Taranto,100,2,7,0,17,0,0,0,26,16,4,1,123,0,0,0,144,170
IT-TA,Taranto,999,123415,132704,5741,7458,100,5,1,269424,108811,133834,8010,33361,58,2,1,284077,553501
IT-TE,Teramo,0,996,0,0,0,0,0,0,996,914,0,0,0,0,0,0,914,1910
IT-TE,Teramo,1,1056,0,0,0,0,0,0,1056,890,0,0,0,0,0,0,890,1946
IT-TE,Teramo,2,1044,0,0,0,0,0,0,1044,954,0,0,0,0,0,0,954,1998
IT-TE,Teramo,3,1070,0,0,0,0,0,0,1070,988,0,0,0,0,0,0,988,2058
IT-TE,Teramo,4,1091,0,0,0,0,0,0,1091,1021,0,0,0,0,0,0,1021,2112
IT-TE,Teramo,5,1086,0,0,0,0,0,0,1086,1040,0,0,0,0,0,0,1040,2126
IT-TE,Teramo,6,1228,0,0,0,0,0,0,1228,1128,0,0,0,0,0,0,1128,2356
IT-TE,Teramo,7,1243,0,0,0,0,0,0,1243,1198,0,0,0,0,0,0,1198,2441
IT-TE,Teramo,8,1237,0,0,0,0,0,0,1237,1197,0,0,0,0,0,0,1197,2434
IT-TE,Teramo,9,1274,0,0,0,0,0,0,1274,1236,0,0,0,0,0,0,1236,2510
IT-TE,Teramo,10,1290,0,0,0,0,0,0,1290,1251,0,0,0,0,0,0,1251,2541
IT-TE,Teramo,11,1334,0,0,0,0,0,0,1334,1307,0,0,0,0,0,0,1307,2641
IT-TE,Teramo,12,1402,0,0,0,0,0,0,1402,1249,0,0,0,0,0,0,1249,2651
IT-TE,Teramo,13,1381,0,0,0,0,0,0,1381,1342,0,0,0,0,0,0,1342,2723
IT-TE,Teramo,14,1362,0,0,0,0,0,0,1362,1315,0,0,0,0,0,0,1315,2677
IT-TE,Teramo,15,1433,0,0,0,0,0,0,1433,1363,0,0,0,0,0,0,1363,2796
IT-TE,Teramo,16,1435,0,0,0,0,0,0,1435,1333,0,0,0,0,0,0,1333,2768
IT-TE,Teramo,17,1363,1,0,0,0,0,0,1364,1336,0,0,0,0,0,0,1336,2700
IT-TE,Teramo,18,1454,0,0,0,0,0,0,1454,1432,0,0,0,0,0,0,1432,2886
IT-TE,Teramo,19,1499,2,0,0,0,0,0,1501,1389,3,0,0,0,0,0,1392,2893
IT-TE,Teramo,20,1483,0,0,0,0,0,0,1483,1330,7,0,0,0,0,0,1337,2820
IT-TE,Teramo,21,1505,6,0,0,0,0,0,1511,1293,14,0,0,0,0,0,1307,2818
IT-TE,Teramo,22,1524,3,0,0,0,0,0,1527,1328,31,1,0,0,0,0,1360,2887
IT-TE,Teramo,23,1509,11,0,1,0,0,0,1521,1344,48,1,0,0,0,0,1393,2914
IT-TE,Teramo,24,1510,15,1,0,0,0,0,1526,1280,60,1,0,0,0,0,1341,2867
IT-TE,Teramo,25,1556,28,2,0,0,0,0,1586,1338,82,0,0,0,0,0,1420,3006
IT-TE,Teramo,26,1517,50,0,0,1,0,0,1568,1269,130,0,0,1,0,0,1400,2968
IT-TE,Teramo,27,1478,60,1,2,0,0,0,1541,1294,163,1,1,0,0,0,1459,3000
IT-TE,Teramo,28,1444,97,1,0,1,0,0,1543,1183,194,3,0,1,0,0,1381,2924
IT-TE,Teramo,29,1462,102,2,0,2,0,0,1568,1264,281,5,0,1,0,0,1551,3119
IT-TE,Teramo,30,1435,173,2,2,0,0,0,1612,1181,349,3,1,0,1,0,1535,3147
IT-TE,Teramo,31,1448,254,8,1,0,0,0,1711,1077,443,8,3,0,0,0,1531,3242
IT-TE,Teramo,32,1332,302,9,6,2,0,0,1651,1060,543,9,1,0,0,0,1613,3264
IT-TE,Teramo,33,1301,372,4,2,0,0,0,1679,1011,585,18,3,1,1,0,1619,3298
IT-TE,Teramo,34,1263,445,10,1,2,0,0,1721,826,642,25,3,3,0,0,1499,3220
IT-TE,Teramo,35,1204,557,15,6,0,0,0,1782,927,706,25,3,3,0,0,1664,3446
IT-TE,Teramo,36,1070,574,16,6,2,0,0,1668,800,810,39,5,4,0,0,1658,3326
IT-TE,Teramo,37,1008,673,26,3,2,0,0,1712,772,932,54,6,2,0,0,1766,3478
IT-TE,Teramo,38,1017,755,22,6,0,0,0,1800,757,949,48,4,8,0,0,1766,3566
IT-TE,Teramo,39,1032,800,30,4,5,0,0,1871,690,1029,64,12,3,0,0,1798,3669
IT-TE,Teramo,40,957,877,38,5,1,0,0,1878,615,1121,66,7,2,0,0,1811,3689
IT-TE,Teramo,41,880,941,42,2,1,0,0,1866,665,1130,81,15,3,0,0,1894,3760
IT-TE,Teramo,42,857,946,55,4,5,0,0,1867,576,1176,77,19,2,0,0,1850,3717
IT-TE,Teramo,43,859,1079,64,6,2,0,1,2011,602,1195,98,16,1,0,0,1912,3923
IT-TE,Teramo,44,802,1139,58,6,2,0,0,2007,548,1311,117,38,1,0,0,2015,4022
IT-TE,Teramo,45,800,1201,65,4,0,0,0,2070,531,1468,122,23,1,0,0,2145,4215
IT-TE,Teramo,46,783,1210,92,9,3,0,0,2097,475,1447,122,22,2,0,0,2068,4165
IT-TE,Teramo,47,730,1332,94,10,1,0,0,2167,476,1491,120,37,2,0,0,2126,4293
IT-TE,Teramo,48,711,1354,72,16,2,0,0,2155,507,1538,150,40,0,0,0,2235,4390
IT-TE,Teramo,49,727,1432,113,14,1,0,0,2287,455,1687,165,54,0,0,0,2361,4648
IT-TE,Teramo,50,684,1471,113,11,4,0,0,2283,399,1752,173,41,0,0,0,2365,4648
IT-TE,Teramo,51,676,1587,134,11,2,0,0,2410,429,1752,166,48,0,0,0,2395,4805
IT-TE,Teramo,52,617,1608,158,10,1,0,0,2394,446,1808,196,69,0,0,0,2519,4913
IT-TE,Teramo,53,572,1572,137,17,3,0,0,2301,338,1850,210,72,2,0,0,2472,4773
IT-TE,Teramo,54,589,1745,145,23,0,0,0,2502,371,1947,207,98,0,0,0,2623,5125
IT-TE,Teramo,55,579,1754,163,22,3,0,0,2521,328,1845,199,92,0,0,0,2464,4985
IT-TE,Teramo,56,517,1848,170,22,4,0,1,2562,312,1918,190,108,0,0,0,2528,5090
IT-TE,Teramo,57,462,1902,163,20,2,0,0,2549,284,1994,169,130,0,0,0,2577,5126
IT-TE,Teramo,58,369,1862,172,27,3,0,0,2433,282,2025,210,154,1,0,0,2672,5105
IT-TE,Teramo,59,396,1894,140,36,0,0,0,2466,269,1990,210,149,1,0,0,2619,5085
IT-TE,Teramo,60,320,1818,127,40,1,0,0,2306,236,1874,178,182,0,0,0,2470,4776
IT-TE,Teramo,61,288,1735,148,46,4,0,0,2221,193,1751,157,174,0,0,0,2275,4496
IT-TE,Teramo,62,244,1668,154,36,0,0,0,2102,189,1717,153,189,1,0,0,2249,4351
IT-TE,Teramo,63,242,1683,126,43,3,0,0,2097,193,1678,140,206,0,0,0,2217,4314
IT-TE,Teramo,64,230,1695,109,66,3,0,0,2103,172,1715,122,250,0,0,0,2259,4362
IT-TE,Teramo,65,207,1601,99,58,2,0,0,1967,175,1576,113,270,0,0,0,2134,4101
IT-TE,Teramo,66,202,1576,97,70,0,0,0,1945,143,1488,97,290,0,0,0,2018,3963
IT-TE,Teramo,67,156,1569,110,70,2,0,0,1907,136,1446,103,331,0,0,0,2016,3923
IT-TE,Teramo,68,169,1486,72,75,0,0,0,1802,118,1398,104,360,0,0,0,1980,3782
IT-TE,Teramo,69,129,1500,78,74,1,0,0,1782,129,1382,74,397,0,1,0,1983,3765
IT-TE,Teramo,70,128,1348,76,60,0,0,0,1612,95,1249,73,389,0,0,0,1806,3418
IT-TE,Teramo,71,125,1351,50,80,1,0,0,1607,113,1162,53,400,0,0,0,1728,3335
IT-TE,Teramo,72,109,1359,40,86,0,0,0,1594,74,1139,67,488,0,0,0,1768,3362
IT-TE,Teramo,73,94,1357,50,102,0,0,0,1603,94,1137,63,531,0,0,0,1825,3428
IT-TE,Teramo,74,101,1312,39,104,1,0,0,1557,77,1076,53,601,0,0,0,1807,3364
IT-TE,Teramo,75,96,1373,44,101,0,0,0,1614,86,1086,43,603,1,0,0,1819,3433
IT-TE,Teramo,76,88,1217,40,115,0,0,0,1460,66,921,47,628,0,0,0,1662,3122
IT-TE,Teramo,77,94,1185,31,101,0,0,0,1411,46,854,43,692,0,0,0,1635,3046
IT-TE,Teramo,78,56,898,24,94,0,0,0,1072,46,712,23,586,0,0,0,1367,2439
IT-TE,Teramo,79,58,898,21,95,0,0,0,1072,50,582,28,614,0,0,0,1274,2346
IT-TE,Teramo,80,50,879,15,126,0,0,0,1070,40,559,25,678,0,0,0,1302,2372
IT-TE,Teramo,81,50,778,15,110,1,0,0,954,48,477,13,705,0,0,0,1243,2197
IT-TE,Teramo,82,40,727,9,154,0,0,0,930,38,420,17,757,0,0,0,1232,2162
IT-TE,Teramo,83,35,774,9,138,0,0,0,956,51,394,15,826,0,0,0,1286,2242
IT-TE,Teramo,84,37,697,20,147,0,0,0,901,37,321,9,889,0,0,0,1256,2157
IT-TE,Teramo,85,34,586,8,175,0,0,0,803,40,326,16,820,0,0,0,1202,2005
IT-TE,Teramo,86,30,512,8,164,0,0,0,714,36,227,9,797,0,0,0,1069,1783
IT-TE,Teramo,87,30,421,7,149,0,0,0,607,26,175,5,702,0,0,0,908,1515
IT-TE,Teramo,88,22,383,4,133,0,0,0,542,29,156,6,714,0,0,0,905,1447
IT-TE,Teramo,89,21,253,4,119,0,0,0,397,28,92,4,643,0,0,0,767,1164
IT-TE,Teramo,90,18,233,0,105,1,0,0,357,22,71,6,582,0,0,0,681,1038
IT-TE,Teramo,91,6,148,1,91,0,0,0,246,22,52,1,473,0,0,0,548,794
IT-TE,Teramo,92,12,119,0,98,0,0,0,229,21,40,2,399,0,0,0,462,691
IT-TE,Teramo,93,5,79,3,78,0,0,0,165,20,34,2,367,0,0,0,423,588
IT-TE,Teramo,94,7,66,4,51,0,0,0,128,19,18,1,249,0,0,0,287,415
IT-TE,Teramo,95,1,39,0,45,0,0,0,85,6,8,1,187,0,0,0,202,287
IT-TE,Teramo,96,7,16,0,21,0,0,0,44,4,8,0,146,0,0,0,158,202
IT-TE,Teramo,97,1,6,0,18,0,0,0,25,5,8,0,109,0,0,0,122,147
IT-TE,Teramo,98,2,6,1,11,0,0,0,20,5,3,0,95,0,0,0,103,123
IT-TE,Teramo,99,0,2,0,7,0,0,0,9,2,0,1,61,0,0,0,64,73
IT-TE,Teramo,100,2,7,0,12,0,0,0,21,6,6,0,90,0,0,0,102,123
IT-TE,Teramo,999,69489,69394,3980,3783,77,0,2,146725,57751,69784,5220,19744,47,3,0,152549,299274
IT-TR,Terni,0,556,0,0,0,0,0,0,556,543,0,0,0,0,0,0,543,1099
IT-TR,Terni,1,564,0,0,0,0,0,0,564,585,0,0,0,0,0,0,585,1149
IT-TR,Terni,2,632,0,0,0,0,0,0,632,617,0,0,0,0,0,0,617,1249
IT-TR,Terni,3,665,0,0,0,0,0,0,665,626,0,0,0,0,0,0,626,1291
IT-TR,Terni,4,682,0,0,0,0,0,0,682,655,0,0,0,0,0,0,655,1337
IT-TR,Terni,5,677,0,0,0,0,0,0,677,694,0,0,0,0,0,0,694,1371
IT-TR,Terni,6,733,0,0,0,0,0,0,733,680,0,0,0,0,0,0,680,1413
IT-TR,Terni,7,761,0,0,0,0,0,0,761,749,0,0,0,0,0,0,749,1510
IT-TR,Terni,8,742,0,0,0,0,0,0,742,727,0,0,0,0,0,0,727,1469
IT-TR,Terni,9,869,0,0,0,0,0,0,869,791,0,0,0,0,0,0,791,1660
IT-TR,Terni,10,879,0,0,0,0,0,0,879,837,0,0,0,0,0,0,837,1716
IT-TR,Terni,11,932,0,0,0,0,0,0,932,877,0,0,0,0,0,0,877,1809
IT-TR,Terni,12,902,0,0,0,0,0,0,902,873,0,0,0,0,0,0,873,1775
IT-TR,Terni,13,980,0,0,0,0,0,0,980,955,0,0,0,0,0,0,955,1935
IT-TR,Terni,14,937,0,0,0,0,0,0,937,885,0,0,0,0,0,0,885,1822
IT-TR,Terni,15,1007,0,0,0,0,0,0,1007,929,0,0,0,0,0,0,929,1936
IT-TR,Terni,16,1071,0,0,0,0,0,0,1071,1011,0,0,0,0,0,0,1011,2082
IT-TR,Terni,17,1027,0,0,0,0,0,0,1027,960,0,0,0,0,0,0,960,1987
IT-TR,Terni,18,1044,0,0,0,0,0,0,1044,913,1,0,0,0,0,0,914,1958
IT-TR,Terni,19,1039,1,0,0,0,0,0,1040,940,2,0,0,0,0,0,942,1982
IT-TR,Terni,20,1007,0,0,0,0,0,0,1007,882,5,0,0,0,0,0,887,1894
IT-TR,Terni,21,1032,0,0,0,0,0,0,1032,943,9,0,0,0,0,0,952,1984
IT-TR,Terni,22,993,0,1,0,0,0,0,994,903,12,1,0,0,0,0,916,1910
IT-TR,Terni,23,1049,6,0,0,0,0,0,1055,923,27,0,0,1,0,0,951,2006
IT-TR,Terni,24,1055,13,2,0,0,0,0,1070,925,39,0,0,1,0,0,965,2035
IT-TR,Terni,25,1069,21,1,0,0,0,0,1091,855,57,0,0,1,0,0,913,2004
IT-TR,Terni,26,1024,27,0,0,0,0,0,1051,833,71,0,1,0,0,0,905,1956
IT-TR,Terni,27,988,44,1,0,0,0,0,1033,789,83,2,0,0,0,0,874,1907
IT-TR,Terni,28,945,56,1,0,0,0,0,1002,747,114,3,1,0,0,0,865,1867
IT-TR,Terni,29,928,77,5,0,0,0,0,1010,762,184,5,1,1,0,0,953,1963
IT-TR,Terni,30,851,108,4,0,2,0,0,965,737,201,3,0,0,0,0,941,1906
IT-TR,Terni,31,892,144,4,0,1,0,0,1041,692,280,6,0,0,0,0,978,2019
IT-TR,Terni,32,881,154,0,1,1,0,0,1037,666,300,10,2,1,0,0,979,2016
IT-TR,Terni,33,848,210,7,1,3,1,0,1070,660,342,19,0,1,1,0,1023,2093
IT-TR,Terni,34,777,241,5,0,0,0,0,1023,609,404,12,6,0,0,0,1031,2054
IT-TR,Terni,35,797,319,10,1,0,0,0,1127,570,443,20,2,2,0,0,1037,2164
IT-TR,Terni,36,728,387,17,0,1,0,0,1133,559,470,27,4,2,1,0,1063,2196
IT-TR,Terni,37,704,356,13,4,1,0,0,1078,547,552,38,3,3,0,0,1143,2221
IT-TR,Terni,38,702,436,26,1,0,1,0,1166,524,585,46,6,1,0,0,1162,2328
IT-TR,Terni,39,645,461,22,1,1,0,0,1130,447,584,50,6,3,0,0,1090,2220
IT-TR,Terni,40,666,500,22,0,3,0,0,1191,516,663,42,4,2,0,0,1227,2418
IT-TR,Terni,41,632,583,23,4,2,1,0,1245,496,718,57,8,0,0,0,1279,2524
IT-TR,Terni,42,579,637,33,2,0,0,0,1251,459,732,75,13,2,0,0,1281,2532
IT-TR,Terni,43,566,685,38,6,2,0,0,1297,408,719,86,21,2,0,0,1236,2533
IT-TR,Terni,44,562,694,50,4,1,0,0,1311,412,849,83,22,1,0,0,1367,2678
IT-TR,Terni,45,557,729,53,7,5,0,0,1351,432,931,114,16,1,0,0,1494,2845
IT-TR,Terni,46,591,807,67,9,1,0,0,1475,391,985,125,23,1,0,0,1525,3000
IT-TR,Terni,47,600,909,82,8,0,0,0,1599,382,969,128,33,0,0,0,1512,3111
IT-TR,Terni,48,553,949,78,5,2,0,0,1587,369,1125,152,34,0,0,0,1680,3267
IT-TR,Terni,49,499,1014,99,6,5,0,0,1623,381,1263,151,35,2,0,0,1832,3455
IT-TR,Terni,50,518,1061,102,10,2,1,0,1694,370,1233,159,31,2,1,0,1796,3490
IT-TR,Terni,51,467,1029,123,10,1,0,0,1630,350,1229,176,44,2,0,0,1801,3431
IT-TR,Terni,52,451,1083,127,11,1,1,0,1674,341,1291,188,58,1,0,0,1879,3553
IT-TR,Terni,53,437,1099,135,16,3,0,0,1690,300,1208,183,57,0,0,0,1748,3438
IT-TR,Terni,54,384,1247,139,16,1,0,0,1787,301,1301,199,63,1,0,0,1865,3652
IT-TR,Terni,55,386,1236,135,15,2,0,0,1774,267,1351,196,80,0,0,0,1894,3668
IT-TR,Terni,56,357,1183,155,20,2,0,0,1717,251,1297,196,77,0,0,0,1821,3538
IT-TR,Terni,57,331,1180,151,30,2,0,0,1694,238,1371,186,86,0,0,0,1881,3575
IT-TR,Terni,58,317,1303,163,32,2,0,0,1817,236,1357,204,113,0,0,0,1910,3727
IT-TR,Terni,59,273,1296,163,25,2,0,0,1759,215,1378,198,121,0,0,0,1912,3671
IT-TR,Terni,60,216,1316,131,26,4,0,0,1693,182,1306,173,124,0,0,0,1785,3478
IT-TR,Terni,61,230,1209,145,27,1,0,0,1612,171,1258,181,118,0,0,1,1729,3341
IT-TR,Terni,62,213,1171,141,33,2,0,0,1560,141,1237,147,138,0,0,0,1663,3223
IT-TR,Terni,63,163,1194,103,37,3,0,0,1500,141,1223,153,161,1,0,0,1679,3179
IT-TR,Terni,64,166,1115,113,37,1,0,0,1432,134,1156,133,156,0,0,0,1579,3011
IT-TR,Terni,65,181,1110,117,37,3,0,0,1448,125,1091,135,179,0,0,0,1530,2978
IT-TR,Terni,66,136,1082,99,43,2,0,0,1362,124,1001,121,187,2,0,0,1435,2797
IT-TR,Terni,67,137,1094,102,51,0,0,0,1384,127,1122,124,233,1,0,0,1607,2991
IT-TR,Terni,68,137,1086,83,55,2,0,0,1363,94,1061,131,265,0,0,0,1551,2914
IT-TR,Terni,69,98,1026,82,54,3,0,0,1263,91,1081,102,230,0,0,0,1504,2767
IT-TR,Terni,70,93,989,78,67,1,0,0,1228,103,953,97,290,0,0,0,1443,2671
IT-TR,Terni,71,81,1001,78,74,0,0,0,1234,92,991,88,282,0,0,0,1453,2687
IT-TR,Terni,72,97,1046,67,69,0,0,0,1279,75,950,84,316,1,0,0,1426,2705
IT-TR,Terni,73,97,983,68,82,0,0,0,1230,75,932,77,370,0,0,0,1454,2684
IT-TR,Terni,74,100,1062,71,99,0,0,0,1332,81,919,72,391,2,0,0,1465,2797
IT-TR,Terni,75,84,1206,56,97,1,0,0,1444,76,981,60,452,0,0,0,1569,3013
IT-TR,Terni,76,92,1099,51,98,0,0,0,1340,65,885,57,496,1,0,0,1504,2844
IT-TR,Terni,77,75,992,38,123,0,0,0,1228,53,847,60,515,0,0,0,1475,2703
IT-TR,Terni,78,56,771,33,87,0,0,0,947,41,653,55,442,0,0,0,1191,2138
IT-TR,Terni,79,53,732,21,105,0,0,0,911,68,600,37,483,0,0,0,1188,2099
IT-TR,Terni,80,45,798,22,113,2,0,0,980,48,577,30,598,0,0,0,1253,2233
IT-TR,Terni,81,49,726,24,113,0,0,0,912,37,503,48,570,0,0,0,1158,2070
IT-TR,Terni,82,47,692,13,127,0,0,0,879,49,449,24,616,0,0,0,1138,2017
IT-TR,Terni,83,46,711,15,141,0,0,0,913,55,415,20,699,0,0,0,1189,2102
IT-TR,Terni,84,40,589,11,168,0,0,0,808,58,360,24,671,0,0,0,1113,1921
IT-TR,Terni,85,34,562,10,158,0,0,0,764,40,276,28,735,0,0,0,1079,1843
IT-TR,Terni,86,25,408,13,157,0,0,0,603,41,227,13,692,0,0,0,973,1576
IT-TR,Terni,87,22,334,10,117,0,0,0,483,15,149,14,593,0,0,0,771,1254
IT-TR,Terni,88,18,296,6,143,0,0,0,463,38,121,9,598,0,0,0,766,1229
IT-TR,Terni,89,29,224,4,123,0,0,0,380,26,93,7,536,0,0,0,662,1042
IT-TR,Terni,90,18,206,6,112,0,0,0,342,26,68,5,508,0,0,0,607,949
IT-TR,Terni,91,8,151,3,73,0,0,0,235,20,54,4,384,0,0,0,462,697
IT-TR,Terni,92,11,113,1,69,0,0,0,194,18,23,7,384,0,0,0,432,626
IT-TR,Terni,93,4,79,3,65,0,0,0,151,14,25,3,336,0,0,0,378,529
IT-TR,Terni,94,3,56,0,44,0,0,0,103,14,13,4,279,0,0,0,310,413
IT-TR,Terni,95,3,24,1,41,0,0,0,69,7,9,0,196,0,0,0,212,281
IT-TR,Terni,96,2,18,3,35,0,0,0,58,9,5,1,136,0,0,0,151,209
IT-TR,Terni,97,0,18,0,26,0,0,0,44,10,0,2,113,0,0,0,125,169
IT-TR,Terni,98,0,11,0,10,0,0,0,21,1,1,1,89,0,0,0,92,113
IT-TR,Terni,99,0,7,0,13,0,0,0,20,0,1,0,45,0,0,0,46,66
IT-TR,Terni,100,0,1,0,6,0,0,0,7,6,1,1,73,0,0,0,81,88
IT-TR,Terni,999,47249,49593,3879,3400,74,5,0,104200,40126,50352,5472,15650,42,3,1,111646,215846
IT-TO,Torino,0,6731,0,0,0,0,0,0,6731,6276,0,0,0,0,0,0,6276,13007
IT-TO,Torino,1,6979,0,0,0,0,0,0,6979,6661,0,0,0,0,0,0,6661,13640
IT-TO,Torino,2,7290,0,0,0,0,0,0,7290,6921,0,0,0,0,0,0,6921,14211
IT-TO,Torino,3,7481,0,0,0,0,0,0,7481,7104,0,0,0,0,0,0,7104,14585
IT-TO,Torino,4,7690,0,0,0,0,0,0,7690,7308,0,0,0,0,0,0,7308,14998
IT-TO,Torino,5,7870,0,0,0,0,0,0,7870,7623,0,0,0,0,0,0,7623,15493
IT-TO,Torino,6,8392,0,0,0,0,0,0,8392,7972,0,0,0,0,0,0,7972,16364
IT-TO,Torino,7,8787,0,0,0,0,0,0,8787,8296,0,0,0,0,0,0,8296,17083
IT-TO,Torino,8,9195,0,0,0,0,0,0,9195,8391,0,0,0,0,0,0,8391,17586
IT-TO,Torino,9,9233,0,0,0,0,0,0,9233,8990,0,0,0,0,0,0,8990,18223
IT-TO,Torino,10,9750,0,0,0,0,0,0,9750,9076,0,0,0,0,0,0,9076,18826
IT-TO,Torino,11,9954,0,0,0,0,0,0,9954,9436,0,0,0,0,0,0,9436,19390
IT-TO,Torino,12,10247,0,0,0,0,0,0,10247,9399,0,0,0,0,0,0,9399,19646
IT-TO,Torino,13,10391,0,0,0,0,0,0,10391,9814,0,0,0,0,0,0,9814,20205
IT-TO,Torino,14,10742,0,0,0,0,0,0,10742,9946,0,0,0,0,0,0,9946,20688
IT-TO,Torino,15,10822,0,0,0,0,0,0,10822,10103,0,0,0,0,0,0,10103,20925
IT-TO,Torino,16,10662,0,0,0,0,0,0,10662,9982,0,1,0,0,0,0,9983,20645
IT-TO,Torino,17,10725,0,0,0,0,0,0,10725,9732,0,0,0,0,0,0,9732,20457
IT-TO,Torino,18,10670,0,0,0,0,0,0,10670,9923,2,0,0,0,0,0,9925,20595
IT-TO,Torino,19,10887,3,0,0,0,0,0,10890,9799,21,0,0,0,0,0,9820,20710
IT-TO,Torino,20,10898,5,0,0,0,0,0,10903,9887,58,1,0,1,0,0,9947,20850
IT-TO,Torino,21,10630,9,1,0,1,0,0,10641,9781,100,2,0,1,0,0,9884,20525
IT-TO,Torino,22,10621,39,1,0,2,0,0,10663,9744,177,9,0,0,0,0,9930,20593
IT-TO,Torino,23,11402,64,3,1,1,0,0,11471,9878,292,5,1,2,0,0,10178,21649
IT-TO,Torino,24,11294,115,9,0,1,0,0,11419,9476,441,6,2,2,1,0,9928,21347
IT-TO,Torino,25,11542,208,6,0,7,0,0,11763,9596,592,11,0,4,0,0,10203,21966
IT-TO,Torino,26,11277,288,7,0,4,0,0,11576,9581,831,21,1,4,1,0,10439,22015
IT-TO,Torino,27,11310,422,13,0,9,1,0,11755,9437,1083,37,2,10,0,0,10569,22324
IT-TO,Torino,28,10993,702,14,0,11,0,0,11720,8991,1399,32,7,6,0,0,10435,22155
IT-TO,Torino,29,10905,940,18,1,10,2,0,11876,8623,1902,65,12,21,0,0,10623,22499
IT-TO,Torino,30,10306,1318,42,0,19,2,0,11687,8534,2389,74,3,23,2,0,11025,22712
IT-TO,Torino,31,10336,1778,53,1,18,2,0,12188,8031,3099,99,6,21,4,0,11260,23448
IT-TO,Torino,32,9764,2245,71,2,18,0,0,12100,7743,3655,127,12,26,0,0,11563,23663
IT-TO,Torino,33,9599,2932,82,1,17,0,0,12631,7272,4206,218,13,33,4,0,11746,24377
IT-TO,Torino,34,8667,3266,111,11,25,1,0,12081,6806,4542,222,13,24,4,0,11611,23692
IT-TO,Torino,35,8326,3895,161,12,46,3,0,12443,6410,5100,270,28,27,2,0,11837,24280
IT-TO,Torino,36,7537,4154,173,7,37,2,0,11910,5839,5469,324,34,39,0,0,11705,23615
IT-TO,Torino,37,7277,4556,225,11,29,2,0,12100,5447,5782,402,42,22,1,0,11696,23796
IT-TO,Torino,38,6980,4940,258,10,30,1,0,12219,5328,6322,486,63,31,1,0,12231,24450
IT-TO,Torino,39,6619,5253,288,13,26,1,0,12200,5122,6456,587,52,31,4,0,12252,24452
IT-TO,Torino,40,6371,5698,353,12,33,0,0,12467,4882,6970,596,67,34,1,0,12550,25017
IT-TO,Torino,41,6246,6284,409,8,22,2,0,12971,4836,7404,710,65,22,2,0,13039,26010
IT-TO,Torino,42,5915,6393,495,38,25,0,0,12866,4635,7512,791,116,25,0,0,13079,25945
IT-TO,Torino,43,5765,6724,528,25,30,2,0,13074,4505,7793,897,131,21,1,0,13348,26422
IT-TO,Torino,44,5816,7143,554,41,28,1,1,13584,4294,8276,1012,135,18,1,0,13736,27320
IT-TO,Torino,45,5922,7556,680,56,26,1,1,14242,4543,8855,1144,148,26,1,0,14717,28959
IT-TO,Torino,46,5952,8172,773,47,31,1,0,14976,4516,9565,1267,172,24,1,0,15545,30521
IT-TO,Torino,47,5981,8629,905,47,24,1,0,15587,4409,9998,1550,206,19,3,0,16185,31772
IT-TO,Torino,48,5990,9464,1129,55,44,0,1,16683,4495,10714,1658,256,31,1,0,17155,33838
IT-TO,Torino,49,6110,10231,1218,63,44,3,0,17669,4357,11393,1886,271,22,3,0,17932,35601
IT-TO,Torino,50,5758,10375,1337,68,50,2,1,17591,4193,11400,1925,301,27,0,0,17846,35437
IT-TO,Torino,51,5437,10941,1383,116,32,1,1,17911,3831,11777,2162,328,14,0,0,18112,36023
IT-TO,Torino,52,5213,10964,1492,99,39,2,1,17810,3615,12300,2164,447,21,2,0,18549,36359
IT-TO,Torino,53,4872,11251,1509,101,35,0,0,17768,3506,12195,2281,496,24,0,0,18502,36270
IT-TO,Torino,54,4680,11549,1634,146,39,1,0,18049,3245,12823,2337,546,15,0,0,18966,37015
IT-TO,Torino,55,4316,11869,1714,139,37,1,0,18076,2965,12503,2480,644,22,1,0,18615,36691
IT-TO,Torino,56,3970,11876,1733,161,34,0,1,17775,2876,12506,2489,734,24,0,0,18629,36404
IT-TO,Torino,57,3784,11993,1851,219,33,1,2,17883,2581,12678,2407,780,12,0,0,18458,36341
IT-TO,Torino,58,3433,11867,1839,201,43,0,2,17385,2444,12458,2450,905,14,0,0,18271,35656
IT-TO,Torino,59,3234,12222,1871,218,37,0,1,17583,2334,12723,2485,977,14,0,0,18533,36116
IT-TO,Torino,60,2765,11508,1735,267,36,1,2,16314,2070,12133,2223,1045,12,0,0,17483,33797
IT-TO,Torino,61,2372,11077,1563,301,28,0,2,15343,1845,11608,2164,1168,10,0,1,16796,32139
IT-TO,Torino,62,2223,11137,1529,295,29,0,1,15214,1634,11571,2032,1350,6,0,0,16593,31807
IT-TO,Torino,63,1932,10802,1515,306,19,0,3,14577,1437,11060,1979,1465,8,0,0,15949,30526
IT-TO,Torino,64,1802,10738,1434,382,31,0,2,14389,1361,10872,1813,1464,3,0,0,15513,29902
IT-TO,Torino,65,1666,10426,1295,382,21,0,1,13791,1273,10538,1710,1685,11,0,0,15217,29008
IT-TO,Torino,66,1565,10458,1241,407,19,0,0,13690,1190,10373,1540,1886,10,0,0,14999,28689
IT-TO,Torino,67,1357,10343,1137,498,22,0,1,13358,1094,10052,1530,2071,9,0,0,14756,28114
IT-TO,Torino,68,1311,10064,1002,527,15,0,1,12920,1001,9733,1376,2287,3,0,0,14400,27320
IT-TO,Torino,69,1243,9875,970,572,10,0,0,12670,956,9476,1262,2459,2,0,0,14155,26825
IT-TO,Torino,70,1091,9433,860,598,13,0,1,11996,829,9094,1207,2598,5,0,1,13734,25730
IT-TO,Torino,71,929,9383,802,671,11,0,0,11796,820,8862,1093,2788,9,0,0,13572,25368
IT-TO,Torino,72,918,9043,687,702,10,0,1,11361,735,8655,991,3110,6,0,0,13497,24858
IT-TO,Torino,73,915,9368,689,745,8,1,2,11728,717,8784,958,3475,1,0,0,13935,25663
IT-TO,Torino,74,805,9590,636,885,8,0,1,11925,721,8634,860,3851,1,0,0,14067,25992
IT-TO,Torino,75,840,9895,599,1043,9,0,3,12389,762,8803,906,4412,3,0,0,14886,27275
IT-TO,Torino,76,723,9790,550,1063,7,0,1,12134,676,8295,797,4622,3,0,0,14393,26527
IT-TO,Torino,77,693,9222,510,1180,7,0,0,11612,662,7627,800,4985,0,0,0,14074,25686
IT-TO,Torino,78,494,6944,334,925,10,0,0,8707,473,5584,497,4191,3,0,0,10748,19455
IT-TO,Torino,79,467,6989,326,1141,7,0,0,8930,544,5573,527,4635,0,0,0,11279,20209
IT-TO,Torino,80,467,6528,268,1117,5,0,1,8386,523,5045,498,5069,0,0,0,11135,19521
IT-TO,Torino,81,495,6280,224,1286,7,0,0,8292,536,4563,486,5302,2,0,0,10889,19181
IT-TO,Torino,82,440,5929,228,1227,4,0,0,7828,530,4120,379,5713,0,0,0,10742,18570
IT-TO,Torino,83,416,6092,232,1552,3,0,1,8296,541,4036,370,6524,1,0,1,11473,19769
IT-TO,Torino,84,375,5530,170,1552,4,0,1,7632,546,3441,334,6636,1,0,1,10959,18591
IT-TO,Torino,85,323,4971,157,1473,3,0,0,6927,484,2916,311,6388,1,0,0,10100,17027
IT-TO,Torino,86,274,3950,121,1441,1,0,0,5787,472,2209,244,5894,0,0,0,8819,14606
IT-TO,Torino,87,196,3121,82,1288,1,0,0,4688,413,1571,190,5403,0,0,0,7577,12265
IT-TO,Torino,88,175,2606,73,1252,1,0,0,4107,368,1267,173,5191,0,0,0,6999,11106
IT-TO,Torino,89,135,2109,52,1067,2,0,0,3365,305,913,129,4800,0,0,0,6147,9512
IT-TO,Torino,90,94,1566,40,954,1,0,0,2655,265,650,108,4087,0,0,0,5110,7765
IT-TO,Torino,91,84,1161,26,828,0,0,0,2099,277,498,75,3601,0,0,0,4451,6550
IT-TO,Torino,92,67,872,16,723,0,0,0,1678,213,304,68,3201,0,0,0,3786,5464
IT-TO,Torino,93,46,642,9,582,0,0,0,1279,208,228,55,2724,0,0,0,3215,4494
IT-TO,Torino,94,34,409,5,405,0,0,0,853,163,127,41,2005,0,0,0,2336,3189
IT-TO,Torino,95,21,261,7,284,0,0,0,573,119,86,21,1487,0,0,0,1713,2286
IT-TO,Torino,96,17,149,1,200,0,0,0,367,93,56,19,1071,0,0,0,1239,1606
IT-TO,Torino,97,10,83,1,145,0,0,0,239,59,20,9,778,0,0,0,866,1105
IT-TO,Torino,98,5,41,0,83,0,0,0,129,51,16,11,517,0,0,0,595,724
IT-TO,Torino,99,7,23,0,59,1,0,0,90,29,6,7,378,0,0,0,420,510
IT-TO,Torino,100,9,23,2,77,0,0,0,111,57,10,7,519,0,0,0,593,704
IT-TO,Torino,999,515347,476764,46071,32415,1350,38,37,1072022,438392,485170,67490,140851,867,41,4,1132815,2204837
IT-TP,Trapani,0,1511,0,0,0,0,0,0,1511,1465,0,0,0,0,0,0,1465,2976
IT-TP,Trapani,1,1562,0,0,0,0,0,0,1562,1468,0,0,0,0,0,0,1468,3030
IT-TP,Trapani,2,1611,0,0,0,0,0,0,1611,1459,0,0,0,0,0,0,1459,3070
IT-TP,Trapani,3,1582,0,0,0,0,0,0,1582,1529,0,0,0,0,0,0,1529,3111
IT-TP,Trapani,4,1692,0,0,0,0,0,0,1692,1482,0,0,0,0,0,0,1482,3174
IT-TP,Trapani,5,1682,0,0,0,0,0,0,1682,1557,0,0,0,0,0,0,1557,3239
IT-TP,Trapani,6,1723,0,0,0,0,0,0,1723,1636,0,0,0,0,0,0,1636,3359
IT-TP,Trapani,7,1763,0,0,0,0,0,0,1763,1639,0,0,0,0,0,0,1639,3402
IT-TP,Trapani,8,1729,0,0,0,0,0,0,1729,1675,0,0,0,0,0,0,1675,3404
IT-TP,Trapani,9,1788,0,0,0,0,0,0,1788,1715,0,0,0,0,0,0,1715,3503
IT-TP,Trapani,10,1759,0,0,0,0,0,0,1759,1740,0,0,0,0,0,0,1740,3499
IT-TP,Trapani,11,1767,0,0,0,0,0,0,1767,1836,0,0,0,0,0,0,1836,3603
IT-TP,Trapani,12,1823,0,0,0,0,0,0,1823,1801,0,0,0,0,0,0,1801,3624
IT-TP,Trapani,13,1928,0,0,0,0,0,0,1928,1810,0,0,0,0,0,0,1810,3738
IT-TP,Trapani,14,2033,0,0,0,0,0,0,2033,1928,0,0,0,0,0,0,1928,3961
IT-TP,Trapani,15,2005,0,0,0,0,0,0,2005,1999,0,0,0,0,0,0,1999,4004
IT-TP,Trapani,16,2091,0,0,0,0,0,0,2091,2001,0,0,0,0,0,0,2001,4092
IT-TP,Trapani,17,2153,0,0,0,0,0,0,2153,1988,0,0,0,0,0,0,1988,4141
IT-TP,Trapani,18,2301,0,0,0,0,0,0,2301,2070,0,0,0,0,0,0,2070,4371
IT-TP,Trapani,19,2491,0,0,0,0,0,0,2491,2136,5,0,0,0,0,0,2141,4632
IT-TP,Trapani,20,2371,0,0,0,0,0,0,2371,2102,12,0,0,0,0,0,2114,4485
IT-TP,Trapani,21,2278,3,0,1,0,0,0,2282,2092,20,0,0,0,0,0,2112,4394
IT-TP,Trapani,22,2327,6,0,0,0,0,0,2333,2090,44,0,1,1,0,0,2136,4469
IT-TP,Trapani,23,2488,20,1,0,0,0,0,2509,2071,62,2,0,0,0,0,2135,4644
IT-TP,Trapani,24,2485,26,3,0,0,0,0,2514,2028,102,0,0,1,0,0,2131,4645
IT-TP,Trapani,25,2381,35,0,0,0,0,0,2416,1991,159,3,1,1,0,0,2155,4571
IT-TP,Trapani,26,2333,58,2,0,0,1,0,2394,1805,228,0,0,0,0,0,2033,4427
IT-TP,Trapani,27,2261,102,1,0,0,0,0,2364,1780,294,5,0,0,0,0,2079,4443
IT-TP,Trapani,28,2162,156,0,0,0,0,0,2318,1655,400,8,0,0,0,0,2063,4381
IT-TP,Trapani,29,2167,231,2,0,0,0,0,2400,1538,594,13,1,0,0,0,2146,4546
IT-TP,Trapani,30,1940,355,3,2,0,0,0,2300,1401,686,13,3,1,0,0,2104,4404
IT-TP,Trapani,31,1892,477,6,0,2,0,0,2377,1305,886,14,3,2,0,0,2210,4587
IT-TP,Trapani,32,1806,591,9,0,1,0,0,2407,1140,919,17,4,0,0,0,2080,4487
IT-TP,Trapani,33,1640,648,10,1,0,0,0,2299,1088,1069,19,4,0,0,0,2180,4479
IT-TP,Trapani,34,1579,841,8,0,4,0,0,2432,994,1236,36,7,1,0,0,2274,4706
IT-TP,Trapani,35,1403,932,19,0,1,0,0,2355,922,1316,43,7,2,0,0,2290,4645
IT-TP,Trapani,36,1319,934,19,3,1,0,0,2276,748,1333,37,9,2,1,0,2130,4406
IT-TP,Trapani,37,1271,1091,19,1,0,0,0,2382,680,1433,40,8,0,0,0,2161,4543
IT-TP,Trapani,38,1171,1208,32,1,1,0,0,2413,698,1467,70,9,3,0,0,2247,4660
IT-TP,Trapani,39,1072,1319,32,5,0,0,0,2428,658,1648,80,10,1,0,0,2397,4825
IT-TP,Trapani,40,1070,1337,38,2,1,0,0,2448,602,1620,95,9,1,0,0,2327,4775
IT-TP,Trapani,41,979,1445,55,4,2,0,0,2485,550,1775,105,20,0,0,0,2450,4935
IT-TP,Trapani,42,954,1495,61,1,0,1,0,2512,497,1800,113,27,3,0,0,2440,4952
IT-TP,Trapani,43,902,1649,63,8,3,0,0,2625,507,1969,117,32,0,0,0,2625,5250
IT-TP,Trapani,44,848,1686,93,8,1,0,0,2636,465,2054,118,32,2,0,0,2671,5307
IT-TP,Trapani,45,892,1786,98,7,1,0,0,2784,422,2031,149,33,2,0,0,2637,5421
IT-TP,Trapani,46,789,1823,89,7,4,0,0,2712,429,2199,159,34,1,0,0,2822,5534
IT-TP,Trapani,47,778,2016,126,7,1,0,0,2928,414,2299,145,41,2,0,0,2901,5829
IT-TP,Trapani,48,800,2200,135,8,3,0,0,3146,422,2369,190,40,2,0,0,3023,6169
IT-TP,Trapani,49,748,2242,173,13,3,0,0,3179,416,2541,178,61,0,0,0,3196,6375
IT-TP,Trapani,50,682,2318,126,19,2,0,0,3147,376,2544,181,80,0,0,0,3181,6328
IT-TP,Trapani,51,613,2260,139,20,2,0,0,3034,345,2510,204,76,0,0,0,3135,6169
IT-TP,Trapani,52,586,2328,144,23,0,0,0,3081,342,2708,211,73,0,0,0,3334,6415
IT-TP,Trapani,53,560,2369,183,23,3,0,1,3139,357,2684,207,106,3,0,0,3357,6496
IT-TP,Trapani,54,547,2613,181,22,0,0,0,3363,350,2745,223,139,1,0,0,3458,6821
IT-TP,Trapani,55,445,2536,156,32,1,0,0,3170,295,2660,213,137,1,0,0,3306,6476
IT-TP,Trapani,56,459,2557,154,33,2,0,0,3205,273,2620,195,159,0,0,0,3247,6452
IT-TP,Trapani,57,389,2527,132,37,4,0,0,3089,319,2563,189,170,0,0,0,3241,6330
IT-TP,Trapani,58,334,2398,165,30,3,0,0,2930,298,2534,202,189,0,0,0,3223,6153
IT-TP,Trapani,59,339,2639,177,61,3,0,0,3219,285,2682,202,223,1,0,0,3393,6612
IT-TP,Trapani,60,284,2546,142,57,1,0,1,3031,277,2543,166,239,0,0,0,3225,6256
IT-TP,Trapani,61,306,2484,154,42,1,0,0,2987,274,2521,146,274,0,0,1,3216,6203
IT-TP,Trapani,62,268,2330,138,56,0,0,0,2792,243,2389,138,295,0,0,0,3065,5857
IT-TP,Trapani,63,257,2413,134,53,0,0,0,2857,237,2333,122,336,0,0,0,3028,5885
IT-TP,Trapani,64,204,2249,96,65,0,0,0,2614,198,2142,113,344,1,0,0,2798,5412
IT-TP,Trapani,65,200,2298,97,69,0,0,0,2664,197,2071,104,395,0,0,0,2767,5431
IT-TP,Trapani,66,187,2162,110,80,1,0,0,2540,212,2042,113,383,0,0,0,2750,5290
IT-TP,Trapani,67,183,2196,107,87,1,0,0,2574,212,2026,106,451,0,0,0,2795,5369
IT-TP,Trapani,68,190,2214,89,80,0,0,0,2573,191,1914,92,514,0,0,0,2711,5284
IT-TP,Trapani,69,160,2164,73,111,1,0,0,2509,185,1868,78,560,0,0,0,2691,5200
IT-TP,Trapani,70,133,1841,72,123,0,0,0,2169,170,1582,99,537,0,0,0,2388,4557
IT-TP,Trapani,71,145,1908,85,118,1,0,0,2257,159,1623,80,598,0,0,0,2460,4717
IT-TP,Trapani,72,140,1946,77,111,0,0,0,2274,151,1582,67,636,0,0,0,2436,4710
IT-TP,Trapani,73,118,1901,49,145,0,0,0,2213,170,1532,79,701,0,0,0,2482,4695
IT-TP,Trapani,74,95,1916,47,137,0,0,0,2195,148,1571,56,883,0,0,0,2658,4853
IT-TP,Trapani,75,88,1948,46,135,0,0,0,2217,162,1508,51,865,0,0,0,2586,4803
IT-TP,Trapani,76,84,1852,39,149,0,0,0,2124,133,1304,41,1017,0,0,0,2495,4619
IT-TP,Trapani,77,81,1655,40,186,0,0,0,1962,131,1198,40,1003,0,0,0,2372,4334
IT-TP,Trapani,78,59,1351,37,170,0,0,0,1617,106,903,32,842,0,0,0,1883,3500
IT-TP,Trapani,79,62,1287,28,165,0,0,0,1542,105,820,32,929,0,0,0,1886,3428
IT-TP,Trapani,80,46,1255,26,192,0,0,0,1519,97,770,29,1024,0,0,0,1920,3439
IT-TP,Trapani,81,47,1149,26,209,0,0,0,1431,88,646,23,1059,0,0,0,1816,3247
IT-TP,Trapani,82,43,988,14,190,0,0,0,1235,86,553,25,949,0,0,0,1613,2848
IT-TP,Trapani,83,54,1136,15,226,0,0,0,1431,87,509,28,1224,0,0,0,1848,3279
IT-TP,Trapani,84,27,985,18,228,0,0,0,1258,86,431,19,1209,0,0,0,1745,3003
IT-TP,Trapani,85,24,823,9,200,0,0,0,1056,90,294,15,1071,0,0,0,1470,2526
IT-TP,Trapani,86,30,645,10,185,0,0,0,870,88,255,14,949,0,0,0,1306,2176
IT-TP,Trapani,87,23,546,9,184,0,0,0,762,74,188,10,887,0,0,0,1159,1921
IT-TP,Trapani,88,17,415,6,207,0,0,0,645,72,158,8,819,0,0,0,1057,1702
IT-TP,Trapani,89,14,407,3,164,0,0,0,588,51,98,13,751,0,0,0,913,1501
IT-TP,Trapani,90,12,308,3,154,0,0,0,477,48,73,7,648,0,0,0,776,1253
IT-TP,Trapani,91,7,199,3,118,0,0,0,327,39,60,4,520,0,0,0,623,950
IT-TP,Trapani,92,7,142,1,107,0,0,0,257,34,30,6,469,0,0,0,539,796
IT-TP,Trapani,93,6,129,2,100,0,0,0,237,27,29,4,459,0,0,0,519,756
IT-TP,Trapani,94,2,73,0,65,0,0,0,140,27,15,3,330,0,0,0,375,515
IT-TP,Trapani,95,4,36,0,53,0,0,0,93,19,12,1,229,0,0,0,261,354
IT-TP,Trapani,96,1,20,1,26,0,0,0,48,15,6,1,169,0,0,0,191,239
IT-TP,Trapani,97,2,15,0,27,0,0,0,44,11,7,2,132,0,0,0,152,196
IT-TP,Trapani,98,0,6,0,16,0,0,0,22,11,3,0,85,0,0,0,99,121
IT-TP,Trapani,99,0,4,0,10,0,0,0,14,9,4,0,73,0,0,0,86,100
IT-TP,Trapani,100,4,8,0,12,0,0,0,24,9,3,2,104,0,0,0,118,142
IT-TP,Trapani,999,92668,101207,4460,5191,55,2,2,203585,76413,100436,5765,26710,35,1,1,209361,412946
IT-TN,Trento,0,1984,0,0,0,0,0,0,1984,1817,0,0,0,0,0,0,1817,3801
IT-TN,Trento,1,2158,0,0,0,0,0,0,2158,1880,0,0,0,0,0,0,1880,4038
IT-TN,Trento,2,2174,0,0,0,0,0,0,2174,2070,0,0,0,0,0,0,2070,4244
IT-TN,Trento,3,2164,0,0,0,0,0,0,2164,1992,0,0,0,0,0,0,1992,4156
IT-TN,Trento,4,2289,0,0,0,0,0,0,2289,2047,0,0,0,0,0,0,2047,4336
IT-TN,Trento,5,2242,0,0,0,0,0,0,2242,2197,0,0,0,0,0,0,2197,4439
IT-TN,Trento,6,2400,0,0,0,0,0,0,2400,2259,0,0,0,0,0,0,2259,4659
IT-TN,Trento,7,2479,0,0,0,0,0,0,2479,2356,0,0,0,0,0,0,2356,4835
IT-TN,Trento,8,2541,0,0,0,0,0,0,2541,2371,0,0,0,0,0,0,2371,4912
IT-TN,Trento,9,2603,0,0,0,0,0,0,2603,2432,0,0,0,0,0,0,2432,5035
IT-TN,Trento,10,2713,0,0,0,0,0,0,2713,2554,0,0,0,0,0,0,2554,5267
IT-TN,Trento,11,2778,0,0,0,0,0,0,2778,2590,0,0,0,0,0,0,2590,5368
IT-TN,Trento,12,2774,0,0,0,0,0,0,2774,2683,0,0,0,0,0,0,2683,5457
IT-TN,Trento,13,2916,0,0,0,0,0,0,2916,2738,0,0,0,0,0,0,2738,5654
IT-TN,Trento,14,2894,0,0,0,0,0,0,2894,2727,0,0,0,0,0,0,2727,5621
IT-TN,Trento,15,2908,0,0,0,0,0,0,2908,2768,0,0,0,0,0,0,2768,5676
IT-TN,Trento,16,2819,0,0,0,0,0,0,2819,2700,0,0,0,0,0,0,2700,5519
IT-TN,Trento,17,2926,0,0,0,0,0,0,2926,2669,0,0,0,0,0,0,2669,5595
IT-TN,Trento,18,3025,0,0,0,0,0,0,3025,2669,2,0,0,0,0,0,2671,5696
IT-TN,Trento,19,3045,0,0,0,0,0,0,3045,2789,7,0,0,0,0,0,2796,5841
IT-TN,Trento,20,2942,1,0,0,0,0,0,2943,2685,12,0,0,0,0,0,2697,5640
IT-TN,Trento,21,2959,6,0,0,0,0,0,2965,2656,27,0,0,0,0,0,2683,5648
IT-TN,Trento,22,3030,14,1,0,0,0,0,3045,2636,63,0,0,0,0,0,2699,5744
IT-TN,Trento,23,3047,21,3,0,0,0,0,3071,2764,114,4,0,1,0,0,2883,5954
IT-TN,Trento,24,3025,38,2,0,0,0,0,3065,2667,134,1,0,0,0,0,2802,5867
IT-TN,Trento,25,3077,56,2,0,0,0,0,3135,2687,210,9,0,0,0,0,2906,6041
IT-TN,Trento,26,2980,100,2,0,0,0,0,3082,2526,272,7,0,0,0,0,2805,5887
IT-TN,Trento,27,2970,182,2,0,3,0,0,3157,2448,369,7,0,0,0,0,2824,5981
IT-TN,Trento,28,2832,253,2,0,1,0,0,3088,2334,516,15,0,1,0,0,2866,5954
IT-TN,Trento,29,2796,286,12,0,5,0,0,3099,2193,635,12,0,1,0,0,2841,5940
IT-TN,Trento,30,2719,429,10,1,3,0,0,3162,2112,773,16,2,3,0,0,2906,6068
IT-TN,Trento,31,2683,541,11,0,2,0,0,3237,2037,940,30,1,7,0,0,3015,6252
IT-TN,Trento,32,2494,656,21,1,6,0,0,3178,1838,1040,37,4,4,1,0,2924,6102
IT-TN,Trento,33,2456,726,18,2,6,0,0,3208,1722,1187,51,6,6,0,0,2972,6180
IT-TN,Trento,34,2132,853,46,1,5,0,0,3037,1610,1287,47,3,5,1,0,2953,5990
IT-TN,Trento,35,2101,1004,31,2,8,0,1,3147,1543,1427,67,5,6,0,0,3048,6195
IT-TN,Trento,36,1870,1141,31,3,5,1,0,3051,1455,1452,79,9,5,0,0,3000,6051
IT-TN,Trento,37,1784,1199,56,0,9,0,0,3048,1284,1549,100,15,7,0,0,2955,6003
IT-TN,Trento,38,1814,1222,57,2,8,0,0,3103,1268,1647,121,11,4,1,0,3052,6155
IT-TN,Trento,39,1671,1425,66,3,6,0,0,3171,1157,1749,135,11,4,1,0,3057,6228
IT-TN,Trento,40,1607,1508,92,3,7,0,0,3217,1174,1807,137,15,2,0,0,3135,6352
IT-TN,Trento,41,1499,1667,84,5,5,1,0,3261,1067,1919,163,19,1,0,0,3169,6430
IT-TN,Trento,42,1388,1700,100,10,5,0,0,3203,1020,1873,181,17,2,0,0,3093,6296
IT-TN,Trento,43,1378,1715,116,8,5,1,0,3223,982,2051,199,27,5,1,0,3265,6488
IT-TN,Trento,44,1352,1795,114,6,5,0,0,3272,898,2181,241,28,1,0,0,3349,6621
IT-TN,Trento,45,1423,1991,139,8,4,0,0,3565,1017,2319,251,43,2,0,0,3632,7197
IT-TN,Trento,46,1357,2118,189,6,6,0,0,3676,961,2362,287,51,3,0,0,3664,7340
IT-TN,Trento,47,1335,2225,193,16,4,1,0,3774,958,2551,330,46,1,1,0,3887,7661
IT-TN,Trento,48,1338,2296,203,9,7,1,0,3854,932,2765,340,60,2,0,0,4099,7953
IT-TN,Trento,49,1376,2567,258,13,12,0,0,4226,913,2853,351,73,2,0,0,4192,8418
IT-TN,Trento,50,1240,2538,307,20,7,0,0,4112,831,2896,418,80,4,1,0,4230,8342
IT-TN,Trento,51,1173,2629,278,22,7,0,0,4109,784,2866,397,77,1,0,0,4125,8234
IT-TN,Trento,52,1196,2690,314,25,5,0,0,4230,746,3040,455,120,1,1,0,4363,8593
IT-TN,Trento,53,1016,2701,344,20,7,0,0,4088,765,2875,433,104,2,0,0,4179,8267
IT-TN,Trento,54,1068,2937,338,34,5,0,0,4382,801,2961,475,125,2,1,0,4365,8747
IT-TN,Trento,55,1023,2961,335,30,12,0,0,4361,664,2988,497,134,2,0,0,4285,8646
IT-TN,Trento,56,962,2911,406,33,3,0,1,4316,687,3124,493,144,5,0,0,4453,8769
IT-TN,Trento,57,988,2994,376,19,4,0,0,4381,634,3164,492,173,1,0,0,4464,8845
IT-TN,Trento,58,918,3133,422,43,3,0,0,4519,625,3152,474,197,1,0,0,4449,8968
IT-TN,Trento,59,804,3147,411,65,8,0,1,4436,553,3204,514,237,1,0,0,4509,8945
IT-TN,Trento,60,721,3000,393,56,7,0,0,4177,523,3008,427,254,2,0,0,4214,8391
IT-TN,Trento,61,623,2798,367,69,6,0,0,3863,468,2845,400,281,0,0,0,3994,7857
IT-TN,Trento,62,595,2899,341,85,3,0,0,3923,481,2839,438,315,3,0,0,4076,7999
IT-TN,Trento,63,580,2778,351,72,4,0,1,3786,419,2756,356,317,3,0,0,3851,7637
IT-TN,Trento,64,494,2788,300,69,3,0,0,3654,365,2728,316,359,1,0,0,3769,7423
IT-TN,Trento,65,468,2555,269,88,1,0,0,3381,376,2489,292,408,1,0,0,3566,6947
IT-TN,Trento,66,423,2570,248,88,1,0,0,3330,324,2491,309,410,3,0,0,3537,6867
IT-TN,Trento,67,437,2574,233,106,3,0,0,3353,289,2367,264,479,0,0,1,3400,6753
IT-TN,Trento,68,397,2443,221,100,2,0,0,3163,312,2315,247,428,2,0,0,3304,6467
IT-TN,Trento,69,374,2383,193,112,2,0,0,3064,266,2154,226,546,1,0,0,3193,6257
IT-TN,Trento,70,367,2318,186,109,1,0,0,2981,291,2065,210,544,0,0,0,3110,6091
IT-TN,Trento,71,297,2306,176,141,0,0,0,2920,240,1981,180,654,0,0,0,3055,5975
IT-TN,Trento,72,324,2208,156,130,2,0,0,2820,225,1894,176,666,0,0,0,2961,5781
IT-TN,Trento,73,298,2279,147,140,2,0,0,2866,225,1953,169,763,1,0,0,3111,5977
IT-TN,Trento,74,275,2149,126,190,1,0,0,2741,207,1721,160,764,0,0,0,2852,5593
IT-TN,Trento,75,271,2138,123,209,0,0,0,2741,185,1712,142,850,1,0,0,2890,5631
IT-TN,Trento,76,252,1997,109,198,2,0,0,2558,204,1652,127,926,0,0,0,2909,5467
IT-TN,Trento,77,231,2104,82,206,0,0,0,2623,222,1705,120,1060,0,0,0,3107,5730
IT-TN,Trento,78,134,1407,78,198,0,0,0,1817,136,1080,84,815,0,0,0,2115,3932
IT-TN,Trento,79,144,1562,60,195,0,0,0,1961,175,1122,71,986,1,0,0,2355,4316
IT-TN,Trento,80,186,1429,49,220,1,0,0,1885,186,1114,64,1069,0,0,0,2433,4318
IT-TN,Trento,81,157,1408,68,227,0,0,0,1860,167,944,61,1155,0,0,0,2327,4187
IT-TN,Trento,82,151,1253,54,241,0,0,0,1699,168,890,55,1209,0,0,0,2322,4021
IT-TN,Trento,83,156,1177,35,255,0,0,0,1623,182,767,59,1312,0,0,0,2320,3943
IT-TN,Trento,84,138,1076,30,251,0,0,0,1495,185,619,46,1284,0,0,0,2134,3629
IT-TN,Trento,85,110,938,24,239,0,0,0,1311,195,531,34,1214,0,0,0,1974,3285
IT-TN,Trento,86,84,779,21,212,0,0,0,1096,150,387,27,1133,0,0,0,1697,2793
IT-TN,Trento,87,77,661,16,208,0,0,0,962,125,322,25,1062,0,0,0,1534,2496
IT-TN,Trento,88,76,547,11,177,0,0,0,811,135,216,21,1094,0,0,0,1466,2277
IT-TN,Trento,89,56,403,9,158,0,0,0,626,120,143,23,1032,0,0,0,1318,1944
IT-TN,Trento,90,41,306,7,155,0,0,0,509,104,113,13,905,0,0,0,1135,1644
IT-TN,Trento,91,34,253,9,144,0,0,0,440,93,93,9,779,0,0,0,974,1414
IT-TN,Trento,92,24,205,5,117,0,0,0,351,79,60,7,695,0,0,0,841,1192
IT-TN,Trento,93,18,153,4,97,0,0,0,272,87,51,5,649,0,0,0,792,1064
IT-TN,Trento,94,19,99,2,70,0,0,0,190,74,26,5,493,0,0,0,598,788
IT-TN,Trento,95,15,64,0,71,0,0,0,150,45,22,4,383,0,0,0,454,604
IT-TN,Trento,96,11,44,0,42,0,0,0,97,46,10,5,269,0,0,0,330,427
IT-TN,Trento,97,6,26,0,29,0,0,0,61,39,3,2,212,0,0,0,256,317
IT-TN,Trento,98,2,11,0,14,0,0,0,27,29,2,2,143,0,0,0,176,203
IT-TN,Trento,99,2,7,0,17,0,0,0,26,19,2,0,98,0,0,0,119,145
IT-TN,Trento,100,3,8,0,24,0,0,0,35,25,2,1,183,0,0,0,211,246
IT-TN,Trento,999,136726,116479,9895,5939,229,5,4,269277,115128,117557,13048,30035,114,9,1,275892,545169
IT-TV,Treviso,0,2926,0,0,0,0,0,0,2926,2822,0,0,0,0,0,0,2822,5748
IT-TV,Treviso,1,3137,0,0,0,0,0,0,3137,2904,0,0,0,0,0,0,2904,6041
IT-TV,Treviso,2,3192,0,0,0,0,0,0,3192,2961,0,0,0,0,0,0,2961,6153
IT-TV,Treviso,3,3299,0,0,0,0,0,0,3299,3044,0,0,0,0,0,0,3044,6343
IT-TV,Treviso,4,3292,0,0,0,0,0,0,3292,3095,0,0,0,0,0,0,3095,6387
IT-TV,Treviso,5,3513,0,0,0,0,0,0,3513,3242,0,0,0,0,0,0,3242,6755
IT-TV,Treviso,6,3706,0,0,0,0,0,0,3706,3450,0,0,0,0,0,0,3450,7156
IT-TV,Treviso,7,3797,0,0,0,0,0,0,3797,3557,0,0,0,0,0,0,3557,7354
IT-TV,Treviso,8,3907,0,0,0,0,0,0,3907,3654,0,0,0,0,0,0,3654,7561
IT-TV,Treviso,9,3994,0,0,0,0,0,0,3994,3909,0,0,0,0,0,0,3909,7903
IT-TV,Treviso,10,4144,0,0,0,0,0,0,4144,3971,0,0,0,0,0,0,3971,8115
IT-TV,Treviso,11,4342,0,0,0,0,0,0,4342,4123,0,0,0,0,0,0,4123,8465
IT-TV,Treviso,12,4354,0,0,0,0,0,0,4354,4131,0,0,0,0,0,0,4131,8485
IT-TV,Treviso,13,4602,0,0,0,0,0,0,4602,4182,0,0,0,0,0,0,4182,8784
IT-TV,Treviso,14,4601,0,0,0,0,0,0,4601,4303,0,0,0,0,0,0,4303,8904
IT-TV,Treviso,15,4608,0,0,0,0,0,0,4608,4568,0,0,0,0,0,0,4568,9176
IT-TV,Treviso,16,4727,0,0,0,0,0,0,4727,4463,0,0,0,0,0,0,4463,9190
IT-TV,Treviso,17,4769,0,0,0,0,0,0,4769,4501,0,0,0,0,0,0,4501,9270
IT-TV,Treviso,18,4744,0,0,0,0,0,0,4744,4457,4,0,0,0,0,0,4461,9205
IT-TV,Treviso,19,4898,2,0,0,0,0,0,4900,4308,23,0,0,0,0,0,4331,9231
IT-TV,Treviso,20,4747,0,0,0,0,0,0,4747,4393,55,0,0,0,0,0,4448,9195
IT-TV,Treviso,21,4818,10,0,0,0,0,0,4828,4203,97,0,0,1,0,0,4301,9129
IT-TV,Treviso,22,4701,24,2,0,0,0,0,4727,4036,145,2,0,0,0,0,4183,8910
IT-TV,Treviso,23,4937,53,3,0,0,0,0,4993,4280,201,9,0,0,0,0,4490,9483
IT-TV,Treviso,24,4642,76,2,0,0,0,0,4720,4020,315,7,0,0,0,0,4342,9062
IT-TV,Treviso,25,4818,141,4,1,0,0,0,4964,3894,389,7,1,2,0,0,4293,9257
IT-TV,Treviso,26,4541,207,8,1,1,0,0,4758,3784,501,7,1,0,0,0,4293,9051
IT-TV,Treviso,27,4509,295,10,1,1,0,0,4816,3631,622,13,1,2,0,0,4269,9085
IT-TV,Treviso,28,4208,421,14,0,3,0,0,4646,3189,841,12,2,0,1,0,4045,8691
IT-TV,Treviso,29,4170,539,6,0,4,0,0,4719,3237,981,31,2,4,0,0,4255,8974
IT-TV,Treviso,30,3864,713,14,0,1,0,0,4592,2937,1271,28,3,2,0,0,4241,8833
IT-TV,Treviso,31,3818,869,20,1,0,1,0,4709,2886,1496,38,6,1,0,0,4427,9136
IT-TV,Treviso,32,3530,1117,32,6,4,0,0,4689,2727,1718,51,3,1,0,0,4500,9189
IT-TV,Treviso,33,3462,1319,34,4,4,0,0,4823,2469,1887,64,4,3,0,0,4427,9250
IT-TV,Treviso,34,3101,1488,40,1,4,0,0,4634,2326,2128,88,2,10,1,0,4555,9189
IT-TV,Treviso,35,3070,1676,52,3,5,0,0,4806,2246,2308,81,8,1,2,0,4646,9452
IT-TV,Treviso,36,2670,1800,50,10,3,0,0,4533,2056,2359,100,8,3,1,0,4527,9060
IT-TV,Treviso,37,2618,1855,66,4,9,0,0,4552,1899,2512,133,21,3,0,0,4568,9120
IT-TV,Treviso,38,2594,2123,78,7,7,1,0,4810,1890,2767,141,26,6,0,1,4831,9641
IT-TV,Treviso,39,2434,2283,99,2,4,0,0,4822,1794,2764,185,23,5,0,0,4771,9593
IT-TV,Treviso,40,2411,2371,96,7,14,0,0,4899,1706,3011,208,28,3,0,0,4956,9855
IT-TV,Treviso,41,2435,2619,132,7,7,1,0,5201,1706,3188,237,32,3,0,0,5166,10367
IT-TV,Treviso,42,2265,2710,173,11,9,0,0,5168,1639,3187,290,46,2,1,0,5165,10333
IT-TV,Treviso,43,2260,2995,190,10,10,0,0,5465,1567,3345,313,39,4,0,0,5268,10733
IT-TV,Treviso,44,2301,2973,188,24,2,0,0,5488,1519,3585,326,58,3,0,0,5491,10979
IT-TV,Treviso,45,2413,3329,255,20,4,0,0,6021,1740,3819,401,70,2,1,0,6033,12054
IT-TV,Treviso,46,2310,3550,243,13,7,1,0,6124,1636,4009,455,87,2,0,0,6189,12313
IT-TV,Treviso,47,2434,3615,320,21,15,0,0,6405,1608,4238,487,95,3,0,0,6431,12836
IT-TV,Treviso,48,2338,4043,366,26,8,0,0,6781,1628,4476,555,113,11,0,0,6783,13564
IT-TV,Treviso,49,2450,4373,429,34,3,0,0,7289,1747,4849,588,140,5,0,0,7329,14618
IT-TV,Treviso,50,2290,4491,446,33,9,0,0,7269,1509,4897,601,111,6,0,0,7124,14393
IT-TV,Treviso,51,2181,4608,465,33,6,0,0,7293,1578,4774,642,141,4,0,0,7139,14432
IT-TV,Treviso,52,2186,4680,470,30,7,1,0,7374,1409,5221,705,172,4,1,0,7512,14886
IT-TV,Treviso,53,2002,4854,529,46,11,0,0,7442,1294,5212,695,183,5,0,0,7389,14831
IT-TV,Treviso,54,1823,5120,579,50,14,0,0,7586,1256,5324,738,213,5,0,0,7536,15122
IT-TV,Treviso,55,1753,4983,531,63,7,0,1,7338,1175,5251,738,200,3,0,0,7367,14705
IT-TV,Treviso,56,1611,5220,563,70,2,0,1,7467,1132,5362,752,277,1,0,0,7524,14991
IT-TV,Treviso,57,1563,5349,615,92,8,0,0,7627,1044,5358,738,288,5,0,0,7433,15060
IT-TV,Treviso,58,1378,5429,624,106,11,0,0,7548,1025,5407,733,333,1,0,0,7499,15047
IT-TV,Treviso,59,1290,5499,606,106,8,1,0,7510,947,5441,695,315,1,0,0,7399,14909
IT-TV,Treviso,60,1117,5139,562,92,5,0,0,6915,836,5123,642,390,4,0,0,6995,13910
IT-TV,Treviso,61,964,5025,528,105,8,0,0,6630,752,4837,588,435,1,0,0,6613,13243
IT-TV,Treviso,62,939,4894,502,111,4,0,0,6450,688,4850,572,489,2,0,0,6601,13051
IT-TV,Treviso,63,784,4706,485,161,5,0,0,6141,607,4551,505,531,1,1,0,6196,12337
IT-TV,Treviso,64,733,4622,433,145,5,0,0,5938,573,4600,429,566,0,0,0,6168,12106
IT-TV,Treviso,65,668,4327,380,133,7,0,0,5515,456,4410,420,543,3,0,0,5832,11347
IT-TV,Treviso,66,592,4259,350,135,5,0,0,5341,462,4006,393,643,3,0,0,5507,10848
IT-TV,Treviso,67,556,4203,293,168,5,0,0,5225,397,3887,398,743,2,0,0,5427,10652
IT-TV,Treviso,68,463,4114,306,204,2,0,0,5089,376,3871,326,805,0,1,0,5379,10468
IT-TV,Treviso,69,478,3949,264,228,2,0,0,4921,370,3706,325,809,1,0,0,5211,10132
IT-TV,Treviso,70,402,3855,240,211,4,0,0,4712,331,3623,293,856,2,0,0,5105,9817
IT-TV,Treviso,71,394,3615,190,240,3,0,0,4442,319,3372,234,981,1,0,0,4907,9349
IT-TV,Treviso,72,366,3573,217,245,4,0,0,4405,273,3236,244,991,0,0,0,4744,9149
IT-TV,Treviso,73,374,3717,175,276,2,0,0,4544,268,3342,229,1113,2,0,0,4954,9498
IT-TV,Treviso,74,322,3598,160,270,1,0,0,4351,256,3033,208,1199,0,0,0,4696,9047
IT-TV,Treviso,75,323,3595,166,345,4,0,0,4433,242,3069,198,1366,0,0,0,4875,9308
IT-TV,Treviso,76,284,3392,136,346,6,0,0,4164,258,2877,196,1515,0,0,0,4846,9010
IT-TV,Treviso,77,313,3588,135,382,2,0,0,4420,266,3053,149,1801,0,0,0,5269,9689
IT-TV,Treviso,78,196,2409,90,291,0,0,0,2986,175,1981,118,1361,0,0,0,3635,6621
IT-TV,Treviso,79,209,2711,88,366,3,0,0,3377,200,2012,115,1685,0,0,0,4012,7389
IT-TV,Treviso,80,220,2575,77,377,0,0,2,3251,186,1874,115,1862,0,0,0,4037,7288
IT-TV,Treviso,81,179,2297,61,376,1,0,0,2914,195,1662,92,1858,0,0,0,3807,6721
IT-TV,Treviso,82,200,2217,50,385,1,0,0,2853,191,1454,79,1959,0,0,0,3683,6536
IT-TV,Treviso,83,174,2181,39,467,1,0,0,2862,190,1372,84,2202,0,0,0,3848,6710
IT-TV,Treviso,84,144,1990,37,444,0,0,0,2615,192,1142,61,2182,0,0,0,3577,6192
IT-TV,Treviso,85,142,1639,35,447,1,0,0,2264,155,853,52,2160,0,0,0,3220,5484
IT-TV,Treviso,86,93,1300,21,434,0,0,0,1848,159,608,46,2090,0,0,0,2903,4751
IT-TV,Treviso,87,85,1110,21,363,0,0,0,1579,160,473,27,1855,0,0,0,2515,4094
IT-TV,Treviso,88,87,964,15,342,0,0,0,1408,123,341,31,1820,0,0,0,2315,3723
IT-TV,Treviso,89,63,748,19,310,0,0,0,1140,135,267,16,1668,0,0,0,2086,3226
IT-TV,Treviso,90,44,509,9,247,0,0,0,809,119,156,19,1427,0,0,0,1721,2530
IT-TV,Treviso,91,38,391,10,243,0,0,0,682,107,115,11,1259,0,0,0,1492,2174
IT-TV,Treviso,92,23,274,2,237,0,0,0,536,75,91,9,1114,0,0,0,1289,1825
IT-TV,Treviso,93,23,203,6,158,0,0,0,390,90,59,10,1018,0,0,0,1177,1567
IT-TV,Treviso,94,12,143,3,141,0,0,0,299,54,27,9,710,0,0,0,800,1099
IT-TV,Treviso,95,11,85,1,89,0,0,0,186,55,24,2,634,0,0,0,715,901
IT-TV,Treviso,96,5,65,3,74,0,0,0,147,47,13,2,498,0,0,0,560,707
IT-TV,Treviso,97,5,32,3,50,0,0,0,90,24,12,4,353,0,0,0,393,483
IT-TV,Treviso,98,5,19,1,33,0,0,0,58,18,6,0,244,0,0,0,268,326
IT-TV,Treviso,99,2,11,0,30,0,0,0,43,18,4,3,142,0,0,0,167,210
IT-TV,Treviso,100,0,12,1,30,0,0,0,43,25,3,1,244,0,0,0,273,316
IT-TV,Treviso,999,211530,197878,14468,10574,293,6,4,434753,176830,199333,19149,49173,139,10,1,444635,879388
IT-TS,Trieste,0,658,0,0,0,0,0,0,658,619,0,0,0,0,0,0,619,1277
IT-TS,Trieste,1,716,0,0,0,0,0,0,716,666,0,0,0,0,0,0,666,1382
IT-TS,Trieste,2,687,0,0,0,0,0,0,687,693,0,0,0,0,0,0,693,1380
IT-TS,Trieste,3,699,0,0,0,0,0,0,699,690,0,0,0,0,0,0,690,1389
IT-TS,Trieste,4,746,0,0,0,0,0,0,746,649,0,0,0,0,0,0,649,1395
IT-TS,Trieste,5,767,0,0,0,0,0,0,767,739,0,0,0,0,0,0,739,1506
IT-TS,Trieste,6,801,0,0,0,0,0,0,801,765,0,0,0,0,0,0,765,1566
IT-TS,Trieste,7,821,0,0,0,0,0,0,821,763,0,0,0,0,0,0,763,1584
IT-TS,Trieste,8,824,0,0,0,0,0,0,824,729,0,0,0,0,0,0,729,1553
IT-TS,Trieste,9,863,0,0,0,0,0,0,863,817,0,0,0,0,0,0,817,1680
IT-TS,Trieste,10,867,0,0,0,0,0,0,867,794,0,0,0,0,0,0,794,1661
IT-TS,Trieste,11,917,0,0,0,0,0,0,917,897,0,0,0,0,0,0,897,1814
IT-TS,Trieste,12,974,0,0,0,0,0,0,974,850,0,0,0,0,0,0,850,1824
IT-TS,Trieste,13,983,0,0,0,0,0,0,983,931,0,0,0,0,0,0,931,1914
IT-TS,Trieste,14,967,0,0,0,0,0,0,967,916,0,0,0,0,0,0,916,1883
IT-TS,Trieste,15,1028,0,0,0,0,0,0,1028,898,0,0,0,0,0,0,898,1926
IT-TS,Trieste,16,1000,0,0,0,0,0,0,1000,969,0,0,0,0,0,0,969,1969
IT-TS,Trieste,17,963,0,0,0,0,0,0,963,970,0,0,0,0,0,0,970,1933
IT-TS,Trieste,18,1071,0,0,0,0,0,0,1071,876,1,0,0,0,0,0,877,1948
IT-TS,Trieste,19,1113,1,0,0,0,0,0,1114,953,2,0,0,0,0,0,955,2069
IT-TS,Trieste,20,1069,1,0,0,0,0,0,1070,918,8,0,0,0,0,0,926,1996
IT-TS,Trieste,21,1070,1,0,0,0,0,0,1071,901,16,0,0,0,0,0,917,1988
IT-TS,Trieste,22,1090,11,0,0,0,0,0,1101,931,21,0,0,0,0,0,952,2053
IT-TS,Trieste,23,1134,5,1,0,1,0,0,1141,975,27,0,0,0,0,0,1002,2143
IT-TS,Trieste,24,1114,13,0,0,0,0,0,1127,949,42,1,0,0,0,0,992,2119
IT-TS,Trieste,25,1125,28,0,0,0,0,0,1153,928,59,3,0,0,0,0,990,2143
IT-TS,Trieste,26,1215,47,1,0,0,0,0,1263,907,80,0,0,0,0,0,987,2250
IT-TS,Trieste,27,1178,56,2,0,1,0,0,1237,958,138,6,1,2,0,0,1105,2342
IT-TS,Trieste,28,1103,79,4,0,0,0,0,1186,890,135,10,0,1,0,0,1036,2222
IT-TS,Trieste,29,1072,101,4,0,1,0,0,1178,875,209,4,1,0,0,0,1089,2267
IT-TS,Trieste,30,1097,164,2,0,1,0,0,1264,832,248,8,0,1,0,0,1089,2353
IT-TS,Trieste,31,1099,199,7,0,1,0,0,1306,824,328,15,1,0,0,0,1168,2474
IT-TS,Trieste,32,1052,267,10,0,3,0,0,1332,776,371,24,2,3,0,0,1176,2508
IT-TS,Trieste,33,1002,273,12,2,4,0,0,1293,770,416,27,3,1,0,0,1217,2510
IT-TS,Trieste,34,941,346,20,0,1,0,0,1308,666,461,31,1,2,0,0,1161,2469
IT-TS,Trieste,35,913,384,23,0,4,0,0,1324,680,496,33,4,4,0,0,1217,2541
IT-TS,Trieste,36,805,412,28,2,5,0,0,1252,625,504,51,1,1,0,0,1182,2434
IT-TS,Trieste,37,785,454,23,1,1,0,0,1264,536,557,51,3,2,0,0,1149,2413
IT-TS,Trieste,38,698,508,28,4,0,0,0,1238,552,587,55,6,3,0,0,1203,2441
IT-TS,Trieste,39,702,492,43,2,4,0,0,1243,491,656,67,4,1,0,0,1219,2462
IT-TS,Trieste,40,643,531,34,2,4,0,0,1214,458,580,62,7,3,0,0,1110,2324
IT-TS,Trieste,41,624,547,40,1,3,0,0,1215,487,623,64,7,4,0,0,1185,2400
IT-TS,Trieste,42,568,562,52,7,1,0,0,1190,423,620,75,13,3,0,0,1134,2324
IT-TS,Trieste,43,591,594,43,5,6,0,0,1239,470,656,94,16,1,0,0,1237,2476
IT-TS,Trieste,44,572,566,54,4,4,0,0,1200,441,673,102,13,2,0,0,1231,2431
IT-TS,Trieste,45,645,664,71,2,0,0,0,1382,493,735,127,28,2,1,0,1386,2768
IT-TS,Trieste,46,635,730,84,2,3,0,0,1454,466,831,135,24,3,0,0,1459,2913
IT-TS,Trieste,47,639,790,98,11,7,0,0,1545,513,956,167,27,3,0,0,1666,3211
IT-TS,Trieste,48,629,833,112,9,6,0,0,1589,515,1008,180,29,1,0,0,1733,3322
IT-TS,Trieste,49,723,922,139,9,7,0,0,1800,523,1012,193,44,3,0,0,1775,3575
IT-TS,Trieste,50,620,986,138,10,0,0,0,1754,521,1079,229,36,5,0,1,1871,3625
IT-TS,Trieste,51,729,1027,164,9,3,0,0,1932,490,1119,229,37,4,0,0,1879,3811
IT-TS,Trieste,52,679,982,164,10,4,0,0,1839,474,1160,249,57,2,0,0,1942,3781
IT-TS,Trieste,53,628,1018,175,16,4,0,0,1841,474,1120,275,63,4,0,0,1936,3777
IT-TS,Trieste,54,609,998,195,8,6,0,0,1816,370,1118,276,58,6,0,0,1828,3644
IT-TS,Trieste,55,528,1069,198,15,3,0,0,1813,372,1146,290,73,1,0,0,1882,3695
IT-TS,Trieste,56,529,1038,185,25,3,0,0,1780,354,1192,329,60,1,0,0,1936,3716
IT-TS,Trieste,57,517,1157,225,14,2,0,0,1915,348,1230,322,96,0,0,0,1996,3911
IT-TS,Trieste,58,465,1180,257,20,2,0,0,1924,352,1303,340,86,1,0,0,2082,4006
IT-TS,Trieste,59,470,1204,250,34,5,0,0,1963,317,1238,310,117,3,0,0,1985,3948
IT-TS,Trieste,60,401,1173,237,36,9,0,1,1857,305,1179,281,123,2,0,0,1890,3747
IT-TS,Trieste,61,333,1105,230,26,3,0,0,1697,237,1143,293,144,2,0,0,1819,3516
IT-TS,Trieste,62,328,1179,203,32,2,0,0,1744,223,1083,291,139,1,0,0,1737,3481
IT-TS,Trieste,63,269,1091,208,36,4,0,0,1608,205,1041,260,176,2,0,0,1684,3292
IT-TS,Trieste,64,269,1065,190,33,0,0,0,1557,186,1038,259,178,1,0,0,1662,3219
IT-TS,Trieste,65,229,992,167,50,1,0,0,1439,167,1018,257,184,0,0,0,1626,3065
IT-TS,Trieste,66,211,970,156,48,3,0,0,1388,182,972,251,218,0,0,0,1623,3011
IT-TS,Trieste,67,196,1009,197,60,3,0,0,1465,117,933,230,239,0,0,0,1519,2984
IT-TS,Trieste,68,171,965,159,54,1,0,0,1350,134,944,209,252,0,0,0,1539,2889
IT-TS,Trieste,69,163,899,153,65,1,0,0,1281,111,863,202,290,2,0,0,1468,2749
IT-TS,Trieste,70,121,885,130,55,0,0,0,1191,124,902,156,280,0,0,0,1462,2653
IT-TS,Trieste,71,108,910,122,79,2,0,0,1221,101,906,165,294,1,0,0,1467,2688
IT-TS,Trieste,72,117,854,119,72,2,0,0,1164,87,827,171,363,0,0,0,1448,2612
IT-TS,Trieste,73,121,929,110,86,1,0,0,1247,108,918,175,451,0,0,0,1652,2899
IT-TS,Trieste,74,82,938,125,109,0,0,0,1254,83,838,156,454,0,0,0,1531,2785
IT-TS,Trieste,75,106,1032,98,110,0,0,0,1346,100,859,169,510,1,0,0,1639,2985
IT-TS,Trieste,76,88,1001,94,124,0,0,0,1307,92,899,166,590,0,0,0,1747,3054
IT-TS,Trieste,77,106,1010,85,131,0,0,0,1332,91,849,153,608,0,0,0,1701,3033
IT-TS,Trieste,78,63,629,76,99,1,0,0,868,53,538,103,461,0,0,0,1155,2023
IT-TS,Trieste,79,62,713,62,123,0,0,0,960,80,594,103,620,0,0,0,1397,2357
IT-TS,Trieste,80,53,745,55,138,1,0,0,992,59,574,99,617,0,0,0,1349,2341
IT-TS,Trieste,81,63,732,56,133,0,0,1,985,84,545,114,636,0,0,0,1379,2364
IT-TS,Trieste,82,51,699,49,166,1,0,0,966,78,507,99,737,0,0,0,1421,2387
IT-TS,Trieste,83,54,677,46,204,0,0,0,981,78,462,97,821,0,0,0,1458,2439
IT-TS,Trieste,84,39,592,33,167,0,0,0,831,65,406,81,791,0,0,0,1343,2174
IT-TS,Trieste,85,30,562,31,180,1,0,0,804,55,304,66,786,0,0,0,1211,2015
IT-TS,Trieste,86,33,459,25,166,1,0,0,684,41,239,49,753,0,0,0,1082,1766
IT-TS,Trieste,87,20,348,19,131,1,0,0,519,66,167,46,686,0,0,0,965,1484
IT-TS,Trieste,88,27,290,10,135,0,0,0,462,52,142,33,651,0,0,0,878,1340
IT-TS,Trieste,89,14,224,14,104,0,0,0,356,40,79,30,596,0,0,0,745,1101
IT-TS,Trieste,90,13,172,8,103,0,0,0,296,34,73,22,487,0,0,0,616,912
IT-TS,Trieste,91,3,142,6,100,0,0,0,251,40,55,25,457,0,0,0,577,828
IT-TS,Trieste,92,13,101,7,86,0,0,0,207,40,30,17,404,0,0,0,491,698
IT-TS,Trieste,93,8,86,5,55,0,0,0,154,24,23,12,366,0,0,0,425,579
IT-TS,Trieste,94,3,44,1,39,0,0,0,87,25,17,11,295,0,0,0,348,435
IT-TS,Trieste,95,5,31,0,33,0,0,0,69,20,6,5,185,0,0,0,216,285
IT-TS,Trieste,96,2,13,1,26,0,0,0,42,7,6,3,156,0,0,0,172,214
IT-TS,Trieste,97,2,12,0,20,0,0,0,34,8,4,0,143,0,0,0,155,189
IT-TS,Trieste,98,0,7,1,13,0,0,0,21,13,4,1,96,0,0,0,114,135
IT-TS,Trieste,99,1,3,0,4,0,0,0,8,2,1,0,55,0,0,0,58,66
IT-TS,Trieste,100,2,11,4,11,0,0,0,28,7,1,5,122,0,0,0,135,163
IT-TS,Trieste,999,53752,46539,6178,3666,138,0,2,110275,44653,46750,9299,17332,85,1,1,118121,228396
IT-UD,Udine,0,1435,0,0,0,0,0,0,1435,1372,0,0,0,0,0,0,1372,2807
IT-UD,Udine,1,1539,0,0,0,0,0,0,1539,1446,0,0,0,0,0,0,1446,2985
IT-UD,Udine,2,1565,0,0,0,0,0,0,1565,1475,0,0,0,0,0,0,1475,3040
IT-UD,Udine,3,1671,0,0,0,0,0,0,1671,1564,0,0,0,0,0,0,1564,3235
IT-UD,Udine,4,1649,0,0,0,0,0,0,1649,1573,0,0,0,0,0,0,1573,3222
IT-UD,Udine,5,1721,0,0,0,0,0,0,1721,1624,0,0,0,0,0,0,1624,3345
IT-UD,Udine,6,1815,0,0,0,0,0,0,1815,1711,0,0,0,0,0,0,1711,3526
IT-UD,Udine,7,1907,0,0,0,0,0,0,1907,1824,0,0,0,0,0,0,1824,3731
IT-UD,Udine,8,1873,0,0,0,0,0,0,1873,1874,0,0,0,0,0,0,1874,3747
IT-UD,Udine,9,2082,0,0,0,0,0,0,2082,1941,0,0,0,0,0,0,1941,4023
IT-UD,Udine,10,2115,0,0,0,0,0,0,2115,2016,0,0,0,0,0,0,2016,4131
IT-UD,Udine,11,2159,0,0,0,0,0,0,2159,2114,0,0,0,0,0,0,2114,4273
IT-UD,Udine,12,2159,0,0,0,0,0,0,2159,2097,0,0,0,0,0,0,2097,4256
IT-UD,Udine,13,2353,0,0,0,0,0,0,2353,2164,0,0,0,0,0,0,2164,4517
IT-UD,Udine,14,2324,0,0,0,0,0,0,2324,2315,0,0,0,0,0,0,2315,4639
IT-UD,Udine,15,2282,0,0,0,0,0,0,2282,2236,0,0,0,0,0,0,2236,4518
IT-UD,Udine,16,2331,0,0,0,0,0,0,2331,2270,0,0,0,0,0,0,2270,4601
IT-UD,Udine,17,2376,0,0,0,0,0,0,2376,2263,0,0,0,0,0,0,2263,4639
IT-UD,Udine,18,2431,0,0,0,0,0,0,2431,2251,1,0,0,0,0,0,2252,4683
IT-UD,Udine,19,2401,0,0,0,0,0,0,2401,2282,6,0,0,0,0,0,2288,4689
IT-UD,Udine,20,2552,2,0,0,0,0,0,2554,2216,13,0,0,0,0,0,2229,4783
IT-UD,Udine,21,2458,6,0,0,0,0,0,2464,2253,30,0,0,0,0,0,2283,4747
IT-UD,Udine,22,2465,12,4,0,0,0,0,2481,2183,58,0,0,0,0,0,2241,4722
IT-UD,Udine,23,2567,13,1,0,0,0,0,2581,2269,76,0,0,2,0,0,2347,4928
IT-UD,Udine,24,2450,34,3,0,0,0,0,2487,2076,102,0,0,0,0,0,2178,4665
IT-UD,Udine,25,2488,52,2,0,1,0,0,2543,2124,124,1,0,0,0,0,2249,4792
IT-UD,Udine,26,2397,80,4,0,1,0,0,2482,2032,205,0,1,0,0,0,2238,4720
IT-UD,Udine,27,2396,105,2,1,3,1,0,2508,1920,278,3,1,1,0,0,2203,4711
IT-UD,Udine,28,2336,165,1,0,2,0,0,2504,1916,372,4,0,1,0,0,2293,4797
IT-UD,Udine,29,2220,211,3,0,3,0,0,2437,1753,464,11,0,1,1,0,2230,4667
IT-UD,Udine,30,2160,287,7,0,4,0,0,2458,1607,518,17,2,1,0,0,2145,4603
IT-UD,Udine,31,2166,446,10,0,3,0,0,2625,1685,726,31,2,2,0,0,2446,5071
IT-UD,Udine,32,1991,528,10,1,1,0,0,2531,1619,785,26,2,4,0,0,2436,4967
IT-UD,Udine,33,2001,556,13,1,3,1,0,2575,1508,936,26,4,2,1,0,2477,5052
IT-UD,Udine,34,1849,698,19,2,6,0,0,2574,1435,1051,47,0,5,0,0,2538,5112
IT-UD,Udine,35,1747,835,39,0,3,0,0,2624,1367,1151,58,4,3,0,0,2583,5207
IT-UD,Udine,36,1618,834,34,4,2,0,0,2492,1223,1237,53,6,5,0,0,2524,5016
IT-UD,Udine,37,1664,879,62,2,6,0,0,2613,1210,1266,97,8,5,0,0,2586,5199
IT-UD,Udine,38,1612,1055,42,1,0,0,0,2710,1179,1450,90,10,2,1,0,2732,5442
IT-UD,Udine,39,1664,1175,42,2,2,1,0,2886,1209,1424,112,11,6,0,0,2762,5648
IT-UD,Udine,40,1473,1276,56,2,2,2,0,2811,1116,1544,128,10,6,0,0,2804,5615
IT-UD,Udine,41,1507,1367,82,4,1,0,0,2961,1050,1704,160,18,4,0,0,2936,5897
IT-UD,Udine,42,1510,1432,91,4,1,0,0,3038,1048,1662,191,28,4,2,0,2935,5973
IT-UD,Udine,43,1474,1509,144,3,2,0,1,3133,1036,1769,201,22,1,1,0,3030,6163
IT-UD,Udine,44,1474,1673,125,11,4,0,0,3287,1062,1842,198,29,3,0,0,3134,6421
IT-UD,Udine,45,1579,1776,155,4,4,0,1,3519,1140,1931,267,47,6,0,0,3391,6910
IT-UD,Udine,46,1543,1695,189,8,3,0,0,3438,1092,2145,282,32,2,0,0,3553,6991
IT-UD,Udine,47,1534,1914,175,9,6,1,0,3639,1130,2197,321,52,2,0,0,3702,7341
IT-UD,Udine,48,1624,2082,228,22,12,0,0,3968,1059,2414,377,74,3,0,0,3927,7895
IT-UD,Udine,49,1584,2294,265,13,5,0,0,4161,1114,2659,411,85,2,1,0,4272,8433
IT-UD,Udine,50,1507,2285,303,26,2,0,0,4123,1124,2614,430,81,6,2,0,4257,8380
IT-UD,Udine,51,1459,2412,305,15,9,0,0,4200,961,2756,436,109,1,0,0,4263,8463
IT-UD,Udine,52,1414,2573,298,24,6,0,0,4315,913,2862,486,125,1,0,0,4387,8702
IT-UD,Udine,53,1334,2582,377,19,6,0,0,4318,922,2952,503,123,6,0,0,4506,8824
IT-UD,Udine,54,1321,2738,379,26,1,0,0,4465,877,2981,462,133,2,2,0,4457,8922
IT-UD,Udine,55,1204,2780,385,27,3,0,0,4399,787,2879,513,187,1,0,0,4367,8766
IT-UD,Udine,56,1128,2804,437,31,3,0,0,4403,763,3057,528,156,3,0,0,4507,8910
IT-UD,Udine,57,1036,2914,412,49,6,0,0,4417,794,3009,538,206,0,0,0,4547,8964
IT-UD,Udine,58,1097,2945,432,46,5,0,0,4525,720,3066,493,204,1,0,0,4484,9009
IT-UD,Udine,59,998,3018,444,58,5,0,0,4523,718,3094,567,223,2,0,0,4604,9127
IT-UD,Udine,60,862,2834,415,55,7,0,0,4173,555,3128,516,290,2,0,0,4491,8664
IT-UD,Udine,61,813,2753,418,70,3,0,0,4057,517,2871,477,335,0,0,0,4200,8257
IT-UD,Udine,62,686,2760,387,68,6,0,0,3907,502,2752,472,343,0,0,0,4069,7976
IT-UD,Udine,63,637,2761,357,68,3,0,0,3826,469,2698,409,356,1,0,0,3933,7759
IT-UD,Udine,64,578,2721,369,97,2,0,0,3767,412,2701,417,414,1,0,0,3945,7712
IT-UD,Udine,65,518,2509,340,91,2,0,0,3460,366,2540,342,454,0,0,0,3702,7162
IT-UD,Udine,66,471,2372,305,108,2,0,1,3259,291,2477,331,445,1,0,0,3545,6804
IT-UD,Udine,67,445,2402,301,126,2,0,0,3276,324,2411,317,535,0,0,0,3587,6863
IT-UD,Udine,68,446,2370,249,136,1,0,0,3202,291,2275,321,551,1,0,0,3439,6641
IT-UD,Udine,69,352,2385,246,122,4,0,0,3109,259,2290,282,618,0,0,0,3449,6558
IT-UD,Udine,70,329,2361,223,143,2,0,0,3058,224,2232,229,730,0,0,0,3415,6473
IT-UD,Udine,71,314,2278,202,150,1,0,0,2945,219,2167,236,733,0,0,0,3355,6300
IT-UD,Udine,72,326,2172,166,137,1,0,1,2803,210,2098,191,833,0,0,0,3332,6135
IT-UD,Udine,73,321,2383,162,202,1,0,0,3069,202,2118,189,908,0,0,0,3417,6486
IT-UD,Udine,74,299,2324,167,218,2,0,0,3010,212,2068,201,995,0,0,0,3476,6486
IT-UD,Udine,75,307,2401,144,234,0,0,0,3086,213,2018,190,1136,1,0,0,3558,6644
IT-UD,Udine,76,272,2383,123,269,1,0,0,3048,190,1926,177,1239,0,0,0,3532,6580
IT-UD,Udine,77,264,2476,108,308,1,0,0,3157,180,1982,159,1458,0,0,0,3779,6936
IT-UD,Udine,78,185,1586,75,224,0,0,0,2070,152,1246,119,1038,0,0,0,2555,4625
IT-UD,Udine,79,189,1847,86,295,0,0,0,2417,148,1308,111,1337,0,0,0,2904,5321
IT-UD,Udine,80,189,1685,83,294,1,0,0,2252,147,1230,109,1363,0,0,0,2849,5101
IT-UD,Udine,81,175,1585,71,292,1,0,0,2124,153,1175,84,1491,0,0,0,2903,5027
IT-UD,Udine,82,151,1536,61,349,2,0,0,2099,164,990,67,1543,0,0,0,2764,4863
IT-UD,Udine,83,155,1478,53,352,0,0,0,2038,164,859,66,1663,1,0,0,2753,4791
IT-UD,Udine,84,136,1315,44,328,0,0,0,1823,163,774,59,1599,0,0,0,2595,4418
IT-UD,Udine,85,107,1125,28,337,0,0,0,1597,131,569,58,1618,0,0,0,2376,3973
IT-UD,Udine,86,91,890,20,303,0,0,0,1304,122,419,54,1417,0,0,0,2012,3316
IT-UD,Udine,87,55,710,19,264,0,0,0,1048,104,289,24,1401,0,0,0,1818,2866
IT-UD,Udine,88,53,582,15,229,0,0,0,879,103,265,21,1322,0,0,1,1712,2591
IT-UD,Udine,89,34,462,15,224,0,0,0,735,106,168,25,1108,0,0,0,1407,2142
IT-UD,Udine,90,34,354,4,196,0,0,0,588,76,91,13,1033,0,0,0,1213,1801
IT-UD,Udine,91,26,258,4,160,0,0,0,448,58,71,18,929,0,0,0,1076,1524
IT-UD,Udine,92,14,206,3,159,0,0,0,382,61,61,10,738,0,0,0,870,1252
IT-UD,Udine,93,21,138,3,125,0,0,0,287,63,28,10,715,0,0,0,816,1103
IT-UD,Udine,94,13,87,2,89,0,0,0,191,36,16,8,509,0,0,0,569,760
IT-UD,Udine,95,7,61,4,68,0,0,0,140,39,13,4,429,0,0,0,485,625
IT-UD,Udine,96,3,44,0,55,0,0,0,102,29,10,5,351,0,0,0,395,497
IT-UD,Udine,97,2,22,0,32,0,0,0,56,16,2,2,247,0,0,0,267,323
IT-UD,Udine,98,1,13,0,20,0,0,0,34,13,3,3,178,0,0,0,197,231
IT-UD,Udine,99,2,6,0,6,0,0,0,14,18,1,2,116,0,0,0,137,151
IT-UD,Udine,100,1,6,0,25,0,0,0,32,16,2,0,194,0,0,0,212,244
IT-UD,Udine,999,120673,112683,10852,7443,171,6,4,251832,100340,113752,14396,36707,104,11,1,265311,517143
IT-AO,Aosta,0,367,0,0,0,0,0,0,367,357,0,0,0,0,0,0,357,724
IT-AO,Aosta,1,405,0,0,0,0,0,0,405,382,0,0,0,0,0,0,382,787
IT-AO,Aosta,2,402,0,0,0,0,0,0,402,358,0,0,0,0,0,0,358,760
IT-AO,Aosta,3,386,0,0,0,0,0,0,386,405,0,0,0,0,0,0,405,791
IT-AO,Aosta,4,403,0,0,0,0,0,0,403,409,0,0,0,0,0,0,409,812
IT-AO,Aosta,5,490,0,0,0,0,0,0,490,407,0,0,0,0,0,0,407,897
IT-AO,Aosta,6,482,0,0,0,0,0,0,482,412,0,0,0,0,0,0,412,894
IT-AO,Aosta,7,512,0,0,0,0,0,0,512,448,0,0,0,0,0,0,448,960
IT-AO,Aosta,8,503,0,0,0,0,0,0,503,482,0,0,0,0,0,0,482,985
IT-AO,Aosta,9,562,0,0,0,0,0,0,562,499,0,0,0,0,0,0,499,1061
IT-AO,Aosta,10,517,0,0,0,0,0,0,517,522,0,0,0,0,0,0,522,1039
IT-AO,Aosta,11,588,0,0,0,0,0,0,588,559,0,0,0,0,0,0,559,1147
IT-AO,Aosta,12,633,0,0,0,0,0,0,633,583,0,0,0,0,0,0,583,1216
IT-AO,Aosta,13,592,0,0,0,0,0,0,592,579,0,0,0,0,0,0,579,1171
IT-AO,Aosta,14,651,0,0,0,0,0,0,651,581,0,0,0,0,0,0,581,1232
IT-AO,Aosta,15,634,0,0,0,0,0,0,634,600,0,0,0,0,0,0,600,1234
IT-AO,Aosta,16,657,1,0,0,0,0,0,658,586,0,0,0,0,0,0,586,1244
IT-AO,Aosta,17,667,0,0,0,0,0,0,667,597,0,0,0,0,0,0,597,1264
IT-AO,Aosta,18,610,0,0,0,0,0,0,610,567,0,0,0,0,0,0,567,1177
IT-AO,Aosta,19,608,0,1,0,0,0,0,609,595,0,2,0,0,0,0,597,1206
IT-AO,Aosta,20,629,0,0,0,0,0,0,629,605,4,0,0,0,0,0,609,1238
IT-AO,Aosta,21,623,0,0,0,0,0,0,623,531,7,0,0,0,0,0,538,1161
IT-AO,Aosta,22,641,2,0,0,0,0,0,643,565,9,1,0,0,0,0,575,1218
IT-AO,Aosta,23,658,1,0,0,0,0,0,659,588,22,1,0,0,0,0,611,1270
IT-AO,Aosta,24,639,6,0,0,0,0,0,645,552,27,0,0,0,0,0,579,1224
IT-AO,Aosta,25,625,12,0,0,0,0,0,637,541,34,1,0,1,0,0,577,1214
IT-AO,Aosta,26,593,13,2,0,0,0,0,608,500,61,2,0,1,0,0,564,1172
IT-AO,Aosta,27,612,28,1,0,0,0,0,641,512,68,2,0,0,0,0,582,1223
IT-AO,Aosta,28,570,44,1,0,0,0,0,615,460,99,1,0,1,0,0,561,1176
IT-AO,Aosta,29,531,60,1,0,0,0,0,592,425,113,2,0,1,0,0,541,1133
IT-AO,Aosta,30,515,85,2,0,0,0,0,602,420,144,6,1,1,0,0,572,1174
IT-AO,Aosta,31,556,96,2,0,0,0,0,654,414,196,7,0,1,0,0,618,1272
IT-AO,Aosta,32,495,123,2,0,1,0,0,621,386,169,10,0,3,0,0,568,1189
IT-AO,Aosta,33,469,135,6,0,0,0,0,610,395,248,12,1,1,0,0,657,1267
IT-AO,Aosta,34,479,172,5,1,1,0,0,658,346,220,21,1,3,0,0,591,1249
IT-AO,Aosta,35,464,197,5,0,0,0,0,666,331,278,21,1,1,0,0,632,1298
IT-AO,Aosta,36,414,196,7,0,1,0,0,618,329,296,14,3,1,0,0,643,1261
IT-AO,Aosta,37,375,227,11,1,0,0,0,614,293,337,23,5,2,0,0,660,1274
IT-AO,Aosta,38,385,232,18,1,0,0,0,636,309,310,19,3,1,0,0,642,1278
IT-AO,Aosta,39,382,278,13,2,0,0,0,675,296,323,23,1,0,0,0,643,1318
IT-AO,Aosta,40,378,329,21,1,2,0,0,731,288,356,41,4,0,0,0,689,1420
IT-AO,Aosta,41,341,332,22,0,0,0,0,695,278,389,43,5,1,1,0,717,1412
IT-AO,Aosta,42,328,309,24,1,3,0,0,665,234,383,49,7,3,0,0,676,1341
IT-AO,Aosta,43,351,379,30,2,0,0,0,762,231,411,49,8,1,0,0,700,1462
IT-AO,Aosta,44,319,365,43,0,0,0,0,727,241,420,43,18,1,0,0,723,1450
IT-AO,Aosta,45,418,420,39,3,1,0,0,881,303,469,63,5,0,0,0,840,1721
IT-AO,Aosta,46,340,453,50,2,2,0,0,847,282,466,67,10,1,1,0,827,1674
IT-AO,Aosta,47,369,437,53,1,1,0,0,861,284,549,76,15,0,0,0,924,1785
IT-AO,Aosta,48,394,445,57,1,1,0,0,898,295,571,76,19,1,0,0,962,1860
IT-AO,Aosta,49,401,505,63,2,0,0,0,971,291,567,111,11,1,0,0,981,1952
IT-AO,Aosta,50,344,572,77,4,4,0,0,1001,257,595,130,21,2,0,0,1005,2006
IT-AO,Aosta,51,359,566,66,6,3,0,0,1000,267,624,114,28,0,0,0,1033,2033
IT-AO,Aosta,52,313,587,87,6,0,0,0,993,242,660,140,32,0,0,0,1074,2067
IT-AO,Aosta,53,338,575,88,4,1,0,0,1006,235,629,156,38,0,0,0,1058,2064
IT-AO,Aosta,54,319,622,122,7,2,0,0,1072,247,698,135,28,0,0,0,1108,2180
IT-AO,Aosta,55,320,599,106,11,2,1,0,1039,210,657,164,37,2,0,0,1070,2109
IT-AO,Aosta,56,297,600,134,10,2,0,0,1043,217,662,152,60,0,0,0,1091,2134
IT-AO,Aosta,57,306,637,137,16,2,0,0,1098,191,698,150,49,1,0,0,1089,2187
IT-AO,Aosta,58,235,662,115,10,0,0,0,1022,180,671,144,57,1,0,0,1053,2075
IT-AO,Aosta,59,262,727,139,16,2,0,0,1146,202,702,162,48,1,0,0,1115,2261
IT-AO,Aosta,60,226,665,127,24,1,0,0,1043,142,663,136,61,2,0,0,1004,2047
IT-AO,Aosta,61,169,609,99,22,0,0,0,899,126,635,136,68,0,0,0,965,1864
IT-AO,Aosta,62,186,640,122,20,3,0,0,971,126,596,126,77,0,0,0,925,1896
IT-AO,Aosta,63,135,575,103,15,1,0,0,829,107,565,136,87,0,0,0,895,1724
IT-AO,Aosta,64,132,632,92,15,0,0,0,871,107,603,117,104,0,0,0,931,1802
IT-AO,Aosta,65,149,539,79,28,0,0,0,795,71,572,99,91,0,0,0,833,1628
IT-AO,Aosta,66,122,560,82,19,1,0,0,784,94,504,114,103,0,0,0,815,1599
IT-AO,Aosta,67,106,581,78,16,0,0,0,781,61,529,85,111,0,0,0,786,1567
IT-AO,Aosta,68,95,502,70,33,1,0,0,701,66,542,89,155,1,0,0,853,1554
IT-AO,Aosta,69,106,524,54,27,0,0,0,711,62,499,86,150,0,0,0,797,1508
IT-AO,Aosta,70,99,564,54,35,0,0,0,752,54,471,63,168,0,0,0,756,1508
IT-AO,Aosta,71,98,508,60,36,0,0,0,702,48,452,62,162,0,0,0,724,1426
IT-AO,Aosta,72,74,499,60,47,0,0,0,680,46,465,53,172,0,0,0,736,1416
IT-AO,Aosta,73,79,508,44,51,0,0,0,682,49,441,55,193,0,0,0,738,1420
IT-AO,Aosta,74,64,507,51,39,0,0,0,661,50,459,55,214,0,0,0,778,1439
IT-AO,Aosta,75,74,510,35,60,2,0,1,682,41,443,65,243,0,0,0,792,1474
IT-AO,Aosta,76,55,523,39,58,0,0,1,676,27,371,51,259,0,0,0,708,1384
IT-AO,Aosta,77,67,441,35,52,0,0,0,595,26,347,39,263,0,0,0,675,1270
IT-AO,Aosta,78,49,299,21,46,0,0,0,415,25,276,29,210,0,0,0,540,955
IT-AO,Aosta,79,45,356,25,65,0,0,0,491,20,226,33,248,0,0,0,527,1018
IT-AO,Aosta,80,40,363,24,63,0,0,0,490,28,249,29,258,0,0,0,564,1054
IT-AO,Aosta,81,45,332,17,68,0,0,0,462,23,205,20,314,0,0,0,562,1024
IT-AO,Aosta,82,42,300,17,73,0,0,0,432,35,204,20,318,0,0,0,577,1009
IT-AO,Aosta,83,43,281,15,75,0,0,0,414,33,179,23,347,0,0,0,582,996
IT-AO,Aosta,84,32,269,7,69,0,0,0,377,32,165,17,332,0,0,0,546,923
IT-AO,Aosta,85,13,240,4,81,0,0,0,338,33,134,13,341,0,0,0,521,859
IT-AO,Aosta,86,17,170,8,74,0,0,0,269,26,104,9,312,0,0,0,451,720
IT-AO,Aosta,87,17,142,3,55,1,0,0,218,14,62,13,290,0,0,0,379,597
IT-AO,Aosta,88,9,124,6,50,0,0,0,189,20,52,11,250,0,0,0,333,522
IT-AO,Aosta,89,14,87,6,44,0,0,0,151,21,35,6,243,0,0,0,305,456
IT-AO,Aosta,90,9,76,1,40,0,0,0,126,18,33,3,216,0,0,0,270,396
IT-AO,Aosta,91,7,48,5,41,0,0,0,101,21,19,3,179,0,0,0,222,323
IT-AO,Aosta,92,6,28,0,33,0,0,0,67,13,13,4,182,0,0,0,212,279
IT-AO,Aosta,93,5,28,1,29,0,0,0,63,12,12,3,150,0,0,0,177,240
IT-AO,Aosta,94,1,21,0,26,0,0,0,48,10,7,1,116,0,0,0,134,182
IT-AO,Aosta,95,4,16,1,8,0,0,0,29,7,6,1,95,0,0,0,109,138
IT-AO,Aosta,96,1,8,0,9,0,0,0,18,7,0,0,57,0,0,0,64,82
IT-AO,Aosta,97,0,4,0,7,0,0,0,11,8,1,1,51,0,0,0,61,72
IT-AO,Aosta,98,1,3,1,6,0,0,0,11,0,0,0,30,0,0,0,30,41
IT-AO,Aosta,99,0,1,0,4,0,0,0,5,2,0,0,16,0,0,0,18,23
IT-AO,Aosta,100,0,0,0,2,0,0,0,2,2,0,1,34,0,0,0,37,39
IT-AO,Aosta,999,30492,25112,2996,1673,41,1,2,60317,25414,25281,4040,7786,37,2,0,62560,122877
IT-VA,Varese,0,2819,0,0,0,0,0,0,2819,2698,0,0,0,0,0,0,2698,5517
IT-VA,Varese,1,2984,0,0,0,0,0,0,2984,2839,0,0,0,0,0,0,2839,5823
IT-VA,Varese,2,3155,0,0,0,0,0,0,3155,3034,0,0,0,0,0,0,3034,6189
IT-VA,Varese,3,3084,0,0,0,0,0,0,3084,2943,0,0,0,0,0,0,2943,6027
IT-VA,Varese,4,3303,0,0,0,0,0,0,3303,3256,0,0,0,0,0,0,3256,6559
IT-VA,Varese,5,3489,0,0,0,0,0,0,3489,3328,0,0,0,0,0,0,3328,6817
IT-VA,Varese,6,3562,0,0,0,0,0,0,3562,3358,0,0,0,0,0,0,3358,6920
IT-VA,Varese,7,3683,0,0,0,0,0,0,3683,3555,0,0,0,0,0,0,3555,7238
IT-VA,Varese,8,3966,0,0,0,0,0,0,3966,3744,0,0,0,0,0,0,3744,7710
IT-VA,Varese,9,4098,0,0,0,0,0,0,4098,3836,0,0,0,0,0,0,3836,7934
IT-VA,Varese,10,4141,0,0,0,0,0,0,4141,4008,0,0,0,0,0,0,4008,8149
IT-VA,Varese,11,4219,0,0,0,0,0,0,4219,4007,0,0,0,0,0,0,4007,8226
IT-VA,Varese,12,4417,0,0,0,0,0,0,4417,4128,0,0,0,0,0,0,4128,8545
IT-VA,Varese,13,4376,0,0,0,0,0,0,4376,4121,0,0,0,0,0,0,4121,8497
IT-VA,Varese,14,4600,0,0,0,0,0,0,4600,4337,0,0,0,0,0,0,4337,8937
IT-VA,Varese,15,4544,0,0,0,0,0,0,4544,4213,0,0,0,0,0,0,4213,8757
IT-VA,Varese,16,4616,0,0,0,0,0,0,4616,4076,0,0,0,0,0,0,4076,8692
IT-VA,Varese,17,4497,0,0,0,0,0,0,4497,4327,0,0,0,0,0,0,4327,8824
IT-VA,Varese,18,4458,0,0,0,0,0,0,4458,4089,2,0,0,0,0,0,4091,8549
IT-VA,Varese,19,4523,1,0,0,0,0,0,4524,4206,9,0,0,0,0,0,4215,8739
IT-VA,Varese,20,4274,4,0,0,0,0,0,4278,4028,20,0,0,0,0,0,4048,8326
IT-VA,Varese,21,4312,3,0,0,0,0,0,4315,3975,42,0,0,0,0,0,4017,8332
IT-VA,Varese,22,4378,14,0,0,1,0,0,4393,3915,93,2,0,1,0,0,4011,8404
IT-VA,Varese,23,4452,27,1,0,0,0,0,4480,3990,146,2,0,1,0,0,4139,8619
IT-VA,Varese,24,4349,63,1,0,0,0,0,4413,3929,187,4,0,2,0,0,4122,8535
IT-VA,Varese,25,4384,93,6,0,1,0,0,4484,3955,261,6,2,1,0,0,4225,8709
IT-VA,Varese,26,4434,133,5,1,0,0,0,4573,3733,380,8,0,2,1,0,4124,8697
IT-VA,Varese,27,4356,188,8,0,2,0,0,4554,3545,507,7,0,2,0,0,4061,8615
IT-VA,Varese,28,4009,307,5,0,2,0,0,4323,3479,698,14,2,2,1,0,4196,8519
IT-VA,Varese,29,4021,407,11,0,8,0,0,4447,3239,977,24,2,3,0,0,4245,8692
IT-VA,Varese,30,3868,621,7,0,6,2,0,4504,3183,1157,28,3,6,0,0,4377,8881
IT-VA,Varese,31,3891,795,14,1,3,1,0,4705,3052,1468,38,3,5,0,0,4566,9271
IT-VA,Varese,32,3740,1000,21,1,11,0,0,4773,2769,1668,49,7,9,0,0,4502,9275
IT-VA,Varese,33,3431,1274,40,3,7,0,0,4755,2699,1972,82,4,8,0,0,4765,9520
IT-VA,Varese,34,3184,1467,43,5,11,0,0,4710,2415,2161,88,6,6,0,0,4676,9386
IT-VA,Varese,35,3244,1634,56,2,12,0,0,4948,2321,2346,118,13,10,1,0,4809,9757
IT-VA,Varese,36,2936,1809,88,4,6,0,0,4843,2091,2421,139,8,9,0,0,4668,9511
IT-VA,Varese,37,2622,1989,73,4,8,0,1,4697,1890,2618,180,17,16,1,0,4722,9419
IT-VA,Varese,38,2667,2271,94,1,6,1,0,5040,1969,2818,195,23,8,0,0,5013,10053
IT-VA,Varese,39,2547,2421,124,4,7,2,0,5105,1789,2856,227,24,9,1,0,4906,10011
IT-VA,Varese,40,2442,2578,126,1,5,0,0,5152,1770,3098,232,32,8,1,0,5141,10293
IT-VA,Varese,41,2436,2706,172,8,5,1,0,5328,1724,3282,266,30,8,1,0,5311,10639
IT-VA,Varese,42,2287,2887,190,13,6,0,0,5383,1639,3287,331,41,10,1,0,5309,10692
IT-VA,Varese,43,2271,2955,212,19,11,0,0,5468,1630,3411,374,43,5,0,0,5463,10931
IT-VA,Varese,44,2239,3163,256,20,11,0,0,5689,1527,3688,409,61,9,0,0,5694,11383
IT-VA,Varese,45,2266,3481,293,18,15,1,0,6074,1599,3883,475,77,7,1,0,6042,12116
IT-VA,Varese,46,2270,3711,348,18,12,0,0,6359,1591,4171,518,68,8,0,0,6356,12715
IT-VA,Varese,47,2284,3891,394,33,11,0,0,6613,1583,4326,536,96,7,0,0,6548,13161
IT-VA,Varese,48,2383,4255,433,21,16,1,0,7109,1624,4655,604,115,13,0,0,7011,14120
IT-VA,Varese,49,2318,4380,487,37,13,0,1,7236,1546,4683,663,113,9,0,0,7014,14250
IT-VA,Varese,50,2251,4378,517,30,11,0,0,7187,1506,4678,729,106,5,1,0,7025,14212
IT-VA,Varese,51,2079,4613,523,46,8,0,0,7269,1414,5007,745,166,5,1,0,7338,14607
IT-VA,Varese,52,2010,4630,575,40,8,0,0,7263,1287,4934,780,186,6,0,0,7193,14456
IT-VA,Varese,53,1808,4657,601,39,15,1,0,7121,1181,4967,797,198,7,1,0,7151,14272
IT-VA,Varese,54,1707,4829,680,55,6,1,0,7278,1171,5233,818,216,5,1,1,7445,14723
IT-VA,Varese,55,1697,5098,633,62,9,0,0,7499,1081,5125,868,225,4,0,0,7303,14802
IT-VA,Varese,56,1529,5018,682,70,9,0,0,7308,1050,5130,867,267,4,0,0,7318,14626
IT-VA,Varese,57,1365,5204,709,77,10,0,0,7365,937,5348,877,313,0,1,0,7476,14841
IT-VA,Varese,58,1251,5353,747,83,15,0,0,7449,958,5441,876,395,3,0,0,7673,15122
IT-VA,Varese,59,1169,5375,662,99,10,0,1,7316,866,5348,792,395,4,0,0,7405,14721
IT-VA,Varese,60,1028,5056,660,99,11,0,0,6854,754,5014,781,405,1,0,0,6955,13809
IT-VA,Varese,61,900,4722,558,94,6,0,0,6280,675,4781,659,480,5,0,0,6600,12880
IT-VA,Varese,62,765,4536,576,130,5,0,0,6012,639,4650,612,495,4,0,0,6400,12412
IT-VA,Varese,63,698,4494,480,143,10,0,1,5826,596,4285,609,556,3,0,0,6049,11875
IT-VA,Varese,64,615,4317,448,143,4,0,1,5528,527,4456,573,652,2,0,0,6210,11738
IT-VA,Varese,65,519,4159,421,138,3,0,2,5242,533,3991,535,631,2,0,0,5692,10934
IT-VA,Varese,66,568,4025,414,167,6,0,0,5180,467,3912,443,731,2,0,0,5555,10735
IT-VA,Varese,67,449,3987,366,171,2,0,0,4975,451,3871,419,755,0,0,0,5496,10471
IT-VA,Varese,68,429,3962,337,183,1,0,0,4912,425,3811,424,858,0,0,0,5518,10430
IT-VA,Varese,69,428,3814,293,209,3,0,0,4747,383,3656,371,976,0,0,0,5386,10133
IT-VA,Varese,70,399,3733,263,250,1,0,1,4647,355,3563,333,993,0,0,0,5244,9891
IT-VA,Varese,71,351,3670,257,269,2,0,0,4549,338,3488,280,1102,0,0,0,5208,9757
IT-VA,Varese,72,336,3694,221,238,2,0,0,4491,313,3362,266,1191,0,0,0,5132,9623
IT-VA,Varese,73,352,3709,198,274,1,0,0,4534,307,3402,241,1287,0,0,0,5237,9771
IT-VA,Varese,74,302,3698,181,350,0,0,0,4531,272,3405,256,1485,2,0,0,5420,9951
IT-VA,Varese,75,296,3724,189,353,1,0,0,4563,297,3284,239,1644,0,0,0,5464,10027
IT-VA,Varese,76,277,3474,162,391,1,0,1,4306,288,2996,235,1722,0,0,0,5241,9547
IT-VA,Varese,77,247,3647,128,426,2,0,0,4450,282,2947,252,2004,0,0,0,5485,9935
IT-VA,Varese,78,199,2606,99,332,1,0,0,3237,215,2099,152,1558,0,0,0,4024,7261
IT-VA,Varese,79,204,2550,73,374,0,0,0,3201,230,2022,134,1722,0,0,0,4108,7309
IT-VA,Varese,80,158,2503,65,436,0,0,0,3162,200,1801,122,1815,0,0,0,3938,7100
IT-VA,Varese,81,148,2366,64,411,0,0,0,2989,210,1738,113,2068,0,0,0,4129,7118
IT-VA,Varese,82,161,2343,61,477,0,0,0,3042,248,1625,118,2159,0,0,0,4150,7192
IT-VA,Varese,83,158,2262,58,498,0,0,0,2976,252,1488,130,2395,2,0,0,4267,7243
IT-VA,Varese,84,122,2104,47,518,0,0,0,2791,235,1263,92,2523,0,0,0,4113,6904
IT-VA,Varese,85,116,1846,44,507,1,0,0,2514,230,1042,70,2358,0,0,0,3700,6214
IT-VA,Varese,86,99,1406,33,463,0,0,0,2001,225,795,62,2209,0,0,0,3291,5292
IT-VA,Varese,87,69,1191,22,390,0,0,0,1672,171,544,57,2004,0,0,0,2776,4448
IT-VA,Varese,88,67,963,13,416,0,0,0,1459,178,462,39,1907,0,0,0,2586,4045
IT-VA,Varese,89,53,763,13,374,0,0,0,1203,172,301,31,1778,0,0,0,2282,3485
IT-VA,Varese,90,28,579,16,307,0,0,0,930,141,248,31,1507,0,0,0,1927,2857
IT-VA,Varese,91,32,412,5,274,0,0,0,723,122,162,19,1389,0,0,0,1692,2415
IT-VA,Varese,92,27,339,5,222,0,0,0,593,112,92,17,1202,0,0,0,1423,2016
IT-VA,Varese,93,19,232,1,168,0,0,0,420,98,55,6,982,0,0,0,1141,1561
IT-VA,Varese,94,9,147,1,136,0,0,0,293,65,34,14,785,0,0,0,898,1191
IT-VA,Varese,95,11,99,0,93,0,0,0,203,51,26,6,574,0,0,0,657,860
IT-VA,Varese,96,6,57,1,76,0,0,0,140,44,15,7,455,0,0,0,521,661
IT-VA,Varese,97,3,33,1,56,0,0,0,93,38,10,3,335,0,0,0,386,479
IT-VA,Varese,98,1,22,0,47,0,0,0,70,23,3,0,237,0,0,0,263,333
IT-VA,Varese,99,0,7,0,17,0,0,0,24,13,2,0,147,0,0,0,162,186
IT-VA,Varese,100,2,15,0,41,0,0,0,58,26,4,1,216,0,0,0,247,305
IT-VA,Varese,999,204346,196949,16611,11476,360,11,9,429762,174954,199207,22520,53549,250,14,1,450495,880257
IT-VE,Venezia,0,2527,0,0,0,0,0,0,2527,2393,0,0,0,0,0,0,2393,4920
IT-VE,Venezia,1,2591,0,0,0,0,0,0,2591,2498,0,0,0,0,0,0,2498,5089
IT-VE,Venezia,2,2762,0,0,0,0,0,0,2762,2612,0,0,0,0,0,0,2612,5374
IT-VE,Venezia,3,2766,0,0,0,0,0,0,2766,2602,0,0,0,0,0,0,2602,5368
IT-VE,Venezia,4,2850,0,0,0,0,0,0,2850,2654,0,0,0,0,0,0,2654,5504
IT-VE,Venezia,5,2988,0,0,0,0,0,0,2988,2848,0,0,0,0,0,0,2848,5836
IT-VE,Venezia,6,3141,0,0,0,0,0,0,3141,2949,0,0,0,0,0,0,2949,6090
IT-VE,Venezia,7,3349,0,0,0,0,0,0,3349,3043,0,0,0,0,0,0,3043,6392
IT-VE,Venezia,8,3323,0,0,0,0,0,0,3323,3111,0,0,0,0,0,0,3111,6434
IT-VE,Venezia,9,3374,0,0,0,0,0,0,3374,3152,0,0,0,0,0,0,3152,6526
IT-VE,Venezia,10,3578,0,0,0,0,0,0,3578,3268,0,0,0,0,0,0,3268,6846
IT-VE,Venezia,11,3762,0,0,0,0,0,0,3762,3495,0,0,0,0,0,0,3495,7257
IT-VE,Venezia,12,3853,0,0,0,0,0,0,3853,3690,0,0,0,0,0,0,3690,7543
IT-VE,Venezia,13,3895,0,0,0,0,0,0,3895,3672,0,0,0,0,0,0,3672,7567
IT-VE,Venezia,14,4035,0,0,0,0,0,0,4035,3686,0,0,0,0,0,0,3686,7721
IT-VE,Venezia,15,4147,0,0,0,0,0,0,4147,3830,0,0,0,0,0,0,3830,7977
IT-VE,Venezia,16,4082,0,0,0,0,0,0,4082,3867,0,0,0,0,0,0,3867,7949
IT-VE,Venezia,17,4052,0,0,0,0,0,0,4052,3775,0,0,0,0,0,0,3775,7827
IT-VE,Venezia,18,4079,1,0,0,0,0,0,4080,3661,3,0,0,0,0,0,3664,7744
IT-VE,Venezia,19,4174,4,0,0,0,0,0,4178,3881,13,0,0,0,0,0,3894,8072
IT-VE,Venezia,20,4302,1,0,0,0,0,0,4303,3769,28,0,0,0,0,0,3797,8100
IT-VE,Venezia,21,4066,6,0,0,0,0,0,4072,3635,52,2,0,0,0,0,3689,7761
IT-VE,Venezia,22,4215,15,2,0,0,0,0,4232,3645,94,2,0,0,0,0,3741,7973
IT-VE,Venezia,23,4351,38,4,0,0,0,0,4393,3739,181,1,0,0,0,0,3921,8314
IT-VE,Venezia,24,4282,56,3,0,0,0,0,4341,3640,249,3,1,3,0,0,3896,8237
IT-VE,Venezia,25,4306,112,4,0,4,0,0,4426,3692,331,5,0,3,0,0,4031,8457
IT-VE,Venezia,26,4082,157,8,0,3,0,0,4250,3556,409,7,1,0,1,0,3974,8224
IT-VE,Venezia,27,3999,214,6,0,2,0,0,4221,3315,494,10,0,2,2,0,3823,8044
IT-VE,Venezia,28,3905,338,9,0,5,0,0,4257,3045,671,23,0,5,0,0,3744,8001
IT-VE,Venezia,29,3631,378,9,0,2,0,0,4020,2894,889,18,1,3,0,0,3805,7825
IT-VE,Venezia,30,3482,513,15,0,7,0,0,4017,2874,1089,22,2,4,0,0,3991,8008
IT-VE,Venezia,31,3504,724,16,0,2,0,0,4246,2693,1252,33,3,3,2,1,3987,8233
IT-VE,Venezia,32,3267,894,19,5,2,1,0,4188,2491,1456,36,8,8,0,0,3999,8187
IT-VE,Venezia,33,3199,1080,25,4,13,2,0,4323,2471,1633,46,11,9,1,0,4171,8494
IT-VE,Venezia,34,2870,1186,28,3,8,2,0,4097,2252,1800,69,10,6,2,0,4139,8236
IT-VE,Venezia,35,2818,1456,47,4,5,2,0,4332,2093,1954,75,4,12,1,0,4139,8471
IT-VE,Venezia,36,2689,1544,58,7,6,0,0,4304,1992,1935,107,6,8,1,0,4049,8353
IT-VE,Venezia,37,2480,1611,55,7,14,0,0,4167,1870,2258,115,13,11,0,0,4267,8434
IT-VE,Venezia,38,2501,1808,60,5,8,0,0,4382,1847,2404,143,20,4,0,0,4418,8800
IT-VE,Venezia,39,2373,1960,82,4,9,1,0,4429,1754,2418,152,31,5,0,0,4360,8789
IT-VE,Venezia,40,2267,2159,90,10,9,0,0,4535,1696,2568,179,34,7,1,0,4485,9020
IT-VE,Venezia,41,2235,2298,110,10,5,0,0,4658,1719,2743,212,37,5,0,0,4716,9374
IT-VE,Venezia,42,2163,2485,139,23,7,1,0,4818,1574,2809,258,51,12,1,0,4705,9523
IT-VE,Venezia,43,2110,2577,155,15,10,0,0,4867,1531,2901,264,57,9,0,0,4762,9629
IT-VE,Venezia,44,2233,2851,195,16,9,0,0,5304,1561,3205,346,55,4,2,0,5173,10477
IT-VE,Venezia,45,2430,3013,219,14,16,1,0,5693,1671,3328,366,73,3,0,0,5441,11134
IT-VE,Venezia,46,2247,3123,221,17,13,0,0,5621,1745,3653,382,86,7,0,0,5873,11494
IT-VE,Venezia,47,2447,3406,252,25,9,0,0,6139,1652,3876,473,94,3,0,0,6098,12237
IT-VE,Venezia,48,2383,3655,316,22,16,0,0,6392,1699,4144,509,120,9,0,0,6481,12873
IT-VE,Venezia,49,2430,3977,350,31,15,0,1,6804,1797,4423,539,114,8,0,0,6881,13685
IT-VE,Venezia,50,2321,4131,413,34,5,0,0,6904,1651,4526,601,141,8,0,0,6927,13831
IT-VE,Venezia,51,2318,4251,449,54,8,0,0,7080,1612,4657,612,165,8,0,0,7054,14134
IT-VE,Venezia,52,2209,4340,446,41,8,1,1,7046,1434,4815,645,173,4,0,0,7071,14117
IT-VE,Venezia,53,1937,4471,483,57,11,1,0,6960,1408,4917,654,187,4,1,0,7171,14131
IT-VE,Venezia,54,1871,4824,609,53,11,0,1,7369,1314,5028,646,237,4,0,0,7229,14598
IT-VE,Venezia,55,1754,4722,506,41,7,0,0,7030,1234,5085,696,286,0,0,0,7301,14331
IT-VE,Venezia,56,1652,4854,557,66,12,0,0,7141,1209,5096,739,292,4,0,0,7340,14481
IT-VE,Venezia,57,1504,5045,538,80,11,0,0,7178,1133,5269,688,318,4,0,0,7412,14590
IT-VE,Venezia,58,1455,5069,588,93,8,0,0,7213,1086,5257,716,353,8,0,0,7420,14633
IT-VE,Venezia,59,1269,5286,614,100,3,0,0,7272,947,5598,744,433,2,0,0,7724,14996
IT-VE,Venezia,60,1190,4890,588,74,7,0,0,6749,873,5247,695,408,3,0,0,7226,13975
IT-VE,Venezia,61,1026,4871,543,145,9,0,0,6594,802,5089,619,481,2,0,0,6993,13587
IT-VE,Venezia,62,922,4869,489,137,8,1,0,6426,698,4970,616,532,2,0,0,6818,13244
IT-VE,Venezia,63,795,4678,417,145,11,0,1,6047,598,4627,549,613,1,0,0,6388,12435
IT-VE,Venezia,64,721,4604,427,147,8,0,0,5907,589,4605,527,657,2,0,0,6380,12287
IT-VE,Venezia,65,653,4220,378,161,9,0,0,5421,508,4366,450,675,0,0,0,5999,11420
IT-VE,Venezia,66,614,4148,360,161,9,0,0,5292,502,4213,423,740,3,0,0,5881,11173
IT-VE,Venezia,67,522,4111,303,190,7,0,0,5133,488,4021,366,826,2,0,0,5703,10836
IT-VE,Venezia,68,456,3887,259,182,8,0,0,4792,411,3782,405,820,2,0,0,5420,10212
IT-VE,Venezia,69,418,3836,285,209,2,0,0,4750,370,3776,339,907,1,0,0,5393,10143
IT-VE,Venezia,70,380,3831,247,233,4,0,0,4695,339,3468,315,940,1,0,0,5063,9758
IT-VE,Venezia,71,330,3747,214,266,3,0,0,4560,327,3441,289,1043,0,0,0,5100,9660
IT-VE,Venezia,72,320,3529,181,260,9,0,1,4300,281,3344,257,1076,3,0,0,4961,9261
IT-VE,Venezia,73,339,3600,176,269,5,0,0,4389,282,3293,266,1278,0,0,0,5119,9508
IT-VE,Venezia,74,321,3685,166,358,2,0,0,4532,266,3292,238,1375,1,0,0,5172,9704
IT-VE,Venezia,75,312,3716,161,333,3,0,0,4525,265,3218,204,1592,0,0,0,5279,9804
IT-VE,Venezia,76,270,3663,141,409,2,0,0,4485,257,2991,226,1755,0,0,0,5229,9714
IT-VE,Venezia,77,277,3739,140,469,1,0,1,4627,278,3030,195,2021,2,0,0,5526,10153
IT-VE,Venezia,78,172,2425,73,348,3,0,0,3021,181,1959,148,1489,0,0,0,3777,6798
IT-VE,Venezia,79,230,2799,91,451,0,0,0,3571,210,2160,117,1919,0,0,0,4406,7977
IT-VE,Venezia,80,195,2619,72,479,1,0,0,3366,235,2011,115,1970,0,0,0,4331,7697
IT-VE,Venezia,81,225,2459,75,480,2,0,0,3241,212,1737,126,2132,0,0,0,4207,7448
IT-VE,Venezia,82,177,2306,66,491,1,0,0,3041,206,1458,109,2231,0,0,0,4004,7045
IT-VE,Venezia,83,150,2303,48,549,0,0,0,3050,213,1513,97,2410,0,0,0,4233,7283
IT-VE,Venezia,84,167,2023,42,525,0,0,0,2757,194,1154,92,2371,0,0,0,3811,6568
IT-VE,Venezia,85,118,1611,35,547,1,0,0,2312,182,935,67,2469,0,0,0,3653,5965
IT-VE,Venezia,86,109,1399,34,481,0,0,0,2023,166,684,54,2260,0,0,0,3164,5187
IT-VE,Venezia,87,81,1025,18,413,0,0,0,1537,167,518,41,2123,0,0,0,2849,4386
IT-VE,Venezia,88,58,986,15,405,0,0,0,1464,125,395,50,1938,0,0,0,2508,3972
IT-VE,Venezia,89,66,775,17,379,0,0,0,1237,100,304,25,1797,0,0,0,2226,3463
IT-VE,Venezia,90,43,547,10,279,0,0,0,879,93,180,31,1535,0,0,0,1839,2718
IT-VE,Venezia,91,36,434,6,292,0,0,0,768,85,130,14,1356,0,0,0,1585,2353
IT-VE,Venezia,92,27,330,1,228,0,0,0,586,88,102,14,1138,0,0,0,1342,1928
IT-VE,Venezia,93,20,233,2,157,0,0,0,412,75,68,15,1009,0,0,0,1167,1579
IT-VE,Venezia,94,16,126,2,122,0,0,0,266,46,26,7,744,0,0,0,823,1089
IT-VE,Venezia,95,12,85,3,117,0,0,0,217,39,24,7,571,0,0,0,641,858
IT-VE,Venezia,96,9,50,1,89,0,0,0,149,43,14,4,467,0,0,0,528,677
IT-VE,Venezia,97,3,29,0,62,0,0,0,94,23,5,5,331,0,0,0,364,458
IT-VE,Venezia,98,1,24,0,33,0,0,0,58,25,1,2,212,0,0,0,240,298
IT-VE,Venezia,99,3,10,1,19,0,0,0,33,13,1,2,140,0,0,0,156,189
IT-VE,Venezia,100,0,7,0,23,0,0,0,30,28,2,0,270,0,0,0,300,330
IT-VE,Venezia,999,192669,188862,13787,11958,398,13,6,407693,162510,191665,19259,54038,224,15,1,427712,835405
IT-VB,Verbano-Cusio-Ossola,0,404,0,0,0,0,0,0,404,356,0,0,0,0,0,0,356,760
IT-VB,Verbano-Cusio-Ossola,1,387,0,0,0,0,0,0,387,392,0,0,0,0,0,0,392,779
IT-VB,Verbano-Cusio-Ossola,2,473,0,0,0,0,0,0,473,432,0,0,0,0,0,0,432,905
IT-VB,Verbano-Cusio-Ossola,3,450,0,0,0,0,0,0,450,445,0,0,0,0,0,0,445,895
IT-VB,Verbano-Cusio-Ossola,4,432,0,0,0,0,0,0,432,401,0,0,0,0,0,0,401,833
IT-VB,Verbano-Cusio-Ossola,5,466,0,0,0,0,0,0,466,465,0,0,0,0,0,0,465,931
IT-VB,Verbano-Cusio-Ossola,6,475,0,0,0,0,0,0,475,480,0,0,0,0,0,0,480,955
IT-VB,Verbano-Cusio-Ossola,7,538,0,0,0,0,0,0,538,503,0,0,0,0,0,0,503,1041
IT-VB,Verbano-Cusio-Ossola,8,545,0,0,0,0,0,0,545,556,0,0,0,0,0,0,556,1101
IT-VB,Verbano-Cusio-Ossola,9,606,0,0,0,0,0,0,606,560,0,0,0,0,0,0,560,1166
IT-VB,Verbano-Cusio-Ossola,10,588,0,0,0,0,0,0,588,601,0,0,0,0,0,0,601,1189
IT-VB,Verbano-Cusio-Ossola,11,586,0,0,0,0,0,0,586,629,0,0,0,0,0,0,629,1215
IT-VB,Verbano-Cusio-Ossola,12,655,0,0,0,0,0,0,655,615,0,0,0,0,0,0,615,1270
IT-VB,Verbano-Cusio-Ossola,13,671,0,0,0,0,0,0,671,629,0,0,0,0,0,0,629,1300
IT-VB,Verbano-Cusio-Ossola,14,698,0,0,0,0,0,0,698,660,0,0,0,0,0,0,660,1358
IT-VB,Verbano-Cusio-Ossola,15,713,0,0,0,0,0,0,713,626,0,0,0,0,0,0,626,1339
IT-VB,Verbano-Cusio-Ossola,16,647,0,0,0,0,0,0,647,644,0,0,0,0,0,0,644,1291
IT-VB,Verbano-Cusio-Ossola,17,719,0,0,0,0,0,0,719,668,0,0,0,0,0,0,668,1387
IT-VB,Verbano-Cusio-Ossola,18,711,0,0,0,0,0,0,711,669,1,0,0,0,0,0,670,1381
IT-VB,Verbano-Cusio-Ossola,19,776,0,0,0,0,0,0,776,650,2,0,0,0,0,0,652,1428
IT-VB,Verbano-Cusio-Ossola,20,749,1,0,0,0,0,0,750,669,3,0,0,0,0,0,672,1422
IT-VB,Verbano-Cusio-Ossola,21,732,2,1,0,0,0,0,735,583,6,2,0,0,0,0,591,1326
IT-VB,Verbano-Cusio-Ossola,22,766,1,2,0,0,0,0,769,661,17,0,0,0,0,0,678,1447
IT-VB,Verbano-Cusio-Ossola,23,746,5,0,0,0,0,0,751,704,23,1,0,0,0,0,728,1479
IT-VB,Verbano-Cusio-Ossola,24,745,10,2,0,0,0,0,757,640,22,0,0,0,0,0,662,1419
IT-VB,Verbano-Cusio-Ossola,25,797,23,0,0,0,0,0,820,677,46,0,1,0,0,0,724,1544
IT-VB,Verbano-Cusio-Ossola,26,751,9,0,0,0,0,0,760,637,53,5,0,0,0,0,695,1455
IT-VB,Verbano-Cusio-Ossola,27,736,36,0,0,0,0,0,772,591,84,4,0,0,0,0,679,1451
IT-VB,Verbano-Cusio-Ossola,28,691,49,2,0,0,0,0,742,567,107,4,0,0,0,0,678,1420
IT-VB,Verbano-Cusio-Ossola,29,691,59,3,0,0,0,0,753,541,164,5,1,0,0,0,711,1464
IT-VB,Verbano-Cusio-Ossola,30,706,73,6,0,1,0,0,786,501,142,11,0,0,0,0,654,1440
IT-VB,Verbano-Cusio-Ossola,31,624,100,0,0,3,0,0,727,467,193,9,3,1,0,0,673,1400
IT-VB,Verbano-Cusio-Ossola,32,625,117,3,2,1,0,0,748,502,245,11,1,0,0,0,759,1507
IT-VB,Verbano-Cusio-Ossola,33,583,172,7,1,0,0,0,763,426,266,19,2,2,0,0,715,1478
IT-VB,Verbano-Cusio-Ossola,34,513,186,12,0,1,0,0,712,412,276,16,3,1,0,0,708,1420
IT-VB,Verbano-Cusio-Ossola,35,544,238,12,0,1,0,0,795,369,334,17,4,0,0,0,724,1519
IT-VB,Verbano-Cusio-Ossola,36,494,231,8,0,0,0,0,733,339,332,24,2,0,0,0,697,1430
IT-VB,Verbano-Cusio-Ossola,37,469,253,16,0,1,1,0,740,336,350,28,7,5,1,0,727,1467
IT-VB,Verbano-Cusio-Ossola,38,472,303,22,0,0,0,0,797,309,386,37,4,0,0,0,736,1533
IT-VB,Verbano-Cusio-Ossola,39,430,327,24,0,2,0,0,783,330,385,41,4,2,0,0,762,1545
IT-VB,Verbano-Cusio-Ossola,40,430,350,30,1,0,0,0,811,283,416,32,5,2,0,0,738,1549
IT-VB,Verbano-Cusio-Ossola,41,449,379,25,0,0,0,0,853,306,449,39,4,1,0,0,799,1652
IT-VB,Verbano-Cusio-Ossola,42,407,421,29,1,0,0,0,858,286,438,61,12,0,0,0,797,1655
IT-VB,Verbano-Cusio-Ossola,43,414,409,40,2,1,0,0,866,315,505,55,6,0,0,0,881,1747
IT-VB,Verbano-Cusio-Ossola,44,425,433,44,1,3,0,0,906,245,542,69,12,1,0,0,869,1775
IT-VB,Verbano-Cusio-Ossola,45,433,474,52,2,2,0,0,963,271,591,100,13,2,0,0,977,1940
IT-VB,Verbano-Cusio-Ossola,46,456,468,64,3,0,0,0,991,317,618,93,13,1,0,0,1042,2033
IT-VB,Verbano-Cusio-Ossola,47,416,566,70,3,0,0,0,1055,289,693,115,13,0,0,0,1110,2165
IT-VB,Verbano-Cusio-Ossola,48,451,628,77,1,1,0,0,1158,303,759,116,19,4,0,0,1201,2359
IT-VB,Verbano-Cusio-Ossola,49,455,667,72,5,1,0,0,1200,343,752,128,27,1,0,0,1251,2451
IT-VB,Verbano-Cusio-Ossola,50,462,727,95,2,0,0,0,1286,306,796,127,23,1,0,0,1253,2539
IT-VB,Verbano-Cusio-Ossola,51,403,709,107,8,0,0,0,1227,296,825,160,24,0,0,0,1305,2532
IT-VB,Verbano-Cusio-Ossola,52,369,800,132,5,1,0,0,1307,270,846,187,44,0,0,0,1347,2654
IT-VB,Verbano-Cusio-Ossola,53,394,783,132,10,3,0,0,1322,264,842,152,39,0,0,0,1297,2619
IT-VB,Verbano-Cusio-Ossola,54,394,835,112,8,1,0,0,1350,244,935,156,57,2,0,0,1394,2744
IT-VB,Verbano-Cusio-Ossola,55,355,853,133,16,0,0,0,1357,234,964,180,52,0,0,0,1430,2787
IT-VB,Verbano-Cusio-Ossola,56,320,828,133,17,2,0,0,1300,210,930,178,61,2,0,0,1381,2681
IT-VB,Verbano-Cusio-Ossola,57,326,897,159,13,3,0,0,1398,234,954,167,69,2,0,0,1426,2824
IT-VB,Verbano-Cusio-Ossola,58,345,908,145,11,2,0,0,1411,205,908,178,74,0,0,0,1365,2776
IT-VB,Verbano-Cusio-Ossola,59,292,934,160,14,2,0,0,1402,200,950,157,94,0,0,1,1402,2804
IT-VB,Verbano-Cusio-Ossola,60,263,900,137,20,3,0,0,1323,171,897,170,92,0,0,0,1330,2653
IT-VB,Verbano-Cusio-Ossola,61,262,845,143,20,1,0,0,1271,128,900,165,105,2,0,0,1300,2571
IT-VB,Verbano-Cusio-Ossola,62,212,804,137,29,3,0,0,1185,142,844,143,115,1,0,0,1245,2430
IT-VB,Verbano-Cusio-Ossola,63,181,838,110,24,0,0,0,1153,126,801,141,141,0,0,0,1209,2362
IT-VB,Verbano-Cusio-Ossola,64,172,791,103,29,0,0,0,1095,117,756,126,138,0,0,0,1137,2232
IT-VB,Verbano-Cusio-Ossola,65,142,766,117,36,2,0,0,1063,97,793,121,158,0,0,0,1169,2232
IT-VB,Verbano-Cusio-Ossola,66,164,790,105,30,0,0,0,1089,105,736,102,165,0,0,0,1108,2197
IT-VB,Verbano-Cusio-Ossola,67,121,767,84,36,1,0,0,1009,86,712,98,163,0,0,0,1059,2068
IT-VB,Verbano-Cusio-Ossola,68,124,739,81,33,1,0,0,978,107,700,99,172,0,0,0,1078,2056
IT-VB,Verbano-Cusio-Ossola,69,108,714,80,38,1,0,0,941,70,742,81,216,0,0,0,1109,2050
IT-VB,Verbano-Cusio-Ossola,70,117,770,74,62,1,0,0,1024,78,704,74,204,0,0,0,1060,2084
IT-VB,Verbano-Cusio-Ossola,71,95,708,66,40,0,0,0,909,71,636,84,225,0,0,0,1016,1925
IT-VB,Verbano-Cusio-Ossola,72,87,677,58,63,0,0,0,885,73,584,69,268,0,0,0,994,1879
IT-VB,Verbano-Cusio-Ossola,73,102,736,64,75,0,0,1,978,58,612,69,288,0,0,0,1027,2005
IT-VB,Verbano-Cusio-Ossola,74,76,715,54,65,0,0,0,910,59,593,64,282,0,0,0,998,1908
IT-VB,Verbano-Cusio-Ossola,75,85,740,50,64,0,0,0,939,69,652,59,309,0,0,1,1090,2029
IT-VB,Verbano-Cusio-Ossola,76,77,694,43,69,1,0,0,884,48,582,43,392,0,0,0,1065,1949
IT-VB,Verbano-Cusio-Ossola,77,78,659,50,88,0,0,0,875,65,525,46,373,0,0,0,1009,1884
IT-VB,Verbano-Cusio-Ossola,78,54,460,26,63,1,0,0,604,37,347,36,305,0,0,0,725,1329
IT-VB,Verbano-Cusio-Ossola,79,47,495,18,67,0,0,0,627,45,387,29,403,1,0,0,865,1492
IT-VB,Verbano-Cusio-Ossola,80,44,433,19,91,0,0,0,587,51,331,28,395,0,0,0,805,1392
IT-VB,Verbano-Cusio-Ossola,81,34,448,18,82,0,0,0,582,43,336,29,395,0,0,0,803,1385
IT-VB,Verbano-Cusio-Ossola,82,40,470,30,96,1,0,0,637,43,306,30,466,0,0,0,845,1482
IT-VB,Verbano-Cusio-Ossola,83,49,436,27,127,0,0,0,639,60,279,18,481,0,0,1,839,1478
IT-VB,Verbano-Cusio-Ossola,84,35,376,16,120,0,0,0,547,35,228,27,533,1,0,0,824,1371
IT-VB,Verbano-Cusio-Ossola,85,32,327,8,107,1,0,0,475,50,207,15,471,0,0,0,743,1218
IT-VB,Verbano-Cusio-Ossola,86,25,292,8,93,0,0,0,418,36,151,12,477,0,0,0,676,1094
IT-VB,Verbano-Cusio-Ossola,87,17,219,10,77,0,0,0,323,23,98,10,393,0,0,0,524,847
IT-VB,Verbano-Cusio-Ossola,88,18,189,6,87,0,0,0,300,29,91,12,398,0,0,0,530,830
IT-VB,Verbano-Cusio-Ossola,89,19,134,4,76,0,0,0,233,25,71,11,373,0,0,0,480,713
IT-VB,Verbano-Cusio-Ossola,90,5,93,4,51,0,0,0,153,35,45,12,319,0,0,0,411,564
IT-VB,Verbano-Cusio-Ossola,91,12,71,2,39,0,0,0,124,30,34,4,282,0,0,0,350,474
IT-VB,Verbano-Cusio-Ossola,92,6,60,2,53,0,0,0,121,19,24,5,232,0,0,0,280,401
IT-VB,Verbano-Cusio-Ossola,93,6,45,3,33,0,0,0,87,12,16,1,225,0,0,0,254,341
IT-VB,Verbano-Cusio-Ossola,94,7,40,0,31,0,0,0,78,14,6,4,156,0,0,0,180,258
IT-VB,Verbano-Cusio-Ossola,95,3,18,0,25,0,0,0,46,16,4,2,118,0,0,0,140,186
IT-VB,Verbano-Cusio-Ossola,96,1,12,0,18,0,0,0,31,11,1,3,93,0,0,0,108,139
IT-VB,Verbano-Cusio-Ossola,97,1,6,0,9,0,0,0,16,7,4,0,73,0,0,0,84,100
IT-VB,Verbano-Cusio-Ossola,98,1,6,0,9,0,0,0,16,5,1,0,37,0,0,0,43,59
IT-VB,Verbano-Cusio-Ossola,99,1,3,0,7,0,0,0,11,2,1,0,37,0,0,0,40,51
IT-VB,Verbano-Cusio-Ossola,100,1,2,0,6,0,0,0,9,12,0,2,45,0,0,0,59,68
IT-VB,Verbano-Cusio-Ossola,999,35324,33552,3688,2314,49,1,1,74929,28973,33887,4728,11206,35,1,3,78833,153762
IT-VC,Vercelli,0,480,0,0,0,0,0,0,480,468,0,0,0,0,0,0,468,948
IT-VC,Vercelli,1,475,0,0,0,0,0,0,475,520,0,0,0,0,0,0,520,995
IT-VC,Vercelli,2,539,0,0,0,0,0,0,539,495,0,0,0,0,0,0,495,1034
IT-VC,Vercelli,3,520,0,0,0,0,0,0,520,517,0,0,0,0,0,0,517,1037
IT-VC,Vercelli,4,573,0,0,0,0,0,0,573,482,0,0,0,0,0,0,482,1055
IT-VC,Vercelli,5,560,0,0,0,0,0,0,560,580,0,0,0,0,0,0,580,1140
IT-VC,Vercelli,6,583,0,0,0,0,0,0,583,594,0,0,0,0,0,0,594,1177
IT-VC,Vercelli,7,638,0,0,0,0,0,0,638,566,0,0,0,0,0,0,566,1204
IT-VC,Vercelli,8,657,0,0,0,0,0,0,657,618,0,0,0,0,0,0,618,1275
IT-VC,Vercelli,9,685,0,0,0,0,0,0,685,613,0,0,0,0,0,0,613,1298
IT-VC,Vercelli,10,643,0,0,0,0,0,0,643,667,0,0,0,0,0,0,667,1310
IT-VC,Vercelli,11,721,0,0,0,0,0,0,721,701,0,0,0,0,0,0,701,1422
IT-VC,Vercelli,12,701,0,0,0,0,0,0,701,629,0,0,0,0,0,0,629,1330
IT-VC,Vercelli,13,738,0,0,0,0,0,0,738,648,0,0,0,0,0,0,648,1386
IT-VC,Vercelli,14,770,0,0,0,0,0,0,770,710,0,0,0,0,0,0,710,1480
IT-VC,Vercelli,15,724,0,0,0,0,0,0,724,706,0,0,0,0,0,0,706,1430
IT-VC,Vercelli,16,774,0,0,0,0,0,0,774,741,0,0,0,0,0,0,741,1515
IT-VC,Vercelli,17,756,0,0,0,0,0,0,756,707,0,0,0,0,0,0,707,1463
IT-VC,Vercelli,18,740,0,0,0,0,0,0,740,706,1,0,0,0,0,0,707,1447
IT-VC,Vercelli,19,758,0,0,0,0,0,0,758,676,2,0,0,0,0,0,678,1436
IT-VC,Vercelli,20,809,0,0,0,0,0,0,809,677,10,0,0,0,0,0,687,1496
IT-VC,Vercelli,21,771,3,0,0,0,0,0,774,691,16,0,0,0,0,0,707,1481
IT-VC,Vercelli,22,770,8,1,0,1,0,0,780,671,14,0,0,0,0,0,685,1465
IT-VC,Vercelli,23,840,9,0,0,0,0,0,849,690,24,2,0,0,0,0,716,1565
IT-VC,Vercelli,24,826,11,2,0,0,0,0,839,694,40,2,0,0,0,0,736,1575
IT-VC,Vercelli,25,838,9,4,0,0,0,0,851,680,53,2,0,0,0,0,735,1586
IT-VC,Vercelli,26,839,24,1,0,1,0,0,865,668,73,1,0,0,0,0,742,1607
IT-VC,Vercelli,27,803,41,1,1,1,0,0,847,656,97,7,1,0,0,0,761,1608
IT-VC,Vercelli,28,818,62,6,0,2,0,0,888,602,128,1,0,1,1,0,733,1621
IT-VC,Vercelli,29,774,70,5,0,0,1,0,850,563,143,3,1,0,0,0,710,1560
IT-VC,Vercelli,30,730,95,3,0,1,0,0,829,552,220,3,0,0,0,0,775,1604
IT-VC,Vercelli,31,750,155,4,1,0,0,0,910,537,230,18,0,0,0,0,785,1695
IT-VC,Vercelli,32,698,178,6,0,0,0,0,882,519,273,7,1,0,1,0,801,1683
IT-VC,Vercelli,33,685,213,11,2,2,1,0,914,469,325,22,2,0,1,0,819,1733
IT-VC,Vercelli,34,583,237,8,2,2,0,0,832,425,334,20,1,1,0,0,781,1613
IT-VC,Vercelli,35,562,281,21,1,0,0,0,865,433,377,18,2,3,0,0,833,1698
IT-VC,Vercelli,36,564,278,14,0,1,0,0,857,383,383,25,1,1,0,0,793,1650
IT-VC,Vercelli,37,535,294,26,4,3,0,0,862,337,479,33,1,0,0,0,850,1712
IT-VC,Vercelli,38,531,376,21,1,2,0,0,931,360,467,42,3,1,0,0,873,1804
IT-VC,Vercelli,39,512,373,34,3,1,0,0,923,356,475,28,4,0,0,0,863,1786
IT-VC,Vercelli,40,469,370,26,1,1,0,0,867,329,533,56,9,0,0,0,927,1794
IT-VC,Vercelli,41,497,467,27,1,1,0,0,993,311,549,54,4,0,0,0,918,1911
IT-VC,Vercelli,42,478,471,32,1,1,0,0,983,319,525,54,4,0,0,0,902,1885
IT-VC,Vercelli,43,403,493,40,4,1,0,0,941,290,594,64,11,0,0,0,959,1900
IT-VC,Vercelli,44,427,563,52,5,0,0,0,1047,265,587,71,9,0,0,0,932,1979
IT-VC,Vercelli,45,452,545,62,4,0,0,0,1063,308,652,87,14,1,0,0,1062,2125
IT-VC,Vercelli,46,458,574,61,5,0,0,0,1098,305,749,97,19,2,0,0,1172,2270
IT-VC,Vercelli,47,425,664,68,5,1,0,0,1163,296,727,106,20,0,1,0,1150,2313
IT-VC,Vercelli,48,455,683,85,5,2,0,0,1230,260,785,131,22,0,0,0,1198,2428
IT-VC,Vercelli,49,462,692,77,7,0,0,0,1238,253,744,120,25,2,0,0,1144,2382
IT-VC,Vercelli,50,412,716,113,4,1,0,0,1246,257,887,125,22,2,0,0,1293,2539
IT-VC,Vercelli,51,440,763,108,11,0,0,0,1322,291,839,137,42,5,0,0,1314,2636
IT-VC,Vercelli,52,416,815,111,5,1,0,0,1348,261,890,158,32,1,0,0,1342,2690
IT-VC,Vercelli,53,398,780,111,9,2,0,0,1300,199,864,175,51,0,0,0,1289,2589
IT-VC,Vercelli,54,350,881,135,11,2,0,0,1379,228,948,171,41,1,0,0,1389,2768
IT-VC,Vercelli,55,358,853,137,11,3,0,0,1362,214,907,172,54,1,0,0,1348,2710
IT-VC,Vercelli,56,308,898,143,9,1,0,0,1359,188,917,160,79,0,0,0,1344,2703
IT-VC,Vercelli,57,301,927,127,13,1,0,0,1369,170,955,214,83,0,0,0,1422,2791
IT-VC,Vercelli,58,296,995,155,17,2,0,0,1465,199,1028,156,85,0,0,0,1468,2933
IT-VC,Vercelli,59,277,954,148,24,0,0,0,1403,185,1031,163,85,0,0,0,1464,2867
IT-VC,Vercelli,60,245,982,132,17,2,0,0,1378,157,983,150,90,0,0,0,1380,2758
IT-VC,Vercelli,61,256,958,129,25,2,0,0,1370,139,934,156,127,1,0,0,1357,2727
IT-VC,Vercelli,62,206,935,131,21,2,0,0,1295,141,942,132,161,0,0,0,1376,2671
IT-VC,Vercelli,63,203,898,124,37,2,0,0,1264,107,944,128,162,0,0,0,1341,2605
IT-VC,Vercelli,64,182,858,107,35,2,0,0,1184,95,867,117,138,0,0,0,1217,2401
IT-VC,Vercelli,65,157,893,89,31,0,0,0,1170,100,876,123,183,0,0,0,1282,2452
IT-VC,Vercelli,66,137,830,100,34,3,0,0,1104,78,849,131,157,0,0,0,1215,2319
IT-VC,Vercelli,67,129,805,85,50,2,0,0,1071,66,790,108,224,0,0,0,1188,2259
IT-VC,Vercelli,68,136,837,93,58,0,0,0,1124,66,784,84,201,0,0,0,1135,2259
IT-VC,Vercelli,69,114,781,96,45,0,0,0,1036,75,755,97,213,0,0,0,1140,2176
IT-VC,Vercelli,70,99,782,72,47,1,0,0,1001,74,710,70,241,0,0,0,1095,2096
IT-VC,Vercelli,71,103,816,67,49,0,0,0,1035,52,684,73,263,0,0,0,1072,2107
IT-VC,Vercelli,72,87,778,62,70,0,0,0,997,37,687,69,256,0,0,0,1049,2046
IT-VC,Vercelli,73,97,785,54,72,0,0,0,1008,57,645,64,343,0,0,0,1109,2117
IT-VC,Vercelli,74,88,740,56,75,0,0,0,959,44,675,61,356,0,0,0,1136,2095
IT-VC,Vercelli,75,84,793,47,99,0,0,0,1023,45,668,77,377,0,0,0,1167,2190
IT-VC,Vercelli,76,73,720,52,86,1,0,0,932,52,579,65,401,0,0,0,1097,2029
IT-VC,Vercelli,77,78,666,37,103,1,0,0,885,48,533,52,436,0,0,0,1069,1954
IT-VC,Vercelli,78,55,465,22,68,0,0,0,610,30,346,27,350,0,0,0,753,1363
IT-VC,Vercelli,79,46,499,22,89,0,0,0,656,41,356,41,390,0,0,0,828,1484
IT-VC,Vercelli,80,46,416,27,83,1,0,0,573,37,352,23,435,0,0,0,847,1420
IT-VC,Vercelli,81,42,443,20,80,0,0,0,585,39,297,28,419,0,0,0,783,1368
IT-VC,Vercelli,82,47,402,16,99,0,0,0,564,43,327,21,430,0,0,0,821,1385
IT-VC,Vercelli,83,40,466,18,117,0,0,0,641,52,273,24,543,0,0,0,892,1533
IT-VC,Vercelli,84,34,417,12,135,0,0,0,598,49,253,29,607,0,0,0,938,1536
IT-VC,Vercelli,85,39,335,12,112,0,0,0,498,37,205,23,566,0,0,0,831,1329
IT-VC,Vercelli,86,37,286,5,109,0,0,0,437,41,135,16,536,0,0,0,728,1165
IT-VC,Vercelli,87,31,219,6,114,0,0,0,370,31,114,14,458,0,0,0,617,987
IT-VC,Vercelli,88,28,195,5,92,0,0,0,320,31,74,8,502,0,0,0,615,935
IT-VC,Vercelli,89,13,164,5,95,0,0,0,277,28,58,6,421,0,0,0,513,790
IT-VC,Vercelli,90,11,107,1,66,0,0,0,185,29,33,8,363,0,0,0,433,618
IT-VC,Vercelli,91,6,82,2,75,0,0,0,165,25,19,4,365,0,0,0,413,578
IT-VC,Vercelli,92,5,73,0,49,0,0,0,127,17,29,3,289,0,0,0,338,465
IT-VC,Vercelli,93,6,51,0,45,0,0,0,102,27,14,3,257,0,0,0,301,403
IT-VC,Vercelli,94,4,22,0,35,0,0,0,61,15,12,3,200,0,0,0,230,291
IT-VC,Vercelli,95,4,12,0,23,0,0,0,39,9,2,3,145,0,0,0,159,198
IT-VC,Vercelli,96,4,9,0,19,0,0,0,32,9,4,0,119,0,0,0,132,164
IT-VC,Vercelli,97,2,5,0,13,0,0,0,20,6,0,3,67,0,0,0,76,96
IT-VC,Vercelli,98,2,7,0,11,0,0,0,20,4,2,0,46,0,0,0,52,72
IT-VC,Vercelli,99,0,2,0,8,0,0,0,10,4,0,0,35,0,0,0,39,49
IT-VC,Vercelli,100,2,4,0,13,0,0,0,19,6,0,1,51,0,0,0,58,77
IT-VC,Vercelli,999,38333,36359,3692,2671,56,2,0,81113,30478,36685,4750,12651,23,4,0,84591,165704
IT-VR,Verona,0,3194,0,0,0,0,0,0,3194,3039,0,0,0,0,0,0,3039,6233
IT-VR,Verona,1,3344,0,0,0,0,0,0,3344,3193,0,0,0,0,0,0,3193,6537
IT-VR,Verona,2,3457,0,0,0,0,0,0,3457,3355,0,0,0,0,0,0,3355,6812
IT-VR,Verona,3,3614,0,0,0,0,0,0,3614,3382,0,0,0,0,0,0,3382,6996
IT-VR,Verona,4,3754,0,0,0,0,0,0,3754,3485,0,0,0,0,0,0,3485,7239
IT-VR,Verona,5,3941,0,0,0,0,0,0,3941,3698,0,0,0,0,0,0,3698,7639
IT-VR,Verona,6,4033,0,0,0,0,0,0,4033,3816,0,0,0,0,0,0,3816,7849
IT-VR,Verona,7,4169,0,0,0,0,0,0,4169,3895,0,0,0,0,0,0,3895,8064
IT-VR,Verona,8,4305,0,0,0,0,0,0,4305,4027,0,0,0,0,0,0,4027,8332
IT-VR,Verona,9,4313,0,0,0,0,0,0,4313,4086,0,0,0,0,0,0,4086,8399
IT-VR,Verona,10,4278,0,0,0,0,0,0,4278,4082,0,0,0,0,0,0,4082,8360
IT-VR,Verona,11,4533,0,0,0,0,0,0,4533,4194,0,0,0,0,0,0,4194,8727
IT-VR,Verona,12,4597,0,0,0,0,0,0,4597,4302,0,0,0,0,0,0,4302,8899
IT-VR,Verona,13,4776,0,0,0,0,0,0,4776,4478,0,0,0,0,0,0,4478,9254
IT-VR,Verona,14,4835,0,0,0,0,0,0,4835,4464,0,0,0,0,0,0,4464,9299
IT-VR,Verona,15,4800,0,0,0,0,0,0,4800,4633,0,0,0,0,0,0,4633,9433
IT-VR,Verona,16,4777,0,0,0,0,0,0,4777,4488,0,0,0,0,0,0,4488,9265
IT-VR,Verona,17,4746,0,0,0,0,0,0,4746,4496,0,0,0,0,0,0,4496,9242
IT-VR,Verona,18,4830,1,0,0,0,0,0,4831,4476,3,0,0,0,0,0,4479,9310
IT-VR,Verona,19,4818,1,0,0,0,0,0,4819,4476,10,0,0,0,0,0,4486,9305
IT-VR,Verona,20,4637,1,0,0,0,0,0,4638,4336,22,0,0,0,0,0,4358,8996
IT-VR,Verona,21,4741,9,0,0,0,0,0,4750,4249,58,1,0,0,0,0,4308,9058
IT-VR,Verona,22,4687,11,1,0,1,0,0,4700,4268,90,5,0,0,0,0,4363,9063
IT-VR,Verona,23,4757,36,5,0,1,0,0,4799,4363,175,6,0,1,0,0,4545,9344
IT-VR,Verona,24,4985,56,3,0,0,0,0,5044,4330,260,8,0,0,0,0,4598,9642
IT-VR,Verona,25,4907,104,8,0,1,0,0,5020,4215,354,7,1,0,0,0,4577,9597
IT-VR,Verona,26,4767,150,8,0,2,0,0,4927,4131,505,13,0,1,0,0,4650,9577
IT-VR,Verona,27,4757,272,10,1,1,0,0,5041,3856,712,22,1,4,0,0,4595,9636
IT-VR,Verona,28,4633,429,14,0,9,1,0,5086,3722,973,20,2,2,0,0,4719,9805
IT-VR,Verona,29,4416,544,19,1,6,0,0,4986,3622,1241,24,0,7,0,0,4894,9880
IT-VR,Verona,30,4256,773,18,0,4,0,0,5051,3377,1479,32,2,5,0,0,4895,9946
IT-VR,Verona,31,4221,1034,26,0,4,0,0,5285,3188,1787,55,3,7,1,0,5041,10326
IT-VR,Verona,32,3876,1261,30,4,2,1,0,5174,2994,2054,67,7,8,0,0,5130,10304
IT-VR,Verona,33,3795,1503,39,1,7,0,0,5345,2754,2287,79,8,8,0,0,5136,10481
IT-VR,Verona,34,3573,1773,43,1,14,0,0,5404,2574,2441,120,8,15,1,0,5159,10563
IT-VR,Verona,35,3477,2034,62,5,11,0,0,5589,2392,2796,132,17,11,2,0,5350,10939
IT-VR,Verona,36,3055,2186,62,7,7,1,0,5318,2207,2914,151,15,14,2,0,5303,10621
IT-VR,Verona,37,2892,2258,82,6,11,0,0,5249,2063,3020,188,19,6,0,0,5296,10545
IT-VR,Verona,38,2915,2581,131,3,15,1,0,5646,1977,3270,235,25,10,1,0,5518,11164
IT-VR,Verona,39,2682,2684,108,6,7,1,0,5488,1853,3423,260,27,6,0,0,5569,11057
IT-VR,Verona,40,2510,2946,162,6,8,1,0,5633,1880,3369,271,35,10,0,0,5565,11198
IT-VR,Verona,41,2559,3087,169,7,7,2,0,5831,1748,3627,331,29,9,0,0,5744,11575
IT-VR,Verona,42,2539,3285,198,23,7,0,0,6052,1744,3714,342,63,7,0,0,5870,11922
IT-VR,Verona,43,2355,3575,250,25,10,1,0,6216,1599,3842,387,52,8,0,0,5888,12104
IT-VR,Verona,44,2394,3570,275,17,9,1,1,6267,1698,4041,468,62,10,3,0,6282,12549
IT-VR,Verona,45,2445,3714,327,28,7,0,0,6521,1674,4253,497,74,6,1,0,6505,13026
IT-VR,Verona,46,2442,3938,350,24,13,0,0,6767,1562,4372,551,92,7,1,0,6585,13352
IT-VR,Verona,47,2408,4196,398,24,11,1,0,7038,1547,4626,624,106,5,0,0,6908,13946
IT-VR,Verona,48,2378,4485,455,35,14,0,0,7367,1516,4921,704,120,5,1,0,7267,14634
IT-VR,Verona,49,2428,4732,511,31,13,0,0,7715,1540,5067,747,154,8,0,0,7516,15231
IT-VR,Verona,50,2230,4661,599,37,12,0,0,7539,1498,4934,781,142,12,0,0,7367,14906
IT-VR,Verona,51,2169,4947,559,49,22,0,0,7746,1342,5103,844,153,8,2,0,7452,15198
IT-VR,Verona,52,2103,4987,622,49,17,0,0,7778,1353,5115,868,195,9,0,0,7540,15318
IT-VR,Verona,53,2006,5030,616,43,6,0,0,7701,1252,5020,870,223,1,0,0,7366,15067
IT-VR,Verona,54,1818,5252,698,55,11,1,1,7836,1195,5361,896,258,7,0,0,7717,15553
IT-VR,Verona,55,1681,5187,715,59,9,0,0,7651,1103,5299,821,271,1,0,1,7496,15147
IT-VR,Verona,56,1493,5386,710,62,7,0,0,7658,1099,5233,869,298,6,0,0,7505,15163
IT-VR,Verona,57,1461,5341,724,79,10,0,0,7615,1016,5385,898,337,5,1,0,7642,15257
IT-VR,Verona,58,1310,5391,764,86,10,0,0,7561,977,5346,883,354,10,0,1,7571,15132
IT-VR,Verona,59,1228,5422,782,76,4,0,0,7512,929,5335,904,444,0,1,0,7613,15125
IT-VR,Verona,60,1199,5154,681,89,13,0,0,7136,791,5047,783,451,7,0,0,7079,14215
IT-VR,Verona,61,986,4898,631,116,15,0,0,6646,721,4702,753,489,3,1,0,6669,13315
IT-VR,Verona,62,862,4808,583,127,13,0,0,6393,690,4608,715,571,5,0,0,6589,12982
IT-VR,Verona,63,859,4536,516,122,8,0,0,6041,575,4386,636,605,6,1,0,6209,12250
IT-VR,Verona,64,746,4466,532,135,11,0,0,5890,556,4448,499,629,4,0,0,6136,12026
IT-VR,Verona,65,648,4317,454,137,7,0,0,5563,508,4197,491,684,1,0,0,5881,11444
IT-VR,Verona,66,633,4136,406,156,7,0,0,5338,505,4054,462,768,3,0,0,5792,11130
IT-VR,Verona,67,578,4148,421,177,1,0,0,5325,466,3880,453,841,0,0,0,5640,10965
IT-VR,Verona,68,497,4049,341,174,6,0,0,5067,371,3829,399,865,4,0,0,5468,10535
IT-VR,Verona,69,472,3893,336,191,6,0,1,4899,382,3630,373,908,0,0,0,5293,10192
IT-VR,Verona,70,425,3801,260,209,6,0,0,4701,318,3389,321,926,0,0,0,4954,9655
IT-VR,Verona,71,406,3636,251,224,8,0,0,4525,313,3313,281,987,0,0,0,4894,9419
IT-VR,Verona,72,340,3628,213,236,2,0,0,4419,310,3256,302,1064,1,0,0,4933,9352
IT-VR,Verona,73,356,3710,192,253,0,0,0,4511,290,3316,277,1236,1,0,0,5120,9631
IT-VR,Verona,74,316,3528,173,284,3,1,0,4305,296,3140,271,1362,1,0,0,5070,9375
IT-VR,Verona,75,324,3667,171,340,1,0,1,4504,274,3232,225,1520,1,0,0,5252,9756
IT-VR,Verona,76,315,3503,138,353,1,0,0,4310,291,2885,231,1701,0,0,0,5108,9418
IT-VR,Verona,77,371,3704,178,398,2,0,0,4653,348,3058,224,1937,0,0,0,5567,10220
IT-VR,Verona,78,194,2331,87,312,2,0,0,2926,218,1801,143,1332,2,0,0,3496,6422
IT-VR,Verona,79,236,2560,106,343,3,0,0,3248,272,2015,112,1714,0,0,0,4113,7361
IT-VR,Verona,80,239,2557,89,377,2,0,0,3264,275,1892,149,1909,0,0,0,4225,7489
IT-VR,Verona,81,223,2309,73,398,2,0,0,3005,265,1703,138,1952,1,0,0,4059,7064
IT-VR,Verona,82,164,2210,66,426,3,0,0,2869,269,1458,103,1999,0,0,1,3830,6699
IT-VR,Verona,83,195,2074,62,493,2,0,0,2826,256,1345,83,2191,1,0,0,3876,6702
IT-VR,Verona,84,163,2061,43,472,0,0,0,2739,286,1158,82,2385,0,0,0,3911,6650
IT-VR,Verona,85,168,1703,40,431,0,0,0,2342,235,988,73,2261,0,0,0,3557,5899
IT-VR,Verona,86,125,1449,35,443,0,0,0,2052,218,667,54,2151,0,0,0,3090,5142
IT-VR,Verona,87,101,1157,14,397,0,0,0,1669,182,499,32,1916,0,0,0,2629,4298
IT-VR,Verona,88,95,943,26,340,1,0,0,1405,222,382,35,1888,0,0,0,2527,3932
IT-VR,Verona,89,76,758,13,370,0,0,0,1217,185,298,27,1733,0,0,0,2243,3460
IT-VR,Verona,90,64,571,11,296,0,0,0,942,173,170,23,1484,0,0,0,1850,2792
IT-VR,Verona,91,41,418,6,233,0,0,0,698,141,120,15,1428,0,0,0,1704,2402
IT-VR,Verona,92,40,335,9,195,0,0,0,579,127,90,12,1169,0,0,0,1398,1977
IT-VR,Verona,93,26,190,3,178,0,0,0,397,110,54,8,995,0,0,0,1167,1564
IT-VR,Verona,94,25,153,2,133,0,0,0,313,90,37,7,755,0,0,0,889,1202
IT-VR,Verona,95,16,103,2,93,0,0,0,214,71,18,5,565,0,0,0,659,873
IT-VR,Verona,96,9,62,2,83,0,0,0,156,55,12,3,468,0,0,0,538,694
IT-VR,Verona,97,5,41,0,59,0,0,0,105,33,5,4,313,0,0,0,355,460
IT-VR,Verona,98,2,24,0,37,0,0,0,63,32,0,0,217,0,0,0,249,312
IT-VR,Verona,99,0,13,0,22,0,0,0,35,16,7,0,163,0,0,0,186,221
IT-VR,Verona,100,5,11,0,29,0,0,0,45,29,0,0,260,0,0,0,289,334
IT-VR,Verona,999,221645,206448,17719,10731,435,13,4,456995,186573,206926,23785,52389,280,19,3,469975,926970
IT-VV,Vibo Valentia,0,584,0,0,0,0,0,0,584,527,0,0,0,0,0,0,527,1111
IT-VV,Vibo Valentia,1,595,0,0,0,0,0,0,595,522,0,0,0,0,0,0,522,1117
IT-VV,Vibo Valentia,2,543,0,0,0,0,0,0,543,543,0,0,0,0,0,0,543,1086
IT-VV,Vibo Valentia,3,598,0,0,0,0,0,0,598,557,0,0,0,0,0,0,557,1155
IT-VV,Vibo Valentia,4,620,0,0,0,0,0,0,620,542,0,0,0,0,0,0,542,1162
IT-VV,Vibo Valentia,5,602,0,0,0,0,0,0,602,610,0,0,0,0,0,0,610,1212
IT-VV,Vibo Valentia,6,622,0,0,0,0,0,0,622,588,0,0,0,0,0,0,588,1210
IT-VV,Vibo Valentia,7,610,0,0,0,0,0,0,610,595,0,0,0,0,0,0,595,1205
IT-VV,Vibo Valentia,8,655,0,0,0,0,0,0,655,615,0,0,0,0,0,0,615,1270
IT-VV,Vibo Valentia,9,684,0,0,0,0,0,0,684,627,0,0,0,0,0,0,627,1311
IT-VV,Vibo Valentia,10,658,0,0,0,0,0,0,658,592,0,0,0,0,0,0,592,1250
IT-VV,Vibo Valentia,11,732,0,0,0,0,0,0,732,642,0,0,0,0,0,0,642,1374
IT-VV,Vibo Valentia,12,679,0,0,0,0,0,0,679,657,0,0,0,0,0,0,657,1336
IT-VV,Vibo Valentia,13,733,0,0,0,0,0,0,733,723,0,0,0,0,0,0,723,1456
IT-VV,Vibo Valentia,14,710,0,0,0,0,0,0,710,705,0,0,0,0,0,0,705,1415
IT-VV,Vibo Valentia,15,745,0,0,0,0,0,0,745,782,0,0,0,0,0,0,782,1527
IT-VV,Vibo Valentia,16,804,0,0,0,0,0,0,804,742,0,0,0,0,0,0,742,1546
IT-VV,Vibo Valentia,17,772,0,0,0,0,0,0,772,770,0,0,0,0,0,0,770,1542
IT-VV,Vibo Valentia,18,853,0,0,0,0,0,0,853,753,0,0,0,0,0,0,753,1606
IT-VV,Vibo Valentia,19,825,0,0,0,0,0,0,825,798,2,0,0,0,0,0,800,1625
IT-VV,Vibo Valentia,20,876,0,0,0,0,0,0,876,760,4,0,0,0,0,0,764,1640
IT-VV,Vibo Valentia,21,808,1,0,0,0,0,0,809,737,16,0,0,0,0,0,753,1562
IT-VV,Vibo Valentia,22,927,1,1,0,0,0,0,929,757,38,0,0,0,0,0,795,1724
IT-VV,Vibo Valentia,23,934,4,0,0,0,0,0,938,714,33,0,0,0,0,0,747,1685
IT-VV,Vibo Valentia,24,887,14,0,0,0,0,0,901,718,56,0,0,0,0,0,774,1675
IT-VV,Vibo Valentia,25,899,33,0,0,0,0,0,932,723,75,0,0,0,0,0,798,1730
IT-VV,Vibo Valentia,26,855,43,0,0,0,0,0,898,716,128,0,0,0,0,0,844,1742
IT-VV,Vibo Valentia,27,829,61,0,0,0,0,0,890,620,167,1,0,0,0,0,788,1678
IT-VV,Vibo Valentia,28,784,93,0,0,0,0,0,877,618,214,2,0,0,0,0,834,1711
IT-VV,Vibo Valentia,29,781,119,1,0,0,0,0,901,552,251,3,1,0,0,0,807,1708
IT-VV,Vibo Valentia,30,730,164,0,0,0,0,0,894,496,341,5,0,0,0,0,842,1736
IT-VV,Vibo Valentia,31,714,231,1,0,0,0,0,946,493,410,3,0,0,0,0,906,1852
IT-VV,Vibo Valentia,32,603,258,2,0,0,0,0,863,419,402,2,0,0,0,0,823,1686
IT-VV,Vibo Valentia,33,622,311,2,0,0,0,0,935,392,473,7,1,0,0,0,873,1808
IT-VV,Vibo Valentia,34,591,348,2,0,0,0,0,941,333,499,9,2,0,0,0,843,1784
IT-VV,Vibo Valentia,35,536,405,4,0,0,0,0,945,366,528,6,0,0,0,0,900,1845
IT-VV,Vibo Valentia,36,492,406,3,1,0,0,0,902,288,563,5,3,0,0,0,859,1761
IT-VV,Vibo Valentia,37,435,455,6,1,0,0,0,897,309,584,18,5,0,0,0,916,1813
IT-VV,Vibo Valentia,38,421,449,8,1,0,0,0,879,260,645,17,2,0,0,0,924,1803
IT-VV,Vibo Valentia,39,427,522,7,2,1,0,0,959,251,574,14,5,0,0,0,844,1803
IT-VV,Vibo Valentia,40,398,515,6,0,0,0,0,919,191,580,19,5,0,0,0,795,1714
IT-VV,Vibo Valentia,41,349,553,14,0,0,0,0,916,199,692,17,10,0,0,0,918,1834
IT-VV,Vibo Valentia,42,339,529,17,2,1,0,0,888,218,658,21,7,0,0,0,904,1792
IT-VV,Vibo Valentia,43,303,595,13,1,0,0,0,912,167,674,27,10,0,0,0,878,1790
IT-VV,Vibo Valentia,44,290,618,10,0,0,0,0,918,206,710,30,11,0,0,0,957,1875
IT-VV,Vibo Valentia,45,321,607,15,3,0,0,0,946,220,707,22,12,0,0,0,961,1907
IT-VV,Vibo Valentia,46,310,638,20,4,0,0,0,972,182,775,39,17,0,0,0,1013,1985
IT-VV,Vibo Valentia,47,294,683,19,1,0,0,0,997,182,864,33,19,0,0,0,1098,2095
IT-VV,Vibo Valentia,48,300,735,31,5,0,0,0,1071,161,796,52,18,0,0,0,1027,2098
IT-VV,Vibo Valentia,49,264,708,25,3,0,0,0,1000,179,883,36,28,0,0,0,1126,2126
IT-VV,Vibo Valentia,50,256,773,27,4,0,0,0,1060,160,867,37,30,0,0,0,1094,2154
IT-VV,Vibo Valentia,51,270,771,21,12,0,0,0,1074,166,853,50,34,0,0,0,1103,2177
IT-VV,Vibo Valentia,52,247,813,32,8,0,0,0,1100,142,867,22,57,0,0,0,1088,2188
IT-VV,Vibo Valentia,53,240,724,33,5,0,0,0,1002,167,884,42,44,1,0,0,1138,2140
IT-VV,Vibo Valentia,54,245,805,34,7,0,0,0,1091,163,977,47,46,0,0,0,1233,2324
IT-VV,Vibo Valentia,55,217,849,34,15,1,0,0,1116,166,919,41,58,0,0,0,1184,2300
IT-VV,Vibo Valentia,56,216,837,36,16,0,0,0,1105,164,889,33,65,0,0,0,1151,2256
IT-VV,Vibo Valentia,57,218,903,31,8,0,0,0,1160,144,993,30,80,0,0,0,1247,2407
IT-VV,Vibo Valentia,58,191,855,36,19,0,0,0,1101,129,882,38,83,0,0,0,1132,2233
IT-VV,Vibo Valentia,59,205,944,30,17,0,0,0,1196,145,999,37,98,0,0,0,1279,2475
IT-VV,Vibo Valentia,60,185,903,30,12,0,0,0,1130,95,927,30,114,0,0,0,1166,2296
IT-VV,Vibo Valentia,61,154,888,27,21,0,0,0,1090,135,943,32,113,0,0,0,1223,2313
IT-VV,Vibo Valentia,62,167,840,25,25,0,0,0,1057,104,904,27,137,0,0,0,1172,2229
IT-VV,Vibo Valentia,63,153,852,42,18,0,0,0,1065,96,909,28,137,0,0,0,1170,2235
IT-VV,Vibo Valentia,64,131,839,25,28,0,0,0,1023,100,837,40,153,0,0,0,1130,2153
IT-VV,Vibo Valentia,65,120,808,22,33,0,0,0,983,78,754,29,139,0,0,0,1000,1983
IT-VV,Vibo Valentia,66,135,771,27,30,0,0,0,963,98,756,26,174,0,0,0,1054,2017
IT-VV,Vibo Valentia,67,113,803,23,32,0,0,0,971,71,678,21,198,0,0,0,968,1939
IT-VV,Vibo Valentia,68,95,829,26,31,1,0,0,982,88,655,24,202,0,0,0,969,1951
IT-VV,Vibo Valentia,69,104,761,16,35,0,0,0,916,61,671,25,194,0,0,0,951,1867
IT-VV,Vibo Valentia,70,87,795,23,34,0,0,0,939,78,607,19,222,0,0,0,926,1865
IT-VV,Vibo Valentia,71,67,716,20,37,0,0,0,840,69,548,19,225,0,0,0,861,1701
IT-VV,Vibo Valentia,72,62,749,22,32,0,0,0,865,64,534,17,219,0,0,0,834,1699
IT-VV,Vibo Valentia,73,60,723,21,45,0,0,0,849,59,531,19,273,0,0,0,882,1731
IT-VV,Vibo Valentia,74,59,728,13,53,0,0,0,853,65,508,11,311,0,0,0,895,1748
IT-VV,Vibo Valentia,75,45,696,15,66,1,0,0,823,54,490,16,339,0,0,0,899,1722
IT-VV,Vibo Valentia,76,57,671,10,62,0,0,0,800,53,404,10,331,0,0,0,798,1598
IT-VV,Vibo Valentia,77,33,583,8,49,0,0,0,673,55,367,9,327,0,0,0,758,1431
IT-VV,Vibo Valentia,78,29,480,17,50,0,0,0,576,42,290,8,266,0,0,0,606,1182
IT-VV,Vibo Valentia,79,24,418,4,61,0,0,0,507,32,230,5,263,0,0,0,530,1037
IT-VV,Vibo Valentia,80,24,350,8,69,0,0,0,451,50,224,8,287,0,0,0,569,1020
IT-VV,Vibo Valentia,81,14,361,6,67,0,0,0,448,26,206,8,308,0,0,0,548,996
IT-VV,Vibo Valentia,82,16,321,3,46,0,0,0,386,30,145,5,293,0,0,0,473,859
IT-VV,Vibo Valentia,83,24,371,10,79,0,0,0,484,43,197,4,345,0,0,0,589,1073
IT-VV,Vibo Valentia,84,24,343,5,77,0,0,0,449,38,167,1,352,0,0,0,558,1007
IT-VV,Vibo Valentia,85,13,276,2,76,0,0,0,367,55,130,4,338,0,0,0,527,894
IT-VV,Vibo Valentia,86,20,231,2,81,0,0,0,334,30,92,4,327,0,0,0,453,787
IT-VV,Vibo Valentia,87,12,183,2,73,0,0,0,270,31,92,1,292,0,0,0,416,686
IT-VV,Vibo Valentia,88,11,152,3,89,0,0,0,255,34,70,5,281,0,0,0,390,645
IT-VV,Vibo Valentia,89,11,138,3,56,0,0,0,208,20,56,2,262,0,0,0,340,548
IT-VV,Vibo Valentia,90,5,121,1,61,0,0,0,188,26,36,3,276,0,0,0,341,529
IT-VV,Vibo Valentia,91,4,82,0,48,0,0,0,134,21,30,1,207,0,0,0,259,393
IT-VV,Vibo Valentia,92,3,54,2,39,0,0,0,98,21,19,2,178,0,0,0,220,318
IT-VV,Vibo Valentia,93,1,44,0,44,0,0,0,89,19,20,0,149,0,0,0,188,277
IT-VV,Vibo Valentia,94,6,22,0,16,0,0,0,44,14,10,5,93,0,0,0,122,166
IT-VV,Vibo Valentia,95,1,14,0,24,0,0,0,39,12,4,0,90,0,0,0,106,145
IT-VV,Vibo Valentia,96,3,15,0,14,0,0,0,32,6,2,0,53,0,0,0,61,93
IT-VV,Vibo Valentia,97,2,7,0,14,0,0,0,23,7,0,1,35,0,0,0,43,66
IT-VV,Vibo Valentia,98,0,5,0,6,0,0,0,11,4,4,0,30,0,0,0,38,49
IT-VV,Vibo Valentia,99,1,5,0,4,0,0,0,10,3,4,0,14,0,0,0,21,31
IT-VV,Vibo Valentia,100,1,6,0,10,0,0,0,17,10,3,1,44,0,0,0,58,75
IT-VV,Vibo Valentia,999,35324,36327,984,1882,5,0,0,74522,28860,36526,1235,9342,1,0,0,75964,150486
IT-VI,Vicenza,0,2883,0,0,0,0,0,0,2883,2785,0,0,0,0,0,0,2785,5668
IT-VI,Vicenza,1,3084,0,0,0,0,0,0,3084,2956,0,0,0,0,0,0,2956,6040
IT-VI,Vicenza,2,3160,0,0,0,0,0,0,3160,3100,0,0,0,0,0,0,3100,6260
IT-VI,Vicenza,3,3254,0,0,0,0,0,0,3254,2938,0,0,0,0,0,0,2938,6192
IT-VI,Vicenza,4,3216,0,0,0,0,0,0,3216,3072,0,0,0,0,0,0,3072,6288
IT-VI,Vicenza,5,3442,0,0,0,0,0,0,3442,3166,0,0,0,0,0,0,3166,6608
IT-VI,Vicenza,6,3480,0,0,0,0,0,0,3480,3264,0,0,0,0,0,0,3264,6744
IT-VI,Vicenza,7,3555,0,0,0,0,0,0,3555,3387,0,0,0,0,0,0,3387,6942
IT-VI,Vicenza,8,3632,0,0,0,0,0,0,3632,3565,0,0,0,0,0,0,3565,7197
IT-VI,Vicenza,9,3899,0,0,0,0,0,0,3899,3649,0,0,0,0,0,0,3649,7548
IT-VI,Vicenza,10,3797,0,0,0,0,0,0,3797,3747,0,0,0,0,0,0,3747,7544
IT-VI,Vicenza,11,4008,0,0,0,0,0,0,4008,3945,0,0,0,0,0,0,3945,7953
IT-VI,Vicenza,12,4096,0,0,0,0,0,0,4096,3972,0,0,0,0,0,0,3972,8068
IT-VI,Vicenza,13,4285,0,0,0,0,0,0,4285,4005,0,0,0,0,0,0,4005,8290
IT-VI,Vicenza,14,4384,0,0,0,0,0,0,4384,4170,0,0,0,0,0,0,4170,8554
IT-VI,Vicenza,15,4518,0,0,0,0,0,0,4518,4206,0,0,0,0,0,0,4206,8724
IT-VI,Vicenza,16,4404,0,0,0,0,0,0,4404,4232,0,0,0,0,0,0,4232,8636
IT-VI,Vicenza,17,4507,0,0,0,0,0,0,4507,4221,0,0,0,0,0,0,4221,8728
IT-VI,Vicenza,18,4576,0,0,0,0,0,0,4576,4294,4,0,0,0,0,0,4298,8874
IT-VI,Vicenza,19,4772,1,0,0,0,0,0,4773,4367,11,0,0,0,0,0,4378,9151
IT-VI,Vicenza,20,4493,4,0,1,0,0,0,4498,4242,26,0,0,0,0,0,4268,8766
IT-VI,Vicenza,21,4591,10,0,0,0,0,0,4601,4289,71,1,0,0,0,0,4361,8962
IT-VI,Vicenza,22,4672,22,2,0,0,0,0,4696,4121,110,2,0,0,0,0,4233,8929
IT-VI,Vicenza,23,4811,30,1,0,1,0,0,4843,4227,180,3,0,1,0,0,4411,9254
IT-VI,Vicenza,24,4608,63,1,1,1,0,0,4674,4202,232,9,0,2,0,0,4445,9119
IT-VI,Vicenza,25,4774,115,8,0,2,0,0,4899,3971,356,6,1,1,0,0,4335,9234
IT-VI,Vicenza,26,4850,180,8,0,1,0,0,5039,3902,468,18,0,2,1,0,4391,9430
IT-VI,Vicenza,27,4603,222,8,0,1,0,0,4834,3693,597,14,0,0,0,0,4304,9138
IT-VI,Vicenza,28,4413,385,9,1,1,1,0,4810,3411,830,13,2,3,0,0,4259,9069
IT-VI,Vicenza,29,4169,500,11,0,0,0,0,4680,3158,998,19,2,7,0,0,4184,8864
IT-VI,Vicenza,30,4034,643,15,0,2,1,0,4695,3196,1184,33,4,2,0,0,4419,9114
IT-VI,Vicenza,31,4030,904,15,0,5,1,0,4955,2818,1527,43,0,11,0,0,4399,9354
IT-VI,Vicenza,32,3629,993,22,4,3,0,0,4651,2695,1666,46,3,8,0,0,4418,9069
IT-VI,Vicenza,33,3632,1197,45,1,8,0,0,4883,2471,1836,55,5,6,0,0,4373,9256
IT-VI,Vicenza,34,3266,1463,41,4,7,0,0,4781,2345,2052,94,5,5,0,0,4501,9282
IT-VI,Vicenza,35,3065,1591,45,4,9,0,0,4714,2173,2320,113,11,6,2,0,4625,9339
IT-VI,Vicenza,36,2779,1716,64,3,11,0,0,4573,1944,2263,104,11,8,0,0,4330,8903
IT-VI,Vicenza,37,2642,1914,58,5,8,2,0,4629,1861,2461,139,19,4,0,0,4484,9113
IT-VI,Vicenza,38,2596,2019,78,5,5,0,0,4703,1873,2547,173,21,8,2,0,4624,9327
IT-VI,Vicenza,39,2487,2167,112,1,9,2,0,4778,1794,2729,177,15,5,0,0,4720,9498
IT-VI,Vicenza,40,2401,2299,114,6,5,0,0,4825,1537,2877,197,34,4,1,0,4650,9475
IT-VI,Vicenza,41,2391,2448,132,6,7,0,0,4984,1614,3037,243,27,8,0,0,4929,9913
IT-VI,Vicenza,42,2261,2667,162,9,11,0,1,5111,1599,3146,260,54,4,0,0,5063,10174
IT-VI,Vicenza,43,2390,2706,183,15,7,0,0,5301,1469,3218,298,42,5,0,0,5032,10333
IT-VI,Vicenza,44,2126,2975,213,18,12,2,1,5347,1461,3477,323,52,8,0,0,5321,10668
IT-VI,Vicenza,45,2280,3262,239,14,16,0,0,5811,1538,3706,427,52,2,1,0,5726,11537
IT-VI,Vicenza,46,2379,3362,300,12,15,1,0,6069,1501,3916,442,75,0,1,0,5935,12004
IT-VI,Vicenza,47,2230,3554,326,27,7,0,0,6144,1349,4131,541,89,3,0,0,6113,12257
IT-VI,Vicenza,48,2333,3793,359,30,7,2,1,6525,1412,4304,576,88,3,0,0,6383,12908
IT-VI,Vicenza,49,2385,4265,402,13,8,0,0,7073,1357,4710,609,113,2,0,0,6791,13864
IT-VI,Vicenza,50,2202,4215,438,35,14,0,0,6904,1322,4728,664,131,2,1,0,6848,13752
IT-VI,Vicenza,51,2055,4496,534,43,13,1,0,7142,1254,4846,654,163,5,0,0,6922,14064
IT-VI,Vicenza,52,2018,4636,537,45,6,0,0,7242,1260,4961,733,166,3,0,1,7124,14366
IT-VI,Vicenza,53,1845,4836,584,41,10,0,0,7316,1104,4959,712,185,3,0,0,6963,14279
IT-VI,Vicenza,54,1757,4984,616,50,9,0,0,7416,1151,5178,721,201,2,0,0,7253,14669
IT-VI,Vicenza,55,1705,4995,587,53,7,0,0,7347,1159,5157,723,241,1,0,0,7281,14628
IT-VI,Vicenza,56,1575,5237,623,73,8,0,1,7517,975,5190,729,249,4,1,0,7148,14665
IT-VI,Vicenza,57,1489,5326,644,82,11,1,0,7553,904,5364,732,283,2,1,0,7286,14839
IT-VI,Vicenza,58,1376,5425,646,67,8,0,0,7522,834,5256,776,357,2,0,0,7225,14747
IT-VI,Vicenza,59,1241,5312,680,99,5,0,0,7337,848,5349,740,358,2,0,0,7297,14634
IT-VI,Vicenza,60,1056,5012,599,95,3,0,0,6765,740,5019,674,366,2,0,0,6801,13566
IT-VI,Vicenza,61,945,4931,566,100,5,0,0,6547,700,4750,624,417,4,0,0,6495,13042
IT-VI,Vicenza,62,906,4763,538,113,3,0,0,6323,639,4567,558,481,1,0,0,6246,12569
IT-VI,Vicenza,63,768,4598,460,123,9,0,0,5958,580,4408,532,491,1,0,0,6012,11970
IT-VI,Vicenza,64,722,4480,434,121,5,0,0,5762,515,4191,480,585,0,0,0,5771,11533
IT-VI,Vicenza,65,625,4115,386,135,3,0,0,5264,439,3940,422,594,1,0,0,5396,10660
IT-VI,Vicenza,66,572,4068,333,174,2,0,0,5149,436,3738,401,654,2,0,0,5231,10380
IT-VI,Vicenza,67,530,3802,314,169,7,0,0,4822,413,3698,341,670,0,0,0,5122,9944
IT-VI,Vicenza,68,503,3778,285,186,2,0,1,4755,329,3504,315,768,2,0,0,4918,9673
IT-VI,Vicenza,69,486,3727,257,200,3,0,0,4673,310,3313,321,832,0,0,0,4776,9449
IT-VI,Vicenza,70,402,3539,234,198,2,0,0,4375,290,3293,262,893,1,0,0,4739,9114
IT-VI,Vicenza,71,389,3503,209,216,1,0,0,4318,297,3158,248,932,2,0,0,4637,8955
IT-VI,Vicenza,72,399,3545,187,215,4,0,0,4350,260,3082,211,975,0,0,1,4529,8879
IT-VI,Vicenza,73,364,3543,201,265,1,0,2,4376,298,3187,217,1147,1,0,0,4850,9226
IT-VI,Vicenza,74,310,3466,166,260,1,0,0,4203,264,2963,178,1302,0,0,0,4707,8910
IT-VI,Vicenza,75,334,3383,164,284,0,0,0,4165,321,2959,193,1384,1,0,0,4858,9023
IT-VI,Vicenza,76,289,3098,114,299,1,0,0,3801,293,2646,176,1479,1,0,0,4595,8396
IT-VI,Vicenza,77,301,3471,135,335,2,0,0,4244,286,2824,176,1800,1,0,0,5087,9331
IT-VI,Vicenza,78,203,2252,96,246,2,0,0,2799,188,1797,116,1361,0,0,0,3462,6261
IT-VI,Vicenza,79,238,2502,80,317,1,0,0,3138,228,1849,112,1721,0,0,0,3910,7048
IT-VI,Vicenza,80,198,2456,72,349,1,0,0,3076,246,1852,110,1888,0,0,0,4096,7172
IT-VI,Vicenza,81,211,2252,75,395,1,0,0,2934,248,1594,95,1883,0,0,0,3820,6754
IT-VI,Vicenza,82,209,2020,67,419,1,0,0,2716,233,1352,76,1981,0,0,0,3642,6358
IT-VI,Vicenza,83,177,2061,59,470,0,0,0,2767,245,1269,70,2222,0,0,0,3806,6573
IT-VI,Vicenza,84,171,1902,34,479,0,0,0,2586,221,1029,78,2193,0,0,0,3521,6107
IT-VI,Vicenza,85,146,1626,27,425,0,0,0,2224,235,843,58,2207,0,0,0,3343,5567
IT-VI,Vicenza,86,93,1285,24,356,0,0,0,1758,209,619,51,1909,0,0,0,2788,4546
IT-VI,Vicenza,87,93,927,14,349,0,0,0,1383,175,448,26,1798,0,0,0,2447,3830
IT-VI,Vicenza,88,75,850,16,329,0,0,0,1270,185,312,22,1748,0,0,0,2267,3537
IT-VI,Vicenza,89,61,698,15,292,0,0,0,1066,179,240,21,1626,0,0,0,2066,3132
IT-VI,Vicenza,90,46,489,4,261,0,0,0,800,136,148,21,1331,0,0,0,1636,2436
IT-VI,Vicenza,91,45,344,3,213,0,0,0,605,127,116,15,1227,0,0,0,1485,2090
IT-VI,Vicenza,92,31,285,4,189,0,0,0,509,99,66,10,1086,0,0,0,1261,1770
IT-VI,Vicenza,93,23,197,3,159,0,0,0,382,101,48,10,902,0,0,0,1061,1443
IT-VI,Vicenza,94,18,125,1,105,0,0,0,249,72,31,6,616,0,0,0,725,974
IT-VI,Vicenza,95,12,77,1,98,0,0,0,188,51,26,3,559,0,0,0,639,827
IT-VI,Vicenza,96,10,59,0,68,0,0,0,137,51,9,2,409,0,0,0,471,608
IT-VI,Vicenza,97,4,28,0,43,0,0,0,75,31,4,2,283,0,0,0,320,395
IT-VI,Vicenza,98,0,10,0,27,0,0,0,37,32,2,0,217,0,0,0,251,288
IT-VI,Vicenza,99,4,3,0,22,0,0,0,29,23,1,2,125,0,0,0,151,180
IT-VI,Vicenza,100,0,13,1,24,0,0,0,38,46,4,1,200,0,0,0,251,289
IT-VI,Vicenza,999,207504,190215,15040,9891,320,14,7,422991,171846,190877,19398,48321,164,11,2,430619,853610
IT-VT,Viterbo,0,877,0,0,0,0,0,0,877,812,0,0,0,0,0,0,812,1689
IT-VT,Viterbo,1,907,0,0,0,0,0,0,907,900,0,0,0,0,0,0,900,1807
IT-VT,Viterbo,2,933,0,0,0,0,0,0,933,915,0,0,0,0,0,0,915,1848
IT-VT,Viterbo,3,948,0,0,0,0,0,0,948,920,0,0,0,0,0,0,920,1868
IT-VT,Viterbo,4,1019,0,0,0,0,0,0,1019,946,0,0,0,0,0,0,946,1965
IT-VT,Viterbo,5,1150,0,0,0,0,0,0,1150,1048,0,0,0,0,0,0,1048,2198
IT-VT,Viterbo,6,1159,0,0,0,0,0,0,1159,1064,0,0,0,0,0,0,1064,2223
IT-VT,Viterbo,7,1189,0,0,0,0,0,0,1189,1146,0,0,0,0,0,0,1146,2335
IT-VT,Viterbo,8,1190,0,0,0,0,0,0,1190,1223,0,0,0,0,0,0,1223,2413
IT-VT,Viterbo,9,1284,0,0,0,0,0,0,1284,1229,0,0,0,0,0,0,1229,2513
IT-VT,Viterbo,10,1291,0,0,0,0,0,0,1291,1209,0,0,0,0,0,0,1209,2500
IT-VT,Viterbo,11,1340,0,0,0,0,0,0,1340,1275,0,0,0,0,0,0,1275,2615
IT-VT,Viterbo,12,1393,0,0,0,0,0,0,1393,1280,0,0,0,0,0,0,1280,2673
IT-VT,Viterbo,13,1383,0,0,0,0,0,0,1383,1342,0,0,0,0,0,0,1342,2725
IT-VT,Viterbo,14,1444,0,0,0,0,0,0,1444,1348,0,0,0,0,0,0,1348,2792
IT-VT,Viterbo,15,1482,0,0,0,0,0,0,1482,1429,0,0,0,0,0,0,1429,2911
IT-VT,Viterbo,16,1445,0,0,0,0,0,0,1445,1314,0,0,0,0,0,0,1314,2759
IT-VT,Viterbo,17,1437,0,0,0,0,0,0,1437,1440,0,0,0,0,0,0,1440,2877
IT-VT,Viterbo,18,1410,0,0,0,0,0,0,1410,1318,1,0,0,1,0,0,1320,2730
IT-VT,Viterbo,19,1465,1,0,0,0,0,0,1466,1292,3,0,0,0,0,0,1295,2761
IT-VT,Viterbo,20,1448,0,0,0,0,0,0,1448,1256,8,0,0,0,0,0,1264,2712
IT-VT,Viterbo,21,1437,3,0,0,0,0,0,1440,1311,14,0,0,0,0,0,1325,2765
IT-VT,Viterbo,22,1458,5,2,0,1,0,0,1466,1348,21,0,0,0,0,0,1369,2835
IT-VT,Viterbo,23,1468,9,0,0,0,0,0,1477,1315,32,1,0,0,0,0,1348,2825
IT-VT,Viterbo,24,1470,12,0,0,0,0,0,1482,1276,50,0,0,1,0,0,1327,2809
IT-VT,Viterbo,25,1571,17,2,0,0,0,0,1590,1253,75,0,0,0,0,0,1328,2918
IT-VT,Viterbo,26,1460,43,1,0,1,0,0,1505,1281,107,2,0,0,0,0,1390,2895
IT-VT,Viterbo,27,1485,55,1,0,0,0,0,1541,1213,134,1,0,1,0,0,1349,2890
IT-VT,Viterbo,28,1478,88,3,0,0,0,0,1569,1200,168,2,0,0,0,0,1370,2939
IT-VT,Viterbo,29,1402,106,1,0,0,0,0,1509,1151,238,6,0,0,0,0,1395,2904
IT-VT,Viterbo,30,1458,123,2,1,1,0,0,1585,1078,282,3,0,1,0,0,1364,2949
IT-VT,Viterbo,31,1455,218,5,0,0,0,0,1678,1069,367,13,1,1,0,0,1451,3129
IT-VT,Viterbo,32,1351,253,8,2,2,0,0,1616,988,429,14,1,3,1,0,1436,3052
IT-VT,Viterbo,33,1380,337,4,0,1,0,0,1722,1057,535,15,4,1,0,0,1612,3334
IT-VT,Viterbo,34,1281,373,9,1,3,0,0,1667,951,593,23,0,0,0,0,1567,3234
IT-VT,Viterbo,35,1257,460,18,2,1,0,0,1738,953,709,42,3,3,2,0,1712,3450
IT-VT,Viterbo,36,1219,555,11,1,2,0,0,1788,883,740,33,0,0,0,0,1656,3444
IT-VT,Viterbo,37,1116,568,26,0,2,0,0,1712,800,804,55,10,1,0,0,1670,3382
IT-VT,Viterbo,38,1138,654,22,1,3,0,0,1818,786,913,48,11,4,0,0,1762,3580
IT-VT,Viterbo,39,1107,732,38,2,5,0,0,1884,776,930,64,8,0,0,0,1778,3662
IT-VT,Viterbo,40,1013,773,27,2,4,0,0,1819,781,1037,67,15,3,0,0,1903,3722
IT-VT,Viterbo,41,975,954,35,2,2,0,0,1968,773,1146,88,20,3,0,0,2030,3998
IT-VT,Viterbo,42,953,1021,59,4,0,0,0,2037,707,1199,101,19,0,0,0,2026,4063
IT-VT,Viterbo,43,938,990,60,4,2,0,0,1994,661,1194,95,15,2,0,0,1967,3961
IT-VT,Viterbo,44,921,1145,78,5,2,0,0,2151,651,1276,135,18,1,0,0,2081,4232
IT-VT,Viterbo,45,887,1248,90,4,2,0,0,2231,631,1437,147,30,1,0,0,2246,4477
IT-VT,Viterbo,46,887,1325,106,3,6,0,0,2327,568,1437,172,32,5,0,0,2214,4541
IT-VT,Viterbo,47,866,1371,110,7,3,0,0,2357,547,1541,188,32,1,0,0,2309,4666
IT-VT,Viterbo,48,872,1523,135,6,5,1,0,2542,566,1657,217,46,2,0,0,2488,5030
IT-VT,Viterbo,49,819,1547,149,6,4,0,0,2525,545,1705,230,49,1,0,0,2530,5055
IT-VT,Viterbo,50,749,1534,161,8,4,0,0,2456,502,1731,257,47,1,0,0,2538,4994
IT-VT,Viterbo,51,667,1619,157,12,1,0,0,2456,462,1780,265,56,0,0,0,2563,5019
IT-VT,Viterbo,52,656,1578,194,14,5,0,1,2448,421,1800,234,77,2,0,0,2534,4982
IT-VT,Viterbo,53,590,1654,206,24,5,0,0,2479,403,1764,243,78,3,0,0,2491,4970
IT-VT,Viterbo,54,530,1717,202,18,2,0,0,2469,403,1829,271,94,1,0,0,2598,5067
IT-VT,Viterbo,55,509,1768,196,31,5,0,0,2509,360,1836,265,107,3,0,0,2571,5080
IT-VT,Viterbo,56,483,1803,228,21,4,1,0,2540,339,1882,271,132,1,0,0,2625,5165
IT-VT,Viterbo,57,468,1912,244,35,6,0,0,2665,342,1852,256,125,0,0,0,2575,5240
IT-VT,Viterbo,58,452,1886,242,34,4,0,0,2618,336,1886,258,167,2,0,0,2649,5267
IT-VT,Viterbo,59,432,1922,230,33,6,0,0,2623,288,1880,267,173,0,0,0,2608,5231
IT-VT,Viterbo,60,351,1834,208,48,0,0,0,2441,257,1821,227,177,0,0,0,2482,4923
IT-VT,Viterbo,61,324,1776,218,47,4,0,0,2369,226,1756,221,208,1,0,0,2412,4781
IT-VT,Viterbo,62,267,1761,193,53,7,0,0,2281,215,1767,190,217,1,0,0,2390,4671
IT-VT,Viterbo,63,256,1713,158,66,3,0,0,2196,198,1707,191,253,1,0,0,2350,4546
IT-VT,Viterbo,64,251,1697,170,57,1,0,0,2176,187,1602,192,252,1,0,0,2234,4410
IT-VT,Viterbo,65,225,1674,151,68,2,0,0,2120,159,1577,159,291,0,0,0,2186,4306
IT-VT,Viterbo,66,201,1587,169,68,1,0,0,2026,176,1572,155,333,0,0,0,2236,4262
IT-VT,Viterbo,67,190,1592,119,78,2,0,0,1981,150,1519,160,342,1,0,0,2172,4153
IT-VT,Viterbo,68,196,1589,132,103,2,0,0,2022,152,1449,144,369,0,0,0,2114,4136
IT-VT,Viterbo,69,177,1622,110,89,1,0,0,1999,120,1490,141,393,1,0,0,2145,4144
IT-VT,Viterbo,70,155,1534,109,90,2,0,0,1890,124,1339,102,425,0,0,0,1990,3880
IT-VT,Viterbo,71,117,1491,82,89,1,0,0,1780,134,1265,115,409,2,0,0,1925,3705
IT-VT,Viterbo,72,127,1356,122,83,2,0,0,1690,102,1187,110,467,2,0,0,1868,3558
IT-VT,Viterbo,73,126,1459,104,126,2,0,0,1817,81,1138,99,512,0,0,0,1830,3647
IT-VT,Viterbo,74,138,1368,99,129,0,0,0,1734,107,1186,80,600,0,0,0,1973,3707
IT-VT,Viterbo,75,122,1457,69,142,1,0,0,1791,93,1161,75,636,1,0,0,1966,3757
IT-VT,Viterbo,76,120,1441,74,153,2,0,0,1790,90,1144,69,687,0,0,0,1990,3780
IT-VT,Viterbo,77,112,1264,59,156,2,0,0,1593,80,980,71,748,0,0,0,1879,3472
IT-VT,Viterbo,78,61,1003,40,137,0,0,0,1241,77,701,46,682,0,0,0,1506,2747
IT-VT,Viterbo,79,70,956,49,152,0,0,1,1228,67,691,42,675,0,0,0,1475,2703
IT-VT,Viterbo,80,50,890,35,145,1,0,0,1121,77,569,45,703,0,0,0,1394,2515
IT-VT,Viterbo,81,51,774,33,140,0,0,0,998,50,529,36,690,0,0,0,1305,2303
IT-VT,Viterbo,82,52,767,33,137,0,0,0,989,60,464,25,728,0,0,0,1277,2266
IT-VT,Viterbo,83,52,719,17,190,0,0,0,978,73,418,31,908,0,0,0,1430,2408
IT-VT,Viterbo,84,45,690,15,187,0,0,0,937,58,336,22,893,0,0,0,1309,2246
IT-VT,Viterbo,85,35,593,18,176,0,0,0,822,57,311,21,821,0,0,0,1210,2032
IT-VT,Viterbo,86,32,465,12,175,0,0,0,684,51,232,21,808,0,0,0,1112,1796
IT-VT,Viterbo,87,30,382,9,133,0,0,0,554,47,170,11,717,0,0,0,945,1499
IT-VT,Viterbo,88,29,313,5,145,0,0,0,492,31,133,13,659,0,0,0,836,1328
IT-VT,Viterbo,89,13,256,1,122,0,0,0,392,24,94,8,631,0,0,0,757,1149
IT-VT,Viterbo,90,12,206,3,118,0,0,0,339,25,66,4,555,0,0,0,650,989
IT-VT,Viterbo,91,11,148,4,97,0,0,0,260,32,50,11,435,0,0,0,528,788
IT-VT,Viterbo,92,11,81,3,77,0,0,0,172,17,27,2,381,0,0,0,427,599
IT-VT,Viterbo,93,5,85,2,55,0,0,0,147,14,19,1,369,0,0,0,403,550
IT-VT,Viterbo,94,4,39,0,55,0,0,0,98,17,20,3,244,0,0,0,284,382
IT-VT,Viterbo,95,3,30,0,32,0,0,0,65,7,6,2,189,0,0,0,204,269
IT-VT,Viterbo,96,6,15,0,34,0,0,0,55,6,5,0,157,0,0,0,168,223
IT-VT,Viterbo,97,1,13,0,13,0,0,0,27,5,4,0,97,0,0,0,106,133
IT-VT,Viterbo,98,1,3,0,9,0,0,0,13,5,2,1,71,0,0,0,79,92
IT-VT,Viterbo,99,0,5,0,7,0,0,0,12,4,2,0,37,0,0,0,43,55
IT-VT,Viterbo,100,0,5,0,3,0,0,0,8,6,2,0,90,0,0,0,98,106
IT-VT,Viterbo,999,70881,70555,5687,4267,130,2,2,151524,59142,69533,7195,20229,60,3,0,156162,307686
